county_nam,mydate,deaths,fhwa_numbe,fips,positive,negative,recoveries,total_tests,active_cases,pop_5yr_est_2018,confirmed_pos,probable_pos,confirmed_neg,probable_neg,confirmed_recov,probable_recov,confirmed_death,probable_death,confirmed_active,probable_active,pcr_test,antigen_test,pcr_pos_test,pcr_neg_test,antigen_pos_test,antigen_neg_test,total_pos_test,total_neg_test,New_Cases_Today,Recovered_Since_Yesterday,New_Deaths_Today,New_Tests_Dashboard
Arkansas_all_counties,1/7/21,3926,5630,5630,245916,2149933,215980,2404053,25984,2990671,200531,45385,1928699,221234,179718,36262,3273,653,17517,8467,2129230,274823,200531,1928699,53589,221234,254120,2149933,3323,2406,25,18001
Arkansas_county,1/7/21,33,1,1,1420,14943,1242,16455,145,18124,1016,404,11420,3523,920,322,27,6,69,76,12436,4019,1016,11420,496,3523,1512,14943,21,16,0,129
Ashley,1/7/21,21,3,3,1355,11113,1218,12507,116,20537,1133,222,10345,768,1037,181,19,2,77,39,11478,1029,1133,10345,261,768,1394,11113,11,11,0,62
Baxter,1/7/21,74,5,5,2292,14398,1948,16716,270,41219,1599,693,12738,1660,1407,541,47,27,145,125,14337,2379,1599,12738,719,1660,2318,14398,28,27,2,94
Benton,1/7/21,286,7,7,19981,140393,17316,161060,2378,258980,15421,4560,132089,8304,13690,3626,222,64,1508,870,147510,13550,15421,132089,5246,8304,20667,140393,347,220,5,1043
Boone,1/7/21,70,9,9,2762,23586,2478,26475,212,37288,2213,549,21786,1800,2032,446,59,11,120,92,23999,2476,2213,21786,676,1800,2889,23586,30,27,1,173
Bradley,1/7/21,17,11,11,1040,7809,898,8874,125,10948,816,224,5291,2518,708,190,9,8,99,26,6107,2767,816,5291,249,2518,1065,7809,12,15,0,28
Calhoun,1/7/21,1,13,13,257,2888,229,3164,27,5202,206,51,2684,204,188,41,1,0,17,10,2890,274,206,2684,70,204,276,2888,5,4,0,22
Carroll,1/7/21,31,15,15,2225,14389,2017,16660,177,27887,1925,300,14022,367,1774,243,28,3,123,54,15947,713,1925,14022,346,367,2271,14389,35,18,0,131
Chicot,1/7/21,32,17,17,1452,10475,1374,11952,46,10826,1341,111,8700,1775,1278,96,31,1,32,14,10041,1911,1341,8700,136,1775,1477,10475,7,10,0,420
Clark,1/7/21,24,19,19,1483,18093,1300,19642,159,22385,1229,254,15328,2765,1091,209,21,3,117,42,16557,3085,1229,15328,320,2765,1549,18093,15,17,0,118
Clay,1/7/21,35,21,21,1396,13100,1243,14537,117,15061,1077,319,9980,3120,978,265,26,9,72,45,11057,3480,1077,9980,360,3120,1437,13100,13,7,0,44
Cleburne,1/7/21,40,23,23,1436,15875,1142,17389,254,25230,1064,372,13059,2816,856,286,37,3,171,83,14123,3266,1064,13059,450,2816,1514,15875,40,22,0,137
Cleveland,1/7/21,21,25,25,615,6746,531,7390,63,8226,419,196,6069,677,364,167,17,4,38,25,6488,902,419,6069,225,677,644,6746,8,10,0,42
Columbia,1/7/21,43,27,27,1669,14297,1505,16106,121,23892,1074,595,11316,2981,1003,502,30,13,41,80,12390,3716,1074,11316,735,2981,1809,14297,9,14,0,70
Conway,1/7/21,18,29,29,1549,15386,1245,16991,286,20906,1220,329,13169,2217,987,258,14,4,219,67,14389,2602,1220,13169,385,2217,1605,15386,30,24,0,111
Craighead,1/7/21,143,31,31,10718,82995,9665,93985,909,105701,9499,1219,73321,9674,8601,1064,130,13,767,142,82820,11165,9499,73321,1491,9674,10990,82995,107,82,0,511
Crawford,1/7/21,66,33,33,4917,47030,4282,52019,568,62472,4117,800,45150,1880,3705,577,56,10,355,213,49267,2752,4117,45150,872,1880,4989,47030,48,60,0,169
Crittenden,1/7/21,77,35,35,4565,29281,4193,33948,294,49013,4270,295,27490,1791,3952,241,66,11,251,43,31760,2188,4270,27490,397,1791,4667,29281,34,26,0,431
Cross,1/7/21,37,37,37,1563,12129,1338,13745,188,16998,1246,317,11381,748,1079,259,35,2,132,56,12627,1118,1246,11381,370,748,1616,12129,28,20,0,92
Dallas,1/7/21,11,39,39,524,5017,457,5549,56,7432,476,48,4775,242,421,36,9,2,46,10,5251,298,476,4775,56,242,532,5017,8,4,0,19
Desha,1/7/21,11,41,41,1008,8330,906,9392,91,11887,841,167,7322,1008,772,134,10,1,59,32,8163,1229,841,7322,221,1008,1062,8330,9,6,0,102
Drew,1/7/21,22,43,43,1567,13695,1396,15302,149,18502,1247,320,11812,1883,1115,281,18,4,114,35,13059,2243,1247,11812,360,1883,1607,13695,23,11,0,73
Faulkner,1/7/21,97,45,45,8591,86144,7286,95131,1207,122416,6826,1765,74862,11282,5992,1294,81,16,752,455,81688,13443,6826,74862,2161,11282,8987,86144,141,106,0,819
Franklin,1/7/21,26,47,47,1192,13924,1061,15152,105,17780,954,238,13182,742,872,189,22,4,60,45,14136,1016,954,13182,274,742,1228,13924,12,18,0,98
Fulton,1/7/21,36,49,49,959,4776,817,5770,106,12139,681,278,3757,1019,603,214,16,20,62,44,4438,1332,681,3757,313,1019,994,4776,13,21,0,38
Garland,1/7/21,164,51,51,6520,63348,5464,70045,890,98296,5550,970,58049,5299,4752,712,139,25,657,233,63599,6446,5550,58049,1147,5299,6697,63348,135,94,1,596
Grant,1/7/21,15,53,53,1162,11589,1009,12802,138,18086,844,318,9895,1694,762,247,14,1,68,70,10739,2063,844,9895,369,1694,1213,11589,7,27,1,44
Greene,1/7/21,55,55,55,4734,33837,4300,38723,379,44623,3817,917,29716,4121,3493,807,45,10,279,100,33533,5190,3817,29716,1069,4121,4886,33837,53,39,0,183
Hempstead,1/7/21,11,57,57,1331,11590,1211,12967,108,22018,1044,287,10871,719,952,259,7,4,84,24,11915,1052,1044,10871,333,719,1377,11590,25,11,0,113
HotSpring,1/7/21,58,59,59,3843,34405,3472,38313,313,33520,3568,275,28636,5769,3256,216,54,4,258,55,32204,6109,3568,28636,340,5769,3908,34405,48,52,0,241
Howard,1/7/21,18,61,61,1169,7741,1083,8971,68,13389,835,334,6099,1642,784,299,16,2,35,33,6934,2037,835,6099,395,1642,1230,7741,6,9,0,101
Independence,1/7/21,95,63,63,3015,26646,2616,29802,304,37264,2087,928,22658,3988,1883,733,72,23,132,172,24745,5057,2087,22658,1069,3988,3156,26646,41,22,0,273
Izard,1/7/21,19,65,65,1411,11771,1228,13263,164,13559,1114,297,8963,2808,1016,212,13,6,85,79,10077,3186,1114,8963,378,2808,1492,11771,10,19,1,67
Jackson,1/7/21,24,67,67,2901,19638,2760,22747,117,17225,2314,587,16018,3620,2227,533,18,6,69,48,18332,4415,2314,16018,795,3620,3109,19638,35,7,0,119
Jefferson,1/7/21,133,69,69,7043,64812,6432,72135,476,70424,5862,1181,57511,7301,5544,888,113,20,203,273,63373,8762,5862,57511,1461,7301,7323,64812,51,51,0,614
Johnson,1/7/21,20,71,71,2048,17473,1791,19552,237,26291,1745,303,16608,865,1551,240,17,3,177,60,18353,1199,1745,16608,334,865,2079,17473,24,41,0,84
Lafayette,1/7/21,4,73,73,365,2477,335,2867,25,6915,271,94,2235,242,250,85,4,0,17,8,2506,361,271,2235,119,242,390,2477,4,3,0,23
Lawrence,1/7/21,36,75,75,1683,10600,1513,12355,134,16669,1388,295,9803,797,1260,253,33,3,95,39,11191,1164,1388,9803,367,797,1755,10600,16,16,0,72
Lee,1/7/21,27,77,77,1496,8680,1392,10193,77,9398,1412,84,7918,762,1336,56,26,1,50,27,9330,863,1412,7918,101,762,1513,8680,7,5,1,151
Lincoln,1/7/21,27,79,79,2877,17409,2771,20343,78,13695,2640,237,13429,3980,2573,198,21,6,45,33,16069,4274,2640,13429,294,3980,2934,17409,11,12,0,1221
LittleRiver,1/7/21,39,81,81,876,5713,760,6619,77,12417,704,172,5046,667,608,152,37,2,59,18,5750,869,704,5046,202,667,906,5713,12,9,0,219
Logan,1/7/21,13,83,83,1575,19168,1376,20791,186,21757,1261,314,16235,2933,1162,214,11,2,88,98,17496,3295,1261,16235,362,2933,1623,19168,15,15,0,98
Lonoke,1/7/21,87,85,85,4710,46653,3925,51629,698,72206,3396,1314,39246,7407,2913,1012,74,13,409,289,42642,8987,3396,39246,1580,7407,4976,46653,110,41,0,413
Madison,1/7/21,13,87,87,1114,9590,993,10739,108,16076,880,234,8951,639,799,194,11,2,70,38,9831,908,880,8951,269,639,1149,9590,15,4,0,77
Marion,1/7/21,24,89,89,707,7160,599,7897,84,16438,516,191,6442,718,458,141,11,13,47,37,6958,939,516,6442,221,718,737,7160,16,8,0,52
Miller,1/7/21,25,91,91,2891,15108,2702,18091,164,43759,2070,821,12948,2160,1913,789,17,8,140,24,15018,3073,2070,12948,913,2160,2983,15108,9,25,0,132
MissingCountyInfo,1/7/21,0,5,5,2763,95266,2464,98039,299,NA,2233,530,95193,73,2036,428,0,0,197,102,97426,613,2233,95193,540,73,2773,95266,75,15,0,205
Mississippi,1/7/21,98,93,93,4615,27889,4242,32583,274,42831,4166,449,20245,7644,3838,404,83,15,244,30,24411,8172,4166,20245,528,7644,4694,27889,33,40,1,225
Monroe,1/7/21,9,95,95,532,5321,444,5868,79,7249,446,86,5035,286,375,69,9,0,62,17,5481,387,446,5035,101,286,547,5321,5,7,0,31
Montgomery,1/7/21,21,97,97,550,5441,455,6004,74,8993,407,143,3453,1988,371,84,16,5,20,54,3860,2144,407,3453,156,1988,563,5441,15,3,1,115
Nevada,1/7/21,22,99,99,617,9038,564,9667,31,8440,529,88,8696,342,488,76,21,1,20,11,9225,442,529,8696,100,342,629,9038,1,3,1,27
Newton,1/7/21,24,101,101,592,4869,533,5475,35,7848,498,94,3051,1818,459,74,20,4,19,16,3549,1926,498,3051,108,1818,606,4869,9,5,0,82
Ouachita,1/7/21,34,103,103,1526,12924,1309,14506,182,24106,1317,209,12165,759,1142,167,26,8,148,34,13482,1024,1317,12165,265,759,1582,12924,48,22,0,143
Perry,1/7/21,5,105,105,518,8568,409,9107,104,10322,423,95,7991,577,344,65,4,1,75,29,8414,693,423,7991,116,577,539,8568,3,4,0,36
Phillips,1/7/21,25,107,107,1362,13512,1228,14912,109,19034,1268,94,13143,369,1146,82,24,1,98,11,14411,501,1268,13143,132,369,1400,13512,32,10,0,110
Pike,1/7/21,12,109,109,753,5676,662,6470,79,10808,597,156,5076,600,539,123,8,4,50,29,5673,797,597,5076,197,600,794,5676,10,13,0,87
Poinsett,1/7/21,64,111,111,2557,19213,2273,21846,220,24054,2286,271,18211,1002,2045,228,51,13,190,30,20497,1349,2286,18211,347,1002,2633,19213,39,27,0,157
Polk,1/7/21,48,113,113,1383,9741,1170,11152,164,20163,1208,175,9214,527,1039,131,35,13,133,31,10422,730,1208,9214,203,527,1411,9741,10,17,0,33
Pope,1/7/21,64,115,115,6001,50732,5304,56824,633,63644,4931,1070,48368,2364,4439,865,52,12,440,193,53299,3525,4931,48368,1161,2364,6092,50732,104,97,0,378
Prairie,1/7/21,17,117,117,592,5089,501,5718,74,8244,434,158,4338,751,372,129,12,5,50,24,4772,946,434,4338,195,751,629,5089,7,7,0,44
Pulaski,1/7/21,415,119,119,27300,285720,23246,313767,3637,393463,24129,3171,264096,21624,20779,2467,380,35,2968,669,288225,25542,24129,264096,3918,21624,28047,285720,472,247,3,2599
Randolph,1/7/21,43,121,121,1578,13293,1374,14942,161,17603,1241,337,11400,1893,1108,266,32,11,101,60,12641,2301,1241,11400,408,1893,1649,13293,7,15,0,184
Saline,1/7/21,116,125,125,8427,75120,7304,83920,1006,118009,6534,1893,63421,11699,5743,1561,100,16,690,316,69955,13965,6534,63421,2266,11699,8800,75120,132,80,4,582
Scott,1/7/21,13,127,127,675,7745,536,8440,126,10442,463,212,7414,331,402,134,13,0,48,78,7877,563,463,7414,232,331,695,7745,19,10,1,82
Searcy,1/7/21,13,129,129,533,4742,481,5302,39,7923,328,205,3897,845,309,172,7,6,12,27,4225,1077,328,3897,232,845,560,4742,3,4,0,10
Sebastian,1/7/21,161,131,131,10608,100612,9147,111368,1297,127461,8637,1971,96549,4063,7770,1377,148,13,717,580,105186,6182,8637,96549,2119,4063,10756,100612,118,96,0,407
Sevier,1/7/21,20,133,133,2151,11551,2056,13788,75,17193,1571,580,9753,1798,1528,528,19,1,24,51,11324,2464,1571,9753,666,1798,2237,11551,16,13,0,74
Sharp,1/7/21,35,135,135,1255,11545,1072,12868,148,17043,878,377,9773,1772,782,290,26,9,70,78,10651,2217,878,9773,445,1772,1323,11545,13,18,0,144
St.Francis,1/7/21,21,123,123,2891,23088,2682,26008,188,26294,2739,152,22628,460,2558,124,21,0,160,28,25367,641,2739,22628,181,460,2920,23088,21,22,1,183
Stone,1/7/21,27,137,137,808,7594,711,8435,70,12446,629,179,6663,931,575,136,24,3,30,40,7292,1143,629,6663,212,931,841,7594,6,2,0,70
Union,1/7/21,74,139,139,2667,19425,2314,22223,279,39732,2065,602,16282,3143,1772,542,56,18,237,42,18347,3876,2065,16282,733,3143,2798,19425,42,48,0,215
VanBuren,1/7/21,9,141,141,839,10440,721,11351,109,16684,593,246,8840,1600,528,193,8,1,57,52,9433,1918,593,8840,318,1600,911,10440,17,8,0,119
Washington,1/7/21,234,143,143,23370,169174,20828,193434,2307,228529,18401,4969,148622,20552,16769,4059,191,43,1441,866,167023,26411,18401,148622,5859,20552,24260,169174,287,194,0,1363
White,1/7/21,72,145,145,5410,36571,4513,42329,824,78804,3681,1729,30333,6238,3194,1319,62,10,424,400,34014,8315,3681,30333,2077,6238,5758,36571,63,45,0,218
Woodruff,1/7/21,2,147,147,427,5427,328,5897,97,6660,349,78,5074,353,266,62,1,1,82,15,5423,474,349,5074,121,353,470,5427,11,0,0,87
Yell,1/7/21,49,149,149,2609,22387,2290,25055,270,21573,2322,287,21450,937,2085,205,40,9,197,73,23772,1283,2322,21450,346,937,2668,22387,21,28,1,122
Arkansas_all_counties,1/6/21,3901,5630,5630,242593,2135255,213574,2385951,25092,2990671,198254,44339,1919438,215817,178025,35549,3252,649,16954,8138,2117692,268259,198254,1919438,52442,215817,250696,2135255,3705,2957,65,19588
Arkansas_county,1/6/21,33,1,1,1399,14835,1226,16326,140,18124,1002,397,11370,3465,909,317,27,6,66,74,12372,3954,1002,11370,489,3465,1491,14835,30,12,1,117
Ashley,1/6/21,21,3,3,1344,11062,1207,12444,116,20537,1125,219,10300,762,1029,178,19,2,77,39,11425,1019,1125,10300,257,762,1382,11062,18,15,0,128
Baxter,1/6/21,72,5,5,2264,14332,1921,16622,271,41219,1575,689,12686,1646,1393,528,45,27,137,134,14261,2361,1575,12686,715,1646,2290,14332,31,21,0,72
Benton,1/6/21,281,7,7,19634,139697,17096,160010,2256,258980,15205,4429,131558,8139,13554,3542,217,64,1433,823,146763,13247,15205,131558,5108,8139,20313,139697,344,310,4,1466
Boone,1/6/21,69,9,9,2732,23443,2451,26300,210,37288,2197,535,21686,1757,2017,434,58,11,120,90,23883,2417,2197,21686,660,1757,2857,23443,39,34,0,172
Bradley,1/6/21,17,11,11,1028,7793,883,8846,128,10948,806,222,5283,2510,696,187,9,8,101,27,6089,2757,806,5283,247,2510,1053,7793,42,8,1,102
Calhoun,1/6/21,1,13,13,252,2871,225,3140,26,5202,202,50,2671,200,183,42,1,0,18,8,2873,267,202,2671,67,200,269,2871,6,4,0,28
Carroll,1/6/21,31,15,15,2190,14293,1999,16528,160,27887,1896,294,13933,360,1760,239,28,3,108,52,15829,699,1896,13933,339,360,2235,14293,21,20,1,169
Chicot,1/6/21,32,17,17,1445,10062,1364,11532,49,10826,1339,106,8642,1420,1271,93,31,1,37,12,9981,1551,1339,8642,131,1420,1470,10062,11,6,0,120
Clark,1/6/21,24,19,19,1468,17990,1283,19524,161,22385,1221,247,15238,2752,1078,205,21,3,122,39,16459,3065,1221,15238,313,2752,1534,17990,30,20,0,103
Clay,1/6/21,35,21,21,1383,13069,1236,14493,111,15061,1068,315,9962,3107,974,262,26,9,67,44,11030,3463,1068,9962,356,3107,1424,13069,14,9,3,156
Cleburne,1/6/21,40,23,23,1396,15778,1120,17251,236,25230,1035,361,12988,2790,840,280,37,3,158,78,14023,3228,1035,12988,438,2790,1473,15778,37,31,1,130
Cleveland,1/6/21,21,25,25,607,6712,521,7348,65,8226,415,192,6045,667,359,162,17,4,39,26,6460,888,415,6045,221,667,636,6712,11,0,1,76
Columbia,1/6/21,43,27,27,1660,14236,1491,16034,126,23892,1071,589,11281,2955,997,494,30,13,44,82,12352,3682,1071,11281,727,2955,1798,14236,36,20,0,146
Conway,1/6/21,18,29,29,1519,15305,1221,16878,280,20906,1194,325,13128,2177,968,253,14,4,212,68,14322,2556,1194,13128,379,2177,1573,15305,49,35,0,218
Craighead,1/6/21,143,31,31,10611,82591,9583,93474,884,105701,9415,1196,73007,9584,8541,1042,130,13,743,141,82422,11052,9415,73007,1468,9584,10883,82591,136,103,0,777
Crawford,1/6/21,66,33,33,4869,46909,4222,51849,580,62472,4090,779,45061,1848,3663,559,56,10,370,210,49151,2698,4090,45061,850,1848,4940,46909,70,53,2,240
Crittenden,1/6/21,77,35,35,4531,28884,4167,33516,286,49013,4242,289,27174,1710,3927,240,66,11,248,38,31416,2100,4242,27174,390,1710,4632,28884,48,27,1,216
Cross,1/6/21,37,37,37,1535,12065,1318,13653,180,16998,1229,306,11327,738,1067,251,35,2,127,53,12556,1097,1229,11327,359,738,1588,12065,23,19,0,203
Dallas,1/6/21,11,39,39,516,5006,453,5530,52,7432,469,47,4765,241,417,36,9,2,43,9,5234,296,469,4765,55,241,524,5006,8,3,0,47
Desha,1/6/21,11,41,41,999,8237,900,9289,88,11887,835,164,7309,928,766,134,10,1,59,29,8144,1145,835,7309,217,928,1052,8237,8,12,0,77
Drew,1/6/21,22,43,43,1544,13645,1385,15229,137,18502,1232,312,11774,1871,1104,281,18,4,110,27,13006,2223,1232,11774,352,1871,1584,13645,24,31,2,126
Faulkner,1/6/21,97,45,45,8450,85466,7180,94310,1172,122416,6741,1709,74513,10953,5932,1248,81,16,727,445,81254,13056,6741,74513,2103,10953,8844,85466,189,152,2,878
Franklin,1/6/21,26,47,47,1180,13838,1043,15054,111,17780,947,233,13112,726,860,183,22,4,65,46,14059,995,947,13112,269,726,1216,13838,15,18,0,116
Fulton,1/6/21,36,49,49,946,4751,796,5732,114,12139,672,274,3740,1011,587,209,16,20,69,45,4412,1320,672,3740,309,1011,981,4751,15,15,0,74
Garland,1/6/21,163,51,51,6385,62887,5370,69445,850,98296,5445,940,57784,5103,4673,697,139,24,631,219,63229,6216,5445,57784,1113,5103,6558,62887,152,98,1,415
Grant,1/6/21,14,53,53,1155,11552,982,12758,159,18086,840,315,9868,1684,745,237,13,1,82,77,10708,2050,840,9868,366,1684,1206,11552,16,13,2,103
Greene,1/6/21,55,55,55,4681,33707,4261,38538,365,44623,3783,898,29625,4082,3464,797,45,10,274,91,33408,5130,3783,29625,1048,4082,4831,33707,55,44,1,328
Hempstead,1/6/21,11,57,57,1306,11502,1200,12854,94,22018,1024,282,10791,711,944,256,7,4,72,22,11815,1039,1024,10791,328,711,1352,11502,13,22,0,54
HotSpring,1/6/21,58,59,59,3795,34212,3420,38072,317,33520,3525,270,28543,5669,3213,207,54,4,258,59,32068,6004,3525,28543,335,5669,3860,34212,46,30,0,278
Howard,1/6/21,18,61,61,1163,7646,1074,8867,71,13389,834,329,6006,1640,781,293,16,2,37,34,6840,2027,834,6006,387,1640,1221,7646,12,15,0,64
Independence,1/6/21,95,63,63,2974,26414,2594,29529,285,37264,2081,893,22446,3968,1868,726,72,23,141,144,24527,5002,2081,22446,1034,3968,3115,26414,41,24,1,281
Izard,1/6/21,18,65,65,1401,11714,1209,13193,174,13559,1106,295,8928,2786,1003,206,12,6,91,83,10034,3159,1106,8928,373,2786,1479,11714,13,24,1,70
Jackson,1/6/21,24,67,67,2866,19554,2753,22628,89,17225,2306,560,15980,3574,2222,531,18,6,66,23,18286,4342,2306,15980,768,3574,3074,19554,7,11,1,57
Jefferson,1/6/21,133,69,69,6992,64249,6381,71519,476,70424,5855,1137,57344,6905,5513,868,113,20,227,249,63199,8320,5855,57344,1415,6905,7270,64249,69,132,2,885
Johnson,1/6/21,20,71,71,2024,17413,1750,19468,254,26291,1726,298,16562,851,1518,232,17,3,191,63,18288,1180,1726,16562,329,851,2055,17413,46,18,0,190
Lafayette,1/6/21,4,73,73,361,2458,332,2844,24,6915,268,93,2218,240,250,82,4,0,14,10,2486,358,268,2218,118,240,386,2458,8,3,0,30
Lawrence,1/6/21,36,75,75,1667,10544,1497,12281,134,16669,1378,289,9756,788,1245,252,33,3,100,34,11134,1147,1378,9756,359,788,1737,10544,16,13,0,102
Lee,1/6/21,26,77,77,1489,8536,1387,10042,76,9398,1407,82,7889,647,1333,54,25,1,49,27,9296,746,1407,7889,99,647,1506,8536,7,5,0,71
Lincoln,1/6/21,27,79,79,2866,16199,2759,19122,79,13695,2638,228,13383,2816,2566,193,21,6,50,29,16021,3101,2638,13383,285,2816,2923,16199,14,10,1,107
LittleRiver,1/6/21,39,81,81,864,5506,751,6400,74,12417,696,168,4846,660,603,148,37,2,56,18,5542,858,696,4846,198,660,894,5506,9,11,0,83
Logan,1/6/21,13,83,83,1560,19085,1361,20694,186,21757,1255,305,16188,2897,1157,204,11,2,87,99,17443,3251,1255,16188,354,2897,1609,19085,25,26,1,384
Lonoke,1/6/21,87,85,85,4600,46350,3884,51209,629,72206,3329,1271,39081,7269,2882,1002,74,13,373,256,42410,8799,3329,39081,1530,7269,4859,46350,87,52,3,402
Madison,1/6/21,13,87,87,1099,9528,989,10661,97,16076,872,227,8898,630,796,193,11,2,65,32,9770,891,872,8898,261,630,1133,9528,18,13,0,80
Marion,1/6/21,24,89,89,691,7124,591,7844,76,16438,507,184,6418,706,455,136,11,13,41,35,6925,919,507,6418,213,706,720,7124,13,10,0,44
Miller,1/6/21,25,91,91,2882,14985,2677,17959,180,43759,2064,818,12839,2146,1895,782,17,8,152,28,14903,3056,2064,12839,910,2146,2974,14985,43,44,0,171
MissingCountyInfo,1/6/21,0,5,5,2688,95136,2449,97832,239,NA,2189,499,95066,70,2024,425,0,0,165,74,97255,577,2189,95066,507,70,2696,95136,-91,-12,0,-352
Mississippi,1/6/21,97,93,93,4582,27697,4202,32358,282,42831,4134,448,20181,7516,3801,401,82,15,250,32,24315,8043,4134,20181,527,7516,4661,27697,39,40,0,240
Monroe,1/6/21,9,95,95,527,5295,437,5837,81,7249,442,85,5014,281,370,67,9,0,63,18,5456,381,442,5014,100,281,542,5295,10,7,0,113
Montgomery,1/6/21,20,97,97,535,5341,452,5889,63,8993,404,131,3447,1894,371,81,15,5,18,45,3851,2038,404,3447,144,1894,548,5341,6,2,2,30
Nevada,1/6/21,21,99,99,616,9012,561,9639,34,8440,528,88,8674,338,485,76,20,1,23,11,9202,437,528,8674,99,338,627,9012,4,6,1,16
Newton,1/6/21,24,101,101,583,4796,528,5393,31,7848,494,89,3041,1755,457,71,20,4,17,14,3535,1858,494,3041,103,1755,597,4796,4,4,0,105
Ouachita,1/6/21,34,103,103,1478,12829,1287,14362,156,24106,1275,203,12112,717,1120,167,26,8,128,28,13387,975,1275,12112,258,717,1533,12829,25,30,2,84
Perry,1/6/21,5,105,105,515,8535,405,9070,105,10322,420,95,7968,567,340,65,4,1,76,29,8388,682,420,7968,115,567,535,8535,14,12,0,91
Phillips,1/6/21,25,107,107,1330,13434,1218,14801,87,19034,1237,93,13068,366,1138,80,24,1,75,12,14305,496,1237,13068,130,366,1367,13434,31,23,0,158
Pike,1/6/21,12,109,109,743,5599,649,6383,82,10808,590,153,5005,594,530,119,8,4,52,30,5595,788,590,5005,194,594,784,5599,16,20,0,49
Poinsett,1/6/21,64,111,111,2518,19095,2246,21688,208,24054,2254,264,18107,988,2021,225,51,13,182,26,20361,1327,2254,18107,339,988,2593,19095,22,14,1,158
Polk,1/6/21,48,113,113,1373,9718,1153,11117,171,20163,1199,174,9197,521,1024,129,35,13,139,32,10396,721,1199,9197,200,521,1399,9718,43,17,2,151
Pope,1/6/21,64,115,115,5897,50458,5207,56446,626,63644,4852,1045,48109,2349,4368,839,52,12,432,194,52961,3485,4852,48109,1136,2349,5988,50458,67,92,2,306
Prairie,1/6/21,17,117,117,585,5052,494,5674,74,8244,430,155,4313,739,369,125,12,5,49,25,4743,931,430,4313,192,739,622,5052,12,6,0,39
Pulaski,1/6/21,412,119,119,26828,283593,22999,311160,3415,393463,23747,3081,262439,21154,20584,2415,378,34,2783,632,286186,24974,23747,262439,3820,21154,27567,283593,478,302,9,2670
Randolph,1/6/21,43,121,121,1571,13116,1359,14758,169,17603,1234,337,11237,1879,1097,262,32,11,105,64,12471,2287,1234,11237,408,1879,1642,13116,41,19,0,114
Saline,1/6/21,112,125,125,8295,74670,7224,83328,958,118009,6439,1856,63059,11611,5697,1527,97,15,644,314,69498,13830,6439,63059,2219,11611,8658,74670,168,97,3,1059
Scott,1/6/21,12,127,127,656,7682,526,8356,118,10442,447,209,7365,317,400,126,12,0,35,83,7812,544,447,7365,227,317,674,7682,12,13,1,117
Searcy,1/6/21,13,129,129,530,4735,477,5289,40,7923,324,206,3893,842,306,171,7,6,11,29,4217,1072,324,3893,230,842,554,4735,5,12,0,19
Sebastian,1/6/21,161,131,131,10490,100323,9051,110958,1275,127461,8577,1913,96336,3987,7710,1341,148,13,717,558,104913,6045,8577,96336,2058,3987,10635,100323,178,125,1,622
Sevier,1/6/21,20,133,133,2135,11493,2043,13714,72,17193,1569,566,9708,1785,1523,520,19,1,27,45,11277,2437,1569,9708,652,1785,2221,11493,5,23,0,28
Sharp,1/6/21,35,135,135,1242,11414,1054,12724,153,17043,868,374,9660,1754,770,284,26,9,72,81,10528,2196,868,9660,442,1754,1310,11414,23,16,1,133
St.Francis,1/6/21,20,123,123,2870,22926,2660,25825,190,26294,2721,149,22472,454,2538,122,20,0,163,27,25193,632,2721,22472,178,454,2899,22926,26,44,0,146
Stone,1/6/21,27,137,137,802,7530,709,8364,66,12446,624,178,6620,910,573,136,24,3,27,39,7244,1120,624,6620,210,910,834,7530,7,11,0,69
Union,1/6/21,74,139,139,2625,19252,2266,22006,285,39732,2029,596,16171,3081,1732,534,56,18,241,44,18200,3806,2029,16171,725,3081,2754,19252,41,42,1,181
VanBuren,1/6/21,9,141,141,822,10338,713,11232,100,16684,583,239,8818,1520,524,189,8,1,51,49,9401,1831,583,8818,311,1520,894,10338,16,8,0,129
Washington,1/6/21,234,143,143,23083,168098,20634,192065,2214,228529,18193,4890,147837,20261,16640,3994,191,43,1362,852,166030,26035,18193,147837,5774,20261,23967,168098,350,268,5,2044
White,1/6/21,72,145,145,5347,36416,4468,42103,806,78804,3647,1700,30215,6201,3168,1300,62,10,416,390,33862,8241,3647,30215,2040,6201,5687,36416,138,78,0,568
Woodruff,1/6/21,2,147,147,416,5351,328,5809,86,6660,339,77,5006,345,266,62,1,1,72,14,5345,464,339,5006,119,345,458,5351,8,8,0,109
Yell,1/6/21,48,149,149,2588,22286,2262,24932,278,21573,2303,285,21354,932,2061,201,40,8,202,76,23657,1275,2303,21354,343,932,2646,22286,42,34,1,236
Arkansas_all_counties,1/5/21,3836,5630,5630,238888,2119372,210617,2366251,24408,2990671,195930,42958,1908393,210979,175818,34799,3205,631,16883,7525,2104323,261928,195930,1908393,50949,210979,246879,2119372,4107,2719,36,16464
Arkansas_county,1/5/21,32,1,1,1369,14748,1214,16208,123,18124,987,382,11309,3439,904,310,26,6,57,66,12296,3912,987,11309,473,3439,1460,14748,29,16,0,95
Ashley,1/5/21,21,3,3,1326,10952,1192,12317,113,20537,1113,213,10223,729,1015,177,19,2,79,34,11336,981,1113,10223,252,729,1365,10952,14,16,0,69
Baxter,1/5/21,72,5,5,2233,14291,1900,16552,261,41219,1562,671,12653,1638,1384,516,45,27,133,128,14215,2337,1562,12653,699,1638,2261,14291,28,19,0,96
Benton,1/5/21,277,7,7,19290,138575,16786,158526,2226,258980,14975,4315,130557,8018,13323,3463,213,64,1438,788,145532,12994,14975,130557,4976,8018,19951,138575,383,314,2,1461
Boone,1/5/21,69,9,9,2693,23310,2417,26128,205,37288,2173,520,21577,1733,1996,421,58,11,117,88,23750,2378,2173,21577,645,1733,2818,23310,30,23,0,264
Bradley,1/5/21,16,11,11,986,7733,875,8744,95,10948,778,208,5246,2487,692,183,9,7,77,18,6024,2720,778,5246,233,2487,1011,7733,9,16,0,33
Calhoun,1/5/21,1,13,13,246,2849,221,3111,24,5202,197,49,2657,192,181,40,1,0,15,9,2854,257,197,2657,65,192,262,2849,2,6,0,25
Carroll,1/5/21,30,15,15,2169,14145,1979,16359,160,27887,1885,284,13793,352,1744,235,27,3,114,46,15678,681,1885,13793,329,352,2214,14145,36,21,0,133
Chicot,1/5/21,32,17,17,1434,9953,1358,11412,44,10826,1335,99,8550,1403,1267,91,31,1,37,7,9885,1527,1335,8550,124,1403,1459,9953,1,2,0,20
Clark,1/5/21,24,19,19,1438,17917,1263,19421,151,22385,1197,241,15181,2736,1063,200,21,3,113,38,16378,3043,1197,15181,307,2736,1504,17917,19,13,0,73
Clay,1/5/21,32,21,21,1369,12927,1227,14336,109,15061,1055,314,9834,3093,968,259,23,9,63,46,10889,3447,1055,9834,354,3093,1409,12927,19,10,0,186
Cleburne,1/5/21,39,23,23,1359,15685,1089,17122,231,25230,1018,341,12929,2756,821,268,36,3,161,70,13947,3175,1018,12929,419,2756,1437,15685,27,10,1,163
Cleveland,1/5/21,20,25,25,596,6647,521,7272,55,8226,407,189,6008,639,359,162,17,3,31,24,6415,857,407,6008,218,639,625,6647,13,7,0,105
Columbia,1/5/21,43,27,27,1624,14126,1471,15886,110,23892,1058,566,11235,2891,992,479,30,13,36,74,12293,3593,1058,11235,702,2891,1760,14126,25,21,-1,213
Conway,1/5/21,18,29,29,1470,15136,1186,16656,266,20906,1157,313,13017,2119,944,242,14,4,199,67,14174,2482,1157,13017,363,2119,1520,15136,36,26,1,112
Craighead,1/5/21,143,31,31,10475,81950,9480,92694,851,105701,9321,1154,72466,9484,8455,1025,130,13,735,116,81787,10907,9321,72466,1423,9484,10744,81950,125,85,1,743
Crawford,1/5/21,64,33,33,4799,46739,4169,51609,565,62472,4058,741,44949,1790,3621,548,55,9,381,184,49007,2602,4058,44949,812,1790,4870,46739,118,47,2,330
Crittenden,1/5/21,76,35,35,4483,28716,4140,33296,266,49013,4204,279,27015,1701,3904,236,65,11,234,32,31219,2077,4204,27015,376,1701,4580,28716,49,45,0,213
Cross,1/5/21,37,37,37,1512,11885,1299,13450,176,16998,1214,298,11160,725,1055,244,35,2,124,52,12374,1076,1214,11160,351,725,1565,11885,38,19,0,101
Dallas,1/5/21,11,39,39,508,4967,450,5483,47,7432,463,45,4732,235,415,35,9,2,39,8,5195,288,463,4732,53,235,516,4967,12,15,0,51
Desha,1/5/21,11,41,41,991,8168,888,9212,92,11887,830,161,7278,890,756,132,10,1,64,28,8108,1104,830,7278,214,890,1044,8168,12,6,0,78
Drew,1/5/21,20,43,43,1520,13543,1354,15103,146,18502,1213,307,11704,1839,1079,275,16,4,118,28,12917,2186,1213,11704,347,1839,1560,13543,10,14,0,113
Faulkner,1/5/21,95,45,45,8261,84777,7028,93415,1137,122416,6624,1637,74015,10762,5822,1206,79,16,722,415,80639,12776,6624,74015,2014,10762,8638,84777,185,114,1,1192
Franklin,1/5/21,26,47,47,1165,13737,1025,14938,114,17780,937,228,13047,690,850,175,22,4,65,49,13984,954,937,13047,264,690,1201,13737,28,11,1,98
Fulton,1/5/21,36,49,49,931,4692,781,5658,114,12139,657,274,3721,971,575,206,16,20,66,48,4378,1280,657,3721,309,971,966,4692,17,13,0,65
Garland,1/5/21,162,51,51,6233,62624,5272,69028,797,98296,5334,899,57635,4989,4587,685,138,24,607,190,62969,6059,5334,57635,1070,4989,6404,62624,229,82,5,567
Grant,1/5/21,12,53,53,1139,11465,969,12655,158,18086,831,308,9823,1642,741,228,11,1,79,79,10654,2001,831,9823,359,1642,1190,11465,15,15,0,94
Greene,1/5/21,54,55,55,4626,33434,4217,38211,355,44623,3743,883,29409,4025,3428,789,44,10,271,84,33152,5059,3743,29409,1034,4025,4777,33434,83,37,1,467
Hempstead,1/5/21,11,57,57,1293,11461,1178,12801,103,22018,1019,274,10764,697,928,250,7,4,83,20,11783,1018,1019,10764,321,697,1340,11461,17,6,0,55
HotSpring,1/5/21,58,59,59,3749,33980,3390,37794,301,33520,3490,259,28386,5594,3186,204,54,4,250,51,31876,5918,3490,28386,324,5594,3814,33980,30,29,1,243
Howard,1/5/21,18,61,61,1151,7594,1059,8801,74,13389,827,324,5998,1596,773,286,16,2,38,36,6825,1976,827,5998,380,1596,1207,7594,22,7,0,99
Independence,1/5/21,94,63,63,2933,26174,2570,29246,269,37264,2062,871,22304,3870,1853,717,71,23,138,131,24366,4880,2062,22304,1010,3870,3072,26174,72,27,0,361
Izard,1/5/21,17,65,65,1388,11657,1185,13123,186,13559,1100,288,8894,2763,991,194,11,6,98,88,9994,3129,1100,8894,366,2763,1466,11657,34,8,2,326
Jackson,1/5/21,23,67,67,2859,19504,2742,22571,94,17225,2302,557,15953,3551,2215,527,17,6,70,24,18255,4316,2302,15953,765,3551,3067,19504,19,29,1,221
Jefferson,1/5/21,131,69,69,6923,63433,6249,70631,541,70424,5829,1094,56807,6626,5404,845,112,19,311,230,62636,7995,5829,56807,1369,6626,7198,63433,58,56,0,546
Johnson,1/5/21,20,71,71,1978,17269,1732,19276,226,26291,1688,290,16428,841,1503,229,17,3,168,58,18116,1160,1688,16428,319,841,2007,17269,40,29,0,140
Lafayette,1/5/21,4,73,73,353,2436,329,2814,19,6915,264,89,2203,233,249,80,4,0,11,8,2467,347,264,2203,114,233,378,2436,2,6,0,26
Lawrence,1/5/21,36,75,75,1651,10458,1484,12178,131,16669,1366,285,9685,773,1234,250,33,3,99,32,11051,1127,1366,9685,354,773,1720,10458,25,20,0,150
Lee,1/5/21,26,77,77,1482,8472,1382,9971,74,9398,1403,79,7832,640,1329,53,25,1,49,25,9235,736,1403,7832,96,640,1499,8472,18,8,0,248
Lincoln,1/5/21,26,79,79,2852,16106,2749,19014,76,13695,2630,222,13326,2780,2560,189,21,5,48,28,15956,3058,2630,13326,278,2780,2908,16106,4,3,0,167
LittleRiver,1/5/21,39,81,81,855,5432,740,6316,76,12417,690,165,4839,593,595,145,37,2,58,18,5529,787,690,4839,194,593,884,5432,12,10,0,48
Logan,1/5/21,12,83,83,1535,18726,1335,20310,188,21757,1240,295,16131,2595,1143,192,10,2,87,101,17371,2939,1240,16131,344,2595,1584,18726,28,21,1,130
Lonoke,1/5/21,84,85,85,4513,46035,3832,50807,597,72206,3289,1224,38891,7144,2847,985,72,12,370,227,42180,8627,3289,38891,1483,7144,4772,46035,142,72,0,435
Madison,1/5/21,13,87,87,1081,9466,976,10581,92,16076,859,222,8849,617,788,188,11,2,60,32,9708,873,859,8849,256,617,1115,9466,19,12,0,89
Marion,1/5/21,24,89,89,678,7093,581,7800,73,16438,499,179,6405,688,447,134,11,13,41,32,6904,896,499,6405,208,688,707,7093,7,6,0,66
Miller,1/5/21,25,91,91,2839,14857,2633,17788,181,43759,2037,802,12738,2119,1869,764,17,8,151,30,14775,3013,2037,12738,894,2119,2931,14857,17,54,0,52
MissingCountyInfo,1/5/21,0,5,5,2779,95397,2461,98185,318,NA,2244,535,95325,72,2018,443,0,0,226,92,97569,616,2244,95325,544,72,2788,95397,18,32,0,-3894
Mississippi,1/5/21,97,93,93,4543,27496,4162,32116,283,42831,4102,441,20099,7397,3767,395,82,15,252,31,24201,7915,4102,20099,518,7397,4620,27496,61,32,0,369
Monroe,1/5/21,9,95,95,517,5192,430,5724,78,7249,433,84,4978,214,365,65,9,0,59,19,5411,313,433,4978,99,214,532,5192,6,6,0,22
Montgomery,1/5/21,18,97,97,529,5317,450,5860,61,8993,400,129,3436,1881,370,80,15,3,15,46,3836,2024,400,3436,143,1881,543,5317,12,11,0,25
Nevada,1/5/21,20,99,99,612,9000,555,9623,37,8440,528,84,8666,334,479,76,19,1,30,7,9194,429,528,8666,95,334,623,9000,1,3,0,41
Newton,1/5/21,24,101,101,579,4695,524,5288,31,7848,493,86,3034,1661,454,70,20,4,19,12,3527,1761,493,3034,100,1661,593,4695,15,9,0,38
Ouachita,1/5/21,32,103,103,1453,12770,1257,14278,163,24106,1256,197,12071,699,1096,161,24,8,135,28,13327,951,1256,12071,252,699,1508,12770,15,17,1,82
Perry,1/5/21,5,105,105,501,8458,393,8978,103,10322,408,93,7907,551,329,64,4,1,75,28,8315,663,408,7907,112,551,520,8458,28,9,0,127
Phillips,1/5/21,25,107,107,1299,13307,1195,14642,79,19034,1207,92,12945,362,1115,80,24,1,68,11,14152,490,1207,12945,128,362,1335,13307,3,5,0,82
Pike,1/5/21,12,109,109,727,5566,629,6329,86,10808,576,151,4989,577,521,108,8,4,47,39,5565,764,576,4989,187,577,763,5566,13,17,1,38
Poinsett,1/5/21,63,111,111,2496,18959,2232,21530,201,24054,2235,261,17983,976,2007,225,50,13,178,23,20218,1312,2235,17983,336,976,2571,18959,35,28,0,139
Polk,1/5/21,46,113,113,1330,9610,1136,10963,147,20163,1168,162,9097,513,1014,122,33,13,120,27,10265,698,1168,9097,185,513,1353,9610,24,13,0,84
Pope,1/5/21,62,115,115,5830,50219,5115,56141,653,63644,4820,1010,47928,2291,4294,821,51,11,475,178,52748,3393,4820,47928,1102,2291,5922,50219,75,90,1,287
Prairie,1/5/21,17,117,117,573,5025,488,5635,68,8244,426,147,4303,722,363,125,12,5,51,17,4729,906,426,4303,184,722,610,5025,7,5,0,49
Pulaski,1/5/21,403,119,119,26350,281401,22697,308477,3248,393463,23370,2980,260646,20755,20337,2360,372,31,2659,589,284016,24461,23370,260646,3706,20755,27076,281401,397,291,4,2647
Randolph,1/5/21,43,121,121,1530,13043,1340,14643,147,17603,1206,324,11187,1856,1081,259,32,11,93,54,12393,2250,1206,11187,394,1856,1600,13043,35,18,0,133
Saline,1/5/21,109,125,125,8127,73779,7127,82265,890,118009,6326,1801,62472,11307,5619,1508,94,15,612,278,68798,13467,6326,62472,2160,11307,8486,73779,193,115,1,947
Scott,1/5/21,11,127,127,644,7577,513,8239,120,10442,442,202,7262,315,396,117,11,0,35,85,7704,535,442,7262,220,315,662,7577,21,9,0,95
Searcy,1/5/21,13,129,129,525,4721,465,5270,47,7923,323,202,3886,835,302,163,7,6,14,33,4209,1061,323,3886,226,835,549,4721,10,9,0,23
Sebastian,1/5/21,160,131,131,10312,99879,8926,110330,1223,127461,8488,1824,96090,3789,7621,1305,147,13,718,505,104578,5752,8488,96090,1963,3789,10451,99879,266,108,2,731
Sevier,1/5/21,20,133,133,2130,11470,2020,13686,90,17193,1567,563,9701,1769,1517,503,19,1,31,59,11268,2418,1567,9701,649,1769,2216,11470,22,8,0,44
Sharp,1/5/21,34,135,135,1219,11304,1038,12590,147,17043,858,361,9617,1687,763,275,25,9,70,77,10475,2115,858,9617,428,1687,1286,11304,35,14,1,209
St.Francis,1/5/21,20,123,123,2844,22806,2616,25681,208,26294,2704,140,22367,439,2498,118,20,0,186,22,25071,610,2704,22367,171,439,2875,22806,19,6,0,286
Stone,1/5/21,27,137,137,795,7468,698,8295,70,12446,623,172,6585,883,566,132,24,3,33,37,7208,1087,623,6585,204,883,827,7468,14,9,0,80
Union,1/5/21,73,139,139,2584,19112,2224,21822,287,39732,1999,585,16139,2973,1697,527,56,17,246,41,18138,3684,1999,16139,711,2973,2710,19112,7,36,0,155
VanBuren,1/5/21,9,141,141,806,10225,705,11103,92,16684,578,228,8791,1434,523,182,8,1,47,45,9369,1734,578,8791,300,1434,878,10225,18,9,1,142
Washington,1/5/21,229,143,143,22733,166404,20366,190008,2136,228529,18030,4703,146610,19794,16435,3931,190,39,1404,732,164640,25368,18030,146610,5574,19794,23604,166404,400,283,3,2125
White,1/5/21,72,145,145,5209,35986,4390,41529,746,78804,3596,1613,29997,5989,3125,1265,62,10,408,338,33593,7936,3596,29997,1947,5989,5543,35986,144,78,0,620
Woodruff,1/5/21,2,147,147,408,5250,320,5700,86,6660,334,74,4946,304,260,60,1,1,73,13,5280,420,334,4946,116,304,450,5250,13,3,0,48
Yell,1/5/21,47,149,149,2546,22092,2228,24697,271,21573,2270,276,21180,912,2031,197,40,7,199,72,23450,1247,2270,21180,335,912,2605,22092,42,20,2,128
Arkansas_all_counties,1/4/21,3800,5630,5630,234781,2107015,207898,2349647,23057,2990671,193655,41126,1901966,205049,173995,33903,3178,622,16459,6598,2095621,254026,193655,1901966,48977,205049,242632,2107015,1306,2436,51,7144
Arkansas_county,1/4/21,32,1,1,1340,14682,1198,16110,110,18124,979,361,11290,3392,899,299,26,6,54,56,12269,3841,979,11290,449,3392,1428,14682,2,10,1,25
Ashley,1/4/21,21,3,3,1312,10897,1176,12248,115,20537,1104,208,10174,723,1003,173,19,2,82,33,11278,970,1104,10174,247,723,1351,10897,1,8,0,9
Baxter,1/4/21,72,5,5,2205,14223,1881,16456,252,41219,1551,654,12597,1626,1373,508,45,27,133,119,14148,2308,1551,12597,682,1626,2233,14223,23,20,0,56
Benton,1/4/21,275,7,7,18907,137497,16472,157046,2159,258980,14727,4180,129614,7883,13120,3352,212,63,1394,765,144341,12705,14727,129614,4822,7883,19549,137497,106,207,6,877
Boone,1/4/21,69,9,9,2663,23076,2394,25864,198,37288,2165,498,21429,1647,1979,415,58,11,126,72,23594,2270,2165,21429,623,1647,2788,23076,16,23,0,62
Bradley,1/4/21,16,11,11,977,7709,859,8711,102,10948,775,202,5236,2473,680,179,9,7,86,16,6011,2700,775,5236,227,2473,1002,7709,2,19,1,10
Calhoun,1/4/21,1,13,13,244,2826,215,3086,28,5202,196,48,2635,191,177,38,1,0,18,10,2831,255,196,2635,64,191,260,2826,0,2,0,0
Carroll,1/4/21,30,15,15,2133,14048,1958,16227,145,27887,1868,265,13712,336,1730,228,27,3,111,34,15580,647,1868,13712,311,336,2179,14048,10,15,0,45
Chicot,1/4/21,32,17,17,1433,9934,1356,11392,45,10826,1334,99,8536,1398,1265,91,31,1,38,7,9870,1522,1334,8536,124,1398,1458,9934,1,5,1,10
Clark,1/4/21,24,19,19,1419,17863,1250,19347,145,22385,1191,228,15139,2724,1053,197,21,3,117,28,16330,3017,1191,15139,293,2724,1484,17863,0,28,0,84
Clay,1/4/21,32,21,21,1350,12760,1217,14149,100,15061,1051,299,9763,2997,961,256,23,9,66,34,10814,3335,1051,9763,338,2997,1389,12760,7,13,1,17
Cleburne,1/4/21,38,23,23,1332,15549,1079,16959,215,25230,1008,324,12889,2660,817,262,35,3,156,59,13897,3062,1008,12889,402,2660,1410,15549,6,29,0,43
Cleveland,1/4/21,20,25,25,583,6555,514,7166,49,8226,403,180,5925,630,357,157,17,3,29,20,6328,838,403,5925,208,630,611,6555,0,4,1,7
Columbia,1/4/21,44,27,27,1599,13938,1450,15675,105,23892,1055,544,11092,2846,988,462,31,13,36,69,12147,3528,1055,11092,682,2846,1737,13938,2,15,1,24
Conway,1/4/21,17,29,29,1434,15060,1160,16543,257,20906,1136,298,12982,2078,926,234,13,4,197,60,14118,2425,1136,12982,347,2078,1483,15060,20,35,1,54
Craighead,1/4/21,142,31,31,10350,81332,9395,91948,812,105701,9235,1115,72034,9298,8383,1012,129,13,722,90,81269,10679,9235,72034,1381,9298,10616,81332,51,99,5,157
Crawford,1/4/21,62,33,33,4681,46527,4122,51277,496,62472,3973,708,44773,1754,3590,532,53,9,329,167,48746,2531,3973,44773,777,1754,4750,46527,33,38,1,180
Crittenden,1/4/21,76,35,35,4434,28552,4095,33083,262,49013,4173,261,26854,1698,3871,224,65,11,236,26,31027,2056,4173,26854,358,1698,4531,28552,13,40,1,102
Cross,1/4/21,37,37,37,1474,11822,1280,13348,157,16998,1200,274,11125,697,1042,238,35,2,123,34,12325,1023,1200,11125,326,697,1526,11822,9,23,1,34
Dallas,1/4/21,11,39,39,496,4928,435,5432,50,7432,455,41,4698,230,403,32,9,2,43,7,5153,279,455,4698,49,230,504,4928,1,3,0,10
Desha,1/4/21,11,41,41,979,8102,882,9133,86,11887,822,157,7239,863,753,129,10,1,59,27,8061,1072,822,7239,209,863,1031,8102,2,11,0,19
Drew,1/4/21,20,43,43,1510,13440,1340,14990,150,18502,1208,302,11619,1821,1068,272,16,4,124,26,12827,2163,1208,11619,342,1821,1550,13440,5,20,1,12
Faulkner,1/4/21,94,45,45,8076,83770,6914,92206,1067,122416,6533,1543,73564,10206,5750,1164,78,16,704,363,80097,12109,6533,73564,1903,10206,8436,83770,85,102,0,354
Franklin,1/4/21,25,47,47,1137,13667,1014,14839,98,17780,927,210,12999,668,844,170,22,3,61,37,13926,913,927,12999,245,668,1172,13667,6,12,0,61
Fulton,1/4/21,36,49,49,914,4644,768,5593,110,12139,649,265,3693,951,566,202,16,20,67,43,4342,1251,649,3693,300,951,949,4644,3,10,0,29
Garland,1/4/21,157,51,51,6004,62286,5190,68454,655,98296,5143,861,57433,4853,4528,662,135,22,478,177,62576,5878,5143,57433,1025,4853,6168,62286,20,67,2,316
Grant,1/4/21,12,53,53,1124,11386,954,12560,158,18086,827,297,9791,1595,733,221,11,1,83,75,10618,1942,827,9791,347,1595,1174,11386,7,24,0,23
Greene,1/4/21,53,55,55,4543,33050,4180,37742,310,44623,3686,857,29083,3967,3402,778,44,9,240,70,32769,4973,3686,29083,1006,3967,4692,33050,20,34,1,85
Hempstead,1/4/21,11,57,57,1276,11423,1172,12745,92,22018,1013,263,10735,688,924,248,7,4,81,11,11748,997,1013,10735,309,688,1322,11423,7,8,0,56
HotSpring,1/4/21,57,59,59,3719,33767,3361,37550,301,33520,3470,249,28309,5458,3163,198,53,4,254,47,31779,5771,3470,28309,313,5458,3783,33767,10,23,0,53
Howard,1/4/21,18,61,61,1129,7517,1052,8703,59,13389,822,307,5925,1592,769,283,16,2,37,22,6747,1956,822,5925,364,1592,1186,7517,5,7,0,7
Independence,1/4/21,94,63,63,2861,25885,2543,28884,224,37264,2039,822,22122,3763,1841,702,71,23,127,97,24161,4723,2039,22122,960,3763,2999,25885,4,25,0,48
Izard,1/4/21,15,65,65,1354,11365,1177,12795,162,13559,1093,261,8832,2533,989,188,9,6,95,67,9925,2870,1093,8832,337,2533,1430,11365,2,18,2,22
Jackson,1/4/21,22,67,67,2840,19302,2713,22350,105,17225,2289,551,15828,3474,2191,522,16,6,82,23,18117,4233,2289,15828,759,3474,3048,19302,1,13,0,13
Jefferson,1/4/21,131,69,69,6865,62945,6193,70082,539,70424,5808,1057,56615,6330,5373,820,112,19,321,218,62423,7659,5808,56615,1329,6330,7137,62945,19,33,2,115
Johnson,1/4/21,20,71,71,1938,17169,1703,19136,215,26291,1660,278,16335,834,1484,219,17,3,159,56,17995,1141,1660,16335,307,834,1967,17169,11,18,0,48
Lafayette,1/4/21,4,73,73,351,2412,323,2788,23,6915,264,87,2181,231,246,77,4,0,14,9,2445,343,264,2181,112,231,376,2412,1,4,0,5
Lawrence,1/4/21,36,75,75,1626,10333,1464,12029,126,16669,1357,269,9574,759,1219,245,33,3,105,21,10931,1098,1357,9574,339,759,1696,10333,5,18,0,26
Lee,1/4/21,26,77,77,1464,8242,1374,9721,64,9398,1398,66,7782,460,1327,47,25,1,46,18,9180,541,1398,7782,81,460,1479,8242,5,10,0,11
Lincoln,1/4/21,26,79,79,2848,15943,2746,18846,75,13695,2630,218,13314,2629,2559,187,21,5,49,26,15944,2902,2630,13314,273,2629,2903,15943,0,9,0,4
LittleRiver,1/4/21,39,81,81,843,5396,730,6267,74,12417,685,158,4810,586,586,144,37,2,62,12,5495,772,685,4810,186,586,871,5396,3,15,0,9
Logan,1/4/21,11,83,83,1507,18624,1314,20172,182,21757,1230,277,16047,2577,1130,184,10,1,90,92,17277,2895,1230,16047,318,2577,1548,18624,8,17,0,73
Lonoke,1/4/21,84,85,85,4371,45742,3760,50371,527,72206,3222,1149,38753,6989,2804,956,72,12,346,181,41975,8396,3222,38753,1407,6989,4629,45742,29,51,1,280
Madison,1/4/21,13,87,87,1062,9396,964,10491,85,16076,846,216,8799,597,780,184,11,2,55,30,9645,846,846,8799,249,597,1095,9396,4,9,1,36
Marion,1/4/21,24,89,89,671,7034,575,7733,72,16438,497,174,6352,682,442,133,11,13,44,28,6849,884,497,6352,202,682,699,7034,4,7,0,32
Miller,1/4/21,25,91,91,2822,14822,2579,17736,218,43759,2026,796,12705,2117,1824,755,17,8,185,33,14731,3005,2026,12705,888,2117,2914,14822,4,14,0,13
MissingCountyInfo,1/4/21,0,5,5,2761,99309,2429,102085,332,NA,2246,515,99239,70,2004,425,0,0,242,90,101485,600,2246,99239,530,70,2776,99309,112,26,0,248
Mississippi,1/4/21,97,93,93,4482,27188,4130,31747,254,42831,4051,431,20017,7171,3737,393,82,15,231,23,24068,7679,4051,20017,508,7171,4559,27188,20,39,2,127
Monroe,1/4/21,9,95,95,511,5176,424,5702,78,7249,430,81,4964,212,360,64,9,0,61,17,5394,308,430,4964,96,212,526,5176,1,6,2,23
Montgomery,1/4/21,18,97,97,517,5304,439,5833,60,8993,395,122,3433,1871,363,76,15,3,17,43,3828,2005,395,3433,134,1871,529,5304,0,6,0,12
Nevada,1/4/21,20,99,99,611,8960,552,9582,39,8440,527,84,8628,332,476,76,19,1,32,7,9155,427,527,8628,95,332,622,8960,6,5,0,101
Newton,1/4/21,24,101,101,564,4672,515,5249,25,7848,491,73,3013,1659,451,64,20,4,20,5,3504,1745,491,3013,86,1659,577,4672,0,4,0,5
Ouachita,1/4/21,31,103,103,1438,12703,1240,14196,166,24106,1253,185,12016,687,1085,155,23,8,144,22,13269,927,1253,12016,240,687,1493,12703,11,13,2,36
Perry,1/4/21,5,105,105,473,8359,384,8850,84,10322,385,88,7813,546,322,62,4,1,59,25,8198,652,385,7813,106,546,491,8359,5,11,0,17
Phillips,1/4/21,25,107,107,1296,13228,1190,14559,81,19034,1206,90,12871,357,1110,80,24,1,72,9,14077,482,1206,12871,125,357,1331,13228,0,14,0,9
Pike,1/4/21,11,109,109,714,5541,612,6285,91,10808,564,150,4975,566,506,106,7,4,51,40,5539,746,564,4975,180,566,744,5541,5,12,0,16
Poinsett,1/4/21,63,111,111,2461,18855,2204,21390,194,24054,2210,251,17895,960,1983,221,50,13,177,17,20105,1285,2210,17895,325,960,2535,18855,11,38,0,41
Polk,1/4/21,46,113,113,1306,9550,1123,10879,136,20163,1154,152,9059,491,1004,119,33,13,116,20,10213,666,1154,9059,175,491,1329,9550,12,12,2,28
Pope,1/4/21,61,115,115,5755,50007,5025,55851,669,63644,4778,977,47749,2258,4228,797,51,10,499,170,52527,3324,4778,47749,1066,2258,5844,50007,29,66,2,194
Prairie,1/4/21,17,117,117,566,4983,483,5586,66,8244,423,143,4294,689,361,122,12,5,50,16,4717,869,423,4294,180,689,603,4983,2,6,1,8
Pulaski,1/4/21,399,119,119,25953,279151,22406,305814,3146,393463,23112,2841,259301,19850,20096,2310,368,31,2646,500,282413,23401,23112,259301,3551,19850,26663,279151,193,313,3,807
Randolph,1/4/21,43,121,121,1495,12945,1322,14510,130,17603,1187,308,11105,1840,1066,256,32,11,89,41,12292,2218,1187,11105,378,1840,1565,12945,9,19,0,37
Saline,1/4/21,108,125,125,7934,73025,7012,81317,813,118009,6210,1724,62051,10974,5542,1470,94,14,573,240,68261,13056,6210,62051,2082,10974,8292,73025,46,90,0,207
Scott,1/4/21,11,127,127,623,7503,504,8144,108,10442,440,183,7205,298,395,109,11,0,34,74,7645,499,440,7205,201,298,641,7503,4,4,0,32
Searcy,1/4/21,13,129,129,515,4708,456,5247,46,7923,321,194,3878,830,300,156,7,6,14,32,4199,1048,321,3878,218,830,539,4708,1,9,0,5
Sebastian,1/4/21,158,131,131,10046,99414,8818,109596,1067,127461,8311,1735,95746,3668,7565,1253,145,13,599,468,104057,5539,8311,95746,1871,3668,10182,99414,64,86,0,575
Sevier,1/4/21,20,133,133,2108,11448,2012,13641,76,17193,1565,543,9692,1756,1515,497,19,1,31,45,11257,2384,1565,9692,628,1756,2193,11448,3,16,0,4
Sharp,1/4/21,33,135,135,1184,11130,1024,12380,127,17043,851,333,9476,1654,759,265,24,9,68,59,10327,2053,851,9476,399,1654,1250,11130,2,16,1,119
St.Francis,1/4/21,20,123,123,2825,22539,2610,25395,195,26294,2692,133,22120,419,2493,117,20,0,179,16,24812,583,2692,22120,164,419,2856,22539,4,23,0,18
Stone,1/4/21,27,137,137,781,7402,689,8215,65,12446,620,161,6542,860,561,128,24,3,35,30,7162,1053,620,6542,193,860,813,7402,1,13,0,24
Union,1/4/21,73,139,139,2577,18964,2188,21667,316,39732,1997,580,15998,2966,1665,523,56,17,276,40,17995,3672,1997,15998,706,2966,2703,18964,8,40,0,25
VanBuren,1/4/21,8,141,141,788,10101,696,10959,84,16684,571,217,8762,1339,519,177,7,1,45,39,9333,1626,571,8762,287,1339,858,10101,8,15,0,24
Washington,1/4/21,226,143,143,22333,164679,20083,187860,2023,228529,17834,4499,145363,19316,16267,3816,188,38,1379,644,163197,24663,17834,145363,5347,19316,23181,164679,137,195,2,655
White,1/4/21,72,145,145,5065,35510,4312,40905,680,78804,3524,1541,29773,5737,3079,1233,62,10,382,298,33297,7608,3524,29773,1871,5737,5395,35510,32,93,1,125
Woodruff,1/4/21,2,147,147,395,5215,317,5652,76,6660,329,66,4921,294,257,60,1,1,71,5,5250,402,329,4921,108,294,437,5215,1,6,0,10
Yell,1/4/21,45,149,149,2504,22006,2208,24568,251,21573,2255,249,21131,875,2014,194,38,7,203,48,23386,1182,2255,21131,307,875,2562,22006,6,25,2,56
Arkansas_all_counties,1/3/21,3749,5630,5630,233475,2101177,205462,2342418,24238,2990671,192809,40666,1897388,203789,172347,33115,3137,612,17302,6936,2090197,252221,192809,1897388,48432,203789,241241,2101177,2033,1761,20,11404
Arkansas_county,1/3/21,31,1,1,1338,14659,1188,16084,119,18124,977,361,11276,3383,897,291,26,5,54,65,12253,3831,977,11276,448,3383,1425,14659,7,9,0,59
Ashley,1/3/21,21,3,3,1311,10889,1168,12239,122,20537,1103,208,10168,721,1001,167,19,2,83,39,11271,968,1103,10168,247,721,1350,10889,13,6,0,27
Baxter,1/3/21,72,5,5,2182,14190,1861,16400,249,41219,1549,633,12571,1619,1363,498,45,27,141,108,14120,2280,1549,12571,661,1619,2210,14190,59,7,1,196
Benton,1/3/21,269,7,7,18801,136726,16265,156161,2266,258980,14680,4121,128949,7777,12982,3283,207,62,1490,776,143629,12532,14680,128949,4755,7777,19435,136726,210,157,1,653
Boone,1/3/21,69,9,9,2647,23030,2371,25803,205,37288,2152,495,21401,1629,1966,405,58,11,126,79,23553,2250,2152,21401,621,1629,2773,23030,27,27,0,81
Bradley,1/3/21,15,11,11,975,7701,840,8701,120,10948,773,202,5228,2473,672,168,9,6,92,28,6001,2700,773,5228,227,2473,1000,7701,4,12,0,14
Calhoun,1/3/21,1,13,13,244,2826,213,3085,30,5202,196,48,2635,191,177,36,1,0,18,12,2831,254,196,2635,63,191,259,2826,1,2,0,9
Carroll,1/3/21,30,15,15,2123,14013,1943,16182,150,27887,1858,265,13680,333,1716,227,27,3,115,35,15538,644,1858,13680,311,333,2169,14013,7,18,0,34
Chicot,1/3/21,31,17,17,1432,9925,1351,11382,50,10826,1334,98,8529,1396,1261,90,30,1,43,7,9863,1519,1334,8529,123,1396,1457,9925,12,9,1,43
Clark,1/3/21,24,19,19,1419,17779,1222,19263,173,22385,1190,229,15058,2721,1033,189,21,3,136,37,16248,3015,1190,15058,294,2721,1484,17779,10,16,3,153
Clay,1/3/21,31,21,21,1343,12750,1204,14132,107,15061,1047,296,9758,2992,955,249,23,8,68,39,10805,3327,1047,9758,335,2992,1382,12750,6,9,0,82
Cleburne,1/3/21,38,23,23,1326,15512,1050,16909,238,25230,999,327,12866,2646,790,260,35,3,174,64,13865,3044,999,12866,398,2646,1397,15512,14,15,0,33
Cleveland,1/3/21,19,25,25,583,6548,510,7159,54,8226,403,180,5919,629,357,153,16,3,30,24,6322,837,403,5919,208,629,611,6548,4,4,0,57
Columbia,1/3/21,43,27,27,1597,13916,1435,15648,119,23892,1053,544,11075,2841,986,449,30,13,37,82,12128,3520,1053,11075,679,2841,1732,13916,2,7,0,7
Conway,1/3/21,16,29,29,1414,15026,1125,16488,273,20906,1123,291,12953,2073,903,222,12,4,208,65,14076,2412,1123,12953,339,2073,1462,15026,23,23,0,40
Craighead,1/3/21,137,31,31,10299,81226,9296,91789,865,105701,9188,1111,71952,9274,8312,984,124,13,751,114,81140,10649,9188,71952,1375,9274,10563,81226,64,74,0,295
Crawford,1/3/21,61,33,33,4648,46380,4084,51096,502,62472,3950,698,44642,1738,3563,521,52,9,334,168,48592,2504,3950,44642,766,1738,4716,46380,47,38,1,294
Crittenden,1/3/21,75,35,35,4421,28463,4055,32981,290,49013,4162,259,26766,1697,3837,218,64,11,260,30,30928,2053,4162,26766,356,1697,4518,28463,34,27,0,96
Cross,1/3/21,36,37,37,1465,11797,1257,13312,172,16998,1192,273,11114,683,1023,234,34,2,135,37,12306,1006,1192,11114,323,683,1515,11797,24,10,0,100
Dallas,1/3/21,11,39,39,495,4919,432,5421,52,7432,453,42,4690,229,401,31,9,2,43,9,5143,278,453,4690,49,229,502,4919,4,5,0,20
Desha,1/3/21,11,41,41,977,8085,871,9114,95,11887,820,157,7224,861,747,124,10,1,63,32,8044,1070,820,7224,209,861,1029,8085,6,10,0,12
Drew,1/3/21,19,43,43,1505,13433,1320,14978,166,18502,1203,302,11616,1817,1057,263,16,3,130,36,12819,2159,1203,11616,342,1817,1545,13433,33,7,0,50
Faulkner,1/3/21,94,45,45,7991,83501,6812,91840,1084,122416,6477,1514,73376,10125,5673,1139,78,16,725,359,79853,11987,6477,73376,1862,10125,8339,83501,73,98,0,354
Franklin,1/3/21,25,47,47,1131,13612,1002,14779,104,17780,924,207,12955,657,836,166,22,3,66,38,13879,900,924,12955,243,657,1167,13612,4,6,0,31
Fulton,1/3/21,36,49,49,911,4618,758,5565,117,12139,648,263,3687,931,559,199,16,20,73,44,4335,1230,648,3687,299,931,947,4618,8,9,0,21
Garland,1/3/21,155,51,51,5984,61990,5123,68137,704,98296,5128,856,57152,4838,4481,642,132,23,513,191,62280,5857,5128,57152,1019,4838,6147,61990,49,48,0,362
Grant,1/3/21,12,53,53,1117,11370,930,12537,175,18086,823,294,9776,1594,724,206,11,1,88,87,10599,1938,823,9776,344,1594,1167,11370,8,29,0,50
Greene,1/3/21,52,55,55,4523,32985,4146,37657,325,44623,3667,856,29037,3948,3385,761,43,9,239,86,32704,4953,3667,29037,1005,3948,4672,32985,44,20,0,121
Hempstead,1/3/21,11,57,57,1269,11374,1164,12689,93,22018,1010,259,10698,676,918,246,7,4,84,9,11708,981,1010,10698,305,676,1315,11374,20,9,0,33
HotSpring,1/3/21,57,59,59,3709,33724,3338,37497,314,33520,3464,245,28275,5449,3147,191,53,4,264,50,31739,5758,3464,28275,309,5449,3773,33724,10,14,0,223
Howard,1/3/21,18,61,61,1124,7515,1045,8696,61,13389,821,303,5924,1591,763,282,16,2,42,19,6745,1951,821,5924,360,1591,1181,7515,5,3,0,25
Independence,1/3/21,94,63,63,2857,25841,2518,28834,245,37264,2033,824,22101,3740,1827,691,71,23,135,110,24134,4700,2033,22101,960,3740,2993,25841,30,22,0,121
Izard,1/3/21,13,65,65,1352,11345,1159,12771,180,13559,1089,263,8820,2525,984,175,8,5,97,83,9909,2862,1089,8820,337,2525,1426,11345,4,5,0,36
Jackson,1/3/21,22,67,67,2839,19290,2700,22337,117,17225,2289,550,15825,3465,2193,507,16,6,80,37,18114,4223,2289,15825,758,3465,3047,19290,4,16,0,17
Jefferson,1/3/21,129,69,69,6846,62849,6160,69967,555,70424,5799,1047,56530,6319,5361,799,111,18,325,230,62329,7638,5799,56530,1319,6319,7118,62849,10,23,0,190
Johnson,1/3/21,20,71,71,1927,17132,1685,19087,222,26291,1654,273,16307,825,1475,210,17,3,162,60,17961,1126,1654,16307,301,825,1955,17132,13,17,0,64
Lafayette,1/3/21,4,73,73,350,2408,319,2782,26,6915,263,87,2177,231,243,76,4,0,16,10,2440,342,263,2177,111,231,374,2408,3,2,0,6
Lawrence,1/3/21,36,75,75,1621,10312,1446,12003,139,16669,1354,267,9562,750,1206,240,33,3,115,24,10916,1087,1354,9562,337,750,1691,10312,21,10,0,107
Lee,1/3/21,26,77,77,1459,8236,1364,9710,69,9398,1395,64,7777,459,1323,41,25,1,47,22,9172,538,1395,7777,79,459,1474,8236,4,6,0,45
Lincoln,1/3/21,26,79,79,2848,15939,2737,18842,84,13695,2630,218,13310,2629,2558,179,21,5,50,34,15940,2902,2630,13310,273,2629,2903,15939,4,2,1,40
LittleRiver,1/3/21,39,81,81,840,5390,715,6258,86,12417,683,157,4805,585,576,139,37,2,70,16,5488,770,683,4805,185,585,868,5390,2,6,0,9
Logan,1/3/21,11,83,83,1499,18559,1297,20099,191,21757,1229,270,16019,2540,1119,178,10,1,100,91,17248,2851,1229,16019,311,2540,1540,18559,20,9,0,51
Lonoke,1/3/21,83,85,85,4342,45491,3709,50091,550,72206,3199,1143,38552,6939,2770,939,71,12,358,192,41751,8340,3199,38552,1401,6939,4600,45491,57,41,2,276
Madison,1/3/21,12,87,87,1058,9364,955,10455,91,16076,844,214,8778,586,777,178,10,2,57,34,9622,833,844,8778,247,586,1091,9364,4,9,0,103
Marion,1/3/21,24,89,89,667,7006,568,7701,75,16438,496,171,6335,671,437,131,11,13,48,27,6831,870,496,6335,199,671,695,7006,7,3,0,46
Miller,1/3/21,25,91,91,2818,14813,2565,17723,228,43759,2023,795,12696,2117,1819,746,17,8,187,41,14719,3004,2023,12696,887,2117,2910,14813,6,12,0,12
MissingCountyInfo,1/3/21,0,5,5,2649,99173,2403,101837,246,NA,2189,460,99103,70,1994,409,0,0,195,51,101292,545,2189,99103,475,70,2664,99173,16,3,0,1604
Mississippi,1/3/21,95,93,93,4462,27081,4091,31620,275,42831,4032,430,19993,7088,3706,385,80,15,245,30,24025,7595,4032,19993,507,7088,4539,27081,34,23,0,73
Monroe,1/3/21,7,95,95,510,5154,418,5679,85,7249,429,81,4944,210,355,63,7,0,67,18,5373,306,429,4944,96,210,525,5154,7,9,0,20
Montgomery,1/3/21,18,97,97,517,5292,433,5821,66,8993,395,122,3426,1866,362,71,15,3,18,48,3821,2000,395,3426,134,1866,529,5292,2,3,0,6
Nevada,1/3/21,20,99,99,605,8865,547,9481,38,8440,522,83,8534,331,472,75,19,1,31,7,9056,425,522,8534,94,331,616,8865,4,2,0,9
Newton,1/3/21,24,101,101,564,4667,511,5244,29,7848,491,73,3010,1657,448,63,20,4,23,6,3501,1743,491,3010,86,1657,577,4667,4,8,0,10
Ouachita,1/3/21,29,103,103,1427,12678,1227,14159,170,24106,1243,184,11995,683,1078,149,21,8,143,27,13238,921,1243,11995,238,683,1481,12678,15,17,0,67
Perry,1/3/21,5,105,105,468,8347,373,8833,90,10322,382,86,7803,544,312,61,4,1,66,24,8185,648,382,7803,104,544,486,8347,3,6,0,30
Phillips,1/3/21,25,107,107,1296,13219,1176,14550,95,19034,1206,90,12862,357,1097,79,24,1,85,10,14068,482,1206,12862,125,357,1331,13219,15,4,0,43
Pike,1/3/21,11,109,109,709,5530,600,6269,98,10808,562,147,4968,562,501,99,7,4,54,44,5530,739,562,4968,177,562,739,5530,6,7,0,74
Poinsett,1/3/21,63,111,111,2450,18825,2166,21348,221,24054,2199,251,17872,953,1947,219,50,13,202,19,20071,1277,2199,17872,324,953,2523,18825,24,15,1,80
Polk,1/3/21,44,113,113,1294,9534,1111,10848,138,20163,1145,149,9051,483,999,112,31,13,114,24,10196,652,1145,9051,169,483,1314,9534,11,10,1,67
Pope,1/3/21,59,115,115,5726,49842,4959,55657,708,63644,4765,961,47684,2158,4178,781,49,10,538,170,52449,3208,4765,47684,1050,2158,5815,49842,38,45,1,374
Prairie,1/3/21,16,117,117,564,4977,477,5578,71,8244,421,143,4288,689,357,120,12,4,52,19,4709,869,421,4288,180,689,601,4977,4,5,0,46
Pulaski,1/3/21,396,119,119,25760,278537,22093,304999,3269,393463,22946,2814,258756,19781,19833,2260,365,31,2746,523,281702,23297,22946,258756,3516,19781,26462,278537,287,258,3,1900
Randolph,1/3/21,43,121,121,1486,12917,1303,14472,140,17603,1177,309,11080,1837,1052,251,32,11,93,47,12257,2215,1177,11080,378,1837,1555,12917,8,3,0,48
Saline,1/3/21,108,125,125,7888,72864,6922,81108,857,118009,6183,1705,61905,10959,5475,1447,94,14,613,244,68088,13020,6183,61905,2061,10959,8244,72864,68,71,2,271
Scott,1/3/21,11,127,127,619,7475,500,8112,108,10442,440,179,7187,288,394,106,11,0,35,73,7627,485,440,7187,197,288,637,7475,2,3,0,-13
Searcy,1/3/21,13,129,129,514,4704,447,5242,54,7923,320,194,3876,828,296,151,7,6,17,37,4196,1046,320,3876,218,828,538,4704,1,4,0,10
Sebastian,1/3/21,158,131,131,9982,98903,8732,109020,1089,127461,8295,1687,95337,3566,7512,1220,145,13,636,453,103632,5388,8295,95337,1822,3566,10117,98903,113,70,0,512
Sevier,1/3/21,20,133,133,2105,11447,1996,13637,89,17193,1565,540,9691,1756,1510,486,19,1,36,53,11256,2381,1565,9691,625,1756,2190,11447,4,6,0,101
Sharp,1/3/21,32,135,135,1182,11013,1008,12261,142,17043,851,331,9467,1546,750,258,24,8,77,65,10318,1943,851,9467,397,1546,1248,11013,14,18,0,44
St.Francis,1/3/21,20,123,123,2821,22525,2587,25377,214,26294,2690,131,22111,414,2473,114,20,0,197,17,24801,576,2690,22111,162,414,2852,22525,46,17,0,125
Stone,1/3/21,27,137,137,780,7379,676,8190,77,12446,619,161,6537,842,552,124,24,3,43,34,7156,1034,619,6537,192,842,811,7379,7,7,0,22
Union,1/3/21,73,139,139,2569,18947,2148,21643,348,39732,1994,575,15989,2958,1634,514,56,17,304,44,17983,3660,1994,15989,702,2958,2696,18947,15,29,0,40
VanBuren,1/3/21,8,141,141,780,10085,681,10935,91,16684,568,212,8751,1334,512,169,7,1,49,42,9319,1616,568,8751,282,1334,850,10085,3,7,0,11
Washington,1/3/21,224,143,143,22196,164161,19888,187193,2083,228529,17743,4453,144885,19276,16119,3769,187,37,1437,646,162628,24565,17743,144885,5289,19276,23032,164161,183,129,1,654
White,1/3/21,71,145,145,5033,35417,4219,40771,742,78804,3510,1523,29716,5701,3027,1192,61,10,421,321,33226,7545,3510,29716,1844,5701,5354,35417,42,47,1,226
Woodruff,1/3/21,2,147,147,394,5206,311,5639,81,6660,329,65,4915,291,253,58,1,1,75,6,5244,395,329,4915,104,291,433,5206,17,2,0,48
Yell,1/3/21,43,149,149,2498,21956,2183,24511,272,21573,2251,247,21108,848,1996,187,37,6,218,54,23359,1152,2251,21108,304,848,2555,21956,19,22,0,204
Arkansas_all_counties,1/2/21,3729,5630,5630,231442,2091806,203701,2330944,23986,2990671,191166,40276,1888622,203184,171049,32652,3121,608,16973,7013,2079788,251156,191166,1888622,47972,203184,239138,2091806,2000,1927,18,12832
Arkansas_county,1/2/21,31,1,1,1331,14607,1179,16025,121,18124,971,360,11238,3369,891,288,26,5,54,67,12209,3816,971,11238,447,3369,1418,14607,7,9,0,58
Ashley,1/2/21,21,3,3,1298,10875,1162,12212,115,20537,1090,208,10155,720,997,165,19,2,74,41,11245,967,1090,10155,247,720,1337,10875,7,8,0,103
Baxter,1/2/21,71,5,5,2123,14053,1854,16203,198,41219,1507,616,12436,1617,1359,495,44,27,104,94,13943,2260,1507,12436,643,1617,2150,14053,9,24,0,123
Benton,1/2/21,268,7,7,18591,136283,16108,155499,2214,258980,14533,4058,128518,7765,12867,3241,206,62,1459,755,143051,12448,14533,128518,4683,7765,19216,136283,236,215,2,639
Boone,1/2/21,69,9,9,2620,22976,2344,25721,205,37288,2129,491,21355,1621,1948,396,58,11,121,84,23484,2237,2129,21355,616,1621,2745,22976,27,16,1,168
Bradley,1/2/21,15,11,11,971,7691,828,8687,128,10948,769,202,5218,2473,662,166,9,6,98,30,5987,2700,769,5218,227,2473,996,7691,14,8,0,32
Calhoun,1/2/21,1,13,13,243,2818,211,3076,31,5202,195,48,2627,191,177,34,1,0,17,14,2822,254,195,2627,63,191,258,2818,4,3,0,10
Carroll,1/2/21,30,15,15,2116,13986,1925,16148,161,27887,1852,264,13653,333,1702,223,27,3,123,38,15505,643,1852,13653,310,333,2162,13986,6,15,0,80
Chicot,1/2/21,30,17,17,1420,9894,1342,11339,48,10826,1322,98,8526,1368,1255,87,29,1,38,10,9848,1491,1322,8526,123,1368,1445,9894,2,5,0,83
Clark,1/2/21,21,19,19,1409,17636,1206,19109,182,22385,1185,224,14919,2717,1019,187,18,3,148,34,16104,3005,1185,14919,288,2717,1473,17636,21,16,0,137
Clay,1/2/21,31,21,21,1337,12674,1195,14050,110,15061,1043,294,9749,2925,950,245,23,8,69,41,10792,3258,1043,9749,333,2925,1376,12674,5,6,0,37
Cleburne,1/2/21,38,23,23,1312,15493,1035,16872,239,25230,983,329,12852,2641,780,255,35,3,168,71,13835,3037,983,12852,396,2641,1379,15493,26,14,0,95
Cleveland,1/2/21,19,25,25,579,6495,506,7100,54,8226,397,182,5866,629,357,149,16,3,24,30,6263,837,397,5866,208,629,605,6495,2,6,0,48
Columbia,1/2/21,43,27,27,1595,13911,1428,15641,124,23892,1051,544,11070,2841,983,445,30,13,38,86,12121,3520,1051,11070,679,2841,1730,13911,4,14,0,26
Conway,1/2/21,16,29,29,1391,15009,1102,16448,273,20906,1107,284,12939,2070,886,216,12,4,209,64,14046,2402,1107,12939,332,2070,1439,15009,48,18,0,151
Craighead,1/2/21,137,31,31,10235,80995,9222,91491,875,105701,9128,1107,71771,9224,8253,969,124,13,750,125,80899,10592,9128,71771,1368,9224,10496,80995,59,70,1,316
Crawford,1/2/21,60,33,33,4601,46133,4046,50798,494,62472,3912,689,44402,1731,3530,516,51,9,330,164,48314,2484,3912,44402,753,1731,4665,46133,59,41,1,160
Crittenden,1/2/21,75,35,35,4387,28401,4028,32884,283,49013,4127,260,26709,1692,3810,218,64,11,252,31,30836,2048,4127,26709,356,1692,4483,28401,27,30,1,258
Cross,1/2/21,36,37,37,1441,11721,1247,13210,158,16998,1169,272,11045,676,1014,233,34,2,121,37,12214,996,1169,11045,320,676,1489,11721,17,10,0,55
Dallas,1/2/21,11,39,39,491,4903,427,5401,53,7432,449,42,4674,229,396,31,9,2,44,9,5123,278,449,4674,49,229,498,4903,1,12,0,16
Desha,1/2/21,11,41,41,971,8079,861,9102,99,11887,814,157,7220,859,741,120,10,1,63,36,8034,1068,814,7220,209,859,1023,8079,4,15,0,47
Drew,1/2/21,19,43,43,1472,13416,1313,14928,140,18502,1170,302,11601,1815,1051,262,16,3,103,37,12771,2157,1170,11601,342,1815,1512,13416,9,17,0,105
Faulkner,1/2/21,94,45,45,7918,83220,6714,91487,1109,122416,6438,1480,73149,10071,5604,1110,78,16,755,354,79587,11900,6438,73149,1829,10071,8267,83220,101,82,0,575
Franklin,1/2/21,25,47,47,1127,13585,996,14747,106,17780,919,208,12928,657,832,164,22,3,65,41,13847,900,919,12928,243,657,1162,13585,16,4,0,51
Fulton,1/2/21,36,49,49,903,4605,749,5544,118,12139,640,263,3674,931,555,194,16,20,69,49,4314,1230,640,3674,299,931,939,4605,8,10,0,16
Garland,1/2/21,155,51,51,5935,61677,5075,67775,703,98296,5093,842,56846,4831,4444,631,132,23,515,188,61939,5836,5093,56846,1005,4831,6098,61677,37,60,1,253
Grant,1/2/21,12,53,53,1109,11328,901,12487,196,18086,818,291,9749,1579,697,204,11,1,110,86,10567,1920,818,9749,341,1579,1159,11328,8,14,0,110
Greene,1/2/21,52,55,55,4479,32908,4126,37535,301,44623,3624,855,28987,3921,3369,757,43,9,212,89,32611,4924,3624,28987,1003,3921,4627,32908,16,48,0,115
Hempstead,1/2/21,11,57,57,1249,11361,1155,12656,82,22018,989,260,10687,674,914,241,7,4,67,15,11676,980,989,10687,306,674,1295,11361,9,16,0,71
HotSpring,1/2/21,57,59,59,3699,33511,3324,37272,318,33520,3459,240,28072,5439,3134,190,53,4,272,46,31531,5741,3459,28072,302,5439,3761,33511,38,26,1,191
Howard,1/2/21,18,61,61,1119,7495,1042,8671,59,13389,817,302,5910,1585,761,281,16,2,40,19,6727,1944,817,5910,359,1585,1176,7495,6,6,0,34
Independence,1/2/21,94,63,63,2827,25750,2496,28711,237,37264,2004,823,22031,3719,1815,681,71,23,118,119,24035,4676,2004,22031,957,3719,2961,25750,18,23,0,210
Izard,1/2/21,13,65,65,1348,11313,1154,12734,181,13559,1082,266,8788,2525,983,171,8,5,91,90,9870,2864,1082,8788,339,2525,1421,11313,14,13,0,27
Jackson,1/2/21,22,67,67,2835,19277,2684,22320,129,17225,2285,550,15814,3463,2188,496,16,6,81,48,18099,4221,2285,15814,758,3463,3043,19277,4,19,0,48
Jefferson,1/2/21,129,69,69,6836,62669,6137,69775,568,70424,5790,1046,56351,6318,5353,784,111,18,324,244,62141,7634,5790,56351,1316,6318,7106,62669,39,54,0,318
Johnson,1/2/21,20,71,71,1914,17081,1668,19023,226,26291,1645,269,16257,824,1468,200,17,3,160,66,17902,1121,1645,16257,297,824,1942,17081,29,26,0,97
Lafayette,1/2/21,4,73,73,347,2405,317,2776,25,6915,260,87,2175,230,242,75,4,0,14,11,2435,341,260,2175,111,230,371,2405,2,7,0,9
Lawrence,1/2/21,36,75,75,1600,10226,1436,11896,128,16669,1337,263,9480,746,1197,239,33,3,107,21,10817,1079,1337,9480,333,746,1670,10226,13,17,1,73
Lee,1/2/21,26,77,77,1455,8195,1358,9665,71,9398,1391,64,7736,459,1317,41,25,1,49,22,9127,538,1391,7736,79,459,1470,8195,6,8,0,14
Lincoln,1/2/21,25,79,79,2844,15903,2735,18802,83,13695,2628,216,13274,2629,2556,179,21,4,50,33,15902,2900,2628,13274,271,2629,2899,15903,16,12,1,73
LittleRiver,1/2/21,39,81,81,838,5383,709,6249,90,12417,681,157,4799,584,571,138,37,2,73,17,5480,769,681,4799,185,584,866,5383,11,8,0,146
Logan,1/2/21,11,83,83,1479,18528,1288,20047,180,21757,1211,268,15988,2540,1115,173,10,1,86,94,17199,2848,1211,15988,308,2540,1519,18528,26,11,0,68
Lonoke,1/2/21,81,85,85,4285,45272,3668,49813,536,72206,3165,1120,38330,6942,2742,926,70,11,353,183,41495,8318,3165,38330,1376,6942,4541,45272,50,46,0,314
Madison,1/2/21,12,87,87,1054,9265,946,10352,96,16076,840,214,8680,585,772,174,10,2,58,38,9520,832,840,8680,247,585,1087,9265,6,5,0,43
Marion,1/2/21,24,89,89,660,6967,565,7655,71,16438,490,170,6296,671,434,131,11,13,45,26,6786,869,490,6296,198,671,688,6967,5,4,0,68
Miller,1/2/21,25,91,91,2812,14807,2553,17711,234,43759,2019,793,12690,2117,1812,741,17,8,190,44,14709,3002,2019,12690,885,2117,2904,14807,29,19,0,64
MissingCountyInfo,1/2/21,0,5,5,2633,97585,2400,100236,233,NA,2162,471,97515,70,1990,410,0,0,172,61,99677,559,2162,97515,489,70,2651,97585,-195,-4,0,1150
Mississippi,1/2/21,95,93,93,4428,27042,4068,31548,264,42831,3999,429,19963,7079,3687,381,80,15,231,33,23962,7586,3999,19963,507,7079,4506,27042,17,19,0,104
Monroe,1/2/21,7,95,95,503,5141,409,5658,87,7249,421,82,4932,209,348,61,7,0,66,21,5353,305,421,4932,96,209,517,5141,17,4,0,72
Montgomery,1/2/21,18,97,97,515,5288,430,5815,67,8993,393,122,3422,1866,360,70,15,3,18,49,3815,2000,393,3422,134,1866,527,5288,7,5,0,24
Nevada,1/2/21,20,99,99,601,8860,545,9471,36,8440,517,84,8530,330,470,75,19,1,28,8,9047,424,517,8530,94,330,611,8860,3,3,0,51
Newton,1/2/21,24,101,101,560,4661,503,5233,33,7848,486,74,3005,1656,442,61,20,4,24,9,3491,1742,486,3005,86,1656,572,4661,3,0,0,10
Ouachita,1/2/21,29,103,103,1412,12626,1210,14090,172,24106,1228,184,11943,683,1064,146,21,8,142,30,13171,919,1228,11943,236,683,1464,12626,19,15,0,115
Perry,1/2/21,5,105,105,465,8320,367,8803,93,10322,379,86,7783,537,309,58,4,1,66,27,8162,641,379,7783,104,537,483,8320,19,3,0,64
Phillips,1/2/21,25,107,107,1281,13191,1172,14507,84,19034,1191,90,12834,357,1093,79,24,1,74,10,14025,482,1191,12834,125,357,1316,13191,9,3,0,43
Pike,1/2/21,11,109,109,703,5462,593,6194,99,10808,558,145,4902,560,497,96,7,4,54,45,5460,734,558,4902,174,560,732,5462,2,11,1,9
Poinsett,1/2/21,62,111,111,2426,18769,2151,21268,213,24054,2175,251,17821,948,1934,217,49,13,192,21,19996,1272,2175,17821,324,948,2499,18769,8,15,0,105
Polk,1/2/21,43,113,113,1283,9478,1101,10781,138,20163,1133,150,8998,480,992,109,30,13,110,28,10131,650,1133,8998,170,480,1303,9478,8,5,1,30
Pope,1/2/21,58,115,115,5688,49506,4914,55283,716,63644,4740,948,47349,2157,4141,773,48,10,551,165,52089,3194,4740,47349,1037,2157,5777,49506,104,40,0,567
Prairie,1/2/21,16,117,117,560,4935,472,5532,72,8244,418,142,4249,686,353,119,12,4,53,19,4667,865,418,4249,179,686,597,4935,6,5,0,22
Pulaski,1/2/21,393,119,119,25473,276924,21835,303087,3243,393463,22720,2753,257191,19733,19612,2223,362,31,2744,499,279911,23176,22720,257191,3443,19733,26163,276924,264,243,1,1799
Randolph,1/2/21,43,121,121,1478,12877,1300,14424,135,17603,1173,305,11049,1828,1050,250,32,11,91,44,12222,2202,1173,11049,374,1828,1547,12877,5,8,1,89
Saline,1/2/21,106,125,125,7820,72661,6851,80836,862,118009,6138,1682,61742,10919,5426,1425,93,13,618,244,67880,12956,6138,61742,2037,10919,8175,72661,69,64,1,356
Scott,1/2/21,11,127,127,617,7490,497,8125,109,10442,439,178,7203,287,394,103,11,0,34,75,7642,483,439,7203,196,287,635,7490,6,8,0,28
Searcy,1/2/21,13,129,129,513,4695,443,5232,57,7923,319,194,3868,827,296,147,7,6,16,41,4187,1045,319,3868,218,827,537,4695,3,2,2,10
Sebastian,1/2/21,158,131,131,9869,98504,8662,108506,1046,127461,8219,1650,94971,3533,7470,1192,145,13,602,444,103190,5316,8219,94971,1783,3533,10002,98504,81,66,0,326
Sevier,1/2/21,20,133,133,2101,11350,1990,13536,91,17193,1561,540,9621,1729,1507,483,19,1,35,56,11182,2354,1561,9621,625,1729,2186,11350,5,8,0,48
Sharp,1/2/21,32,135,135,1168,10983,990,12217,146,17043,841,327,9444,1539,735,255,24,8,82,64,10285,1932,841,9444,393,1539,1234,10983,10,17,0,42
St.Francis,1/2/21,20,123,123,2775,22446,2570,25252,185,26294,2644,131,22032,414,2459,111,20,0,165,20,24676,576,2644,22032,162,414,2806,22446,17,5,0,55
Stone,1/2/21,27,137,137,773,7364,669,8166,77,12446,611,162,6528,836,547,122,24,3,40,37,7139,1027,611,6528,191,836,802,7364,3,25,0,57
Union,1/2/21,73,139,139,2554,18922,2119,21603,362,39732,1983,571,15964,2958,1610,509,56,17,317,45,17947,3656,1983,15964,698,2958,2681,18922,31,23,0,212
VanBuren,1/2/21,8,141,141,777,10077,674,10923,95,16684,566,211,8744,1333,508,166,7,1,51,44,9310,1613,566,8744,280,1333,846,10077,6,5,0,35
Washington,1/2/21,223,143,143,22013,163690,19759,186534,2030,228529,17602,4411,144432,19258,16022,3737,186,37,1394,636,162034,24500,17602,144432,5242,19258,22844,163690,208,141,0,1050
White,1/2/21,70,145,145,4991,35233,4172,40539,748,78804,3477,1514,29535,5698,2997,1175,61,9,418,330,33012,7527,3477,29535,1829,5698,5306,35233,98,50,1,392
Woodruff,1/2/21,2,147,147,377,5175,309,5591,66,6660,312,65,4890,285,252,57,1,1,59,7,5202,389,312,4890,104,285,416,5175,10,6,0,99
Yell,1/2/21,43,149,149,2479,21771,2161,24307,275,21573,2233,246,20928,843,1981,180,37,6,215,60,23161,1146,2233,20928,303,843,2536,21771,56,22,0,133
Arkansas_all_counties,1/1/21,3711,5630,5630,229442,2080974,201774,2317995,23930,2990671,189569,39873,1878515,202459,169701,32073,3106,605,16739,7191,2068084,249911,189569,1878515,47452,202459,237021,2080974,4304,2527,35,20370
Arkansas_county,1/1/21,31,1,1,1324,14556,1170,15967,123,18124,966,358,11193,3363,888,282,26,5,52,71,12159,3808,966,11193,445,3363,1411,14556,10,15,1,117
Ashley,1/1/21,21,3,3,1291,10779,1154,12109,116,20537,1082,209,10058,721,993,161,19,2,70,46,11140,969,1082,10058,248,721,1330,10779,18,15,0,129
Baxter,1/1/21,71,5,5,2114,13939,1830,16080,213,41219,1500,614,12324,1615,1346,484,44,27,110,103,13824,2256,1500,12324,641,1615,2141,13939,49,21,0,141
Benton,1/1/21,266,7,7,18355,135880,15893,154851,2195,258980,14358,3997,128142,7738,12731,3162,205,61,1421,774,142500,12351,14358,128142,4613,7738,18971,135880,597,239,2,1985
Boone,1/1/21,68,9,9,2593,22835,2328,25553,195,37288,2119,474,21220,1615,1939,389,57,11,121,74,23339,2214,2119,21220,599,1615,2718,22835,22,23,0,236
Bradley,1/1/21,15,11,11,957,7673,820,8655,122,10948,755,202,5200,2473,657,163,9,6,89,33,5955,2700,755,5200,227,2473,982,7673,17,22,4,62
Calhoun,1/1/21,1,13,13,239,2812,208,3066,30,5202,191,48,2621,191,176,32,1,0,14,16,2812,254,191,2621,63,191,254,2812,5,3,0,68
Carroll,1/1/21,30,15,15,2110,13912,1910,16068,170,27887,1846,264,13579,333,1689,221,27,3,130,40,15425,643,1846,13579,310,333,2156,13912,37,15,0,135
Chicot,1/1/21,30,17,17,1418,9813,1337,11256,51,10826,1320,98,8445,1368,1251,86,29,1,40,11,9765,1491,1320,8445,123,1368,1443,9813,8,8,0,82
Clark,1/1/21,21,19,19,1388,17520,1190,18972,177,22385,1165,223,14808,2712,1008,182,18,3,139,38,15973,2999,1165,14808,287,2712,1452,17520,17,15,0,93
Clay,1/1/21,31,21,21,1332,12642,1189,14012,111,15061,1041,291,9745,2897,945,244,23,8,72,39,10786,3226,1041,9745,329,2897,1370,12642,15,9,1,95
Cleburne,1/1/21,38,23,23,1286,15424,1021,16775,227,25230,962,324,12781,2643,772,249,35,3,155,72,13743,3032,962,12781,389,2643,1351,15424,50,21,0,332
Cleveland,1/1/21,19,25,25,577,6449,500,7051,58,8226,395,182,5827,622,355,145,16,3,24,34,6222,829,395,5827,207,622,602,6449,6,4,2,62
Columbia,1/1/21,43,27,27,1591,13889,1414,15615,134,23892,1050,541,11052,2837,982,432,30,13,38,96,12102,3513,1050,11052,676,2837,1726,13889,24,18,2,329
Conway,1/1/21,16,29,29,1343,14906,1084,16297,243,20906,1061,282,12838,2068,876,208,12,4,173,70,13899,2398,1061,12838,330,2068,1391,14906,37,27,0,150
Craighead,1/1/21,136,31,31,10176,80738,9152,91173,887,105701,9070,1106,71612,9126,8198,954,123,13,748,139,80682,10491,9070,71612,1365,9126,10435,80738,99,86,0,647
Crawford,1/1/21,59,33,33,4542,46032,4005,50638,477,62472,3873,669,44311,1721,3503,502,50,9,319,158,48184,2454,3873,44311,733,1721,4606,46032,91,61,1,456
Crittenden,1/1/21,74,35,35,4360,28170,3998,32625,287,49013,4100,260,26478,1692,3784,214,63,11,252,35,30578,2047,4100,26478,355,1692,4455,28170,41,41,1,132
Cross,1/1/21,36,37,37,1424,11683,1237,13152,151,16998,1156,268,11010,673,1005,232,34,2,117,34,12166,986,1156,11010,313,673,1469,11683,30,21,0,193
Dallas,1/1/21,11,39,39,490,4888,415,5385,64,7432,448,42,4660,228,384,31,9,2,55,9,5108,277,448,4660,49,228,497,4888,8,3,0,97
Desha,1/1/21,11,41,41,967,8036,846,9051,110,11887,810,157,7183,853,726,120,10,1,74,36,7993,1058,810,7183,205,853,1015,8036,14,15,0,85
Drew,1/1/21,19,43,43,1463,13320,1296,14822,148,18502,1160,303,11506,1814,1034,262,16,3,110,38,12666,2156,1160,11506,342,1814,1502,13320,15,26,0,97
Faulkner,1/1/21,94,45,45,7817,82746,6632,90903,1090,122416,6341,1476,72677,10069,5551,1081,78,16,711,379,79018,11885,6341,72677,1816,10069,8157,82746,199,99,2,738
Franklin,1/1/21,25,47,47,1111,13550,992,14696,94,17780,909,202,12894,656,830,162,22,3,57,37,13803,893,909,12894,237,656,1146,13550,23,11,0,154
Fulton,1/1/21,36,49,49,895,4597,739,5528,120,12139,635,260,3666,931,551,188,16,20,68,52,4301,1227,635,3666,296,931,931,4597,11,12,0,42
Garland,1/1/21,154,51,51,5898,61461,5015,67519,727,98296,5070,828,56647,4814,4403,612,131,23,534,193,61717,5802,5070,56647,988,4814,6058,61461,116,77,1,664
Grant,1/1/21,12,53,53,1101,11226,887,12377,202,18086,812,289,9655,1571,689,198,11,1,112,90,10467,1910,812,9655,339,1571,1151,11226,30,22,0,157
Greene,1/1/21,52,55,55,4463,32809,4078,37418,333,44623,3610,853,28921,3888,3332,746,43,9,235,98,32531,4887,3610,28921,999,3888,4609,32809,32,31,1,117
Hempstead,1/1/21,11,57,57,1240,11299,1139,12585,89,22018,980,260,10631,668,906,233,7,4,66,23,11611,974,980,10631,306,668,1286,11299,20,14,0,69
HotSpring,1/1/21,56,59,59,3661,33358,3298,37081,307,33520,3425,236,27925,5433,3113,185,52,4,260,47,31350,5731,3425,27925,298,5433,3723,33358,25,18,1,223
Howard,1/1/21,18,61,61,1113,7467,1036,8635,59,13389,811,302,5887,1580,756,280,16,2,39,20,6698,1937,811,5887,357,1580,1168,7467,7,4,0,35
Independence,1/1/21,94,63,63,2809,25558,2473,28500,242,37264,1995,814,21833,3725,1802,671,71,23,122,120,23828,4672,1995,21833,947,3725,2942,25558,58,20,1,398
Izard,1/1/21,13,65,65,1334,11300,1141,12691,180,13559,1065,269,8775,2525,973,168,8,5,84,96,9840,2851,1065,8775,326,2525,1391,11300,36,10,0,120
Jackson,1/1/21,22,67,67,2831,19233,2665,22272,144,17225,2283,548,15771,3462,2174,491,16,6,93,51,18054,4218,2283,15771,756,3462,3039,19233,10,105,0,60
Jefferson,1/1/21,129,69,69,6797,62390,6083,69455,583,70424,5769,1028,56185,6205,5312,771,111,18,344,239,61954,7501,5769,56185,1296,6205,7065,62390,79,126,2,308
Johnson,1/1/21,20,71,71,1885,17013,1642,18926,223,26291,1621,264,16195,818,1454,188,17,3,150,73,17816,1110,1621,16195,292,818,1913,17013,62,23,0,237
Lafayette,1/1/21,4,73,73,345,2398,310,2767,30,6915,260,85,2168,230,238,72,4,0,18,12,2428,339,260,2168,109,230,369,2398,3,3,0,34
Lawrence,1/1/21,35,75,75,1587,10166,1419,11823,133,16669,1326,261,9423,743,1183,236,32,3,111,22,10749,1074,1326,9423,331,743,1657,10166,13,18,0,63
Lee,1/1/21,26,77,77,1449,8187,1350,9651,73,9398,1388,61,7727,460,1312,38,25,1,51,22,9115,536,1388,7727,76,460,1464,8187,19,7,0,65
Lincoln,1/1/21,24,79,79,2828,15846,2723,18727,80,13695,2617,211,13219,2627,2548,175,20,4,48,32,15836,2891,2617,13219,264,2627,2881,15846,8,6,0,59
LittleRiver,1/1/21,39,81,81,827,5248,701,6103,87,12417,671,156,4664,584,564,137,37,2,70,17,5335,768,671,4664,184,584,855,5248,6,1,1,23
Logan,1/1/21,11,83,83,1453,18486,1277,19980,165,21757,1197,256,15951,2535,1108,169,10,1,79,86,17148,2832,1197,15951,297,2535,1494,18486,34,12,0,252
Lonoke,1/1/21,81,85,85,4235,45008,3622,49497,532,72206,3135,1100,38142,6866,2713,909,70,11,352,180,41277,8220,3135,38142,1354,6866,4489,45008,102,63,2,551
Madison,1/1/21,12,87,87,1048,9228,941,10309,95,16076,837,211,8645,583,770,171,10,2,57,38,9482,827,837,8645,244,583,1081,9228,23,20,0,170
Marion,1/1/21,24,89,89,655,6904,561,7576,70,16438,476,179,6233,671,433,128,11,13,32,38,6709,867,476,6233,196,671,672,6904,26,9,0,89
Miller,1/1/21,25,91,91,2783,14772,2534,17646,224,43759,1990,793,12655,2117,1804,730,17,8,169,55,14645,3001,1990,12655,884,2117,2874,14772,34,27,0,81
MissingCountyInfo,1/1/21,0,5,5,2828,96240,2404,99091,424,NA,2272,556,96171,69,1991,413,0,0,281,143,98443,648,2272,96171,579,69,2851,96240,9,2,0,174
Mississippi,1/1/21,95,93,93,4411,26955,4049,31444,266,42831,3982,429,19884,7071,3669,380,80,15,232,34,23866,7578,3982,19884,507,7071,4489,26955,18,35,1,144
Monroe,1/1/21,7,95,95,486,5086,405,5585,74,7249,404,82,4877,209,346,59,7,0,51,23,5281,304,404,4877,95,209,499,5086,11,4,0,31
Montgomery,1/1/21,18,97,97,508,5271,425,5791,65,8993,389,119,3404,1867,356,69,15,3,18,47,3793,1998,389,3404,131,1867,520,5271,16,8,0,43
Nevada,1/1/21,20,99,99,598,8812,542,9420,36,8440,514,84,8483,329,467,75,19,1,28,8,8997,423,514,8483,94,329,608,8812,4,4,0,100
Newton,1/1/21,24,101,101,557,4654,503,5223,30,7848,484,73,2998,1656,442,61,20,4,22,8,3482,1741,484,2998,85,1656,569,4654,4,2,0,23
Ouachita,1/1/21,29,103,103,1393,12530,1195,13975,168,24106,1209,184,11847,683,1054,141,21,8,133,35,13056,919,1209,11847,236,683,1445,12530,23,15,2,230
Perry,1/1/21,5,105,105,446,8275,364,8739,77,10322,364,82,7737,538,307,57,4,1,53,24,8101,638,364,7737,100,538,464,8275,8,9,0,49
Phillips,1/1/21,25,107,107,1272,13157,1169,14464,78,19034,1183,89,12801,356,1090,79,24,1,69,9,13984,480,1183,12801,124,356,1307,13157,8,10,0,97
Pike,1/1/21,10,109,109,701,5455,582,6185,109,10808,558,143,4896,559,488,94,7,3,63,46,5454,731,558,4896,172,559,730,5455,16,15,0,52
Poinsett,1/1/21,62,111,111,2418,18672,2136,21163,220,24054,2169,249,17729,943,1919,217,49,13,201,19,19898,1265,2169,17729,322,943,2491,18672,12,31,0,91
Polk,1/1/21,42,113,113,1275,9456,1096,10751,136,20163,1126,149,8976,480,987,109,29,13,109,27,10102,649,1126,8976,169,480,1295,9456,20,5,0,84
Pope,1/1/21,58,115,115,5584,49043,4874,54714,652,63644,4647,937,46929,2114,4105,769,48,10,494,158,51576,3138,4647,46929,1024,2114,5671,49043,136,78,0,510
Prairie,1/1/21,16,117,117,554,4919,467,5509,71,8244,413,141,4232,687,349,118,12,4,52,19,4645,864,413,4232,177,687,590,4919,9,4,0,55
Pulaski,1/1/21,392,119,119,25209,275389,21592,301279,3223,393463,22498,2711,255679,19710,19408,2184,361,31,2727,496,278177,23102,22498,255679,3392,19710,25890,275389,547,272,2,2437
Randolph,1/1/21,42,121,121,1473,12793,1292,14335,139,17603,1168,305,10965,1828,1042,250,31,11,95,44,12133,2202,1168,10965,374,1828,1542,12793,18,10,0,106
Saline,1/1/21,105,125,125,7751,72374,6787,80476,858,118009,6090,1661,61461,10913,5383,1404,92,13,614,244,67551,12925,6090,61461,2012,10913,8102,72374,188,91,1,825
Scott,1/1/21,11,127,127,611,7468,489,8096,111,10442,434,177,7182,286,392,97,11,0,31,80,7616,480,434,7182,194,286,628,7468,23,3,0,166
Searcy,1/1/21,11,129,129,510,4688,441,5222,58,7923,317,193,3863,825,293,148,6,5,18,40,4180,1042,317,3863,217,825,534,4688,7,5,0,28
Sebastian,1/1/21,158,131,131,9788,98259,8596,108178,1031,127461,8189,1599,94752,3507,7437,1159,145,13,605,426,102941,5237,8189,94752,1730,3507,9919,98259,274,120,2,968
Sevier,1/1/21,20,133,133,2096,11307,1982,13486,94,17193,1557,539,9584,1723,1506,476,19,1,32,62,11141,2345,1557,9584,622,1723,2179,11307,17,15,0,70
Sharp,1/1/21,32,135,135,1158,10951,973,12175,153,17043,836,322,9410,1541,723,250,24,8,89,64,10246,1929,836,9410,388,1541,1224,10951,24,13,0,120
St.Francis,1/1/21,20,123,123,2758,22408,2565,25197,173,26294,2631,127,21993,415,2457,108,20,0,154,19,24624,573,2631,21993,158,415,2789,22408,30,18,0,144
Stone,1/1/21,27,137,137,770,7310,644,8109,99,12446,608,162,6480,830,527,117,24,3,57,42,7088,1021,608,6480,191,830,799,7310,5,7,0,140
Union,1/1/21,73,139,139,2523,18741,2096,21387,354,39732,1952,571,15788,2953,1593,503,56,17,303,51,17740,3647,1952,15788,694,2953,2646,18741,95,27,0,382
VanBuren,1/1/21,8,141,141,771,10048,669,10888,94,16684,561,210,8717,1331,505,164,7,1,49,45,9278,1610,561,8717,279,1331,840,10048,28,8,0,139
Washington,1/1/21,223,143,143,21805,162848,19618,185472,1962,228529,17452,4353,143638,19210,15926,3692,186,37,1340,622,161090,24382,17452,143638,5172,19210,22624,162848,385,168,1,2096
White,1/1/21,69,145,145,4893,34939,4122,40141,701,78804,3430,1463,29299,5640,2970,1152,60,9,399,302,32729,7412,3430,29299,1772,5640,5202,34939,145,74,0,393
Woodruff,1/1/21,2,147,147,367,5086,303,5491,62,6660,302,65,4803,283,246,57,1,1,55,7,5105,386,302,4803,103,283,405,5086,5,6,0,54
Yell,1/1/21,43,149,149,2423,21694,2139,24171,241,21573,2179,244,20855,839,1962,177,37,6,180,61,23034,1137,2179,20855,298,839,2477,21694,33,22,1,187
Arkansas_all_counties,12/31/20,3676,5630,5630,225138,2064908,199247,2297510,22189,2990671,186784,38354,1864704,200204,167893,31354,3088,588,15780,6409,2051488,246022,186784,1864704,45818,200204,232602,2064908,2708,2333,39,16548
Arkansas_county,12/31/20,30,1,1,1314,14449,1155,15849,129,18124,958,356,11100,3349,883,272,26,4,49,80,12058,3791,958,11100,442,3349,1400,14449,17,14,1,67
Ashley,12/31/20,21,3,3,1273,10668,1139,11980,113,20537,1073,200,9951,717,983,156,19,2,71,42,11024,956,1073,9951,239,717,1312,10668,23,11,1,107
Baxter,12/31/20,71,5,5,2065,13847,1809,15939,185,41219,1489,576,12238,1609,1334,475,44,27,111,74,13727,2212,1489,12238,603,1609,2092,13847,25,22,0,99
Benton,12/31/20,264,7,7,17758,134492,15654,152852,1839,258980,13979,3779,126926,7566,12570,3084,205,59,1203,636,140905,11947,13979,126926,4381,7566,18360,134492,255,227,1,2109
Boone,12/31/20,68,9,9,2571,22621,2305,25316,196,37288,2106,465,21017,1604,1923,382,57,11,124,72,23123,2193,2106,21017,589,1604,2695,22621,24,21,0,178
Bradley,12/31/20,11,11,11,940,7628,798,8596,131,10948,743,197,5157,2471,642,156,9,2,92,39,5900,2696,743,5157,225,2471,968,7628,22,10,0,97
Calhoun,12/31/20,1,13,13,234,2749,205,2998,28,5202,190,44,2596,153,173,32,1,0,16,12,2786,212,190,2596,59,153,249,2749,7,3,0,17
Carroll,12/31/20,30,15,15,2073,13814,1895,15931,148,27887,1819,254,13486,328,1676,219,27,3,116,32,15305,626,1819,13486,298,328,2117,13814,19,19,0,120
Chicot,12/31/20,30,17,17,1410,9739,1329,11173,51,10826,1312,98,8375,1364,1245,84,29,1,38,13,9687,1486,1312,8375,122,1364,1434,9739,12,6,1,92
Clark,12/31/20,21,19,19,1371,17444,1175,18879,175,22385,1153,218,14758,2686,993,182,18,3,142,33,15911,2968,1153,14758,282,2686,1435,17444,18,9,0,104
Clay,12/31/20,30,21,21,1317,12562,1180,13916,106,15061,1027,290,9671,2891,938,242,23,7,65,41,10698,3218,1027,9671,327,2891,1354,12562,11,14,0,57
Cleburne,12/31/20,38,23,23,1236,15142,1000,16437,198,25230,920,316,12584,2558,757,243,35,3,128,70,13504,2933,920,12584,375,2558,1295,15142,28,24,1,128
Cleveland,12/31/20,17,25,25,571,6393,496,6990,58,8226,391,180,5772,621,354,142,15,2,22,36,6163,827,391,5772,206,621,597,6393,16,3,0,52
Columbia,12/31/20,41,27,27,1567,13584,1396,15285,130,23892,1039,528,10752,2832,974,422,29,12,36,94,11791,3494,1039,10752,662,2832,1701,13584,15,10,0,60
Conway,12/31/20,16,29,29,1306,14793,1057,16147,233,20906,1032,274,12725,2068,856,201,12,4,164,69,13757,2390,1032,12725,322,2068,1354,14793,17,27,1,200
Craighead,12/31/20,136,31,31,10077,80190,9066,90524,874,105701,8983,1094,71114,9076,8127,939,123,13,732,142,80097,10427,8983,71114,1351,9076,10334,80190,117,100,0,506
Crawford,12/31/20,58,33,33,4451,45667,3944,50179,448,62472,3810,641,43980,1687,3456,488,49,9,304,144,47790,2389,3810,43980,702,1687,4512,45667,49,33,0,299
Crittenden,12/31/20,73,35,35,4319,28079,3957,32492,288,49013,4066,253,26388,1691,3747,210,62,11,256,32,30454,2038,4066,26388,347,1691,4413,28079,26,34,1,350
Cross,12/31/20,36,37,37,1394,11520,1216,12958,142,16998,1132,262,10853,667,987,229,34,2,111,31,11985,973,1132,10853,306,667,1438,11520,17,25,0,184
Dallas,12/31/20,11,39,39,482,4799,412,5287,59,7432,442,40,4573,226,381,31,9,2,52,7,5015,272,442,4573,46,226,488,4799,6,5,0,69
Desha,12/31/20,11,41,41,953,7965,831,8966,111,11887,800,153,7127,838,715,116,10,1,75,36,7927,1039,800,7127,201,838,1001,7965,10,19,0,42
Drew,12/31/20,19,43,43,1448,13238,1270,14725,159,18502,1147,301,11423,1815,1013,257,16,3,118,41,12570,2155,1147,11423,340,1815,1487,13238,25,21,1,197
Faulkner,12/31/20,92,45,45,7618,82207,6533,90154,992,122416,6227,1391,72181,10026,5490,1043,76,16,660,332,78408,11746,6227,72181,1720,10026,7947,82207,102,115,0,684
Franklin,12/31/20,25,47,47,1088,13419,981,14542,82,17780,893,195,12777,642,822,159,22,3,49,33,13670,872,893,12777,230,642,1123,13419,9,11,0,101
Fulton,12/31/20,36,49,49,884,4566,727,5485,121,12139,630,254,3647,919,544,183,16,20,70,51,4277,1208,630,3647,289,919,919,4566,20,11,2,51
Garland,12/31/20,153,51,51,5782,60913,4938,66850,689,98296,4998,784,56218,4695,4343,595,130,23,523,166,61216,5634,4998,56218,939,4695,5937,60913,43,65,1,392
Grant,12/31/20,12,53,53,1071,11099,865,12220,194,18086,794,277,9536,1563,679,186,11,1,104,90,10330,1890,794,9536,327,1563,1121,11099,15,16,1,83
Greene,12/31/20,51,55,55,4431,32724,4047,37300,333,44623,3592,839,28856,3868,3315,732,42,9,235,98,32448,4852,3592,28856,984,3868,4576,32724,33,48,0,245
Hempstead,12/31/20,11,57,57,1220,11250,1125,12516,83,22018,963,257,10583,667,898,227,7,4,57,26,11546,970,963,10583,303,667,1266,11250,5,17,0,21
HotSpring,12/31/20,55,59,59,3636,33160,3280,36858,301,33520,3404,232,27740,5420,3100,180,51,4,253,48,31144,5714,3404,27740,294,5420,3698,33160,21,23,0,196
Howard,12/31/20,18,61,61,1106,7439,1032,8600,56,13389,805,301,5859,1580,754,278,16,2,35,21,6664,1936,805,5859,356,1580,1161,7439,9,7,0,23
Independence,12/31/20,93,63,63,2751,25218,2453,28094,205,37264,1969,782,21558,3660,1787,666,70,23,112,93,23527,4567,1969,21558,907,3660,2876,25218,27,36,0,220
Izard,12/31/20,13,65,65,1298,11216,1131,12569,154,13559,1050,248,8710,2506,967,164,8,5,75,79,9760,2809,1050,8710,303,2506,1353,11216,27,14,1,133
Jackson,12/31/20,22,67,67,2821,19183,2560,22212,239,17225,2279,542,15729,3454,2075,485,16,6,188,51,18008,4204,2279,15729,750,3454,3029,19183,5,7,1,43
Jefferson,12/31/20,127,69,69,6718,62161,5957,69145,632,70424,5752,966,55980,6181,5204,753,110,17,436,196,61732,7413,5752,55980,1232,6181,6984,62161,70,77,0,704
Johnson,12/31/20,20,71,71,1823,16838,1619,18689,184,26291,1580,243,16022,816,1435,184,17,3,128,56,17602,1087,1580,16022,271,816,1851,16838,6,18,0,49
Lafayette,12/31/20,4,73,73,342,2367,307,2733,30,6915,257,85,2138,229,238,69,4,0,15,15,2395,338,257,2138,109,229,366,2367,1,1,0,8
Lawrence,12/31/20,35,75,75,1574,10116,1401,11758,138,16669,1315,259,9380,736,1168,233,32,3,115,23,10695,1063,1315,9380,327,736,1642,10116,6,19,0,47
Lee,12/31/20,26,77,77,1430,8141,1343,9585,61,9398,1376,54,7682,459,1305,38,25,1,46,15,9058,527,1376,7682,68,459,1444,8141,5,8,0,25
Lincoln,12/31/20,24,79,79,2820,15795,2717,18667,78,13695,2608,212,13169,2626,2542,175,20,4,45,33,15777,2890,2608,13169,264,2626,2872,15795,10,6,0,125
LittleRiver,12/31/20,38,81,81,821,5231,700,6080,83,12417,664,157,4647,584,563,137,36,2,65,18,5311,769,664,4647,185,584,849,5231,15,8,0,47
Logan,12/31/20,11,83,83,1419,18268,1265,19725,143,21757,1184,235,15786,2482,1102,163,10,1,72,71,16970,2755,1184,15786,273,2482,1457,18268,11,14,0,101
Lonoke,12/31/20,79,85,85,4133,44559,3559,48939,495,72206,3072,1061,37777,6782,2672,887,68,11,332,163,40849,8090,3072,37777,1308,6782,4380,44559,40,52,1,412
Madison,12/31/20,12,87,87,1025,9081,921,10139,92,16076,822,203,8515,566,754,167,10,2,58,34,9337,802,822,8515,236,566,1058,9081,11,14,0,59
Marion,12/31/20,24,89,89,629,6841,552,7486,53,16438,472,157,6176,665,428,124,11,13,33,20,6648,838,472,6176,173,665,645,6841,9,11,1,31
Miller,12/31/20,25,91,91,2749,14725,2507,17565,217,43759,1959,790,12618,2107,1790,717,17,8,152,65,14577,2988,1959,12618,881,2107,2840,14725,16,19,0,126
MissingCountyInfo,12/31/20,0,5,5,2819,96075,2402,98921,417,NA,2273,546,96008,67,1987,415,0,0,286,131,98281,640,2273,96008,573,67,2846,96075,103,15,0,-677
Mississippi,12/31/20,94,93,93,4393,26829,4014,31301,284,42831,3970,423,19826,7003,3641,373,79,15,249,35,23796,7505,3970,19826,502,7003,4472,26829,28,31,1,163
Monroe,12/31/20,7,95,95,475,5066,401,5554,67,7249,396,79,4860,206,342,59,7,0,47,20,5256,298,396,4860,92,206,488,5066,8,2,0,49
Montgomery,12/31/20,18,97,97,492,5244,417,5748,57,8993,386,106,3383,1861,351,66,15,3,20,37,3769,1979,386,3383,118,1861,504,5244,3,4,0,111
Nevada,12/31/20,20,99,99,594,8716,538,9319,36,8440,509,85,8390,326,463,75,19,1,27,9,8899,420,509,8390,94,326,603,8716,4,7,0,20
Newton,12/31/20,24,101,101,553,4635,501,5200,28,7848,480,73,2980,1655,441,60,20,4,19,9,3460,1740,480,2980,85,1655,565,4635,2,5,0,24
Ouachita,12/31/20,27,103,103,1370,12323,1180,13747,162,24106,1191,179,11646,677,1043,137,21,6,126,36,12837,910,1191,11646,233,677,1424,12323,25,14,1,70
Perry,12/31/20,5,105,105,438,8234,355,8690,78,10322,361,77,7698,536,299,56,4,1,58,20,8059,631,361,7698,95,536,456,8234,10,4,0,103
Phillips,12/31/20,25,107,107,1264,13068,1159,14367,80,19034,1175,89,12712,356,1082,77,24,1,69,11,13887,480,1175,12712,124,356,1299,13068,8,18,0,33
Pike,12/31/20,10,109,109,685,5419,567,6132,108,10808,548,137,4875,544,478,89,7,3,63,45,5423,709,548,4875,165,544,713,5419,5,11,0,31
Poinsett,12/31/20,62,111,111,2406,18593,2105,21071,239,24054,2159,247,17659,934,1893,212,49,13,217,22,19818,1253,2159,17659,319,934,2478,18593,20,24,1,135
Polk,12/31/20,42,113,113,1255,9392,1091,10666,121,20163,1109,146,8915,477,982,109,29,13,97,24,10024,642,1109,8915,165,477,1274,9392,12,3,4,34
Pope,12/31/20,58,115,115,5448,48669,4796,54198,594,63644,4561,887,46569,2100,4051,745,48,10,462,132,51130,3068,4561,46569,968,2100,5529,48669,45,54,3,201
Prairie,12/31/20,16,117,117,545,4873,463,5453,66,8244,405,140,4190,683,346,117,12,4,47,19,4595,858,405,4190,175,683,580,4873,13,1,1,58
Pulaski,12/31/20,390,119,119,24662,273499,21320,298843,2950,393463,22087,2575,253894,19605,19199,2121,360,30,2526,424,275981,22862,22087,253894,3257,19605,25344,273499,372,262,6,2194
Randolph,12/31/20,42,121,121,1455,12705,1282,14226,131,17603,1155,300,10894,1811,1035,247,31,11,89,42,12049,2177,1155,10894,366,1811,1521,12705,15,18,1,192
Saline,12/31/20,104,125,125,7563,71737,6696,79646,762,118009,5973,1590,60846,10891,5323,1373,92,12,557,205,66819,12827,5973,60846,1936,10891,7909,71737,69,77,2,523
Scott,12/31/20,11,127,127,588,7325,486,7929,91,10442,421,167,7041,284,391,95,11,0,19,72,7462,467,421,7041,183,284,604,7325,15,5,0,109
Searcy,12/31/20,11,129,129,503,4667,436,5195,56,7923,317,186,3845,822,292,144,6,5,19,37,4162,1033,317,3845,211,822,528,4667,3,8,0,21
Sebastian,12/31/20,156,131,131,9514,97565,8476,107207,879,127461,8008,1506,94151,3414,7354,1122,144,12,508,371,102159,5048,8008,94151,1634,3414,9642,97565,111,56,2,896
Sevier,12/31/20,20,133,133,2079,11254,1967,13414,92,17193,1551,528,9532,1722,1500,467,19,1,32,60,11083,2331,1551,9532,609,1722,2160,11254,16,16,0,80
Sharp,12/31/20,32,135,135,1134,10855,960,12055,142,17043,820,314,9361,1494,713,247,24,8,83,59,10181,1874,820,9361,380,1494,1200,10855,12,18,0,50
St.Francis,12/31/20,20,123,123,2728,22294,2547,25053,161,26294,2605,123,21887,407,2441,106,20,0,144,17,24492,561,2605,21887,154,407,2759,22294,14,13,0,161
Stone,12/31/20,27,137,137,765,7175,637,7969,101,12446,606,159,6357,818,524,113,24,3,58,43,6963,1006,606,6357,188,818,794,7175,4,13,1,48
Union,12/31/20,73,139,139,2428,18454,2069,21004,286,39732,1863,565,15573,2881,1583,486,56,17,224,62,17436,3568,1863,15573,687,2881,2550,18454,44,36,0,321
VanBuren,12/31/20,8,141,141,743,9937,661,10749,74,16684,545,198,8625,1312,499,162,7,1,39,35,9170,1579,545,8625,267,1312,812,9937,4,11,0,74
Washington,12/31/20,222,143,143,21420,161137,19450,183365,1747,228529,17251,4169,142580,18557,15820,3630,185,37,1246,501,159831,23534,17251,142580,4977,18557,22228,161137,312,207,0,1760
White,12/31/20,69,145,145,4748,34691,4048,39738,630,78804,3330,1418,29092,5599,2933,1115,60,9,336,294,32422,7316,3330,29092,1717,5599,5047,34691,107,75,0,481
Woodruff,12/31/20,2,147,147,362,5037,297,5437,63,6660,299,63,4754,283,242,55,1,1,56,7,5053,384,299,4754,101,283,400,5037,22,3,0,144
Yell,12/31/20,42,149,149,2390,21540,2117,23983,231,21573,2154,236,20711,829,1943,174,37,5,174,57,22865,1118,2154,20711,289,829,2443,21540,27,48,0,79
Arkansas_all_counties,12/30/20,3637,5630,5630,222430,2051068,196914,2280851,21853,2990671,184947,37483,1854113,196955,166198,30716,3068,569,15658,6195,2039060,241791,184947,1854113,44836,196955,229783,2051068,3184,2478,34,23428
Arkansas_county,12/30/20,29,1,1,1297,14399,1141,15782,127,18124,952,345,11072,3327,875,266,26,3,51,76,12024,3758,952,11072,431,3327,1383,14399,23,12,0,126
Ashley,12/30/20,20,3,3,1250,10584,1128,11874,102,20537,1068,182,9894,690,975,153,19,1,74,28,10962,912,1068,9894,222,690,1290,10584,14,9,0,112
Baxter,12/30/20,71,5,5,2040,13773,1787,15840,182,41219,1473,567,12168,1605,1323,464,44,27,106,76,13641,2199,1473,12168,594,1605,2067,13773,31,30,0,127
Benton,12/30/20,263,7,7,17503,132638,15427,150738,1812,258980,13833,3670,125219,7419,12418,3009,204,59,1210,602,139052,11686,13833,125219,4267,7419,18100,132638,268,217,3,1333
Boone,12/30/20,68,9,9,2547,22467,2284,25138,193,37288,2096,451,20945,1522,1907,377,57,11,130,63,23041,2097,2096,20945,575,1522,2671,22467,41,25,0,213
Bradley,12/30/20,11,11,11,918,7553,788,8497,119,10948,729,189,5120,2433,640,148,9,2,80,39,5849,2648,729,5120,215,2433,944,7553,16,15,0,152
Calhoun,12/30/20,1,13,13,227,2739,202,2980,24,5202,185,42,2586,153,172,30,1,0,12,12,2771,209,185,2586,56,153,241,2739,6,7,0,22
Carroll,12/30/20,30,15,15,2054,13713,1876,15811,148,27887,1810,244,13402,311,1662,214,27,3,121,27,15212,599,1810,13402,288,311,2098,13713,28,28,0,116
Chicot,12/30/20,29,17,17,1398,9659,1323,11080,46,10826,1308,90,8309,1350,1239,84,28,1,41,5,9617,1463,1308,8309,113,1350,1421,9659,9,6,0,381
Clark,12/30/20,21,19,19,1353,17358,1166,18775,166,22385,1137,216,14685,2673,987,179,18,3,132,34,15822,2953,1137,14685,280,2673,1417,17358,34,19,0,262
Clay,12/30/20,30,21,21,1306,12516,1166,13860,109,15061,1026,280,9639,2877,930,236,23,7,72,37,10665,3195,1026,9639,318,2877,1344,12516,15,11,0,215
Cleburne,12/30/20,37,23,23,1208,15042,976,16306,195,25230,899,309,12524,2518,741,235,34,3,124,71,13423,2883,899,12524,365,2518,1264,15042,42,15,0,211
Cleveland,12/30/20,17,25,25,555,6357,493,6938,45,8226,387,168,5763,594,352,141,15,2,20,25,6150,788,387,5763,194,594,581,6357,4,4,0,46
Columbia,12/30/20,41,27,27,1552,13539,1386,15225,125,23892,1035,517,10726,2813,971,415,29,12,35,90,11761,3464,1035,10726,651,2813,1686,13539,25,13,0,137
Conway,12/30/20,15,29,29,1289,14610,1030,15947,244,20906,1020,269,12648,1962,837,193,12,3,171,73,13668,2279,1020,12648,317,1962,1337,14610,28,22,2,119
Craighead,12/30/20,136,31,31,9960,79801,8966,90013,857,105701,8901,1059,70793,9008,8036,930,123,13,741,116,79694,10319,8901,70793,1311,9008,10212,79801,98,145,0,777
Crawford,12/30/20,58,33,33,4402,45417,3911,49880,432,62472,3787,615,43783,1634,3429,482,49,9,308,124,47570,2310,3787,43783,676,1634,4463,45417,79,43,0,463
Crittenden,12/30/20,72,35,35,4293,27755,3923,32142,297,49013,4042,251,26070,1685,3714,209,61,11,266,31,30112,2030,4042,26070,345,1685,4387,27755,57,32,0,355
Cross,12/30/20,36,37,37,1377,11353,1191,12772,150,16998,1119,258,10699,654,966,225,34,2,119,31,11818,954,1119,10699,300,654,1419,11353,26,13,2,112
Dallas,12/30/20,11,39,39,476,4736,407,5218,58,7432,437,39,4514,222,376,31,9,2,52,6,4951,267,437,4514,45,222,482,4736,8,2,0,35
Desha,12/30/20,11,41,41,943,7933,812,8923,120,11887,799,144,7101,832,699,113,10,1,90,30,7900,1023,799,7101,191,832,990,7933,14,11,0,84
Drew,12/30/20,18,43,43,1423,13066,1249,14527,156,18502,1135,288,11286,1780,994,255,15,3,126,30,12421,2106,1135,11286,326,1780,1461,13066,9,14,0,100
Faulkner,12/30/20,92,45,45,7516,81625,6418,89463,1005,122416,6145,1371,71869,9756,5410,1008,76,16,658,347,78014,11449,6145,71869,1693,9756,7838,81625,160,98,3,862
Franklin,12/30/20,25,47,47,1079,13327,970,14442,84,17780,889,190,12719,608,816,154,22,3,51,33,13608,834,889,12719,226,608,1115,13327,10,7,0,123
Fulton,12/30/20,34,49,49,864,4535,716,5434,114,12139,624,240,3632,903,536,180,16,18,72,42,4256,1178,624,3632,275,903,899,4535,19,11,0,53
Garland,12/30/20,152,51,51,5739,60564,4873,66458,712,98296,4969,770,55958,4606,4296,577,129,23,542,170,60927,5531,4969,55958,925,4606,5894,60564,121,69,3,589
Grant,12/30/20,11,53,53,1056,11031,849,12137,196,18086,787,269,9505,1526,671,178,10,1,106,90,10292,1845,787,9505,319,1526,1106,11031,23,30,1,101
Greene,12/30/20,51,55,55,4398,32512,3999,37053,348,44623,3572,826,28664,3848,3280,719,42,9,250,98,32236,4817,3572,28664,969,3848,4541,32512,48,32,0,307
Hempstead,12/30/20,11,57,57,1215,11234,1108,12494,95,22018,957,258,10571,663,884,224,7,4,65,30,11528,966,957,10571,303,663,1260,11234,11,16,0,141
HotSpring,12/30/20,55,59,59,3615,32985,3257,36662,303,33520,3383,232,27575,5410,3081,176,51,4,251,52,30958,5704,3383,27575,294,5410,3677,32985,52,31,0,909
Howard,12/30/20,18,61,61,1097,7425,1025,8571,54,13389,797,300,5850,1575,751,274,16,2,30,24,6647,1924,797,5850,349,1575,1146,7425,12,10,0,124
Independence,12/30/20,93,63,63,2724,25025,2417,27870,214,37264,1960,764,21453,3572,1766,651,70,23,124,90,23413,4457,1960,21453,885,3572,2845,25025,40,18,3,291
Izard,12/30/20,12,65,65,1271,11110,1117,12422,142,13559,1028,243,8639,2471,956,161,7,5,65,77,9667,2755,1028,8639,284,2471,1312,11110,10,5,0,270
Jackson,12/30/20,21,67,67,2816,19145,2553,22170,242,17225,2274,542,15695,3450,2070,483,16,5,188,54,17969,4201,2274,15695,751,3450,3025,19145,26,46,0,733
Jefferson,12/30/20,127,69,69,6648,61527,5880,68434,639,70424,5711,937,55526,6001,5146,734,110,17,453,186,61237,7197,5711,55526,1196,6001,6907,61527,35,126,0,1135
Johnson,12/30/20,20,71,71,1817,16795,1601,18640,196,26291,1575,242,15991,804,1425,176,17,3,133,63,17566,1074,1575,15991,270,804,1845,16795,46,34,1,219
Lafayette,12/30/20,4,73,73,341,2360,306,2725,30,6915,256,85,2132,228,237,69,4,0,15,15,2388,337,256,2132,109,228,365,2360,9,5,0,34
Lawrence,12/30/20,35,75,75,1568,10075,1382,11711,151,16669,1310,258,9341,734,1157,225,32,3,121,30,10651,1060,1310,9341,326,734,1636,10075,25,19,0,111
Lee,12/30/20,26,77,77,1425,8121,1335,9560,64,9398,1373,52,7666,455,1297,38,25,1,51,13,9039,521,1373,7666,66,455,1439,8121,11,3,2,148
Lincoln,12/30/20,24,79,79,2810,15680,2711,18540,74,13695,2603,207,13084,2596,2539,172,20,4,43,31,15687,2853,2603,13084,257,2596,2860,15680,5,8,0,437
LittleRiver,12/30/20,38,81,81,806,5199,692,6033,76,12417,651,155,4621,578,555,137,36,2,60,16,5272,761,651,4621,183,578,834,5199,8,4,0,238
Logan,12/30/20,11,83,83,1408,18178,1251,19623,146,21757,1177,231,15728,2450,1090,161,10,1,77,69,16905,2718,1177,15728,268,2450,1445,18178,27,16,0,115
Lonoke,12/30/20,78,85,85,4093,44187,3507,48523,508,72206,3033,1060,37445,6742,2638,869,67,11,328,180,40478,8045,3033,37445,1303,6742,4336,44187,70,48,1,439
Madison,12/30/20,12,87,87,1014,9033,907,10080,95,16076,816,198,8469,564,745,162,10,2,61,34,9285,795,816,8469,231,564,1047,9033,20,10,0,64
Marion,12/30/20,23,89,89,620,6819,541,7456,56,16438,469,151,6160,659,422,119,11,12,36,20,6629,827,469,6160,168,659,637,6819,9,8,0,66
Miller,12/30/20,25,91,91,2733,14615,2488,17438,220,43759,1945,788,12560,2055,1781,707,17,8,147,73,14505,2933,1945,12560,878,2055,2823,14615,30,20,0,753
MissingCountyInfo,12/30/20,0,5,5,2716,96855,2387,99596,329,NA,2202,514,96788,67,1974,413,0,0,228,101,98990,606,2202,96788,539,67,2741,96855,4,9,0,22
Mississippi,12/30/20,93,93,93,4365,26694,3983,31137,288,42831,3948,417,19749,6945,3617,366,79,14,251,37,23697,7440,3948,19749,495,6945,4443,26694,34,50,0,460
Monroe,12/30/20,7,95,95,467,5025,399,5505,61,7249,391,76,4826,199,341,58,7,0,43,18,5217,288,391,4826,89,199,480,5025,11,9,0,45
Montgomery,12/30/20,18,97,97,489,5136,413,5637,58,8993,386,103,3378,1758,348,65,15,3,23,35,3764,1873,386,3378,115,1758,501,5136,1,0,1,17
Nevada,12/30/20,20,99,99,590,8700,531,9299,39,8440,508,82,8378,322,456,75,19,1,33,6,8886,413,508,8378,91,322,599,8700,3,4,0,47
Newton,12/30/20,24,101,101,551,4613,496,5176,31,7848,479,72,2971,1642,437,59,20,4,22,9,3450,1726,479,2971,84,1642,563,4613,0,3,0,66
Ouachita,12/30/20,26,103,103,1345,12278,1166,13678,152,24106,1173,172,11607,671,1034,132,21,5,117,35,12780,898,1173,11607,227,671,1400,12278,31,22,1,90
Perry,12/30/20,5,105,105,428,8141,351,8587,72,10322,353,75,7628,513,297,54,4,1,52,20,7981,606,353,7628,93,513,446,8141,12,7,0,100
Phillips,12/30/20,25,107,107,1256,13043,1141,14334,90,19034,1169,87,12688,355,1068,73,24,1,77,13,13857,477,1169,12688,122,355,1291,13043,8,21,1,114
Pike,12/30/20,10,109,109,680,5393,556,6097,114,10808,544,136,4865,528,473,83,7,3,64,50,5409,688,544,4865,160,528,704,5393,14,11,0,124
Poinsett,12/30/20,61,111,111,2386,18478,2081,20935,244,24054,2141,245,17549,929,1873,208,48,13,220,24,19690,1245,2141,17549,316,929,2457,18478,36,29,0,173
Polk,12/30/20,38,113,113,1243,9370,1088,10636,116,20163,1103,140,8895,475,979,109,29,9,94,22,9998,638,1103,8895,163,475,1266,9370,39,11,0,136
Pope,12/30/20,55,115,115,5403,48513,4742,53996,606,63644,4525,878,46455,2058,4005,737,46,9,474,132,50980,3016,4525,46455,958,2058,5483,48513,97,66,1,361
Prairie,12/30/20,15,117,117,532,4828,462,5394,55,8244,392,140,4155,673,345,117,11,4,36,19,4547,847,392,4155,174,673,566,4828,6,5,0,37
Pulaski,12/30/20,384,119,119,24290,271677,21058,296639,2846,393463,21744,2546,252620,19057,18978,2080,356,28,2408,438,274364,22275,21744,252620,3218,19057,24962,271677,357,239,3,3007
Randolph,12/30/20,41,121,121,1440,12528,1264,14034,135,17603,1143,297,10728,1800,1024,240,30,11,89,46,11871,2163,1143,10728,363,1800,1506,12528,26,14,0,210
Saline,12/30/20,102,125,125,7494,71283,6619,79123,772,118009,5916,1578,60492,10791,5269,1350,90,12,556,216,66408,12715,5916,60492,1924,10791,7840,71283,101,74,3,943
Scott,12/30/20,11,127,127,573,7231,481,7820,81,10442,420,153,6962,269,389,92,11,0,20,61,7382,438,420,6962,169,269,589,7231,20,6,0,116
Searcy,12/30/20,11,129,129,500,4649,428,5174,61,7923,316,184,3832,817,288,140,6,5,22,39,4148,1026,316,3832,209,817,525,4649,10,6,0,42
Sebastian,12/30/20,154,131,131,9403,96780,8420,106315,826,127461,7951,1452,93533,3247,7319,1101,144,10,486,340,101484,4831,7951,93533,1584,3247,9535,96780,137,73,1,754
Sevier,12/30/20,20,133,133,2063,11190,1951,13332,92,17193,1548,515,9473,1717,1494,457,19,1,35,57,11021,2311,1548,9473,594,1717,2142,11190,13,7,0,82
Sharp,12/30/20,32,135,135,1122,10817,942,12005,148,17043,808,314,9343,1474,701,241,24,8,83,65,10151,1854,808,9343,380,1474,1188,10817,22,15,0,121
St.Francis,12/30/20,20,123,123,2714,22147,2534,24892,160,26294,2593,121,21749,398,2428,106,20,0,145,15,24342,550,2593,21749,152,398,2745,22147,15,18,0,79
Stone,12/30/20,26,137,137,761,7131,624,7921,111,12446,605,156,6340,791,518,106,24,2,63,48,6945,976,605,6340,185,791,790,7131,7,4,0,43
Union,12/30/20,73,139,139,2384,18177,2033,20680,278,39732,1819,565,15305,2872,1559,474,56,17,204,74,17124,3556,1819,15305,684,2872,2503,18177,65,36,0,209
VanBuren,12/30/20,8,141,141,739,9867,650,10675,81,16684,542,197,8571,1296,491,159,7,1,44,37,9113,1562,542,8571,266,1296,808,9867,7,23,0,42
Washington,12/30/20,222,143,143,21108,159689,19243,181593,1642,228529,17084,4024,141262,18427,15667,3576,185,37,1232,410,158346,23247,17084,141262,4820,18427,21904,159689,277,248,1,1533
White,12/30/20,69,145,145,4641,34317,3973,39243,598,78804,3255,1386,28852,5465,2892,1081,60,9,302,296,32107,7136,3255,28852,1671,5465,4926,34317,93,72,0,465
Woodruff,12/30/20,2,147,147,340,4915,294,5289,44,6660,273,67,4645,270,239,55,1,1,33,11,4918,371,273,4645,101,270,374,4915,5,6,0,40
Yell,12/30/20,42,149,149,2363,21488,2069,23904,252,21573,2134,229,20675,813,1903,166,37,5,194,58,22809,1095,2134,20675,282,813,2416,21488,31,23,1,190
Arkansas_all_counties,12/29/20,3603,5630,5630,219246,2030824,194436,2257295,21181,2990671,182627,36619,1841869,188955,164404,30032,3042,561,15158,6023,2024496,232799,182627,1841869,43844,188955,226471,2030824,2718,2302,66,13039
Arkansas_county,12/29/20,29,1,1,1274,14296,1129,15657,116,18124,942,332,11027,3269,867,262,26,3,49,67,11969,3688,942,11027,419,3269,1361,14296,18,14,0,55
Ashley,12/29/20,20,3,3,1236,10486,1119,11762,97,20537,1057,179,9804,682,968,151,19,1,70,27,10861,901,1057,9804,219,682,1276,10486,4,13,0,51
Baxter,12/29/20,71,5,5,2009,13677,1757,15711,181,41219,1444,565,12086,1591,1306,451,44,27,94,87,13530,2181,1444,12086,590,1591,2034,13677,20,28,2,83
Benton,12/29/20,260,7,7,17235,131573,15210,149388,1764,258980,13650,3585,124248,7325,12266,2944,203,57,1180,584,137898,11490,13650,124248,4165,7325,17815,131573,217,181,4,657
Boone,12/29/20,68,9,9,2506,22295,2259,24925,177,37288,2069,437,20830,1465,1888,371,57,11,122,55,22899,2026,2069,20830,561,1465,2630,22295,27,27,0,201
Bradley,12/29/20,11,11,11,902,7417,773,8345,118,10948,720,182,5103,2314,628,145,9,2,83,35,5823,2522,720,5103,208,2314,928,7417,8,21,2,25
Calhoun,12/29/20,1,13,13,221,2723,195,2958,25,5202,183,38,2575,148,167,28,1,0,15,10,2758,200,183,2575,52,148,235,2723,3,5,0,6
Carroll,12/29/20,30,15,15,2026,13625,1848,15695,148,27887,1788,238,13324,301,1641,207,27,3,120,28,15112,583,1788,13324,282,301,2070,13625,20,18,0,90
Chicot,12/29/20,29,17,17,1389,9287,1317,10699,43,10826,1301,88,8271,1016,1236,81,28,1,37,6,9572,1127,1301,8271,111,1016,1412,9287,1,4,0,14
Clark,12/29/20,21,19,19,1319,17130,1147,18512,151,22385,1109,210,14522,2608,971,176,18,3,120,31,15631,2881,1109,14522,273,2608,1382,17130,14,22,0,125
Clay,12/29/20,30,21,21,1291,12316,1155,13645,105,15061,1015,276,9554,2762,925,230,23,7,66,39,10569,3076,1015,9554,314,2762,1329,12316,15,15,0,66
Cleburne,12/29/20,37,23,23,1166,14873,961,16090,168,25230,874,292,12431,2442,731,230,34,3,109,59,13305,2785,874,12431,343,2442,1217,14873,26,12,2,119
Cleveland,12/29/20,17,25,25,551,6315,489,6891,45,8226,383,168,5737,578,348,141,15,2,20,25,6120,771,383,5737,193,578,576,6315,4,7,0,40
Columbia,12/29/20,41,27,27,1527,13427,1373,15088,113,23892,1029,498,10677,2750,963,410,29,12,37,76,11706,3382,1029,10677,632,2750,1661,13427,16,14,1,78
Conway,12/29/20,13,29,29,1261,14519,1008,15828,240,20906,997,264,12576,1943,822,186,12,1,163,77,13573,2255,997,12576,312,1943,1309,14519,12,22,0,141
Craighead,12/29/20,136,31,31,9862,79122,8821,89235,904,105701,8805,1057,70264,8858,7914,907,123,13,767,137,79069,10166,8805,70264,1308,8858,10113,79122,113,130,2,651
Crawford,12/29/20,58,33,33,4323,45033,3868,49416,396,62472,3727,596,43502,1531,3399,469,49,9,278,118,47229,2187,3727,43502,656,1531,4383,45033,38,41,0,195
Crittenden,12/29/20,72,35,35,4236,27457,3891,31783,272,49013,4000,236,25923,1534,3687,204,61,11,251,21,29923,1860,4000,25923,326,1534,4326,27457,30,44,0,109
Cross,12/29/20,34,37,37,1351,11267,1178,12659,139,16998,1107,244,10622,645,958,220,32,2,117,22,11729,930,1107,10622,285,645,1392,11267,16,14,0,63
Dallas,12/29/20,11,39,39,468,4709,405,5183,52,7432,431,37,4495,214,374,31,9,2,48,4,4926,257,431,4495,43,214,474,4709,2,5,1,41
Desha,12/29/20,11,41,41,929,7863,801,8839,117,11887,790,139,7052,811,693,108,10,1,87,30,7842,997,790,7052,186,811,976,7863,15,11,0,50
Drew,12/29/20,18,43,43,1414,12975,1235,14427,161,18502,1126,288,11238,1737,983,252,15,3,128,33,12364,2063,1126,11238,326,1737,1452,12975,5,20,1,17
Faulkner,12/29/20,89,45,45,7356,80923,6320,88597,946,122416,6034,1322,71439,9484,5334,986,73,16,626,320,77473,11124,6034,71439,1640,9484,7674,80923,112,83,2,857
Franklin,12/29/20,25,47,47,1069,13214,963,14319,81,17780,882,187,12621,593,812,151,22,3,48,33,13503,816,882,12621,223,593,1105,13214,17,11,0,43
Fulton,12/29/20,34,49,49,845,4501,705,5379,106,12139,606,239,3601,900,531,174,16,18,59,47,4207,1172,606,3601,272,900,878,4501,6,10,1,22
Garland,12/29/20,149,51,51,5618,60096,4804,65864,663,98296,4861,757,55577,4519,4247,557,126,23,486,177,60438,5426,4861,55577,907,4519,5768,60096,149,57,5,601
Grant,12/29/20,10,53,53,1033,10953,819,12035,204,18086,770,263,9456,1497,643,176,9,1,118,86,10226,1809,770,9456,312,1497,1082,10953,22,17,0,63
Greene,12/29/20,51,55,55,4350,32253,3967,36744,332,44623,3531,819,28453,3800,3254,713,42,9,235,97,31984,4760,3531,28453,960,3800,4491,32253,49,45,1,185
Hempstead,12/29/20,11,57,57,1204,11104,1092,12353,100,22018,950,254,10449,655,872,220,7,4,70,30,11399,954,950,10449,299,655,1249,11104,12,10,0,48
HotSpring,12/29/20,55,59,59,3563,32128,3226,35751,282,33520,3345,218,27373,4755,3056,170,51,4,238,44,30718,5033,3345,27373,278,4755,3623,32128,28,21,0,114
Howard,12/29/20,18,61,61,1085,7313,1015,8447,52,13389,791,294,5751,1562,747,268,16,2,28,24,6542,1905,791,5751,343,1562,1134,7313,12,15,0,53
Independence,12/29/20,90,63,63,2684,24774,2399,27577,195,37264,1944,740,21277,3497,1756,643,68,22,120,75,23221,4356,1944,21277,859,3497,2803,24774,21,13,1,146
Izard,12/29/20,12,65,65,1261,10850,1112,12151,137,13559,1023,238,8600,2250,953,159,7,5,63,74,9623,2528,1023,8600,278,2250,1301,10850,40,8,1,129
Jackson,12/29/20,21,67,67,2790,18438,2507,21435,262,17225,2268,522,15648,2790,2045,462,16,5,207,55,17916,3519,2268,15648,729,2790,2997,18438,31,16,0,210
Jefferson,12/29/20,127,69,69,6613,60427,5754,67296,730,70424,5688,925,55138,5289,5034,720,110,17,542,188,60826,6470,5688,55138,1181,5289,6869,60427,65,31,1,300
Johnson,12/29/20,19,71,71,1771,16622,1567,18420,185,26291,1532,239,15825,797,1405,162,16,3,111,74,17357,1063,1532,15825,266,797,1798,16622,25,29,1,82
Lafayette,12/29/20,4,73,73,332,2335,301,2691,26,6915,252,80,2113,222,234,67,4,0,14,12,2365,326,252,2113,104,222,356,2335,1,0,0,8
Lawrence,12/29/20,35,75,75,1543,9989,1363,11598,145,16669,1289,254,9280,709,1143,220,32,3,114,31,10569,1029,1289,9280,320,709,1609,9989,17,16,1,88
Lee,12/29/20,24,77,77,1414,7984,1332,9411,58,9398,1367,47,7601,383,1295,37,23,1,49,9,8968,443,1367,7601,60,383,1427,7984,2,4,0,10
Lincoln,12/29/20,24,79,79,2805,15248,2703,18102,77,13695,2600,205,13017,2231,2534,169,20,4,45,32,15617,2485,2600,13017,254,2231,2854,15248,5,12,2,13
LittleRiver,12/29/20,38,81,81,798,4969,688,5795,72,12417,646,152,4425,544,552,136,36,2,58,14,5071,724,646,4425,180,544,826,4969,18,3,0,44
Logan,12/29/20,11,83,83,1381,18090,1235,19507,135,21757,1163,218,15657,2433,1078,157,10,1,75,60,16820,2687,1163,15657,254,2433,1417,18090,21,10,0,184
Lonoke,12/29/20,77,85,85,4023,43818,3459,48082,487,72206,2988,1035,37215,6603,2611,848,67,10,310,177,40203,7879,2988,37215,1276,6603,4264,43818,70,46,0,296
Madison,12/29/20,12,87,87,994,8989,897,10016,85,16076,802,192,8426,563,737,160,10,2,55,30,9228,788,802,8426,225,563,1027,8989,10,11,1,38
Marion,12/29/20,23,89,89,611,6762,533,7390,55,16438,463,148,6119,643,420,113,11,12,32,23,6582,808,463,6119,165,643,628,6762,13,1,2,97
Miller,12/29/20,25,91,91,2703,13892,2468,16680,210,43759,1927,776,12402,1490,1767,701,17,8,143,67,14329,2351,1927,12402,861,1490,2788,13892,30,20,0,235
MissingCountyInfo,12/29/20,0,5,5,2712,96837,2378,99574,334,NA,2204,508,96771,66,1961,417,0,0,243,91,98975,599,2204,96771,533,66,2737,96837,-20,12,0,31
Mississippi,12/29/20,93,93,93,4331,26268,3933,30676,304,42831,3920,411,19663,6605,3578,355,79,14,262,42,23583,7093,3920,19663,488,6605,4408,26268,55,34,1,417
Monroe,12/29/20,7,95,95,456,4991,390,5459,59,7249,385,71,4797,194,335,55,7,0,43,16,5182,277,385,4797,83,194,468,4991,2,3,1,7
Montgomery,12/29/20,17,97,97,488,5120,413,5620,58,8993,385,103,3367,1753,347,66,15,2,23,35,3752,1868,385,3367,115,1753,500,5120,18,5,0,94
Nevada,12/29/20,20,99,99,587,8656,527,9252,40,8440,507,80,8337,319,452,75,19,1,36,4,8844,408,507,8337,89,319,596,8656,1,6,0,103
Newton,12/29/20,24,101,101,551,4547,493,5110,34,7848,479,72,2964,1583,435,58,20,4,24,10,3443,1667,479,2964,84,1583,563,4547,5,4,0,62
Ouachita,12/29/20,25,103,103,1314,12219,1144,13588,144,24106,1146,168,11562,657,1016,128,20,5,109,35,12708,880,1146,11562,223,657,1369,12219,19,30,2,60
Perry,12/29/20,5,105,105,416,8053,344,8487,67,10322,344,72,7539,514,294,50,4,1,46,21,7883,604,344,7539,90,514,434,8053,5,7,0,39
Phillips,12/29/20,24,107,107,1248,12937,1120,14220,104,19034,1164,84,12585,352,1052,68,23,1,89,15,13749,471,1164,12585,119,352,1283,12937,9,12,2,34
Pike,12/29/20,10,109,109,666,5283,545,5974,111,10808,533,133,4758,525,465,80,7,3,61,50,5291,683,533,4758,158,525,691,5283,14,10,1,48
Poinsett,12/29/20,61,111,111,2350,18341,2052,20761,237,24054,2111,239,17429,912,1850,202,48,13,213,24,19540,1221,2111,17429,309,912,2420,18341,32,33,2,121
Polk,12/29/20,38,113,113,1204,9273,1077,10499,88,20163,1070,134,8805,468,970,107,29,9,70,18,9875,624,1070,8805,156,468,1226,9273,18,8,0,44
Pope,12/29/20,54,115,115,5306,48249,4676,53635,576,63644,4442,864,46212,2037,3957,719,45,9,440,136,50654,2981,4442,46212,944,2037,5386,48249,54,76,1,252
Prairie,12/29/20,15,117,117,526,4797,457,5356,54,8244,387,139,4139,658,341,116,11,4,35,19,4526,830,387,4139,172,658,559,4797,7,3,1,42
Pulaski,12/29/20,381,119,119,23933,269027,20819,293619,2731,393463,21419,2514,250914,18113,18785,2034,353,28,2279,452,272333,21286,21419,250914,3173,18113,24592,269027,418,244,8,1814
Randolph,12/29/20,41,121,121,1414,12344,1250,13823,123,17603,1130,284,10687,1657,1013,237,30,11,87,36,11817,2006,1130,10687,349,1657,1479,12344,41,14,2,207
Saline,12/29/20,99,125,125,7393,70441,6545,78179,748,118009,5837,1556,59927,10514,5214,1331,87,12,535,213,65764,12415,5837,59927,1901,10514,7738,70441,116,80,5,530
Scott,12/29/20,11,127,127,553,7135,475,7704,67,10442,412,141,6876,259,383,92,11,0,18,49,7288,416,412,6876,157,259,569,7135,15,5,1,31
Searcy,12/29/20,11,129,129,490,4617,422,5132,57,7923,313,177,3822,795,285,137,6,5,22,35,4135,997,313,3822,202,795,515,4617,9,2,0,22
Sebastian,12/29/20,153,131,131,9266,96163,8347,105558,763,127461,7851,1415,93008,3155,7273,1074,143,10,433,330,100859,4699,7851,93008,1544,3155,9395,96163,96,80,2,471
Sevier,12/29/20,20,133,133,2050,11121,1944,13249,86,17193,1542,508,9407,1714,1491,453,19,1,32,54,10949,2300,1542,9407,586,1714,2128,11121,19,14,0,33
Sharp,12/29/20,32,135,135,1100,10718,927,11884,141,17043,800,300,9260,1458,694,233,24,8,82,59,10060,1824,800,9260,366,1458,1166,10718,24,16,0,70
St.Francis,12/29/20,20,123,123,2699,22083,2516,24813,163,26294,2579,120,21692,391,2412,104,20,0,147,16,24271,542,2579,21692,151,391,2730,22083,18,10,0,60
Stone,12/29/20,26,137,137,754,7095,620,7877,108,12446,603,151,6326,769,516,104,24,2,63,45,6929,948,603,6326,179,769,782,7095,9,6,0,45
Union,12/29/20,73,139,139,2319,18033,1997,20470,249,39732,1772,547,15247,2786,1549,448,56,17,167,82,17019,3451,1772,15247,665,2786,2437,18033,31,43,0,154
VanBuren,12/29/20,8,141,141,732,9832,627,10630,97,16684,539,193,8560,1272,474,153,7,1,58,39,9099,1531,539,8560,259,1272,798,9832,8,13,1,87
Washington,12/29/20,221,143,143,20831,158433,18995,180039,1614,228529,16885,3946,140181,18252,15500,3495,185,36,1200,414,157066,22973,16885,140181,4721,18252,21606,158433,149,258,1,1015
White,12/29/20,69,145,145,4548,33945,3901,38768,577,78804,3215,1333,28559,5386,2846,1055,60,9,308,269,31774,6994,3215,28559,1608,5386,4823,33945,112,90,1,292
Woodruff,12/29/20,2,147,147,335,4880,288,5249,45,6660,268,67,4615,265,235,53,1,1,32,13,4883,366,268,4615,101,265,369,4880,7,4,0,22
Yell,12/29/20,41,149,149,2332,21329,2046,23714,245,21573,2116,216,20536,793,1886,160,36,5,194,51,22652,1062,2116,20536,269,793,2385,21329,27,23,0,89
Arkansas_all_counties,12/28/20,3537,5630,5630,216528,2020503,192134,2244154,20831,2990671,181178,35350,1835968,184535,162787,29347,3005,532,15363,5468,2017146,227008,181178,1835968,42473,184535,223651,2020503,1651,2219,55,8154
Arkansas_county,12/28/20,29,1,1,1256,14259,1115,15602,112,18124,938,318,11012,3247,860,255,26,3,52,60,11950,3652,938,11012,405,3247,1343,14259,6,11,0,30
Ashley,12/28/20,20,3,3,1232,10439,1106,11711,106,20537,1055,177,9776,663,957,149,19,1,79,27,10831,880,1055,9776,217,663,1272,10439,2,13,1,24
Baxter,12/28/20,69,5,5,1989,13614,1729,15629,191,41219,1441,548,12031,1583,1290,439,43,26,108,83,13472,2157,1441,12031,574,1583,2015,13614,31,19,5,56
Benton,12/28/20,256,7,7,17018,131133,15029,148726,1732,258980,13558,3460,123921,7212,12149,2880,201,55,1207,525,137479,11247,13558,123921,4035,7212,17593,131133,134,165,3,918
Boone,12/28/20,68,9,9,2479,22121,2232,24724,177,37288,2053,426,20738,1383,1867,365,57,11,127,50,22791,1933,2053,20738,550,1383,2603,22121,16,24,2,117
Bradley,12/28/20,9,11,11,894,7400,752,8320,133,10948,716,178,5100,2300,618,134,8,1,90,43,5816,2504,716,5100,204,2300,920,7400,3,16,0,26
Calhoun,12/28/20,1,13,13,218,2720,190,2952,27,5202,183,35,2572,148,164,26,1,0,18,9,2755,197,183,2572,49,148,232,2720,0,3,0,15
Carroll,12/28/20,30,15,15,2006,13555,1830,15604,146,27887,1773,233,13261,294,1624,206,27,3,122,24,15034,570,1773,13261,276,294,2049,13555,6,19,0,61
Chicot,12/28/20,29,17,17,1388,9274,1313,10685,46,10826,1300,88,8265,1009,1234,79,28,1,38,8,9565,1120,1300,8265,111,1009,1411,9274,2,11,0,10
Clark,12/28/20,21,19,19,1305,17019,1125,18385,159,22385,1098,207,14430,2589,951,174,18,3,129,30,15528,2857,1098,14430,268,2589,1366,17019,3,19,0,32
Clay,12/28/20,30,21,21,1276,12265,1140,13579,105,15061,1004,272,9517,2748,917,223,23,7,63,42,10521,3058,1004,9517,310,2748,1314,12265,3,17,0,58
Cleburne,12/28/20,35,23,23,1140,14780,949,15969,156,25230,860,280,12396,2384,726,223,32,3,102,54,13256,2713,860,12396,329,2384,1189,14780,8,24,0,49
Cleveland,12/28/20,17,25,25,547,6279,482,6851,48,8226,382,165,5704,575,345,137,15,2,22,26,6086,765,382,5704,190,575,572,6279,6,7,1,13
Columbia,12/28/20,40,27,27,1511,13365,1359,15010,112,23892,1028,483,10661,2704,958,401,28,12,42,70,11689,3321,1028,10661,617,2704,1645,13365,18,10,0,154
Conway,12/28/20,13,29,29,1249,14390,986,15686,250,20906,990,259,12544,1846,803,183,12,1,175,75,13534,2152,990,12544,306,1846,1296,14390,26,11,1,78
Craighead,12/28/20,134,31,31,9749,78584,8691,88580,923,105701,8719,1030,69836,8748,7810,881,122,12,786,137,78555,10025,8719,69836,1277,8748,9996,78584,73,107,3,687
Crawford,12/28/20,58,33,33,4285,44876,3827,49218,399,62472,3717,568,43457,1419,3368,459,49,9,299,100,47174,2044,3717,43457,625,1419,4342,44876,44,47,0,274
Crittenden,12/28/20,72,35,35,4206,27378,3847,31669,286,49013,3977,229,25870,1508,3651,196,61,11,264,22,29847,1822,3977,25870,314,1508,4291,27378,14,34,1,216
Cross,12/28/20,34,37,37,1335,11220,1164,12595,137,16998,1095,240,10605,615,948,216,32,2,115,22,11700,895,1095,10605,280,615,1375,11220,14,17,0,148
Dallas,12/28/20,10,39,39,466,4670,400,5142,56,7432,429,37,4457,213,370,30,8,2,51,5,4886,256,429,4457,43,213,472,4670,3,4,1,16
Desha,12/28/20,11,41,41,914,7828,790,8787,113,11887,780,134,7026,802,682,108,10,1,88,25,7806,981,780,7026,179,802,959,7828,3,10,0,41
Drew,12/28/20,17,43,43,1409,12963,1215,14410,177,18502,1126,283,11235,1728,965,250,14,3,147,30,12361,2049,1126,11235,321,1728,1447,12963,1,8,1,64
Faulkner,12/28/20,87,45,45,7244,80178,6237,87736,919,122416,5993,1251,71016,9162,5280,957,71,16,641,278,77009,10727,5993,71016,1565,9162,7558,80178,107,74,0,577
Franklin,12/28/20,25,47,47,1052,13188,952,14276,75,17780,877,175,12605,583,805,147,22,3,50,25,13482,794,877,12605,211,583,1088,13188,1,11,0,80
Fulton,12/28/20,33,49,49,839,4485,695,5358,111,12139,603,236,3592,893,526,169,16,17,61,50,4195,1163,603,3592,270,893,873,4485,7,13,3,34
Garland,12/28/20,144,51,51,5469,59644,4747,65263,576,98296,4760,709,55330,4314,4207,540,124,20,427,149,60090,5173,4760,55330,859,4314,5619,59644,39,63,3,349
Grant,12/28/20,10,53,53,1011,10912,802,11971,199,18086,764,247,9441,1471,632,170,9,1,123,76,10205,1766,764,9441,295,1471,1059,10912,13,19,0,38
Greene,12/28/20,50,55,55,4301,32117,3922,36554,329,44623,3495,806,28361,3756,3214,708,41,9,240,89,31856,4698,3495,28361,942,3756,4437,32117,18,36,0,358
Hempstead,12/28/20,11,57,57,1192,11068,1082,12303,98,22018,945,247,10427,641,863,219,7,4,74,24,11372,931,945,10427,290,641,1235,11068,1,22,0,43
HotSpring,12/28/20,55,59,59,3535,32042,3205,35635,275,33520,3325,210,27314,4728,3039,166,51,4,235,40,30639,4996,3325,27314,268,4728,3593,32042,12,24,0,102
Howard,12/28/20,18,61,61,1073,7272,1000,8393,55,13389,788,285,5746,1526,742,258,16,2,30,25,6534,1859,788,5746,333,1526,1121,7272,5,27,1,8
Independence,12/28/20,89,63,63,2663,24649,2386,27432,188,37264,1942,721,21253,3396,1749,637,68,21,125,63,23195,4237,1942,21253,841,3396,2783,24649,13,22,2,174
Izard,12/28/20,11,65,65,1221,10761,1104,12023,106,13559,1020,201,8592,2169,951,153,7,4,62,44,9612,2411,1020,8592,242,2169,1262,10761,4,14,0,36
Jackson,12/28/20,21,67,67,2759,18259,2491,21221,247,17225,2243,516,15486,2773,2033,458,16,5,194,53,17729,3492,2243,15486,719,2773,2962,18259,8,21,2,10
Jefferson,12/28/20,126,69,69,6548,60192,5723,66993,697,70424,5659,889,54982,5210,5021,702,110,16,526,171,60641,6352,5659,54982,1142,5210,6801,60192,32,46,1,135
Johnson,12/28/20,18,71,71,1746,16565,1538,18338,190,26291,1520,226,15782,783,1386,152,15,3,119,71,17302,1036,1520,15782,253,783,1773,16565,11,12,0,94
Lafayette,12/28/20,4,73,73,331,2328,301,2683,25,6915,253,78,2112,216,234,67,4,0,15,10,2365,318,253,2112,102,216,355,2328,5,6,0,5
Lawrence,12/28/20,34,75,75,1526,9918,1347,11508,145,16669,1280,246,9239,679,1126,221,32,2,122,23,10519,989,1280,9239,310,679,1590,9918,17,8,0,69
Lee,12/28/20,24,77,77,1412,7976,1328,9401,60,9398,1367,45,7595,381,1293,35,23,1,51,9,8962,439,1367,7595,58,381,1425,7976,1,13,0,20
Lincoln,12/28/20,22,79,79,2800,15240,2691,18088,86,13695,2601,199,13013,2227,2523,168,19,3,58,28,15614,2474,2601,13013,247,2227,2848,15240,10,16,1,19
LittleRiver,12/28/20,38,81,81,780,4943,685,5751,57,12417,632,148,4410,533,549,136,36,2,47,10,5042,709,632,4410,176,533,808,4943,3,7,1,31
Logan,12/28/20,11,83,83,1360,17927,1225,19322,124,21757,1155,205,15545,2382,1071,154,10,1,74,50,16700,2622,1155,15545,240,2382,1395,17927,7,14,0,351
Lonoke,12/28/20,77,85,85,3953,43592,3413,47784,463,72206,2957,996,37133,6459,2582,831,67,10,308,155,40090,7694,2957,37133,1235,6459,4192,43592,38,46,0,265
Madison,12/28/20,11,87,87,984,8961,886,9979,87,16076,797,187,8405,556,733,153,10,1,54,33,9202,777,797,8405,221,556,1018,8961,6,13,0,30
Marion,12/28/20,21,89,89,598,6678,532,7295,45,16438,460,138,6046,632,420,112,11,10,29,16,6506,789,460,6046,157,632,617,6678,4,5,2,27
Miller,12/28/20,25,91,91,2673,13687,2448,16444,200,43759,1913,760,12385,1302,1752,696,17,8,144,56,14298,2146,1913,12385,844,1302,2757,13687,19,19,1,74
MissingCountyInfo,12/28/20,0,5,5,2732,96786,2366,99531,366,NA,2226,506,96719,67,1950,416,0,0,276,90,98945,586,2226,96719,519,67,2745,96786,21,19,0,-5004
Mississippi,12/28/20,92,93,93,4276,25906,3899,30258,284,42831,3873,403,19593,6313,3544,355,78,14,250,34,23466,6792,3873,19593,479,6313,4352,25906,28,33,0,306
Monroe,12/28/20,6,95,95,454,4986,387,5452,61,7249,385,69,4790,196,334,53,6,0,45,16,5175,277,385,4790,81,196,466,4986,0,5,0,31
Montgomery,12/28/20,17,97,97,470,5044,408,5526,45,8993,384,86,3362,1682,342,66,15,2,27,18,3746,1780,384,3362,98,1682,482,5044,3,8,0,15
Nevada,12/28/20,20,99,99,586,8554,521,9149,45,8440,506,80,8238,316,446,75,19,1,41,4,8744,405,506,8238,89,316,595,8554,1,10,0,84
Newton,12/28/20,24,101,101,546,4490,489,5048,33,7848,476,70,2954,1536,433,56,20,4,23,10,3430,1618,476,2954,82,1536,558,4490,2,1,0,17
Ouachita,12/28/20,23,103,103,1295,12178,1114,13527,157,24106,1140,155,11540,638,996,118,20,3,123,34,12680,847,1140,11540,209,638,1349,12178,5,13,0,174
Perry,12/28/20,5,105,105,411,8019,337,8448,69,10322,343,68,7527,492,287,50,4,1,52,17,7870,578,343,7527,86,492,429,8019,5,11,0,21
Phillips,12/28/20,22,107,107,1239,12912,1108,14186,109,19034,1156,83,12561,351,1045,63,22,0,89,20,13717,469,1156,12561,118,351,1274,12912,2,19,0,90
Pike,12/28/20,9,109,109,652,5249,535,5925,108,10808,525,127,4727,522,460,75,7,2,58,50,5252,673,525,4727,151,522,676,5249,1,6,0,10
Poinsett,12/28/20,59,111,111,2318,18252,2019,20641,240,24054,2091,227,17356,896,1824,195,47,12,220,20,19447,1194,2091,17356,298,896,2389,18252,11,24,0,112
Polk,12/28/20,38,113,113,1186,9247,1069,10454,78,20163,1059,127,8789,458,963,106,29,9,66,12,9848,606,1059,8789,148,458,1207,9247,3,11,3,44
Pope,12/28/20,53,115,115,5252,48051,4600,53375,599,63644,4416,836,46065,1986,3897,703,44,9,475,124,50481,2894,4416,46065,908,1986,5324,48051,58,58,2,376
Prairie,12/28/20,14,117,117,519,4762,454,5314,51,8244,384,135,4129,633,341,113,11,3,32,19,4513,801,384,4129,168,633,552,4762,4,8,0,23
Pulaski,12/28/20,373,119,119,23515,267631,20575,291801,2565,393463,21129,2386,249919,17712,18590,1985,347,26,2190,375,271048,20753,21129,249919,3041,17712,24170,267631,270,271,7,1833
Randolph,12/28/20,39,121,121,1373,12178,1236,13616,98,17603,1110,263,10663,1515,1001,235,29,10,80,18,11773,1843,1110,10663,328,1515,1438,12178,5,12,0,42
Saline,12/28/20,94,125,125,7277,70027,6465,77647,717,118009,5776,1501,59715,10312,5152,1313,83,11,540,177,65491,12156,5776,59715,1844,10312,7620,70027,91,84,1,480
Scott,12/28/20,10,127,127,538,7119,470,7672,58,10442,408,130,6865,254,377,93,10,0,21,37,7273,399,408,6865,145,254,553,7119,9,4,1,91
Searcy,12/28/20,11,129,129,481,4604,420,5110,50,7923,312,169,3812,792,285,135,6,5,21,29,4124,986,312,3812,194,792,506,4604,4,7,0,21
Sebastian,12/28/20,151,131,131,9170,95788,8267,105081,749,127461,7805,1365,92932,2856,7223,1044,142,9,438,311,100737,4344,7805,92932,1488,2856,9293,95788,87,73,1,705
Sevier,12/28/20,20,133,133,2031,11107,1930,13216,81,17193,1541,490,9401,1706,1485,445,19,1,37,44,10942,2274,1541,9401,568,1706,2109,11107,6,20,0,58
Sharp,12/28/20,32,135,135,1076,10672,911,11813,133,17043,795,281,9253,1419,686,225,24,8,85,48,10048,1765,795,9253,346,1419,1141,10672,11,20,0,140
St.Francis,12/28/20,20,123,123,2681,22041,2506,24753,155,26294,2564,117,21673,368,2406,100,20,0,138,17,24237,516,2564,21673,148,368,2712,22041,7,23,0,432
Stone,12/28/20,26,137,137,745,7059,614,7832,105,12446,603,142,6321,738,511,103,24,2,68,37,6924,908,603,6321,170,738,773,7059,1,8,0,45
Union,12/28/20,73,139,139,2288,17910,1954,20311,261,39732,1756,532,15226,2684,1522,432,56,17,178,83,16982,3329,1756,15226,645,2684,2401,17910,10,30,0,57
VanBuren,12/28/20,7,141,141,724,9753,614,10543,103,16684,536,188,8491,1262,467,147,6,1,63,40,9027,1516,536,8491,254,1262,790,9753,5,8,0,36
Washington,12/28/20,220,143,143,20682,157567,18737,179023,1724,228529,16791,3891,139509,18058,15343,3394,185,35,1263,461,156300,22723,16791,139509,4665,18058,21456,157567,135,187,3,1022
White,12/28/20,68,145,145,4436,33765,3811,38465,556,78804,3150,1286,28499,5266,2785,1026,59,9,305,251,31649,6816,3150,28499,1550,5266,4700,33765,58,70,1,244
Woodruff,12/28/20,2,147,147,328,4865,284,5227,42,6660,266,62,4611,254,233,51,1,1,32,10,4877,350,266,4611,96,254,362,4865,1,5,0,537
Yell,12/28/20,41,149,149,2305,21267,2023,23625,241,21573,2101,204,20504,763,1871,152,36,5,194,47,22605,1020,2101,20504,257,763,2358,21267,10,24,0,96
Arkansas_all_counties,12/27/20,3482,5630,5630,214877,2014000,189915,2235899,21454,2990671,180289,34588,1831319,182681,161207,28708,2976,506,16083,5371,2011608,224291,180289,1831319,41610,182681,221899,2014000,908,1702,41,5862
Arkansas_county,12/27/20,29,1,1,1250,14235,1104,15570,117,18124,936,314,10991,3244,853,251,26,3,57,60,11927,3643,936,10991,399,3244,1335,14235,4,11,0,12
Ashley,12/27/20,19,3,3,1230,10417,1093,11687,118,20537,1053,177,9757,660,948,145,18,1,87,31,10810,877,1053,9757,217,660,1270,10417,2,13,0,22
Baxter,12/27/20,64,5,5,1958,13589,1710,15575,184,41219,1440,518,12006,1583,1277,433,42,22,121,63,13446,2129,1440,12006,546,1583,1986,13589,11,23,3,62
Benton,12/27/20,253,7,7,16884,130349,14864,147800,1766,258980,13496,3388,123204,7145,12040,2824,199,54,1256,510,136700,11100,13496,123204,3955,7145,17451,130349,44,115,5,279
Boone,12/27/20,66,9,9,2463,22020,2208,24608,187,37288,2045,418,20650,1370,1846,362,56,10,141,46,22695,1913,2045,20650,543,1370,2588,22020,5,15,1,21
Bradley,12/27/20,9,11,11,891,7377,736,8294,146,10948,713,178,5079,2298,608,128,8,1,97,49,5792,2502,713,5079,204,2298,917,7377,3,11,0,20
Calhoun,12/27/20,1,13,13,218,2705,187,2937,30,5202,183,35,2559,146,162,25,1,0,20,10,2742,195,183,2559,49,146,232,2705,2,1,0,5
Carroll,12/27/20,30,15,15,2000,13500,1811,15542,159,27887,1770,230,13209,291,1611,200,27,3,132,27,14979,563,1770,13209,272,291,2042,13500,1,17,0,7
Chicot,12/27/20,29,17,17,1386,9266,1302,10675,55,10826,1300,86,8257,1009,1225,77,28,1,47,8,9557,1118,1300,8257,109,1009,1409,9266,0,4,0,4
Clark,12/27/20,21,19,19,1302,16990,1106,18353,175,22385,1096,206,14403,2587,938,168,18,3,140,35,15499,2854,1096,14403,267,2587,1363,16990,3,25,0,14
Clay,12/27/20,30,21,21,1273,12210,1123,13521,119,15061,1002,271,9478,2732,905,218,23,7,73,46,10480,3041,1002,9478,309,2732,1311,12210,5,7,0,12
Cleburne,12/27/20,35,23,23,1132,14739,925,15919,172,25230,858,274,12366,2373,715,210,32,3,111,61,13224,2695,858,12366,322,2373,1180,14739,4,11,0,32
Cleveland,12/27/20,16,25,25,541,6272,475,6838,50,8226,381,160,5697,575,343,132,14,2,24,26,6078,760,381,5697,185,575,566,6272,4,4,0,48
Columbia,12/27/20,40,27,27,1493,13229,1349,14853,104,23892,1024,469,10557,2672,952,397,28,12,44,60,11581,3272,1024,10557,600,2672,1624,13229,3,13,1,46
Conway,12/27/20,12,29,29,1223,14338,975,15605,236,20906,981,242,12503,1835,798,177,11,1,172,64,13484,2121,981,12503,286,1835,1267,14338,11,21,0,28
Craighead,12/27/20,131,31,31,9676,77970,8584,87887,960,105701,8647,1029,69329,8641,7720,864,119,12,807,153,77976,9911,8647,69329,1270,8641,9917,77970,80,69,2,238
Crawford,12/27/20,58,33,33,4241,44646,3780,48943,402,62472,3696,545,43235,1411,3333,447,49,9,313,89,46931,2012,3696,43235,601,1411,4297,44646,18,47,0,49
Crittenden,12/27/20,71,35,35,4192,27176,3813,31453,307,49013,3964,228,25675,1501,3620,193,60,11,283,24,29639,1814,3964,25675,313,1501,4277,27176,9,18,1,27
Cross,12/27/20,34,37,37,1321,11086,1147,12446,140,16998,1082,239,10480,606,933,214,32,2,117,23,11562,884,1082,10480,278,606,1360,11086,12,20,0,22
Dallas,12/27/20,9,39,39,463,4657,396,5126,58,7432,428,35,4444,213,366,30,8,1,54,4,4872,254,428,4444,41,213,469,4657,0,8,0,7
Desha,12/27/20,11,41,41,911,7790,780,8745,120,11887,779,132,6992,798,674,106,10,1,95,25,7771,974,779,6992,176,798,955,7790,2,11,0,12
Drew,12/27/20,16,43,43,1408,12900,1207,14346,185,18502,1125,283,11193,1707,959,248,14,2,152,33,12318,2028,1125,11193,321,1707,1446,12900,5,14,0,15
Faulkner,12/27/20,87,45,45,7137,79708,6163,87147,886,122416,5924,1213,70745,8963,5226,937,71,16,626,260,76669,10478,5924,70745,1515,8963,7439,79708,59,67,3,285
Franklin,12/27/20,25,47,47,1051,13109,941,14196,85,17780,876,175,12538,571,799,142,22,3,55,30,13414,782,876,12538,211,571,1087,13109,5,9,0,68
Fulton,12/27/20,30,49,49,832,4458,682,5326,120,12139,603,229,3572,886,516,166,16,14,71,49,4175,1151,603,3572,265,886,868,4458,4,11,0,12
Garland,12/27/20,141,51,51,5430,59334,4684,64902,603,98296,4746,684,55137,4197,4164,520,121,20,459,144,59883,5019,4746,55137,822,4197,5568,59334,14,46,0,193
Grant,12/27/20,10,53,53,998,10887,783,11932,205,18086,762,236,9424,1463,621,162,9,1,132,73,10186,1746,762,9424,283,1463,1045,10887,22,8,0,54
Greene,12/27/20,50,55,55,4283,31777,3886,36192,347,44623,3481,802,28123,3654,3191,695,41,9,249,98,31604,4588,3481,28123,934,3654,4415,31777,9,27,0,42
Hempstead,12/27/20,11,57,57,1191,11026,1060,12260,119,22018,945,246,10385,641,849,211,7,4,88,31,11330,930,945,10385,289,641,1234,11026,3,8,0,16
HotSpring,12/27/20,55,59,59,3523,31952,3181,35532,287,33520,3320,203,27230,4722,3016,165,51,4,253,34,30550,4982,3320,27230,260,4722,3580,31952,22,20,0,101
Howard,12/27/20,17,61,61,1068,7269,973,8385,78,13389,785,283,5744,1525,722,251,16,1,47,31,6529,1856,785,5744,331,1525,1116,7269,1,12,0,4
Independence,12/27/20,87,63,63,2650,24488,2364,27258,199,37264,1936,714,21094,3394,1734,630,67,20,135,64,23030,4228,1936,21094,834,3394,2770,24488,8,17,0,14
Izard,12/27/20,11,65,65,1217,10729,1090,11987,116,13559,1020,197,8562,2167,945,145,7,4,68,48,9582,2405,1020,8562,238,2167,1258,10729,4,3,1,12
Jackson,12/27/20,19,67,67,2751,18257,2470,21211,262,17225,2241,510,15484,2773,2028,442,15,4,198,64,17725,3486,2241,15484,713,2773,2954,18257,1,6,0,3
Jefferson,12/27/20,125,69,69,6516,60089,5677,66856,712,70424,5656,860,54888,5201,5006,671,109,16,539,173,60544,6312,5656,54888,1111,5201,6767,60089,5,54,0,151
Johnson,12/27/20,18,71,71,1735,16482,1526,18243,191,26291,1518,217,15701,781,1379,147,15,3,124,67,17219,1024,1518,15701,243,781,1761,16482,5,12,0,49
Lafayette,12/27/20,4,73,73,326,2328,295,2678,26,6915,251,75,2116,212,231,64,4,0,16,10,2367,311,251,2116,99,212,350,2328,0,1,0,4
Lawrence,12/27/20,34,75,75,1509,9866,1339,11438,136,16669,1264,245,9188,678,1120,219,32,2,112,24,10452,986,1264,9188,308,678,1572,9866,7,7,0,26
Lee,12/27/20,24,77,77,1411,7957,1315,9381,72,9398,1366,45,7581,376,1283,32,23,1,60,12,8947,434,1366,7581,58,376,1424,7957,2,3,0,39
Lincoln,12/27/20,21,79,79,2790,15231,2675,18069,93,13695,2592,198,13005,2226,2508,167,18,3,65,28,15597,2472,2592,13005,246,2226,2838,15231,3,5,0,19
LittleRiver,12/27/20,37,81,81,777,4915,678,5720,62,12417,631,146,4382,533,545,133,35,2,51,11,5013,707,631,4382,174,533,805,4915,4,3,0,6
Logan,12/27/20,11,83,83,1353,17583,1211,18970,131,21757,1153,200,15408,2175,1062,149,10,1,81,50,16561,2409,1153,15408,234,2175,1387,17583,10,10,0,64
Lonoke,12/27/20,77,85,85,3915,43365,3367,47512,471,72206,2937,978,36930,6435,2550,817,67,10,320,151,39867,7645,2937,36930,1210,6435,4147,43365,32,29,0,133
Madison,12/27/20,11,87,87,978,8937,873,9949,94,16076,794,184,8384,553,725,148,10,1,59,35,9178,771,794,8384,218,553,1012,8937,1,16,0,20
Marion,12/27/20,19,89,89,594,6655,527,7270,48,16438,459,135,6037,618,415,112,11,8,33,15,6496,774,459,6037,156,618,615,6655,3,3,1,35
Miller,12/27/20,24,91,91,2654,13632,2429,16370,201,43759,1910,744,12331,1301,1740,689,17,7,153,48,14241,2129,1910,12331,828,1301,2738,13632,6,12,0,7
MissingCountyInfo,12/27/20,0,5,5,2711,101811,2347,104535,364,NA,2223,488,101743,68,1948,399,0,0,275,89,103966,569,2223,101743,501,68,2724,101811,-9,8,0,373
Mississippi,12/27/20,92,93,93,4248,25628,3866,29949,289,42831,3846,402,19482,6146,3519,347,78,14,248,41,23328,6621,3846,19482,475,6146,4321,25628,14,19,0,153
Monroe,12/27/20,6,95,95,454,4955,382,5421,66,7249,385,69,4761,194,331,51,6,0,48,18,5146,275,385,4761,81,194,466,4955,6,9,0,14
Montgomery,12/27/20,17,97,97,467,5032,400,5510,50,8993,381,86,3352,1680,337,63,15,2,29,21,3733,1777,381,3352,97,1680,478,5032,0,5,0,5
Nevada,12/27/20,20,99,99,585,8471,511,9065,54,8440,506,79,8158,313,439,72,19,1,48,6,8664,401,506,8158,88,313,594,8471,1,7,0,6
Newton,12/27/20,24,101,101,544,4475,488,5031,32,7848,476,68,2940,1535,432,56,20,4,24,8,3416,1615,476,2940,80,1535,556,4475,1,2,0,3
Ouachita,12/27/20,23,103,103,1290,12009,1101,13353,165,24106,1137,153,11378,631,988,113,20,3,128,37,12515,838,1137,11378,207,631,1344,12009,3,11,0,38
Perry,12/27/20,5,105,105,406,8003,326,8427,75,10322,339,67,7518,485,279,47,4,1,56,19,7857,570,339,7518,85,485,424,8003,1,4,0,12
Phillips,12/27/20,22,107,107,1237,12824,1089,14096,126,19034,1154,83,12476,348,1027,62,22,0,105,21,13630,466,1154,12476,118,348,1272,12824,3,9,1,28
Pike,12/27/20,9,109,109,651,5240,529,5914,113,10808,525,126,4720,520,456,73,7,2,62,51,5245,669,525,4720,149,520,674,5240,2,6,0,7
Poinsett,12/27/20,59,111,111,2307,18151,1995,20528,253,24054,2080,227,17268,883,1808,187,47,12,225,28,19348,1180,2080,17268,297,883,2377,18151,8,25,0,38
Polk,12/27/20,35,113,113,1183,9206,1058,10412,89,20163,1058,125,8756,450,955,103,28,7,74,15,9814,598,1058,8756,148,450,1206,9206,10,6,6,26
Pope,12/27/20,51,115,115,5194,47733,4542,53000,601,63644,4397,797,45761,1972,3846,696,44,7,507,94,50158,2842,4397,45761,870,1972,5267,47733,14,51,0,229
Prairie,12/27/20,14,117,117,515,4743,446,5290,55,8244,381,134,4114,629,335,111,11,3,35,20,4495,795,381,4114,166,629,547,4743,3,9,1,9
Pulaski,12/27/20,366,119,119,23245,266068,20304,289958,2573,393463,20932,2313,248590,17478,18362,1942,342,24,2226,347,269522,20436,20932,248590,2958,17478,23890,266068,164,209,5,1414
Randolph,12/27/20,39,121,121,1368,12141,1224,13572,105,17603,1104,264,10634,1507,991,233,29,10,84,21,11738,1834,1104,10634,327,1507,1431,12141,5,16,0,24
Saline,12/27/20,93,125,125,7186,69638,6381,77162,711,118009,5725,1461,59393,10245,5083,1298,83,10,558,153,65118,12044,5725,59393,1799,10245,7524,69638,33,51,2,188
Scott,12/27/20,9,127,127,529,7037,466,7581,54,10442,407,122,6787,250,374,92,9,0,24,30,7194,387,407,6787,137,250,544,7037,4,1,0,6
Searcy,12/27/20,11,129,129,477,4587,413,5089,53,7923,311,166,3799,788,284,129,6,5,21,32,4110,979,311,3799,191,788,502,4587,0,6,0,6
Sebastian,12/27/20,150,131,131,9083,95170,8194,104373,736,127461,7770,1313,92372,2798,7175,1019,141,9,452,284,100142,4231,7770,92372,1433,2798,9203,95170,41,49,4,115
Sevier,12/27/20,20,133,133,2025,11055,1910,13157,95,17193,1540,485,9356,1699,1474,436,19,1,47,48,10896,2261,1540,9356,562,1699,2102,11055,3,9,0,9
Sharp,12/27/20,32,135,135,1065,10543,891,11672,142,17043,790,275,9127,1416,677,214,24,8,89,53,9917,1755,790,9127,339,1416,1129,10543,6,8,1,14
St.Francis,12/27/20,20,123,123,2674,21616,2483,24321,171,26294,2559,115,21260,356,2385,98,20,0,154,17,23819,502,2559,21260,146,356,2705,21616,10,91,0,19
Stone,12/27/20,26,137,137,744,7015,606,7787,112,12446,604,140,6284,731,508,98,24,2,72,40,6888,899,604,6284,168,731,772,7015,1,15,0,10
Union,12/27/20,73,139,139,2278,17863,1924,20254,281,39732,1754,524,15203,2660,1505,419,56,17,193,88,16957,3297,1754,15203,637,2660,2391,17863,9,12,1,37
VanBuren,12/27/20,7,141,141,719,9722,606,10506,106,16684,531,188,8463,1259,461,145,6,1,64,42,8994,1512,531,8463,253,1259,784,9722,2,9,0,38
Washington,12/27/20,217,143,143,20547,156680,18550,178000,1779,228529,16712,3835,138711,17969,15203,3347,184,33,1325,454,155423,22577,16712,138711,4608,17969,21320,156680,70,127,2,393
White,12/27/20,67,145,145,4378,33579,3741,38214,569,78804,3133,1245,28346,5233,2743,998,58,9,331,238,31479,6735,3133,28346,1502,5233,4635,33579,35,40,0,263
Woodruff,12/27/20,2,147,147,327,4329,279,4690,46,6660,266,61,4076,253,229,50,1,1,36,10,4342,348,266,4076,95,253,361,4329,2,2,0,9
Yell,12/27/20,41,149,149,2295,21181,1999,23525,255,21573,2094,201,20438,743,1852,147,36,5,206,49,22532,993,2094,20438,250,743,2344,21181,8,19,0,37
Arkansas_all_counties,12/26/20,3441,5630,5630,213969,2009046,188213,2230007,22289,2990671,179640,34329,1827152,181894,159966,28247,2962,479,16689,5600,2006792,223215,179640,1827152,41321,181894,220961,2009046,702,1788,3,8655
Arkansas_county,12/26/20,29,1,1,1246,14227,1093,15558,124,18124,936,310,10988,3239,848,245,26,3,62,62,11924,3634,936,10988,395,3239,1331,14227,3,9,0,32
Ashley,12/26/20,19,3,3,1228,10397,1080,11663,129,20537,1051,177,9737,660,936,144,18,1,97,32,10788,875,1051,9737,215,660,1266,10397,6,10,0,42
Baxter,12/26/20,61,5,5,1947,13538,1687,15516,199,41219,1432,515,11955,1583,1263,424,42,19,127,72,13387,2129,1432,11955,546,1583,1978,13538,6,20,0,33
Benton,12/26/20,248,7,7,16840,130114,14749,147520,1842,258980,13467,3373,122989,7125,11965,2784,198,50,1303,539,136456,11064,13467,122989,3939,7125,17406,130114,57,170,0,437
Boone,12/26/20,65,9,9,2458,22004,2193,24588,198,37288,2044,414,20635,1369,1835,358,56,9,151,47,22679,1909,2044,20635,540,1369,2584,22004,4,26,0,21
Bradley,12/26/20,9,11,11,888,7360,725,8272,154,10948,708,180,5062,2298,598,127,8,1,102,52,5770,2502,708,5062,204,2298,912,7360,10,20,0,48
Calhoun,12/26/20,1,13,13,216,2702,186,2930,29,5202,181,35,2556,146,161,25,1,0,19,10,2737,193,181,2556,47,146,228,2702,0,2,0,4
Carroll,12/26/20,30,15,15,1999,13494,1794,15534,175,27887,1770,229,13203,291,1602,192,27,3,141,34,14973,561,1770,13203,270,291,2040,13494,6,16,0,66
Chicot,12/26/20,29,17,17,1386,9262,1298,10671,59,10826,1300,86,8253,1009,1222,76,28,1,50,9,9553,1118,1300,8253,109,1009,1409,9262,3,7,0,53
Clark,12/26/20,21,19,19,1299,16979,1081,18339,197,22385,1094,205,14397,2582,918,163,18,3,158,39,15491,2848,1094,14397,266,2582,1360,16979,12,13,0,100
Clay,12/26/20,30,21,21,1268,12203,1116,13509,121,15061,997,271,9474,2729,900,216,23,7,73,48,10471,3038,997,9474,309,2729,1306,12203,5,10,0,45
Cleburne,12/26/20,35,23,23,1128,14711,914,15886,179,25230,856,272,12344,2367,709,205,32,3,115,64,13200,2686,856,12344,319,2367,1175,14711,8,23,0,64
Cleveland,12/26/20,16,25,25,537,6228,471,6790,50,8226,378,159,5653,575,339,132,14,2,25,25,6031,759,378,5653,184,575,562,6228,3,3,0,32
Columbia,12/26/20,39,27,27,1490,13186,1336,14807,115,23892,1023,467,10517,2669,952,384,28,11,43,72,11540,3267,1023,10517,598,2669,1621,13186,1,6,0,28
Conway,12/26/20,12,29,29,1212,14321,954,15575,246,20906,976,236,12492,1829,783,171,11,1,182,64,13468,2107,976,12492,278,1829,1254,14321,9,10,0,82
Craighead,12/26/20,129,31,31,9596,77812,8515,87648,951,105701,8591,1005,69191,8621,7660,855,119,10,811,140,77782,9866,8591,69191,1245,8621,9836,77812,19,77,3,172
Crawford,12/26/20,58,33,33,4223,44615,3733,48894,431,62472,3685,538,43211,1404,3300,433,49,9,335,96,46896,1998,3685,43211,594,1404,4279,44615,9,36,0,151
Crittenden,12/26/20,70,35,35,4183,27158,3795,31426,317,49013,3957,226,25662,1496,3605,190,59,11,292,25,29619,1807,3957,25662,311,1496,4268,27158,22,35,0,211
Cross,12/26/20,34,37,37,1309,11076,1127,12424,148,16998,1073,236,10469,607,920,207,32,2,121,27,11542,882,1073,10469,275,607,1348,11076,7,8,0,110
Dallas,12/26/20,9,39,39,463,4650,388,5119,66,7432,428,35,4439,211,358,30,8,1,62,4,4867,252,428,4439,41,211,469,4650,4,5,0,9
Desha,12/26/20,11,41,41,909,7780,769,8733,129,11887,778,131,6983,797,666,103,10,1,102,27,7761,972,778,6983,175,797,953,7780,9,17,0,18
Drew,12/26/20,16,43,43,1403,12890,1193,14331,194,18502,1124,279,11183,1707,947,246,14,2,163,31,12307,2024,1124,11183,317,1707,1441,12890,8,13,0,89
Faulkner,12/26/20,84,45,45,7078,79482,6096,86861,897,122416,5896,1182,70556,8926,5177,919,69,15,649,248,76452,10409,5896,70556,1483,8926,7379,79482,37,65,0,276
Franklin,12/26/20,25,47,47,1046,13046,932,14128,89,17780,872,174,12478,568,792,140,22,3,58,31,13350,778,872,12478,210,568,1082,13046,5,3,0,30
Fulton,12/26/20,30,49,49,828,4450,671,5314,127,12139,602,226,3564,886,510,161,16,14,76,51,4166,1148,602,3564,262,886,864,4450,4,6,0,18
Garland,12/26/20,141,51,51,5416,59155,4638,64708,635,98296,4738,678,55042,4113,4128,510,121,20,487,148,59780,4928,4738,55042,815,4113,5553,59155,47,56,0,472
Grant,12/26/20,10,53,53,976,10855,775,11877,191,18086,750,226,9401,1454,616,159,9,1,125,66,10151,1726,750,9401,272,1454,1022,10855,7,10,0,31
Greene,12/26/20,50,55,55,4274,31744,3859,36149,365,44623,3472,802,28093,3651,3169,690,41,9,262,103,31565,4584,3472,28093,933,3651,4405,31744,3,32,0,43
Hempstead,12/26/20,11,57,57,1188,11013,1052,12243,124,22018,942,246,10378,635,845,207,7,4,89,35,11320,923,942,10378,288,635,1230,11013,6,8,0,18
HotSpring,12/26/20,55,59,59,3501,31873,3161,35431,285,33520,3300,201,27172,4701,3004,157,51,4,245,40,30472,4959,3300,27172,258,4701,3558,31873,12,20,0,99
Howard,12/26/20,17,61,61,1067,7266,961,8379,89,13389,784,283,5741,1525,715,246,16,1,53,36,6525,1854,784,5741,329,1525,1113,7266,1,9,0,18
Independence,12/26/20,87,63,63,2642,24482,2347,27244,208,37264,1929,713,21089,3393,1726,621,67,20,136,72,23018,4226,1929,21089,833,3393,2762,24482,16,21,0,314
Izard,12/26/20,10,65,65,1213,10721,1087,11976,116,13559,1018,195,8554,2167,942,145,7,3,69,47,9572,2404,1018,8554,237,2167,1255,10721,3,8,0,27
Jackson,12/26/20,19,67,67,2750,18255,2464,21207,267,17225,2239,511,15484,2771,2026,438,15,4,198,69,17723,3484,2239,15484,713,2771,2952,18255,5,35,0,53
Jefferson,12/26/20,125,69,69,6511,59943,5623,66703,761,70424,5651,860,54745,5198,4960,663,109,16,580,181,60396,6307,5651,54745,1109,5198,6760,59943,3,34,0,227
Johnson,12/26/20,18,71,71,1730,16438,1514,18193,198,26291,1517,213,15678,760,1371,143,15,3,131,67,17195,998,1517,15678,238,760,1755,16438,7,17,0,35
Lafayette,12/26/20,4,73,73,326,2324,294,2674,27,6915,251,75,2112,212,231,63,4,0,16,11,2363,311,251,2112,99,212,350,2324,1,2,0,2
Lawrence,12/26/20,34,75,75,1502,9847,1332,11412,136,16669,1258,244,9169,678,1114,218,32,2,112,24,10427,985,1258,9169,307,678,1565,9847,7,13,0,80
Lee,12/26/20,24,77,77,1409,7920,1312,9341,73,9398,1364,45,7543,377,1281,31,23,1,60,13,8907,434,1364,7543,57,377,1421,7920,11,5,0,79
Lincoln,12/26/20,21,79,79,2787,15215,2670,18049,95,13695,2589,198,12990,2225,2503,167,18,3,67,28,15579,2470,2589,12990,245,2225,2834,15215,4,9,0,38
LittleRiver,12/26/20,37,81,81,773,4913,675,5714,61,12417,631,142,4381,532,544,131,35,2,52,9,5012,702,631,4381,170,532,801,4913,2,1,0,115
Logan,12/26/20,11,83,83,1343,17529,1201,18906,131,21757,1149,194,15401,2128,1055,146,10,1,84,47,16550,2356,1149,15401,228,2128,1377,17529,2,15,0,66
Lonoke,12/26/20,77,85,85,3883,43264,3338,47378,468,72206,2920,963,36841,6423,2527,811,67,10,326,142,39761,7617,2920,36841,1194,6423,4114,43264,13,50,0,179
Madison,12/26/20,11,87,87,977,8918,857,9929,109,16076,793,184,8365,553,712,145,10,1,71,38,9158,771,793,8365,218,553,1011,8918,11,14,0,124
Marion,12/26/20,18,89,89,591,6623,524,7236,49,16438,457,134,6005,618,413,111,11,7,33,16,6462,774,457,6005,156,618,613,6623,1,3,0,12
Miller,12/26/20,24,91,91,2648,13631,2417,16362,207,43759,1908,740,12330,1301,1733,684,17,7,158,49,14238,2124,1908,12330,823,1301,2731,13631,15,9,0,73
MissingCountyInfo,12/26/20,0,5,5,2720,101429,2339,104168,381,NA,2213,507,101361,68,1938,401,0,0,275,106,103574,594,2213,101361,526,68,2739,101429,-45,-27,0,662
Mississippi,12/26/20,92,93,93,4234,25489,3847,29796,294,42831,3836,398,19457,6032,3503,344,78,14,254,40,23293,6503,3836,19457,471,6032,4307,25489,5,26,0,54
Monroe,12/26/20,6,95,95,448,4947,373,5407,69,7249,383,65,4755,192,325,48,6,0,52,17,5138,269,383,4755,77,192,460,4947,5,3,0,13
Montgomery,12/26/20,17,97,97,467,5027,395,5504,55,8993,380,87,3349,1678,334,61,15,2,31,24,3729,1775,380,3349,97,1678,477,5027,0,6,0,12
Nevada,12/26/20,20,99,99,584,8466,504,9059,60,8440,505,79,8157,309,434,70,19,1,52,8,8662,397,505,8157,88,309,593,8466,0,2,0,16
Newton,12/26/20,24,101,101,543,4473,486,5028,33,7848,475,68,2938,1535,430,56,20,4,25,8,3413,1615,475,2938,80,1535,555,4473,1,3,0,4
Ouachita,12/26/20,23,103,103,1287,11974,1090,13315,173,24106,1134,153,11345,629,978,112,20,3,135,38,12479,836,1134,11345,207,629,1341,11974,9,11,0,129
Perry,12/26/20,5,105,105,405,7992,322,8415,78,10322,340,65,7510,482,278,44,4,1,58,20,7850,565,340,7510,83,482,423,7992,3,1,0,27
Phillips,12/26/20,21,107,107,1234,12799,1080,14068,133,19034,1152,82,12451,348,1023,57,21,0,108,25,13603,465,1152,12451,117,348,1269,12799,1,7,0,130
Pike,12/26/20,9,109,109,649,5235,523,5905,117,10808,522,127,4715,520,452,71,7,2,63,54,5237,668,522,4715,148,520,670,5235,2,9,0,71
Poinsett,12/26/20,59,111,111,2299,18121,1970,20489,270,24054,2072,227,17243,878,1785,185,47,12,240,30,19315,1174,2072,17243,296,878,2368,18121,8,19,0,67
Polk,12/26/20,29,113,113,1173,9190,1052,10392,91,20163,1054,119,8741,449,950,102,28,1,75,16,9795,597,1054,8741,148,449,1202,9190,4,16,0,46
Pope,12/26/20,51,115,115,5180,47518,4491,52770,638,63644,4385,795,45551,1967,3811,680,44,7,530,108,49936,2834,4385,45551,867,1967,5252,47518,9,48,0,337
Prairie,12/26/20,13,117,117,512,4737,437,5281,62,8244,380,132,4108,629,330,107,10,3,40,22,4488,793,380,4108,164,629,544,4737,1,6,0,9
Pulaski,12/26/20,361,119,119,23081,264818,20095,288540,2623,393463,20787,2294,247492,17326,18185,1910,339,22,2261,362,268279,20261,20787,247492,2935,17326,23722,264818,66,191,0,745
Randolph,12/26/20,39,121,121,1363,12122,1208,13547,116,17603,1099,264,10617,1505,977,231,29,10,93,23,11716,1831,1099,10617,326,1505,1425,12122,3,6,0,85
Saline,12/26/20,91,125,125,7153,69483,6330,76973,731,118009,5697,1456,59263,10220,5047,1283,81,10,568,163,64960,12013,5697,59263,1793,10220,7490,69483,35,89,0,343
Scott,12/26/20,9,127,127,525,7035,465,7575,51,10442,405,120,6785,250,373,92,9,0,23,28,7190,385,405,6785,135,250,540,7035,3,0,0,7
Searcy,12/26/20,11,129,129,477,4581,407,5083,59,7923,311,166,3796,785,284,123,6,5,21,38,4107,976,311,3796,191,785,502,4581,3,5,0,21
Sebastian,12/26/20,146,131,131,9042,95096,8145,104259,748,127461,7763,1279,92337,2759,7144,1001,138,8,479,269,100100,4159,7763,92337,1400,2759,9163,95096,24,75,0,272
Sevier,12/26/20,20,133,133,2022,11049,1901,13146,101,17193,1538,484,9351,1698,1472,429,19,1,47,54,10889,2257,1538,9351,559,1698,2097,11049,5,13,0,50
Sharp,12/26/20,31,135,135,1059,10535,883,11659,145,17043,785,274,9120,1415,669,214,24,7,92,53,9905,1754,785,9120,339,1415,1124,10535,7,16,0,30
St.Francis,12/26/20,20,123,123,2664,21607,2392,24302,252,26294,2554,110,21250,357,2298,94,20,0,236,16,23804,498,2554,21250,141,357,2695,21607,6,26,0,66
Stone,12/26/20,26,137,137,743,7006,591,7776,126,12446,602,141,6282,724,504,87,24,2,74,52,6884,892,602,6282,168,724,770,7006,4,6,0,121
Union,12/26/20,72,139,139,2269,17835,1912,20216,285,39732,1748,521,15184,2651,1499,413,56,16,193,92,16932,3284,1748,15184,633,2651,2381,17835,23,17,0,214
VanBuren,12/26/20,7,141,141,717,9686,597,10468,113,16684,530,187,8451,1235,456,141,6,1,68,45,8981,1487,530,8451,252,1235,782,9686,1,10,0,89
Washington,12/26/20,215,143,143,20477,156357,18423,177605,1838,228529,16643,3834,138397,17960,15126,3297,184,31,1333,505,155040,22565,16643,138397,4605,17960,21248,156357,63,153,0,390
White,12/26/20,67,145,145,4343,33351,3701,37946,574,78804,3119,1224,28158,5193,2718,983,58,9,342,232,31277,6669,3119,28158,1476,5193,4595,33351,14,50,0,134
Woodruff,12/26/20,2,147,147,325,4322,277,4680,46,6660,263,62,4069,253,227,50,1,1,35,11,4332,348,263,4069,95,253,358,4322,5,4,0,167
Yell,12/26/20,41,149,149,2287,21152,1980,23488,266,21573,2086,201,20414,738,1835,145,36,5,215,51,22500,988,2086,20414,250,738,2336,21152,3,16,0,68
Arkansas_all_counties,12/25/20,3438,5630,5630,213267,2001093,186425,2221257,23378,2990671,178980,34287,1819928,181165,158718,27707,2959,479,17280,6098,1998908,222349,178980,1819928,41184,181165,220164,2001093,2122,2090,32,10889
Arkansas_county,12/25/20,29,1,1,1243,14198,1084,15524,130,18124,931,312,10959,3239,842,242,26,3,63,67,11890,3634,931,10959,395,3239,1326,14198,12,17,0,47
Ashley,12/25/20,19,3,3,1222,10361,1070,11621,133,20537,1045,177,9701,660,929,141,18,1,98,35,10746,875,1045,9701,215,660,1260,10361,8,13,0,36
Baxter,12/25/20,61,5,5,1941,13511,1667,15483,213,41219,1426,515,11928,1583,1249,418,42,19,135,78,13354,2129,1426,11928,546,1583,1972,13511,25,28,5,64
Benton,12/25/20,248,7,7,16783,129734,14579,147077,1955,258980,13408,3375,122660,7074,11840,2739,198,50,1369,586,136068,11009,13408,122660,3935,7074,17343,129734,205,180,2,902
Boone,12/25/20,65,9,9,2454,21987,2167,24567,220,37288,2041,413,20621,1366,1818,349,56,9,165,55,22662,1905,2041,20621,539,1366,2580,21987,19,16,1,56
Bradley,12/25/20,9,11,11,878,7322,705,8224,164,10948,699,179,5024,2298,584,121,8,1,107,57,5723,2501,699,5024,203,2298,902,7322,8,10,0,21
Calhoun,12/25/20,1,13,13,216,2698,184,2926,31,5202,181,35,2552,146,160,24,1,0,20,11,2733,193,181,2552,47,146,228,2698,3,4,0,11
Carroll,12/25/20,30,15,15,1993,13434,1778,15468,185,27887,1764,229,13145,289,1590,188,27,3,147,38,14909,559,1764,13145,270,289,2034,13434,16,17,0,51
Chicot,12/25/20,29,17,17,1383,9212,1291,10618,63,10826,1298,85,8237,975,1216,75,28,1,54,9,9535,1083,1298,8237,108,975,1406,9212,4,8,0,42
Clark,12/25/20,21,19,19,1287,16891,1068,18239,198,22385,1083,204,14320,2571,907,161,18,3,158,40,15403,2836,1083,14320,265,2571,1348,16891,20,28,1,191
Clay,12/25/20,30,21,21,1263,12163,1106,13464,126,15061,992,271,9436,2727,893,213,23,7,75,51,10428,3036,992,9436,309,2727,1301,12163,8,11,0,61
Cleburne,12/25/20,35,23,23,1120,14655,891,15820,194,25230,848,272,12290,2365,699,192,32,3,117,77,13138,2682,848,12290,317,2365,1165,14655,18,19,0,127
Cleveland,12/25/20,16,25,25,534,6199,468,6758,50,8226,375,159,5631,568,338,130,14,2,23,27,6006,752,375,5631,184,568,559,6199,6,6,0,19
Columbia,12/25/20,39,27,27,1489,13159,1330,14779,120,23892,1022,467,10499,2660,951,379,28,11,43,77,11521,3258,1022,10499,598,2660,1620,13159,8,10,0,146
Conway,12/25/20,12,29,29,1203,14248,944,15491,247,20906,966,237,12418,1830,777,167,11,1,178,69,13384,2107,966,12418,277,1830,1243,14248,34,22,0,79
Craighead,12/25/20,126,31,31,9577,77659,8438,87475,1012,105701,8573,1004,69057,8602,7591,847,116,10,865,147,77630,9845,8573,69057,1243,8602,9816,77659,59,85,0,303
Crawford,12/25/20,58,33,33,4214,44473,3697,48742,458,62472,3677,537,43072,1401,3271,426,49,9,356,102,46749,1993,3677,43072,592,1401,4269,44473,43,44,0,411
Crittenden,12/25/20,70,35,35,4161,26969,3760,31215,330,49013,3935,226,25475,1494,3573,187,59,11,302,28,29410,1805,3935,25475,311,1494,4246,26969,57,39,0,84
Cross,12/25/20,34,37,37,1302,10973,1119,12313,149,16998,1065,237,10368,605,916,203,32,2,117,32,11433,880,1065,10368,275,605,1340,10973,18,15,0,49
Dallas,12/25/20,9,39,39,459,4645,383,5110,67,7432,424,35,4434,211,353,30,8,1,63,4,4858,252,424,4434,41,211,465,4645,2,7,0,55
Desha,12/25/20,11,41,41,900,7771,752,8714,137,11887,769,131,6976,795,650,102,10,1,109,28,7745,969,769,6976,174,795,943,7771,6,15,0,12
Drew,12/25/20,16,43,43,1395,12809,1180,14241,199,18502,1116,279,11102,1707,938,242,14,2,164,35,12218,2023,1116,11102,316,1707,1432,12809,9,22,1,32
Faulkner,12/25/20,84,45,45,7041,79243,6031,86578,925,122416,5857,1184,70322,8921,5140,891,69,15,647,278,76179,10399,5857,70322,1478,8921,7335,79243,77,96,1,287
Franklin,12/25/20,25,47,47,1041,13021,929,14098,87,17780,868,173,12456,565,790,139,22,3,56,31,13324,774,868,12456,209,565,1077,13021,12,3,1,47
Fulton,12/25/20,30,49,49,824,4436,665,5296,129,12139,602,222,3557,879,507,158,16,14,79,50,4159,1137,602,3557,258,879,860,4436,14,7,2,39
Garland,12/25/20,141,51,51,5369,58730,4582,64234,644,98296,4700,669,54721,4009,4089,493,121,20,488,156,59421,4813,4700,54721,804,4009,5504,58730,72,64,0,310
Grant,12/25/20,10,53,53,969,10831,765,11845,194,18086,742,227,9380,1451,610,155,9,1,123,71,10122,1723,742,9380,272,1451,1014,10831,20,13,0,83
Greene,12/25/20,50,55,55,4271,31704,3827,36105,394,44623,3468,803,28061,3643,3143,684,41,9,284,110,31529,4576,3468,28061,933,3643,4401,31704,36,37,0,79
Hempstead,12/25/20,11,57,57,1182,11001,1044,12221,126,22018,936,246,10367,634,841,203,7,4,87,39,11303,918,936,10367,284,634,1220,11001,16,17,0,27
HotSpring,12/25/20,55,59,59,3489,31786,3141,35332,293,33520,3289,200,27086,4700,2988,153,51,4,250,43,30375,4957,3289,27086,257,4700,3546,31786,35,16,0,191
Howard,12/25/20,17,61,61,1066,7249,952,8360,97,13389,783,283,5724,1525,711,241,16,1,56,41,6507,1853,783,5724,328,1525,1111,7249,4,11,0,8
Independence,12/25/20,87,63,63,2626,24184,2326,26930,213,37264,1915,711,20798,3386,1711,615,67,20,137,76,22713,4217,1915,20798,831,3386,2746,24184,18,18,0,37
Izard,12/25/20,10,65,65,1210,10697,1079,11948,121,13559,1012,198,8531,2166,938,141,7,3,67,54,9543,2405,1012,8531,239,2166,1251,10697,12,5,2,18
Jackson,12/25/20,19,67,67,2745,18207,2429,21154,297,17225,2234,511,15437,2770,2002,427,15,4,217,80,17671,3483,2234,15437,713,2770,2947,18207,1,49,0,37
Jefferson,12/25/20,125,69,69,6508,59719,5589,66474,792,70424,5645,863,54625,5094,4939,650,109,16,595,197,60270,6204,5645,54625,1110,5094,6755,59719,42,32,0,110
Johnson,12/25/20,18,71,71,1723,16410,1497,18157,208,26291,1513,210,15653,757,1362,135,15,3,136,72,17166,991,1513,15653,234,757,1747,16410,23,14,0,70
Lafayette,12/25/20,4,73,73,325,2323,292,2671,28,6915,250,75,2111,212,231,61,4,0,15,13,2361,310,250,2111,98,212,348,2323,4,4,0,16
Lawrence,12/25/20,34,75,75,1495,9774,1319,11332,142,16669,1251,244,9100,674,1108,211,32,2,111,31,10351,981,1251,9100,307,674,1558,9774,23,13,0,54
Lee,12/25/20,24,77,77,1398,7852,1307,9262,67,9398,1354,44,7476,376,1276,31,23,1,55,12,8830,432,1354,7476,56,376,1410,7852,4,3,0,19
Lincoln,12/25/20,21,79,79,2783,15181,2661,18011,100,13695,2585,198,12960,2221,2497,164,18,3,69,31,15545,2466,2585,12960,245,2221,2830,15181,18,10,0,32
LittleRiver,12/25/20,37,81,81,771,4800,674,5594,60,12417,628,143,4269,531,544,130,35,2,49,11,4897,697,628,4269,166,531,794,4800,5,2,0,7
Logan,12/25/20,11,83,83,1341,17465,1186,18840,144,21757,1148,193,15385,2080,1044,142,10,1,94,50,16533,2307,1148,15385,227,2080,1375,17465,20,15,0,158
Lonoke,12/25/20,77,85,85,3870,43098,3288,47196,505,72206,2907,963,36696,6402,2498,790,67,10,342,163,39603,7593,2907,36696,1191,6402,4098,43098,34,53,0,152
Madison,12/25/20,11,87,87,966,8805,843,9805,112,16076,783,183,8253,552,706,137,10,1,67,45,9036,769,783,8253,217,552,1000,8805,8,14,0,97
Marion,12/25/20,18,89,89,590,6612,521,7224,51,16438,456,134,5994,618,413,108,11,7,32,19,6450,774,456,5994,156,618,612,6612,6,3,4,25
Miller,12/25/20,24,91,91,2633,13573,2408,16285,201,43759,1900,733,12272,1301,1729,679,17,7,154,47,14172,2113,1900,12272,812,1301,2712,13573,23,11,0,53
MissingCountyInfo,12/25/20,0,5,5,2765,100722,2366,103498,399,NA,2236,529,100656,66,1958,408,0,0,278,121,102892,606,2236,100656,540,66,2776,100722,34,20,0,1005
Mississippi,12/25/20,92,93,93,4229,25440,3821,29742,315,42831,3832,397,19412,6028,3478,343,78,14,275,40,23244,6498,3832,19412,470,6028,4302,25440,39,39,0,123
Monroe,12/25/20,6,95,95,443,4939,370,5394,67,7249,378,65,4747,192,323,47,6,0,49,18,5125,269,378,4747,77,192,455,4939,8,5,0,23
Montgomery,12/25/20,17,97,97,467,5015,389,5492,61,8993,380,87,3338,1677,331,58,15,2,34,27,3718,1774,380,3338,97,1677,477,5015,4,3,0,16
Nevada,12/25/20,20,99,99,584,8450,502,9043,62,8440,505,79,8143,307,434,68,19,1,52,10,8648,395,505,8143,88,307,593,8450,2,2,0,21
Newton,12/25/20,24,101,101,542,4470,483,5024,35,7848,474,68,2935,1535,428,55,20,4,26,9,3409,1615,474,2935,80,1535,554,4470,3,1,0,6
Ouachita,12/25/20,23,103,103,1278,11854,1079,13186,175,24106,1125,153,11227,627,971,108,20,3,133,42,12352,834,1125,11227,207,627,1332,11854,19,19,1,83
Perry,12/25/20,5,105,105,402,7968,321,8387,76,10322,336,66,7485,483,277,44,4,1,55,21,7821,566,336,7485,83,483,419,7968,12,3,0,46
Phillips,12/25/20,21,107,107,1233,12670,1073,13938,139,19034,1151,82,12323,347,1017,56,21,0,113,26,13474,464,1151,12323,117,347,1268,12670,10,9,1,19
Pike,12/25/20,9,109,109,647,5166,514,5833,124,10808,521,126,4646,520,445,69,7,2,69,55,5167,666,521,4646,146,520,667,5166,10,11,0,26
Poinsett,12/25/20,59,111,111,2291,18062,1951,20420,281,24054,2063,228,17188,874,1766,185,47,12,250,31,19251,1169,2063,17188,295,874,2358,18062,21,21,0,54
Polk,12/25/20,29,113,113,1169,9148,1036,10346,103,20163,1052,117,8699,449,937,99,28,1,86,17,9751,595,1052,8699,146,449,1198,9148,7,8,0,31
Pope,12/25/20,51,115,115,5171,47190,4443,52432,677,63644,4375,796,45231,1959,3778,665,44,7,553,124,49606,2826,4375,45231,867,1959,5242,47190,111,56,0,390
Prairie,12/25/20,13,117,117,511,4729,431,5271,67,8244,378,133,4101,628,328,103,10,3,40,27,4479,792,378,4101,164,628,542,4729,-1,8,1,27
Pulaski,12/25/20,361,119,119,23015,264139,19904,287790,2748,393463,20723,2292,246850,17289,18035,1869,339,22,2347,401,267573,20217,20723,246850,2928,17289,23651,264139,247,256,1,1543
Randolph,12/25/20,39,121,121,1360,12040,1202,13462,119,17603,1096,264,10594,1446,970,232,29,10,97,22,11690,1772,1096,10594,326,1446,1422,12040,9,17,0,67
Saline,12/25/20,91,125,125,7118,69175,6241,76630,785,118009,5664,1454,58969,10206,4989,1252,81,10,593,192,64633,11997,5664,58969,1791,10206,7455,69175,48,88,1,345
Scott,12/25/20,9,127,127,522,7031,465,7568,48,10442,404,118,6785,246,373,92,9,0,22,26,7189,379,404,6785,133,246,537,7031,8,5,0,40
Searcy,12/25/20,11,129,129,474,4563,402,5062,61,7923,308,166,3779,784,281,121,6,5,21,40,4087,975,308,3779,191,784,499,4563,6,1,1,12
Sebastian,12/25/20,146,131,131,9018,94848,8070,103985,799,127461,7745,1273,92124,2724,7102,968,138,8,503,296,99869,4116,7745,92124,1392,2724,9137,94848,82,66,0,524
Sevier,12/25/20,20,133,133,2017,11004,1888,13094,109,17193,1535,482,9319,1685,1466,422,19,1,50,59,10854,2240,1535,9319,555,1685,2090,11004,10,10,0,21
Sharp,12/25/20,31,135,135,1052,10512,867,11629,154,17043,780,272,9099,1413,659,208,24,7,97,57,9879,1750,780,9099,337,1413,1117,10512,13,14,1,44
St.Francis,12/25/20,20,123,123,2658,21547,2366,24236,272,26294,2548,110,21192,355,2275,91,20,0,253,19,23740,496,2548,21192,141,355,2689,21547,24,17,1,45
Stone,12/25/20,26,137,137,739,6889,585,7654,128,12446,599,140,6168,721,503,82,24,2,72,56,6767,887,599,6168,166,721,765,6889,5,6,0,22
Union,12/25/20,72,139,139,2246,17644,1895,19996,279,39732,1725,521,14999,2645,1485,410,56,16,184,95,16724,3272,1725,14999,627,2645,2352,17644,50,17,2,131
VanBuren,12/25/20,7,141,141,716,9598,587,10378,122,16684,528,188,8368,1230,448,139,6,1,74,48,8896,1482,528,8368,252,1230,780,9598,4,16,0,28
Washington,12/25/20,215,143,143,20414,156030,18270,177210,1928,228529,16608,3806,138108,17922,15022,3248,184,31,1402,526,154716,22494,16608,138108,4572,17922,21180,156030,140,156,2,958
White,12/25/20,67,145,145,4329,33231,3651,37807,610,78804,3108,1221,28043,5188,2691,960,58,9,358,252,31151,6656,3108,28043,1468,5188,4576,33231,43,57,0,255
Woodruff,12/25/20,2,147,147,320,4160,273,4509,45,6660,254,66,3907,253,223,50,1,1,30,15,4161,348,254,3907,95,253,349,4160,2,7,0,10
Yell,12/25/20,41,149,149,2284,21087,1964,23420,279,21573,2085,199,20354,733,1823,141,36,5,226,53,22439,981,2085,20354,248,733,2333,21087,37,26,0,219
Arkansas_all_counties,12/24/20,3406,5630,5630,211145,1992326,184335,2210250,23378,2990671,177140,34005,1811933,180393,157204,27131,2946,460,16967,6411,1989073,221177,177140,1811933,40784,180393,217924,1992326,3204,2311,30,22808
Arkansas_county,12/24/20,29,1,1,1231,14163,1067,15473,135,18124,921,310,10927,3236,833,234,26,3,62,73,11848,3625,921,10927,389,3236,1310,14163,14,9,0,161
Ashley,12/24/20,19,3,3,1214,10333,1057,11581,138,20537,1036,178,9673,660,919,138,18,1,99,39,10709,872,1036,9673,212,660,1248,10333,25,18,0,86
Baxter,12/24/20,56,5,5,1916,13472,1639,15424,221,41219,1407,509,11889,1583,1230,409,42,14,135,86,13296,2128,1407,11889,545,1583,1952,13472,25,17,7,195
Benton,12/24/20,246,7,7,16578,129037,14399,146165,1932,258980,13230,3348,122014,7023,11739,2660,196,50,1294,638,135244,10921,13230,122014,3898,7023,17128,129037,327,153,1,1481
Boone,12/24/20,64,9,9,2435,21950,2151,24512,218,37288,2024,411,20587,1363,1806,345,56,8,160,58,22611,1901,2024,20587,538,1363,2562,21950,30,30,3,201
Bradley,12/24/20,9,11,11,870,7309,695,8203,166,10948,691,179,5011,2298,576,119,8,1,107,59,5702,2501,691,5011,203,2298,894,7309,15,19,0,68
Calhoun,12/24/20,1,13,13,213,2690,180,2915,32,5202,178,35,2544,146,158,22,1,0,19,13,2722,193,178,2544,47,146,225,2690,4,0,0,46
Carroll,12/24/20,30,15,15,1977,13399,1761,15416,186,27887,1749,228,13111,288,1575,186,27,3,147,39,14860,556,1749,13111,268,288,2017,13399,14,21,0,127
Chicot,12/24/20,29,17,17,1379,9174,1283,10575,67,10826,1293,86,8199,975,1208,75,28,1,57,10,9492,1083,1293,8199,108,975,1401,9174,11,8,0,56
Clark,12/24/20,20,19,19,1267,16720,1040,18048,207,22385,1068,199,14258,2462,882,158,17,3,169,38,15326,2722,1068,14258,260,2462,1328,16720,17,14,1,240
Clay,12/24/20,30,21,21,1255,12110,1095,13403,129,15061,986,269,9384,2726,883,212,23,7,79,50,10370,3033,986,9384,307,2726,1293,12110,14,14,0,90
Cleburne,12/24/20,35,23,23,1102,14546,872,15687,195,25230,829,273,12221,2325,688,184,32,3,109,86,13050,2637,829,12221,312,2325,1141,14546,36,19,0,297
Cleveland,12/24/20,16,25,25,528,6186,462,6739,50,8226,371,157,5618,568,334,128,14,2,23,27,5989,750,371,5618,182,568,553,6186,4,7,0,20
Columbia,12/24/20,39,27,27,1481,13021,1320,14632,122,23892,1015,466,10366,2655,946,374,28,11,41,81,11381,3251,1015,10366,596,2655,1611,13021,28,16,0,139
Conway,12/24/20,12,29,29,1169,14203,922,15414,235,20906,938,231,12376,1827,763,159,11,1,164,71,13314,2100,938,12376,273,1827,1211,14203,35,30,1,253
Craighead,12/24/20,126,31,31,9518,77415,8353,87163,1038,105701,8509,1009,68815,8600,7518,835,116,10,874,164,77324,9839,8509,68815,1239,8600,9748,77415,152,88,0,778
Crawford,12/24/20,58,33,33,4171,44105,3653,48331,459,62472,3636,535,42707,1398,3243,410,49,9,343,116,46343,1988,3636,42707,590,1398,4226,44105,50,42,0,403
Crittenden,12/24/20,70,35,35,4104,26942,3721,31130,312,49013,3881,223,25449,1493,3539,182,59,11,282,30,29330,1800,3881,25449,307,1493,4188,26942,53,42,0,398
Cross,12/24/20,34,37,37,1284,10942,1104,12258,146,16998,1043,241,10343,599,905,199,32,2,106,40,11386,872,1043,10343,273,599,1316,10942,17,21,0,229
Dallas,12/24/20,9,39,39,457,4592,376,5055,72,7432,423,34,4381,211,346,30,8,1,69,3,4804,251,423,4381,40,211,463,4592,7,4,0,75
Desha,12/24/20,11,41,41,894,7765,737,8702,146,11887,765,129,6970,795,637,100,10,1,118,28,7735,967,765,6970,172,795,937,7765,17,22,0,55
Drew,12/24/20,15,43,43,1386,12786,1158,14208,213,18502,1106,280,11079,1707,916,242,13,2,177,36,12185,2023,1106,11079,316,1707,1422,12786,30,26,0,123
Faulkner,12/24/20,83,45,45,6964,79033,5935,86285,945,122416,5790,1174,70130,8903,5067,868,69,14,653,292,75920,10365,5790,70130,1462,8903,7252,79033,135,86,4,1137
Franklin,12/24/20,24,47,47,1029,12986,926,14051,79,17780,858,171,12423,563,789,137,22,2,47,32,13281,770,858,12423,207,563,1065,12986,10,10,0,73
Fulton,12/24/20,28,49,49,810,4411,658,5258,124,12139,590,220,3532,879,503,155,15,13,72,52,4122,1136,590,3532,257,879,847,4411,22,9,1,67
Garland,12/24/20,141,51,51,5297,58492,4518,63922,636,98296,4635,662,54493,3999,4036,482,121,20,476,160,59128,4794,4635,54493,795,3999,5430,58492,65,54,2,674
Grant,12/24/20,10,53,53,949,10768,752,11761,187,18086,730,219,9308,1460,602,150,9,1,119,68,10038,1723,730,9308,263,1460,993,10768,25,8,0,162
Greene,12/24/20,50,55,55,4235,31661,3790,36025,395,44623,3440,795,28018,3643,3108,682,41,9,291,104,31458,4567,3440,28018,924,3643,4364,31661,64,53,0,344
Hempstead,12/24/20,11,57,57,1166,10990,1027,12193,127,22018,925,241,10361,629,830,197,7,4,87,40,11286,907,925,10361,278,629,1203,10990,27,12,2,110
HotSpring,12/24/20,55,59,59,3454,31630,3125,35139,274,33520,3256,198,26939,4691,2974,151,51,4,231,43,30195,4944,3256,26939,253,4691,3509,31630,48,35,0,435
Howard,12/24/20,17,61,61,1062,7245,941,8351,104,13389,778,284,5720,1525,705,236,16,1,57,47,6498,1853,778,5720,328,1525,1106,7245,19,20,0,93
Independence,12/24/20,87,63,63,2608,24165,2308,26886,213,37264,1898,710,20787,3378,1699,609,67,20,132,81,22685,4201,1898,20787,823,3378,2721,24165,39,34,1,296
Izard,12/24/20,8,65,65,1198,10691,1074,11932,116,13559,1001,197,8525,2166,937,137,7,1,57,59,9526,2406,1001,8525,240,2166,1241,10691,31,9,0,221
Jackson,12/24/20,19,67,67,2744,18171,2380,21118,345,17225,2233,511,15402,2769,1957,423,15,4,261,84,17635,3483,2233,15402,714,2769,2947,18171,30,19,1,114
Jefferson,12/24/20,125,69,69,6466,59651,5557,66362,782,70424,5614,852,54559,5092,4923,634,109,16,580,202,60173,6189,5614,54559,1097,5092,6711,59651,93,66,0,437
Johnson,12/24/20,18,71,71,1700,16363,1483,18087,199,26291,1491,209,15606,757,1351,132,15,3,125,74,17097,990,1491,15606,233,757,1724,16363,30,11,1,257
Lafayette,12/24/20,4,73,73,321,2311,288,2655,28,6915,247,74,2102,209,229,59,4,0,14,14,2349,306,247,2102,97,209,344,2311,5,3,0,18
Lawrence,12/24/20,34,75,75,1472,9743,1306,11271,132,16669,1232,240,9069,674,1098,208,32,2,102,30,10301,970,1232,9069,296,674,1528,9743,22,6,0,78
Lee,12/24/20,24,77,77,1394,7837,1304,9243,66,9398,1350,44,7463,374,1273,31,23,1,54,12,8813,430,1350,7463,56,374,1406,7837,7,19,0,62
Lincoln,12/24/20,21,79,79,2765,15167,2651,17979,92,13695,2575,190,12946,2221,2491,160,18,3,65,27,15521,2458,2575,12946,237,2221,2812,15167,8,10,0,107
LittleRiver,12/24/20,37,81,81,766,4798,672,5586,57,12417,624,142,4267,531,543,129,35,2,46,11,4891,695,624,4267,164,531,788,4798,13,5,0,82
Logan,12/24/20,11,83,83,1321,17327,1171,18681,139,21757,1135,186,15255,2072,1039,132,10,1,86,53,16390,2291,1135,15255,219,2072,1354,17327,16,24,0,97
Lonoke,12/24/20,77,85,85,3836,42980,3235,47041,524,72206,2882,954,36596,6384,2464,771,67,10,351,173,39478,7563,2882,36596,1179,6384,4061,42980,61,36,-1,441
Madison,12/24/20,11,87,87,958,8716,829,9708,118,16076,777,181,8168,548,696,133,10,1,71,47,8945,763,777,8168,215,548,992,8716,13,12,0,79
Marion,12/24/20,14,89,89,584,6593,518,7203,52,16438,454,130,5977,616,411,107,11,3,32,20,6431,772,454,5977,156,616,610,6593,4,4,0,40
Miller,12/24/20,24,91,91,2610,13543,2397,16232,189,43759,1881,729,12242,1301,1720,677,17,7,144,45,14123,2109,1881,12242,808,1301,2689,13543,42,9,0,173
MissingCountyInfo,12/24/20,0,5,5,2731,99751,2346,102492,385,NA,2220,511,99685,66,1940,406,0,0,280,105,101905,587,2220,99685,521,66,2741,99751,-110,14,0,1238
Mississippi,12/24/20,92,93,93,4190,25356,3782,29619,315,42831,3795,395,19328,6028,3444,338,78,14,272,43,23123,6496,3795,19328,468,6028,4263,25356,35,46,0,235
Monroe,12/24/20,6,95,95,435,4924,365,5370,64,7249,369,66,4733,191,320,45,6,0,43,21,5102,268,369,4733,77,191,446,4924,10,5,0,63
Montgomery,12/24/20,17,97,97,463,5003,386,5476,60,8993,378,85,3326,1677,329,57,15,2,34,26,3704,1772,378,3326,95,1677,473,5003,8,8,0,154
Nevada,12/24/20,20,99,99,582,8431,500,9022,62,8440,504,78,8126,305,434,66,19,1,51,11,8630,392,504,8126,87,305,591,8431,12,6,0,127
Newton,12/24/20,24,101,101,539,4467,482,5018,33,7848,471,68,2933,1534,427,55,20,4,24,9,3404,1614,471,2933,80,1534,551,4467,7,5,0,81
Ouachita,12/24/20,22,103,103,1259,11790,1060,13101,176,24106,1105,154,11163,627,956,104,19,3,129,47,12268,833,1105,11163,206,627,1311,11790,31,23,0,97
Perry,12/24/20,5,105,105,390,7934,318,8341,67,10322,326,64,7453,481,277,41,4,1,45,22,7779,562,326,7453,81,481,407,7934,11,7,0,156
Phillips,12/24/20,20,107,107,1223,12661,1064,13917,139,19034,1140,83,12314,347,1008,56,20,0,112,27,13454,463,1140,12314,116,347,1256,12661,18,12,0,157
Pike,12/24/20,9,109,109,637,5150,503,5807,125,10808,514,123,4633,517,437,66,7,2,70,55,5147,660,514,4633,143,517,657,5150,47,4,0,154
Poinsett,12/24/20,59,111,111,2270,18029,1930,20360,281,24054,2041,229,17155,874,1746,184,47,12,248,33,19196,1164,2041,17155,290,874,2331,18029,45,21,3,169
Polk,12/24/20,29,113,113,1162,9124,1028,10314,104,20163,1045,117,8675,449,930,98,28,1,86,18,9720,594,1045,8675,145,449,1190,9124,23,17,0,124
Pope,12/24/20,51,115,115,5060,46911,4387,52042,622,63644,4264,796,44956,1955,3736,651,44,7,484,138,49220,2822,4264,44956,867,1955,5131,46911,122,73,0,517
Prairie,12/24/20,12,117,117,512,4701,423,5244,77,8244,378,134,4074,627,327,96,9,3,42,35,4452,792,378,4074,165,627,543,4701,12,2,-1,76
Pulaski,12/24/20,360,119,119,22768,262843,19648,286238,2758,393463,20511,2257,245693,17150,17806,1842,338,22,2365,393,266204,20034,20511,245693,2884,17150,23395,262843,349,265,1,2913
Randolph,12/24/20,39,121,121,1351,11982,1185,13391,127,17603,1087,264,10536,1446,955,230,29,10,103,24,11623,1768,1087,10536,322,1446,1409,11982,18,15,0,118
Saline,12/24/20,90,125,125,7070,68878,6153,76282,826,118009,5622,1448,58689,10189,4928,1225,80,10,613,213,64311,11971,5622,58689,1782,10189,7404,68878,117,87,0,900
Scott,12/24/20,9,127,127,514,6999,460,7528,45,10442,404,110,6755,244,368,92,9,0,27,18,7159,369,404,6755,125,244,529,6999,6,2,0,44
Searcy,12/24/20,10,129,129,468,4557,401,5050,57,7923,303,165,3773,784,280,121,6,4,17,40,4076,974,303,3773,190,784,493,4557,7,11,0,33
Sebastian,12/24/20,146,131,131,8936,94406,8004,103459,783,127461,7675,1261,91693,2713,7063,941,138,8,472,311,99368,4091,7675,91693,1378,2713,9053,94406,111,85,1,721
Sevier,12/24/20,20,133,133,2007,10993,1878,13071,109,17193,1530,477,9310,1683,1461,417,19,1,50,59,10840,2231,1530,9310,548,1683,2078,10993,19,9,0,205
Sharp,12/24/20,30,135,135,1039,10481,853,11586,156,17043,771,268,9077,1404,652,201,24,6,95,61,9848,1738,771,9077,334,1404,1105,10481,22,15,0,158
St.Francis,12/24/20,19,123,123,2634,21526,2349,24191,266,26294,2525,109,21174,352,2258,91,19,0,248,18,23699,492,2525,21174,140,352,2665,21526,49,37,0,318
Stone,12/24/20,26,137,137,734,6872,579,7632,129,12446,595,139,6154,718,500,79,24,2,71,58,6749,883,595,6154,165,718,760,6872,35,4,0,222
Union,12/24/20,70,139,139,2196,17563,1878,19861,248,39732,1673,523,14962,2601,1477,401,56,14,140,108,16635,3226,1673,14962,625,2601,2298,17563,52,33,0,284
VanBuren,12/24/20,7,141,141,712,9574,571,10349,134,16684,526,186,8344,1230,440,131,6,1,80,54,8870,1479,526,8344,249,1230,775,9574,15,14,1,193
Washington,12/24/20,213,143,143,20274,155212,18114,176242,1946,228529,16495,3779,137397,17815,14927,3187,182,31,1386,560,153892,22350,16495,137397,4535,17815,21030,155212,278,204,1,1620
White,12/24/20,67,145,145,4286,33019,3594,37544,624,78804,3076,1210,27936,5083,2665,929,58,9,352,272,31012,6532,3076,27936,1449,5083,4525,33019,49,60,0,243
Woodruff,12/24/20,2,147,147,318,4152,266,4499,50,6660,253,65,3903,249,217,49,1,1,35,15,4156,343,253,3903,94,249,347,4152,11,7,0,65
Yell,12/24/20,41,149,149,2247,20905,1938,23201,268,21573,2049,198,20173,732,1807,131,36,5,206,62,22222,979,2049,20173,247,732,2296,20905,41,46,0,305
Arkansas_all_counties,12/23/20,3376,5630,5630,207941,1972722,182024,2187353,22516,2990671,174782,33159,1796073,176649,155447,26577,2939,437,16374,6142,1970855,216498,174782,1796073,39849,176649,214631,1972722,2893,2318,38,17227
Arkansas_county,12/23/20,29,1,1,1217,14016,1058,15311,130,18124,918,299,10819,3197,827,231,26,3,65,65,11737,3574,918,10819,377,3197,1295,14016,18,15,1,99
Ashley,12/23/20,19,3,3,1189,10272,1039,11495,131,20537,1020,169,9615,657,904,135,18,1,98,33,10635,860,1020,9615,203,657,1223,10272,22,19,0,127
Baxter,12/23/20,49,5,5,1891,13302,1622,15235,220,41219,1396,495,11808,1494,1216,406,42,7,138,82,13204,2031,1396,11808,537,1494,1933,13302,21,13,1,155
Benton,12/23/20,245,7,7,16251,127883,14246,144677,1759,258980,12987,3264,120920,6963,11622,2624,196,49,1168,591,133907,10770,12987,120920,3807,6963,16794,127883,267,174,3,1227
Boone,12/23/20,61,9,9,2405,21779,2121,24313,221,37288,2010,395,20467,1312,1783,338,56,5,169,52,22477,1836,2010,20467,524,1312,2534,21779,26,27,0,169
Bradley,12/23/20,9,11,11,855,7256,676,8135,170,10948,677,178,4968,2288,561,115,8,1,108,62,5645,2490,677,4968,202,2288,879,7256,21,20,0,54
Calhoun,12/23/20,1,13,13,209,2648,180,2868,28,5202,178,31,2521,127,158,22,1,0,19,9,2699,169,178,2521,42,127,220,2648,6,3,0,22
Carroll,12/23/20,30,15,15,1963,13286,1740,15289,193,27887,1737,226,13004,282,1562,178,27,3,148,45,14741,548,1737,13004,266,282,2003,13286,22,30,0,89
Chicot,12/23/20,29,17,17,1368,9129,1275,10518,64,10826,1283,85,8154,975,1202,73,28,1,53,11,9437,1081,1283,8154,106,975,1389,9129,8,6,0,46
Clark,12/23/20,19,19,19,1250,16497,1026,17806,205,22385,1055,195,14117,2380,872,154,16,3,167,38,15172,2634,1055,14117,254,2380,1309,16497,25,20,0,177
Clay,12/23/20,30,21,21,1241,12034,1081,13313,129,15061,975,266,9358,2676,872,209,23,7,79,50,10333,2980,975,9358,304,2676,1279,12034,17,13,2,232
Cleburne,12/23/20,35,23,23,1066,14285,853,15389,178,25230,804,262,12000,2285,675,178,32,3,97,81,12804,2585,804,12000,300,2285,1104,14285,18,11,4,141
Cleveland,12/23/20,16,25,25,524,6170,455,6718,53,8226,368,156,5605,565,328,127,14,2,26,27,5973,745,368,5605,180,565,548,6170,4,5,0,37
Columbia,12/23/20,39,27,27,1453,12910,1304,14493,110,23892,1008,445,10297,2613,935,369,28,11,45,65,11305,3188,1008,10297,575,2613,1583,12910,17,15,0,194
Conway,12/23/20,11,29,29,1134,13985,892,15160,231,20906,913,221,12251,1734,748,144,10,1,155,76,13164,1996,913,12251,262,1734,1175,13985,31,20,0,133
Craighead,12/23/20,126,31,31,9366,76789,8265,86383,974,105701,8381,985,68269,8520,7439,826,116,10,825,149,76650,9733,8381,68269,1213,8520,9594,76789,108,97,2,658
Crawford,12/23/20,58,33,33,4121,43752,3611,47928,451,62472,3595,526,42375,1377,3208,403,49,9,337,114,45970,1958,3595,42375,581,1377,4176,43752,28,43,1,206
Crittenden,12/23/20,70,35,35,4051,26597,3679,30726,301,49013,3830,221,25104,1493,3496,183,59,11,274,27,28934,1792,3830,25104,299,1493,4129,26597,36,38,0,186
Cross,12/23/20,34,37,37,1267,10730,1083,12026,150,16998,1026,241,10152,578,887,196,32,2,107,43,11178,848,1026,10152,270,578,1296,10730,14,18,0,83
Dallas,12/23/20,9,39,39,450,4524,372,4980,69,7432,417,33,4321,203,342,30,8,1,67,2,4738,242,417,4321,39,203,456,4524,17,3,0,58
Desha,12/23/20,11,41,41,877,7727,715,8645,151,11887,753,124,6939,788,619,96,10,1,124,27,7692,953,753,6939,165,788,918,7727,15,12,0,73
Drew,12/23/20,15,43,43,1356,12693,1132,14084,209,18502,1079,277,10989,1704,896,236,13,2,170,39,12068,2016,1079,10989,312,1704,1391,12693,25,16,0,170
Faulkner,12/23/20,79,45,45,6829,78031,5849,85140,900,122416,5680,1149,69452,8579,4999,850,66,13,614,286,75132,10008,5680,69452,1429,8579,7109,78031,122,101,0,794
Franklin,12/23/20,24,47,47,1019,12923,916,13978,79,17780,851,168,12365,558,781,135,22,2,48,31,13216,762,851,12365,204,558,1055,12923,2,8,0,93
Fulton,12/23/20,27,49,49,788,4366,649,5190,112,12139,575,213,3506,860,497,152,15,12,63,49,4081,1109,575,3506,249,860,824,4366,16,4,1,52
Garland,12/23/20,139,51,51,5232,57883,4464,63250,627,98296,4587,645,54001,3882,3998,466,121,18,466,161,58588,4662,4587,54001,780,3882,5367,57883,89,54,0,526
Grant,12/23/20,10,53,53,924,10631,744,11599,170,18086,717,207,9261,1370,597,147,9,1,111,59,9978,1621,717,9261,251,1370,968,10631,25,12,0,97
Greene,12/23/20,50,55,55,4171,31381,3737,35681,384,44623,3406,765,27774,3607,3061,676,41,9,304,80,31180,4501,3406,27774,894,3607,4300,31381,77,43,0,431
Hempstead,12/23/20,9,57,57,1139,10907,1015,12085,115,22018,905,234,10292,615,823,192,7,2,75,40,11197,888,905,10292,273,615,1178,10907,16,9,0,141
HotSpring,12/23/20,55,59,59,3406,31243,3090,34703,261,33520,3214,192,26623,4620,2942,148,51,4,221,40,29837,4866,3214,26623,246,4620,3460,31243,30,26,1,237
Howard,12/23/20,17,61,61,1043,7171,921,8258,105,13389,769,274,5658,1513,698,223,16,1,55,50,6427,1831,769,5658,318,1513,1087,7171,12,4,0,85
Independence,12/23/20,86,63,63,2569,23908,2274,26591,209,37264,1868,701,20559,3349,1674,600,67,19,127,82,22427,4164,1868,20559,815,3349,2683,23908,28,14,0,240
Izard,12/23/20,8,65,65,1167,10501,1065,11709,94,13559,987,180,8397,2104,930,135,7,1,50,44,9384,2325,987,8397,221,2104,1208,10501,8,8,0,140
Jackson,12/23/20,18,67,67,2714,18087,2361,21004,335,17225,2224,490,15320,2767,1946,415,14,4,264,71,17544,3460,2224,15320,693,2767,2917,18087,16,115,1,183
Jefferson,12/23/20,125,69,69,6373,59307,5491,65924,755,70424,5552,821,54252,5055,4869,622,109,16,572,183,59804,6120,5552,54252,1065,5055,6617,59307,111,18,1,869
Johnson,12/23/20,17,71,71,1670,16136,1472,17830,181,26291,1471,199,15380,756,1342,130,15,2,114,67,16851,979,1471,15380,223,756,1694,16136,20,19,0,93
Lafayette,12/23/20,4,73,73,316,2298,285,2637,26,6915,244,72,2091,207,226,59,4,0,14,12,2335,302,244,2091,95,207,339,2298,4,1,0,35
Lawrence,12/23/20,34,75,75,1450,9687,1300,11192,116,16669,1209,241,9016,671,1096,204,32,2,81,35,10225,967,1209,9016,296,671,1505,9687,15,9,0,86
Lee,12/23/20,24,77,77,1387,7782,1285,9181,78,9398,1345,42,7416,366,1254,31,23,1,68,10,8761,420,1345,7416,54,366,1399,7782,6,2,2,43
Lincoln,12/23/20,21,79,79,2757,15068,2641,17872,94,13695,2569,188,12853,2215,2483,158,18,3,67,27,15422,2450,2569,12853,235,2215,2804,15068,8,10,0,32
LittleRiver,12/23/20,37,81,81,753,4729,667,5504,49,12417,615,138,4201,528,541,126,35,2,39,10,4816,688,615,4201,160,528,775,4729,14,2,0,191
Logan,12/23/20,11,83,83,1305,17246,1147,18584,147,21757,1124,181,15180,2066,1021,126,10,1,93,54,16304,2280,1124,15180,214,2066,1338,17246,12,30,0,93
Lonoke,12/23/20,78,85,85,3775,42600,3199,46590,498,72206,2839,936,36267,6333,2431,768,68,10,340,158,39106,7484,2839,36267,1151,6333,3990,42600,67,35,1,381
Madison,12/23/20,11,87,87,945,8650,817,9629,117,16076,769,176,8108,542,688,129,10,1,71,46,8877,752,769,8108,210,542,979,8650,17,14,0,89
Marion,12/23/20,14,89,89,580,6557,514,7163,52,16438,452,128,5954,603,409,105,11,3,32,20,6406,757,452,5954,154,603,606,6557,9,7,0,47
Miller,12/23/20,24,91,91,2568,13412,2388,16059,156,43759,1850,718,12117,1295,1717,671,17,7,116,40,13967,2092,1850,12117,797,1295,2647,13412,75,21,0,209
MissingCountyInfo,12/23/20,0,5,5,2841,98403,2332,101254,509,NA,2317,524,98338,65,1922,410,0,0,395,114,100655,599,2317,98338,534,65,2851,98403,69,-11,0,-218
Mississippi,12/23/20,92,93,93,4155,25156,3736,29384,326,42831,3766,389,19180,5976,3405,331,78,14,282,44,22946,6438,3766,19180,462,5976,4228,25156,45,52,0,201
Monroe,12/23/20,6,95,95,425,4871,360,5307,59,7249,363,62,4683,188,318,42,6,0,39,20,5046,261,363,4683,73,188,436,4871,5,6,0,41
Montgomery,12/23/20,17,97,97,455,4857,378,5322,60,8993,373,82,3296,1561,324,54,15,2,34,26,3669,1653,373,3296,92,1561,465,4857,11,3,0,63
Nevada,12/23/20,20,99,99,570,8316,494,8894,56,8440,492,78,8019,297,431,63,19,1,42,14,8511,383,492,8019,86,297,578,8316,8,6,0,64
Newton,12/23/20,24,101,101,532,4393,477,4937,31,7848,465,67,2920,1473,422,55,20,4,23,8,3385,1552,465,2920,79,1473,544,4393,2,3,0,14
Ouachita,12/23/20,22,103,103,1228,11724,1037,13004,168,24106,1081,147,11120,604,934,103,19,3,127,41,12201,803,1081,11120,199,604,1280,11724,16,26,0,61
Perry,12/23/20,5,105,105,379,7789,311,8184,63,10322,316,63,7326,463,272,39,4,1,40,23,7642,542,316,7326,79,463,395,7789,8,3,0,56
Phillips,12/23/20,20,107,107,1205,12522,1052,13759,133,19034,1123,82,12179,343,1000,52,20,0,103,30,13302,457,1123,12179,114,343,1237,12522,10,8,0,144
Pike,12/23/20,9,109,109,590,5043,499,5651,82,10808,492,98,4612,431,434,65,7,2,51,31,5104,547,492,4612,116,431,608,5043,15,15,0,116
Poinsett,12/23/20,56,111,111,2225,17905,1909,20193,260,24054,2003,222,17041,864,1726,183,47,9,230,30,19044,1149,2003,17041,285,864,2288,17905,23,34,0,131
Polk,12/23/20,29,113,113,1139,9023,1011,10190,98,20163,1026,113,8576,447,915,96,28,1,82,16,9602,588,1026,8576,141,447,1167,9023,18,10,0,55
Pope,12/23/20,51,115,115,4938,46516,4314,51521,573,63644,4158,780,44598,1918,3677,637,44,7,437,136,48756,2765,4158,44598,847,1918,5005,46516,61,52,0,258
Prairie,12/23/20,13,117,117,500,4637,421,5168,66,8244,372,128,4019,618,326,95,10,3,36,30,4391,777,372,4019,159,618,531,4637,7,14,1,42
Pulaski,12/23/20,359,119,119,22419,260279,19383,283315,2675,393463,20202,2217,243961,16318,17584,1799,337,22,2279,396,264163,19152,20202,243961,2834,16318,23036,260279,271,265,4,2333
Randolph,12/23/20,39,121,121,1333,11882,1170,13273,124,17603,1076,257,10455,1427,944,226,29,10,103,21,11531,1742,1076,10455,315,1427,1391,11882,17,19,0,138
Saline,12/23/20,90,125,125,6953,68095,6066,75378,796,118009,5538,1415,58196,9899,4878,1188,80,10,579,217,63734,11644,5538,58196,1745,9899,7283,68095,93,110,3,777
Scott,12/23/20,9,127,127,508,6961,458,7484,41,10442,403,105,6719,242,366,92,9,0,28,13,7122,362,403,6719,120,242,523,6961,10,4,2,74
Searcy,12/23/20,10,129,129,461,4531,390,5017,61,7923,300,161,3750,781,272,118,6,4,22,39,4050,967,300,3750,186,781,486,4531,7,6,2,25
Sebastian,12/23/20,145,131,131,8825,93796,7919,102738,758,127461,7599,1226,91130,2666,7010,909,138,7,449,309,98729,4009,7599,91130,1343,2666,8942,93796,97,86,1,804
Sevier,12/23/20,20,133,133,1988,10807,1869,12866,99,17193,1525,463,9174,1633,1456,413,19,1,50,49,10699,2167,1525,9174,534,1633,2059,10807,13,9,0,51
Sharp,12/23/20,30,135,135,1017,10345,838,11428,149,17043,757,260,8968,1377,640,198,24,6,93,56,9725,1703,757,8968,326,1377,1083,10345,18,17,0,85
St.Francis,12/23/20,19,123,123,2585,21257,2312,23872,254,26294,2478,107,20913,344,2225,87,19,0,234,20,23391,481,2478,20913,137,344,2615,21257,16,58,0,56
Stone,12/23/20,26,137,137,699,6685,575,7409,98,12446,567,132,6003,682,497,78,24,2,46,52,6570,839,567,6003,157,682,724,6685,14,8,0,84
Union,12/23/20,70,139,139,2144,17331,1845,19572,229,39732,1632,512,14778,2553,1460,385,56,14,116,113,16410,3162,1632,14778,609,2553,2241,17331,42,33,1,267
VanBuren,12/23/20,6,141,141,697,9396,557,10154,134,16684,518,179,8193,1203,432,125,5,1,81,53,8711,1443,518,8193,240,1203,758,9396,19,13,0,60
Washington,12/23/20,212,143,143,19996,153870,17910,174610,1873,228529,16299,3697,136290,17580,14786,3124,181,31,1332,541,152589,22021,16299,136290,4441,17580,20740,153870,275,208,0,1431
White,12/23/20,67,145,145,4237,32825,3534,37297,635,78804,3043,1194,27770,5055,2632,902,58,9,352,283,30813,6484,3043,27770,1429,5055,4472,32825,109,45,1,343
Woodruff,12/23/20,2,147,147,307,4098,259,4434,46,6660,251,56,3850,248,216,43,1,1,34,12,4101,333,251,3850,85,248,336,4098,3,10,1,29
Yell,12/23/20,41,149,149,2206,20641,1892,22893,273,21573,2015,191,19920,721,1768,124,36,5,211,62,21935,958,2015,19920,237,721,2252,20641,26,22,1,119
Arkansas_all_counties,12/22/20,3338,5630,5630,205048,1958388,179706,2170051,21979,2990671,172782,32266,1785196,173192,153677,26029,2910,428,16173,5806,1957978,212073,172782,1785196,38881,173192,211663,1958388,1941,2077,43,13446
Arkansas_county,12/22/20,28,1,1,1199,13935,1043,15212,128,18124,912,287,10773,3162,818,225,26,2,68,60,11685,3527,912,10773,365,3162,1277,13935,11,9,0,87
Ashley,12/22/20,19,3,3,1167,10167,1020,11368,128,20537,1009,158,9531,636,888,132,18,1,103,25,10540,828,1009,9531,192,636,1201,10167,3,11,0,41
Baxter,12/22/20,48,5,5,1870,13168,1609,15079,213,41219,1382,488,11687,1481,1210,399,41,7,131,82,13069,2010,1382,11687,529,1481,1911,13168,15,19,0,84
Benton,12/22/20,242,7,7,15984,126923,14072,143447,1669,258980,12831,3153,120042,6881,11505,2567,195,47,1130,539,132873,10574,12831,120042,3693,6881,16524,126923,158,151,4,804
Boone,12/22/20,61,9,9,2379,21636,2094,24144,222,37288,1989,390,20385,1251,1763,331,56,5,168,54,22374,1770,1989,20385,519,1251,2508,21636,33,31,2,227
Bradley,12/22/20,9,11,11,834,7223,656,8081,169,10948,667,167,4949,2274,551,105,8,1,108,61,5616,2465,667,4949,191,2274,858,7223,11,11,0,182
Calhoun,12/22/20,1,13,13,203,2632,177,2846,25,5202,175,28,2508,124,156,21,1,0,18,7,2683,163,175,2508,39,124,214,2632,3,1,0,15
Carroll,12/22/20,30,15,15,1941,13219,1710,15201,201,27887,1720,221,12940,279,1535,175,27,3,158,43,14660,541,1720,12940,262,279,1982,13219,19,13,2,79
Chicot,12/22/20,29,17,17,1360,9091,1269,10472,62,10826,1275,85,8117,974,1198,71,28,1,49,13,9392,1080,1275,8117,106,974,1381,9091,0,5,0,42
Clark,12/22/20,19,19,19,1225,16345,1006,17629,200,22385,1039,186,13985,2360,856,150,16,3,167,33,15024,2605,1039,13985,245,2360,1284,16345,10,17,0,51
Clay,12/22/20,28,21,21,1224,11819,1068,13080,127,15061,966,258,9253,2566,862,206,21,7,82,45,10219,2861,966,9253,295,2566,1261,11819,18,8,2,151
Cleburne,12/22/20,31,23,23,1048,14162,842,15247,175,25230,794,254,11973,2189,665,177,29,2,100,75,12767,2480,794,11973,291,2189,1085,14162,14,13,0,199
Cleveland,12/22/20,16,25,25,520,6137,450,6681,54,8226,368,152,5587,550,326,124,14,2,28,26,5955,726,368,5587,176,550,544,6137,10,11,0,27
Columbia,12/22/20,39,27,27,1436,12733,1289,14299,108,23892,1004,432,10259,2474,926,363,28,11,50,58,11263,3036,1004,10259,562,2474,1566,12733,23,14,1,229
Conway,12/22/20,11,29,29,1103,13883,872,15027,220,20906,890,213,12155,1728,733,139,10,1,147,73,13045,1982,890,12155,254,1728,1144,13883,8,21,1,94
Craighead,12/22/20,124,31,31,9258,76239,8168,85724,965,105701,8292,966,67907,8332,7351,817,114,10,826,139,76199,9525,8292,67907,1193,8332,9485,76239,67,90,3,770
Crawford,12/22/20,57,33,33,4093,43574,3568,47719,467,62472,3577,516,42213,1361,3171,397,49,8,356,111,45790,1929,3577,42213,568,1361,4145,43574,37,60,0,151
Crittenden,12/22/20,70,35,35,4015,26447,3641,30542,303,49013,3799,216,24970,1477,3465,176,59,11,274,29,28769,1773,3799,24970,296,1477,4095,26447,14,35,1,166
Cross,12/22/20,34,37,37,1253,10661,1065,11942,154,16998,1019,234,10087,574,871,194,32,2,116,38,11106,836,1019,10087,262,574,1281,10661,20,23,0,63
Dallas,12/22/20,9,39,39,433,4483,369,4922,55,7432,401,32,4280,203,339,30,8,1,54,1,4681,241,401,4280,38,203,439,4483,1,5,0,23
Desha,12/22/20,11,41,41,862,7669,703,8572,148,11887,742,120,6886,783,608,95,10,1,124,24,7628,944,742,6886,161,783,903,7669,9,9,0,52
Drew,12/22/20,15,43,43,1331,12548,1116,13914,200,18502,1057,274,10849,1699,884,232,13,2,160,40,11906,2008,1057,10849,309,1699,1366,12548,13,21,0,92
Faulkner,12/22/20,79,45,45,6707,77359,5748,84338,879,122416,5610,1097,68981,8378,4917,831,66,13,626,253,74591,9747,5610,68981,1369,8378,6979,77359,66,102,1,879
Franklin,12/22/20,24,47,47,1017,12832,908,13885,85,17780,848,169,12291,541,774,134,22,2,52,33,13139,746,848,12291,205,541,1053,12832,17,7,0,90
Fulton,12/22/20,26,49,49,772,4330,645,5138,101,12139,562,210,3480,850,497,148,14,12,51,50,4042,1096,562,3480,246,850,808,4330,10,4,1,53
Garland,12/22/20,139,51,51,5143,57446,4410,62722,592,98296,4525,618,53695,3751,3955,455,121,18,447,145,58220,4502,4525,53695,751,3751,5276,57446,60,56,2,354
Grant,12/22/20,10,53,53,899,10559,732,11499,157,18086,708,191,9224,1335,590,142,9,1,109,48,9932,1567,708,9224,232,1335,940,10559,16,7,0,64
Greene,12/22/20,50,55,55,4094,31027,3694,35249,350,44623,3351,743,27637,3390,3028,666,41,9,282,68,30988,4261,3351,27637,871,3390,4222,31027,23,53,0,151
Hempstead,12/22/20,9,57,57,1123,10782,1006,11944,108,22018,894,229,10180,602,817,189,7,2,70,38,11074,870,894,10180,268,602,1162,10782,9,7,0,70
HotSpring,12/22/20,54,59,59,3376,31036,3064,34466,258,33520,3187,189,26486,4550,2920,144,50,4,217,41,29673,4793,3187,26486,243,4550,3430,31036,27,19,0,237
Howard,12/22/20,17,61,61,1031,7098,917,8172,97,13389,759,272,5588,1510,697,220,16,1,46,51,6347,1825,759,5588,315,1510,1074,7098,8,7,0,64
Independence,12/22/20,86,63,63,2541,23696,2260,26346,195,37264,1847,694,20389,3307,1669,591,67,19,111,84,22236,4110,1847,20389,803,3307,2650,23696,35,23,3,372
Izard,12/22/20,8,65,65,1159,10369,1057,11569,94,13559,983,176,8367,2002,926,131,7,1,50,44,9350,2219,983,8367,217,2002,1200,10369,12,3,0,81
Jackson,12/22/20,17,67,67,2698,17920,2246,20823,435,17225,2207,491,15158,2762,1832,414,14,3,361,74,17365,3458,2207,15158,696,2762,2903,17920,8,33,1,86
Jefferson,12/22/20,124,69,69,6262,58549,5473,65052,663,70424,5464,798,53636,4913,4857,616,108,16,497,166,59100,5952,5464,53636,1039,4913,6503,58549,26,22,1,231
Johnson,12/22/20,17,71,71,1650,16063,1453,17737,180,26291,1455,195,15335,728,1328,125,15,2,112,68,16790,947,1455,15335,219,728,1674,16063,13,17,0,141
Lafayette,12/22/20,4,73,73,312,2267,284,2602,23,6915,242,70,2079,188,225,59,4,0,13,10,2321,281,242,2079,93,188,335,2267,1,0,0,17
Lawrence,12/22/20,34,75,75,1435,9616,1291,11106,110,16669,1197,238,8954,662,1087,204,32,2,78,32,10151,955,1197,8954,293,662,1490,9616,6,14,0,61
Lee,12/22/20,22,77,77,1381,7745,1283,9137,76,9398,1340,41,7382,363,1252,31,21,1,67,9,8722,415,1340,7382,52,363,1392,7745,4,11,0,22
Lincoln,12/22/20,21,79,79,2749,15044,2631,17840,96,13695,2562,187,12835,2209,2477,154,18,3,66,30,15397,2443,2562,12835,234,2209,2796,15044,8,25,0,28
LittleRiver,12/22/20,37,81,81,739,4552,665,5311,37,12417,604,135,4109,443,540,125,35,2,29,8,4713,598,604,4109,155,443,759,4552,7,7,0,35
Logan,12/22/20,11,83,83,1293,17165,1117,18491,165,21757,1117,176,15110,2055,999,118,10,1,108,57,16227,2264,1117,15110,209,2055,1326,17165,14,10,0,187
Lonoke,12/22/20,77,85,85,3708,42286,3164,46208,467,72206,2788,920,36017,6269,2406,758,67,10,315,152,38805,7403,2788,36017,1134,6269,3922,42286,48,44,0,307
Madison,12/22/20,11,87,87,928,8578,803,9538,114,16076,757,171,8037,541,676,127,10,1,71,43,8794,744,757,8037,203,541,960,8578,11,8,0,22
Marion,12/22/20,14,89,89,571,6519,507,7116,50,16438,445,126,5926,593,408,99,11,3,26,24,6371,745,445,5926,152,593,597,6519,6,5,0,40
Miller,12/22/20,24,91,91,2493,13278,2367,15850,102,43759,1795,698,12025,1253,1702,665,17,7,76,26,13820,2030,1795,12025,777,1253,2572,13278,11,22,0,45
MissingCountyInfo,12/22/20,0,5,5,2772,98690,2343,101471,429,NA,2252,520,98626,64,1920,423,0,0,332,97,100878,593,2252,98626,529,64,2781,98690,-33,15,0,-169
Mississippi,12/22/20,92,93,93,4110,25000,3684,29183,333,42831,3726,384,19103,5897,3362,322,78,14,285,48,22829,6354,3726,19103,457,5897,4183,25000,38,47,1,385
Monroe,12/22/20,6,95,95,420,4835,354,5266,60,7249,360,60,4650,185,313,41,6,0,41,19,5010,256,360,4650,71,185,431,4835,10,4,1,25
Montgomery,12/22/20,17,97,97,444,4805,375,5259,52,8993,371,73,3287,1518,325,50,15,2,31,21,3658,1601,371,3287,83,1518,454,4805,6,8,0,-14
Nevada,12/22/20,20,99,99,562,8260,488,8830,54,8440,486,76,7967,293,427,61,19,1,40,14,8453,377,486,7967,84,293,570,8260,6,4,0,85
Newton,12/22/20,24,101,101,530,4381,474,4923,32,7848,465,65,2912,1469,419,55,20,4,26,6,3377,1546,465,2912,77,1469,542,4381,3,0,0,14
Ouachita,12/22/20,22,103,103,1212,11679,1011,12943,178,24106,1071,141,11088,591,912,99,19,3,139,39,12159,784,1071,11088,193,591,1264,11679,13,10,0,64
Perry,12/22/20,5,105,105,371,7741,308,8128,58,10322,311,60,7281,460,269,39,4,1,38,20,7592,536,311,7281,76,460,387,7741,9,6,0,69
Phillips,12/22/20,20,107,107,1195,12388,1044,13615,131,19034,1112,83,12049,339,993,51,20,0,99,32,13161,454,1112,12049,115,339,1227,12388,7,10,1,40
Pike,12/22/20,9,109,109,575,4942,484,5534,82,10808,487,88,4528,414,426,58,7,2,54,28,5015,519,487,4528,105,414,592,4942,9,5,1,25
Poinsett,12/22/20,56,111,111,2202,17797,1875,20061,271,24054,1980,222,16950,847,1693,182,47,9,240,31,18930,1131,1980,16950,284,847,2264,17797,39,19,3,145
Polk,12/22/20,29,113,113,1121,8986,1001,10135,90,20163,1010,111,8547,439,905,96,28,1,76,14,9557,578,1010,8547,139,439,1149,8986,3,12,0,43
Pope,12/22/20,51,115,115,4877,46319,4262,51260,564,63644,4106,771,44437,1882,3643,619,44,7,419,145,48543,2717,4106,44437,835,1882,4941,46319,42,49,1,299
Prairie,12/22/20,12,117,117,493,4602,407,5125,74,8244,365,128,3991,611,321,86,10,2,34,40,4356,769,365,3991,158,611,523,4602,37,16,0,165
Pulaski,12/22/20,355,119,119,22148,258217,19118,280972,2673,393463,19979,2169,242214,16003,17352,1766,333,22,2292,381,262193,18779,19979,242214,2776,16003,22755,258217,281,233,4,2047
Randolph,12/22/20,39,121,121,1316,11761,1151,13135,126,17603,1063,253,10402,1359,930,221,29,10,104,22,11465,1670,1063,10402,311,1359,1374,11761,14,18,0,57
Saline,12/22/20,87,125,125,6860,67411,5956,74604,816,118009,5464,1396,57730,9681,4799,1157,77,10,587,229,63194,11410,5464,57730,1729,9681,7193,67411,86,73,1,595
Scott,12/22/20,7,127,127,498,6897,454,7410,37,10442,401,97,6664,233,365,89,7,0,29,8,7065,345,401,6664,112,233,513,6897,2,5,0,24
Searcy,12/22/20,8,129,129,454,4513,384,4992,62,7923,299,155,3736,777,270,114,4,4,25,37,4035,957,299,3736,180,777,479,4513,8,10,0,28
Sebastian,12/22/20,144,131,131,8728,93089,7833,101928,748,127461,7551,1177,90482,2607,6946,887,137,7,466,282,98033,3895,7551,90482,1288,2607,8839,93089,56,76,2,394
Sevier,12/22/20,20,133,133,1975,10769,1860,12815,95,17193,1518,457,9145,1624,1453,407,19,1,46,49,10663,2152,1518,9145,528,1624,2046,10769,8,6,0,48
Sharp,12/22/20,30,135,135,999,10278,821,11343,148,17043,746,253,8925,1353,628,193,24,6,94,54,9671,1672,746,8925,319,1353,1065,10278,15,10,0,109
St.Francis,12/22/20,19,123,123,2569,21217,2254,23816,296,26294,2463,106,20878,339,2168,86,19,0,276,20,23341,475,2463,20878,136,339,2599,21217,10,16,0,39
Stone,12/22/20,26,137,137,685,6615,567,7324,92,12446,560,125,5960,655,490,77,24,2,46,46,6520,804,560,5960,149,655,709,6615,20,7,0,82
Union,12/22/20,69,139,139,2102,17106,1812,19304,221,39732,1609,493,14580,2526,1448,364,56,13,105,116,16189,3115,1609,14580,589,2526,2198,17106,31,22,0,164
VanBuren,12/22/20,6,141,141,678,9355,544,10091,128,16684,507,171,8165,1190,423,121,5,1,79,49,8672,1419,507,8165,229,1190,736,9355,4,29,0,106
Washington,12/22/20,212,143,143,19721,152714,17702,173164,1806,228529,16160,3561,135279,17435,14653,3049,181,31,1326,480,151439,21725,16160,135279,4290,17435,20450,152714,166,203,1,889
White,12/22/20,66,145,145,4128,32591,3489,36954,572,78804,2964,1164,27666,4925,2602,887,57,9,304,268,30630,6324,2964,27666,1399,4925,4363,32591,82,52,1,293
Woodruff,12/22/20,1,147,147,304,4072,249,4405,54,6660,248,56,3840,232,209,40,1,0,38,16,4088,317,248,3840,85,232,333,4072,3,7,0,27
Yell,12/22/20,40,149,149,2180,20548,1870,22774,270,21573,1993,187,19857,691,1753,117,35,5,205,65,21850,924,1993,19857,233,691,2226,20548,23,21,1,102
Arkansas_all_counties,12/21/20,3295,5630,5630,203107,1946883,177629,2156543,22158,2990671,171672,31435,1777857,169026,152176,25453,2885,410,16589,5569,1949529,207014,171672,1777857,37988,169026,209660,1946883,1457,2242,58,11217
Arkansas_county,12/21/20,28,1,1,1188,13859,1034,15124,126,18124,908,280,10758,3101,811,223,26,2,71,55,11666,3458,908,10758,357,3101,1265,13859,1,4,1,80
Ashley,12/21/20,19,3,3,1164,10129,1009,11326,136,20537,1009,155,9521,608,878,131,18,1,113,23,10530,796,1009,9521,188,608,1197,10129,5,16,0,37
Baxter,12/21/20,48,5,5,1855,13099,1590,14995,217,41219,1382,473,11626,1473,1200,390,41,7,141,76,13008,1987,1382,11626,514,1473,1896,13099,23,22,2,149
Benton,12/21/20,238,7,7,15826,126277,13921,142640,1666,258980,12759,3067,119560,6717,11419,2502,192,46,1147,519,132319,10321,12759,119560,3604,6717,16363,126277,132,155,5,1174
Boone,12/21/20,59,9,9,2346,21442,2063,23917,222,37288,1969,377,20321,1121,1743,320,54,5,170,52,22290,1627,1969,20321,506,1121,2475,21442,6,27,1,138
Bradley,12/21/20,9,11,11,823,7052,645,7898,169,10948,665,158,4943,2109,545,100,8,1,112,57,5608,2290,665,4943,181,2109,846,7052,12,13,0,73
Calhoun,12/21/20,1,13,13,200,2620,176,2831,23,5202,173,27,2501,119,155,21,1,0,17,6,2674,157,173,2501,38,119,211,2620,4,1,0,23
Carroll,12/21/20,28,15,15,1922,13159,1697,15121,197,27887,1707,215,12891,268,1523,174,26,2,158,39,14598,523,1707,12891,255,268,1962,13159,13,33,2,75
Chicot,12/21/20,29,17,17,1360,9049,1264,10430,67,10826,1275,85,8112,937,1194,70,28,1,53,14,9387,1043,1275,8112,106,937,1381,9049,3,5,0,52
Clark,12/21/20,19,19,19,1215,16304,989,17578,207,22385,1029,186,13967,2337,845,144,16,3,168,39,14996,2582,1029,13967,245,2337,1274,16304,7,19,1,199
Clay,12/21/20,26,21,21,1206,11686,1060,12929,119,15061,958,248,9130,2556,855,205,20,6,82,37,10088,2841,958,9130,285,2556,1243,11686,4,15,0,528
Cleburne,12/21/20,31,23,23,1034,13977,829,15047,174,25230,789,245,11838,2139,657,172,29,2,103,71,12627,2420,789,11838,281,2139,1070,13977,9,12,0,84
Cleveland,12/21/20,16,25,25,510,6120,439,6654,55,8226,367,143,5582,538,317,122,14,2,36,19,5949,705,367,5582,167,538,534,6120,1,6,0,56
Columbia,12/21/20,38,27,27,1413,12527,1275,14070,100,23892,1001,412,10104,2423,917,358,28,10,56,44,11105,2965,1001,10104,542,2423,1543,12527,4,17,0,64
Conway,12/21/20,10,29,29,1095,13797,851,14932,234,20906,885,210,12110,1687,719,132,10,0,156,78,12995,1937,885,12110,250,1687,1135,13797,10,22,0,81
Craighead,12/21/20,121,31,31,9191,75536,8078,84951,991,105701,8244,947,67524,8012,7275,803,111,10,857,134,75768,9183,8244,67524,1171,8012,9415,75536,84,120,1,684
Crawford,12/21/20,57,33,33,4056,43460,3508,47567,490,62472,3559,497,42114,1346,3120,388,49,8,389,101,45673,1894,3559,42114,548,1346,4107,43460,40,41,1,420
Crittenden,12/21/20,69,35,35,4001,26295,3606,30373,325,49013,3786,215,24843,1452,3431,175,59,10,295,30,28629,1744,3786,24843,292,1452,4078,26295,18,40,2,328
Cross,12/21/20,34,37,37,1233,10618,1042,11878,157,16998,1007,226,10059,559,850,192,32,2,125,32,11066,812,1007,10059,253,559,1260,10618,16,20,1,104
Dallas,12/21/20,9,39,39,432,4461,364,4899,59,7432,400,32,4269,192,334,30,8,1,58,1,4669,230,400,4269,38,192,438,4461,1,4,0,34
Desha,12/21/20,11,41,41,853,7626,694,8520,148,11887,737,116,6871,755,600,94,10,1,127,21,7608,912,737,6871,157,755,894,7626,1,15,0,59
Drew,12/21/20,15,43,43,1318,12469,1095,13822,208,18502,1053,265,10826,1643,867,228,13,2,173,35,11879,1943,1053,10826,300,1643,1353,12469,8,26,4,165
Faulkner,12/21/20,78,45,45,6641,76546,5646,83456,916,122416,5574,1067,68577,7969,4845,801,65,13,663,253,74151,9305,5574,68577,1336,7969,6910,76546,60,95,4,578
Franklin,12/21/20,24,47,47,1000,12759,901,13795,75,17780,842,158,12234,525,769,132,22,2,51,24,13076,719,842,12234,194,525,1036,12759,5,7,1,94
Fulton,12/21/20,25,49,49,762,4287,641,5085,96,12139,562,200,3468,819,495,146,13,12,54,42,4030,1055,562,3468,236,819,798,4287,4,10,2,50
Garland,12/21/20,137,51,51,5083,57152,4354,62367,590,98296,4487,596,53451,3701,3912,442,121,16,452,138,57938,4429,4487,53451,728,3701,5215,57152,61,47,1,490
Grant,12/21/20,10,53,53,883,10511,725,11433,148,18086,696,187,9200,1311,585,140,9,1,102,46,9896,1537,696,9200,226,1311,922,10511,32,9,0,151
Greene,12/21/20,50,55,55,4071,30899,3641,35099,380,44623,3335,736,27563,3336,2988,653,41,9,306,74,30898,4201,3335,27563,865,3336,4200,30899,25,55,1,353
Hempstead,12/21/20,9,57,57,1114,10721,999,11874,106,22018,888,226,10128,593,811,188,7,2,70,36,11016,858,888,10128,265,593,1153,10721,11,14,0,116
HotSpring,12/21/20,54,59,59,3349,30826,3045,34228,250,33520,3161,188,26305,4521,2904,141,50,4,207,43,29466,4762,3161,26305,241,4521,3402,30826,12,14,2,113
Howard,12/21/20,17,61,61,1023,7042,910,8107,96,13389,754,269,5574,1468,694,216,16,1,44,52,6328,1779,754,5574,311,1468,1065,7042,5,16,0,29
Independence,12/21/20,83,63,63,2506,23359,2237,25974,186,37264,1841,665,20356,3003,1652,585,66,17,123,63,22197,3777,1841,20356,774,3003,2615,23359,5,26,0,150
Izard,12/21/20,8,65,65,1147,10300,1054,11487,85,13559,979,168,8350,1950,923,131,7,1,49,36,9329,2158,979,8350,208,1950,1187,10300,0,5,0,54
Jackson,12/21/20,16,67,67,2690,17842,2213,20736,461,17225,2204,486,15106,2736,1807,406,13,3,384,77,17310,3426,2204,15106,690,2736,2894,17842,6,24,0,79
Jefferson,12/21/20,123,69,69,6236,58344,5451,64819,660,70424,5456,780,53477,4867,4850,601,108,15,496,164,58933,5886,5456,53477,1019,4867,6475,58344,31,32,0,179
Johnson,12/21/20,17,71,71,1637,15935,1436,17596,184,26291,1451,186,15222,713,1313,123,15,2,123,61,16673,923,1451,15222,210,713,1661,15935,14,12,0,172
Lafayette,12/21/20,4,73,73,311,2251,284,2585,22,6915,241,70,2070,181,225,59,4,0,12,10,2311,274,241,2070,93,181,334,2251,2,2,0,9
Lawrence,12/21/20,34,75,75,1429,9561,1277,11043,118,16669,1194,235,8936,625,1076,201,32,2,86,32,10130,913,1194,8936,288,625,1482,9561,10,16,0,202
Lee,12/21/20,22,77,77,1377,7727,1272,9115,83,9398,1338,39,7368,359,1242,30,21,1,75,8,8706,409,1338,7368,50,359,1388,7727,6,14,1,58
Lincoln,12/21/20,21,79,79,2741,15024,2606,17811,113,13695,2560,181,12825,2199,2455,151,18,3,86,27,15385,2426,2560,12825,227,2199,2787,15024,8,18,0,750
LittleRiver,12/21/20,37,81,81,732,4524,658,5275,37,12417,598,134,4081,443,536,122,35,2,27,10,4679,596,598,4081,153,443,751,4524,5,0,0,94
Logan,12/21/20,11,83,83,1279,16992,1107,18304,161,21757,1113,166,14960,2032,993,114,10,1,110,51,16073,2231,1113,14960,199,2032,1312,16992,11,8,0,231
Lonoke,12/21/20,77,85,85,3660,42027,3120,45896,463,72206,2762,898,35889,6138,2382,738,67,10,313,150,38651,7245,2762,35889,1107,6138,3869,42027,41,36,3,196
Madison,12/21/20,11,87,87,917,8567,795,9516,111,16076,752,165,8027,540,672,123,10,1,70,41,8779,737,752,8027,197,540,949,8567,9,13,0,65
Marion,12/21/20,14,89,89,565,6485,502,7075,49,16438,443,122,5901,584,404,98,11,3,28,21,6344,731,443,5901,147,584,590,6485,6,6,1,217
Miller,12/21/20,24,91,91,2482,13244,2345,15804,113,43759,1787,695,11993,1251,1694,651,17,7,76,37,13780,2024,1787,11993,773,1251,2560,13244,18,20,0,74
MissingCountyInfo,12/21/20,0,5,5,2805,98826,2328,101639,477,NA,2249,556,98765,61,1900,428,0,0,349,128,101014,625,2249,98765,564,61,2813,98826,-47,42,0,-5603
Mississippi,12/21/20,91,93,93,4072,24653,3637,28797,343,42831,3695,377,19059,5594,3324,313,77,14,293,50,22754,6043,3695,19059,449,5594,4144,24653,27,49,1,214
Monroe,12/21/20,5,95,95,410,4820,350,5240,55,7249,350,60,4636,184,310,40,5,0,35,20,4986,254,350,4636,70,184,420,4820,5,4,0,66
Montgomery,12/21/20,17,97,97,438,4825,367,5273,54,8993,368,70,3281,1544,318,49,15,2,35,19,3649,1624,368,3281,80,1544,448,4825,2,9,1,32
Nevada,12/21/20,20,99,99,556,8181,484,8745,52,8440,482,74,7909,272,425,59,19,1,38,14,8391,354,482,7909,82,272,564,8181,7,1,1,139
Newton,12/21/20,24,101,101,527,4370,474,4910,29,7848,465,62,2905,1465,419,55,20,4,26,3,3370,1540,465,2905,75,1465,540,4370,7,3,0,77
Ouachita,12/21/20,22,103,103,1199,11628,1001,12879,175,24106,1066,133,11061,567,905,96,19,3,141,34,12127,752,1066,11061,185,567,1251,11628,9,16,0,67
Perry,12/21/20,5,105,105,362,7681,302,8059,55,10322,306,56,7232,449,265,37,4,1,37,18,7538,521,306,7232,72,449,378,7681,1,5,0,40
Phillips,12/21/20,19,107,107,1188,12355,1034,13575,135,19034,1107,81,12021,334,983,51,19,0,105,30,13128,447,1107,12021,113,334,1220,12355,11,20,0,134
Pike,12/21/20,8,109,109,566,4926,479,5508,79,10808,477,89,4522,404,424,55,6,2,47,32,4999,509,477,4522,105,404,582,4926,9,8,1,89
Poinsett,12/21/20,53,111,111,2163,17691,1856,19918,254,24054,1949,214,16870,821,1675,181,46,7,228,26,18819,1099,1949,16870,278,821,2227,17691,21,37,1,146
Polk,12/21/20,29,113,113,1118,8946,989,10092,99,20163,1008,110,8510,436,894,95,28,1,85,14,9518,574,1008,8510,138,436,1146,8946,5,15,0,104
Pope,12/21/20,50,115,115,4835,46062,4213,50961,572,63644,4079,756,44233,1829,3605,608,44,6,430,142,48312,2649,4079,44233,820,1829,4899,46062,43,65,0,562
Prairie,12/21/20,12,117,117,456,4474,391,4957,53,8244,363,93,3984,490,319,72,10,2,34,19,4347,610,363,3984,120,490,483,4474,3,1,0,16
Pulaski,12/21/20,351,119,119,21867,256451,18885,278917,2629,393463,19742,2125,240733,15718,17161,1724,329,22,2250,379,260475,18442,19742,240733,2724,15718,22466,256451,197,281,7,2238
Randolph,12/21/20,39,121,121,1302,11718,1133,13078,130,17603,1053,249,10382,1336,915,218,29,10,109,21,11435,1643,1053,10382,307,1336,1360,11718,8,19,1,130
Saline,12/21/20,86,125,125,6774,66902,5883,74009,804,118009,5404,1370,57392,9510,4746,1137,76,10,581,223,62796,11213,5404,57392,1703,9510,7107,66902,57,79,1,530
Scott,12/21/20,7,127,127,496,6875,449,7386,40,10442,401,95,6644,231,361,88,7,0,33,7,7045,341,401,6644,110,231,511,6875,1,5,1,15
Searcy,12/21/20,8,129,129,446,4493,374,4964,64,7923,298,148,3723,770,267,107,4,4,27,37,4021,943,298,3723,173,770,471,4493,2,10,0,19
Sebastian,12/21/20,142,131,131,8672,92751,7757,101535,770,127461,7532,1140,90201,2550,6894,863,136,6,500,270,97733,3802,7532,90201,1252,2550,8784,92751,62,65,2,609
Sevier,12/21/20,20,133,133,1967,10729,1854,12767,93,17193,1518,449,9135,1594,1452,402,19,1,47,46,10653,2114,1518,9135,520,1594,2038,10729,13,13,0,61
Sharp,12/21/20,30,135,135,984,10184,811,11234,143,17043,742,242,8898,1286,621,190,24,6,97,46,9640,1594,742,8898,308,1286,1050,10184,6,12,0,149
St.Francis,12/21/20,19,123,123,2559,21188,2238,23777,302,26294,2455,104,20853,335,2155,83,19,0,281,21,23308,469,2455,20853,134,335,2589,21188,18,12,0,439
Stone,12/21/20,26,137,137,665,6553,560,7241,79,12446,551,114,5934,619,487,73,24,2,40,39,6485,756,551,5934,137,619,688,6553,0,17,0,63
Union,12/21/20,69,139,139,2071,16973,1790,19136,212,39732,1605,466,14545,2428,1433,357,56,13,116,96,16150,2986,1605,14545,558,2428,2163,16973,30,28,1,159
VanBuren,12/21/20,6,141,141,674,9253,515,9985,153,16684,506,168,8088,1165,406,109,5,1,95,58,8594,1391,506,8088,226,1165,732,9253,12,14,0,50
Washington,12/21/20,211,143,143,19555,151991,17499,172269,1844,228529,16057,3498,134667,17324,14517,2982,181,30,1359,485,150724,21545,16057,134667,4221,17324,20278,151991,112,213,2,1074
White,12/21/20,65,145,145,4046,32380,3437,36660,543,78804,2934,1112,27517,4863,2575,862,57,8,301,242,30451,6209,2934,27517,1346,4863,4280,32380,27,39,0,238
Woodruff,12/21/20,1,147,147,301,4048,242,4378,58,6660,246,55,3832,216,203,39,1,0,42,16,4078,300,246,3832,84,216,330,4048,4,4,0,38
Yell,12/21/20,39,149,149,2157,20469,1849,22672,269,21573,1984,173,19794,675,1735,114,35,4,214,55,21778,894,1984,19794,219,675,2203,20469,16,24,1,211
Arkansas_all_counties,12/20/20,3237,5630,5630,201650,1937123,175387,2145240,23001,2990671,170603,31047,1769637,167486,150604,24783,2842,395,17135,5866,1940240,205000,170603,1769637,37514,167486,208117,1937123,1536,1555,46,15961
Arkansas_county,12/20/20,27,1,1,1187,13780,1030,15043,130,18124,909,278,10696,3084,808,222,25,2,76,54,11605,3438,909,10696,354,3084,1263,13780,8,4,1,100
Ashley,12/20/20,19,3,3,1159,10097,993,11289,147,20537,1004,155,9492,605,864,129,18,1,122,25,10496,793,1004,9492,188,605,1192,10097,9,8,1,67
Baxter,12/20/20,46,5,5,1832,12973,1568,14847,218,41219,1374,458,11502,1471,1184,384,40,6,150,68,12876,1971,1374,11502,500,1471,1874,12973,16,11,2,49
Benton,12/20/20,233,7,7,15694,125235,13766,141458,1694,258980,12669,3025,118563,6672,11321,2445,188,45,1159,535,131232,10226,12669,118563,3554,6672,16223,125235,169,100,9,791
Boone,12/20/20,58,9,9,2340,21310,2036,23780,244,37288,1964,376,20203,1107,1725,311,54,4,183,61,22167,1613,1964,20203,506,1107,2470,21310,28,17,0,77
Bradley,12/20/20,9,11,11,811,6991,632,7824,170,10948,653,158,4885,2106,537,95,8,1,108,62,5538,2286,653,4885,180,2106,833,6991,12,5,0,46
Calhoun,12/20/20,1,13,13,196,2601,175,2808,20,5202,170,26,2482,119,153,22,1,0,16,4,2652,156,170,2482,37,119,207,2601,2,3,0,12
Carroll,12/20/20,26,15,15,1909,13097,1664,15046,219,27887,1695,214,12831,266,1498,166,25,1,172,47,14526,520,1695,12831,254,266,1949,13097,4,14,1,28
Chicot,12/20/20,29,17,17,1357,9000,1259,10378,69,10826,1273,84,8066,934,1190,69,28,1,55,14,9339,1039,1273,8066,105,934,1378,9000,11,6,0,98
Clark,12/20/20,18,19,19,1208,16112,970,17378,220,22385,1023,185,13782,2330,830,140,15,3,178,42,14805,2573,1023,13782,243,2330,1266,16112,15,8,0,182
Clay,12/20/20,26,21,21,1202,11162,1045,12401,130,15061,956,246,8638,2524,848,197,20,6,87,43,9594,2807,956,8638,283,2524,1239,11162,5,10,0,30
Cleburne,12/20/20,31,23,23,1025,13902,817,14961,177,25230,780,245,11770,2132,653,164,29,2,98,79,12550,2411,780,11770,279,2132,1059,13902,8,10,0,114
Cleveland,12/20/20,16,25,25,509,6065,433,6598,60,8226,367,142,5530,535,313,120,14,2,40,20,5897,701,367,5530,166,535,533,6065,1,3,0,18
Columbia,12/20/20,38,27,27,1409,12467,1258,14006,113,23892,998,411,10046,2421,910,348,28,10,60,53,11044,2962,998,10046,541,2421,1539,12467,5,9,0,28
Conway,12/20/20,10,29,29,1085,13726,829,14851,246,20906,880,205,12042,1684,707,122,10,0,163,83,12922,1929,880,12042,245,1684,1125,13726,21,10,0,97
Craighead,12/20/20,120,31,31,9107,74936,7958,84262,1028,105701,8181,926,67008,7928,7177,781,110,10,893,135,75189,9073,8181,67008,1145,7928,9326,74936,55,73,0,365
Crawford,12/20/20,56,33,33,4016,43080,3467,47147,492,62472,3529,487,41739,1341,3090,377,48,8,390,102,45268,1879,3529,41739,538,1341,4067,43080,43,32,3,302
Crittenden,12/20/20,67,35,35,3983,25985,3566,30045,349,49013,3769,214,24535,1450,3395,171,58,9,315,34,28304,1741,3769,24535,291,1450,4060,25985,33,22,1,276
Cross,12/20/20,33,37,37,1217,10530,1022,11773,162,16998,992,225,9979,551,841,181,31,2,120,42,10971,802,992,9979,251,551,1243,10530,10,15,1,127
Dallas,12/20/20,9,39,39,431,4428,360,4864,62,7432,399,32,4235,193,330,30,8,1,61,1,4634,230,399,4235,37,193,436,4428,8,7,0,54
Desha,12/20/20,11,41,41,852,7568,679,8459,162,11887,736,116,6820,748,590,89,10,1,136,26,7556,903,736,6820,155,748,891,7568,23,8,0,49
Drew,12/20/20,11,43,43,1310,12312,1069,13657,230,18502,1046,264,10683,1629,848,221,10,1,188,42,11729,1928,1046,10683,299,1629,1345,12312,28,20,1,136
Faulkner,12/20/20,74,45,45,6581,76028,5551,82872,955,122416,5529,1052,68125,7903,4777,774,62,12,689,266,73654,9218,5529,68125,1315,7903,6844,76028,64,45,1,356
Franklin,12/20/20,23,47,47,995,12670,894,13700,78,17780,838,157,12148,522,765,129,21,2,52,26,12986,714,838,12148,192,522,1030,12670,3,6,1,57
Fulton,12/20/20,23,49,49,758,4241,631,5035,104,12139,558,200,3437,804,488,143,12,11,58,46,3995,1040,558,3437,236,804,794,4241,7,4,2,20
Garland,12/20/20,136,51,51,5022,56723,4307,61877,577,98296,4432,590,53031,3692,3877,430,121,15,432,145,57463,4414,4432,53031,722,3692,5154,56723,26,39,0,198
Grant,12/20/20,10,53,53,851,10392,716,11282,125,18086,670,181,9086,1306,578,138,9,1,83,42,9756,1526,670,9086,220,1306,890,10392,6,9,0,36
Greene,12/20/20,49,55,55,4046,30571,3586,34744,411,44623,3311,735,27258,3313,2942,644,40,9,329,82,30569,4175,3311,27258,862,3313,4173,30571,32,117,0,107
Hempstead,12/20/20,9,57,57,1103,10616,985,11758,109,22018,879,224,10026,590,801,184,7,2,71,38,10905,853,879,10026,263,590,1142,10616,4,6,0,54
HotSpring,12/20/20,52,59,59,3337,30725,3031,34116,254,33520,3157,180,26218,4507,2893,138,48,4,216,38,29375,4741,3157,26218,234,4507,3391,30725,15,9,0,349
Howard,12/20/20,17,61,61,1018,7018,894,8073,107,13389,752,266,5551,1467,684,210,16,1,52,55,6303,1770,752,5551,303,1467,1055,7018,2,6,0,16
Independence,12/20/20,83,63,63,2501,23214,2211,25823,207,37264,1836,665,20214,3000,1637,574,66,17,133,74,22050,3773,1836,20214,773,3000,2609,23214,17,13,1,259
Izard,12/20/20,8,65,65,1147,10246,1049,11427,90,13559,973,174,8302,1944,918,131,7,1,48,42,9275,2152,973,8302,208,1944,1181,10246,9,9,0,591
Jackson,12/20/20,16,67,67,2684,17769,2189,20657,479,17225,2202,482,15036,2733,1800,389,13,3,389,90,17238,3419,2202,15036,686,2733,2888,17769,17,18,0,428
Jefferson,12/20/20,123,69,69,6205,58196,5419,64636,661,70424,5444,761,53341,4855,4832,587,108,15,502,159,58785,5851,5444,53341,996,4855,6440,58196,41,14,0,1062
Johnson,12/20/20,17,71,71,1623,15777,1424,17424,182,26291,1443,180,15079,698,1302,122,15,2,126,56,16522,902,1443,15079,204,698,1647,15777,13,17,0,85
Lafayette,12/20/20,4,73,73,309,2244,282,2576,22,6915,240,69,2063,181,224,58,4,0,12,10,2303,273,240,2063,92,181,332,2244,-1,0,0,5
Lawrence,12/20/20,34,75,75,1419,9369,1261,10841,124,16669,1186,233,8748,621,1061,200,32,2,93,31,9934,907,1186,8748,286,621,1472,9369,28,4,1,133
Lee,12/20/20,21,77,77,1371,7675,1258,9057,92,9398,1332,39,7317,358,1228,30,20,1,84,8,8649,408,1332,7317,50,358,1382,7675,10,4,0,58
Lincoln,12/20/20,21,79,79,2733,14282,2588,17061,123,13695,2557,176,12770,1512,2446,142,18,3,92,31,15327,1734,2557,12770,222,1512,2779,14282,10,12,0,115
LittleRiver,12/20/20,37,81,81,727,4435,658,5181,32,12417,595,132,3994,441,537,121,35,2,23,9,4589,592,595,3994,151,441,746,4435,5,0,0,30
Logan,12/20/20,11,83,83,1268,16772,1099,18073,158,21757,1103,165,14743,2029,987,112,10,1,106,52,15846,2227,1103,14743,198,2029,1301,16772,9,10,1,97
Lonoke,12/20/20,74,85,85,3619,41872,3084,45695,461,72206,2729,890,35749,6123,2354,730,65,9,310,151,38478,7217,2729,35749,1094,6123,3823,41872,35,25,3,212
Madison,12/20/20,11,87,87,908,8511,782,9452,115,16076,747,161,7975,536,662,120,10,1,75,40,8722,730,747,7975,194,536,941,8511,3,9,0,40
Marion,12/20/20,13,89,89,559,6274,496,6857,50,16438,439,120,5695,579,401,95,11,2,27,23,6134,723,439,5695,144,579,583,6274,4,3,1,56
Miller,12/20/20,24,91,91,2464,13188,2325,15730,115,43759,1777,687,11939,1249,1685,640,17,7,75,40,13716,2014,1777,11939,765,1249,2542,13188,7,13,0,179
MissingCountyInfo,12/20/20,0,5,5,2852,104382,2286,107244,566,NA,2284,568,104320,62,1893,393,0,0,391,175,106604,640,2284,104320,578,62,2862,104382,27,14,0,2420
Mississippi,12/20/20,90,93,93,4045,24466,3588,28581,366,42831,3675,370,18909,5557,3282,306,76,14,316,50,22584,5997,3675,18909,440,5557,4115,24466,22,31,0,217
Monroe,12/20/20,5,95,95,405,4759,346,5174,54,7249,346,59,4577,182,308,38,5,0,33,21,4923,251,346,4577,69,182,415,4759,2,5,0,44
Montgomery,12/20/20,16,97,97,436,4795,358,5241,62,8993,366,70,3257,1538,314,44,14,2,38,24,3623,1618,366,3257,80,1538,446,4795,2,4,0,14
Nevada,12/20/20,19,99,99,549,8049,483,8607,47,8440,476,73,7777,272,424,59,18,1,34,13,8253,354,476,7777,82,272,558,8049,3,3,0,12
Newton,12/20/20,24,101,101,520,4300,471,4833,25,7848,458,62,2886,1414,416,55,20,4,22,3,3344,1489,458,2886,75,1414,533,4300,3,6,0,7
Ouachita,12/20/20,22,103,103,1190,11570,985,12812,182,24106,1058,132,11004,566,891,94,19,3,147,35,12062,750,1058,11004,184,566,1242,11570,14,4,0,95
Perry,12/20/20,5,105,105,361,7642,297,8019,59,10322,306,55,7200,442,260,37,4,1,42,17,7506,513,306,7200,71,442,377,7642,5,4,0,23
Phillips,12/20/20,19,107,107,1177,12232,1014,13440,144,19034,1096,81,11901,331,967,47,19,0,110,34,12997,443,1096,11901,112,331,1208,12232,14,4,0,44
Pike,12/20/20,7,109,109,557,4846,471,5419,79,10808,471,86,4442,404,419,52,5,2,47,32,4913,506,471,4442,102,404,573,4846,3,7,0,27
Poinsett,12/20/20,52,111,111,2142,17566,1819,19770,271,24054,1934,208,16757,809,1646,173,46,6,242,29,18691,1079,1934,16757,270,809,2204,17566,17,21,0,128
Polk,12/20/20,29,113,113,1113,8847,974,9988,109,20163,1005,108,8411,436,880,94,28,1,96,13,9416,572,1005,8411,136,436,1141,8847,6,12,6,34
Pope,12/20/20,50,115,115,4792,45543,4148,50395,594,63644,4055,737,43719,1824,3559,589,44,6,452,142,47774,2621,4055,43719,797,1824,4852,45543,31,37,0,283
Prairie,12/20/20,12,117,117,453,4461,390,4941,51,8244,362,91,3972,489,318,72,10,2,34,17,4334,607,362,3972,118,489,480,4461,4,4,0,27
Pulaski,12/20/20,344,119,119,21670,254410,18604,276664,2720,393463,19563,2107,238772,15638,16941,1663,323,21,2297,423,258335,18329,19563,238772,2691,15638,22254,254410,184,183,4,1909
Randolph,12/20/20,38,121,121,1294,11596,1114,12948,142,17603,1047,247,10266,1330,900,214,28,10,119,23,11313,1635,1047,10266,305,1330,1352,11596,4,19,0,143
Saline,12/20/20,85,125,125,6717,66429,5804,73478,827,118009,5362,1355,56945,9484,4693,1111,75,10,593,234,62307,11171,5362,56945,1687,9484,7049,66429,32,62,0,505
Scott,12/20/20,6,127,127,495,6861,444,7371,45,10442,400,95,6633,228,357,87,6,0,37,8,7033,338,400,6633,110,228,510,6861,0,3,0,5
Searcy,12/20/20,8,129,129,444,4476,364,4945,72,7923,297,147,3706,770,266,98,4,4,27,45,4003,942,297,3706,172,770,469,4476,5,6,0,9
Sebastian,12/20/20,140,131,131,8610,92204,7692,100926,775,127461,7505,1105,89681,2523,6847,845,134,6,522,253,97186,3740,7505,89681,1217,2523,8722,92204,52,55,0,617
Sevier,12/20/20,20,133,133,1954,10681,1841,12705,93,17193,1512,442,9087,1594,1445,396,19,1,48,45,10599,2106,1512,9087,512,1594,2024,10681,3,6,0,26
Sharp,12/20/20,30,135,135,978,10041,799,11085,149,17043,735,243,8791,1250,615,184,24,6,96,53,9526,1559,735,8791,309,1250,1044,10041,7,7,1,46
St.Francis,12/20/20,19,123,123,2541,20767,2226,23336,296,26294,2435,106,20441,326,2143,83,19,0,273,23,22876,460,2435,20441,134,326,2569,20767,6,9,0,106
Stone,12/20/20,26,137,137,665,6490,543,7178,96,12446,551,114,5878,612,475,68,24,2,52,44,6429,749,551,5878,137,612,688,6490,3,4,0,70
Union,12/20/20,68,139,139,2041,16844,1762,18978,211,39732,1599,442,14420,2424,1416,346,56,12,127,84,16019,2959,1599,14420,535,2424,2134,16844,13,17,1,144
VanBuren,12/20/20,6,141,141,662,9215,501,9934,155,16684,501,161,8057,1158,399,102,5,1,97,58,8558,1376,501,8057,218,1158,719,9215,8,16,0,39
Washington,12/20/20,209,143,143,19443,151029,17286,171195,1947,228529,15978,3465,133741,17288,14372,2914,179,30,1427,520,149719,21476,15978,133741,4188,17288,20166,151029,151,164,3,1039
White,12/20/20,65,145,145,4019,32169,3398,36415,555,78804,2916,1103,27311,4858,2553,845,57,8,305,250,30227,6188,2916,27311,1330,4858,4246,32169,27,37,0,120
Woodruff,12/20/20,1,147,147,297,4014,238,4339,58,6660,243,54,3798,216,201,37,1,0,41,17,4041,298,243,3798,82,216,325,4014,1,4,0,20
Yell,12/20/20,38,149,149,2141,20274,1825,22457,278,21573,1971,170,19606,668,1713,112,35,3,223,55,21577,880,1971,19606,212,668,2183,20274,7,20,0,199
Arkansas_all_counties,12/19/20,3191,5630,5630,200114,1922698,173832,2129245,23066,2990671,169287,30827,1757984,164714,149433,24399,2821,370,17011,6055,1927271,201974,169287,1757984,37260,164714,206547,1922698,2693,1968,52,17020
Arkansas_county,12/19/20,26,1,1,1179,13688,1026,14943,127,18124,904,275,10612,3076,804,222,24,2,76,51,11516,3427,904,10612,351,3076,1255,13688,21,8,0,120
Ashley,12/19/20,18,3,3,1150,10039,985,11222,147,20537,995,155,9449,590,859,126,17,1,119,28,10444,778,995,9449,188,590,1183,10039,19,16,0,190
Baxter,12/19/20,44,5,5,1816,12940,1557,14800,215,41219,1360,456,11471,1469,1181,376,40,4,139,76,12831,1969,1360,11471,500,1469,1860,12940,22,15,1,100
Benton,12/19/20,224,7,7,15525,124613,13666,140668,1634,258980,12525,3000,117920,6693,11266,2400,184,40,1074,560,130445,10223,12525,117920,3530,6693,16055,124613,278,165,2,1179
Boone,12/19/20,58,9,9,2312,21261,2019,23703,233,37288,1939,373,20154,1107,1709,310,54,4,174,59,22093,1610,1939,20154,503,1107,2442,21261,14,18,4,111
Bradley,12/19/20,9,11,11,799,6957,627,7778,163,10948,642,157,4851,2106,533,94,8,1,101,62,5493,2285,642,4851,179,2106,821,6957,27,6,0,85
Calhoun,12/19/20,1,13,13,194,2591,172,2796,21,5202,168,26,2472,119,150,22,1,0,17,4,2640,156,168,2472,37,119,205,2591,3,4,0,19
Carroll,12/19/20,25,15,15,1905,13073,1650,15018,230,27887,1692,213,12807,266,1486,164,25,0,181,49,14499,519,1692,12807,253,266,1945,13073,34,22,1,171
Chicot,12/19/20,29,17,17,1346,8913,1253,10279,64,10826,1261,85,7979,934,1184,69,28,1,49,15,9240,1039,1261,7979,105,934,1366,8913,2,7,0,71
Clark,12/19/20,18,19,19,1193,15945,962,17195,213,22385,1007,186,13617,2328,823,139,15,3,169,44,14624,2571,1007,13617,243,2328,1250,15945,14,15,2,198
Clay,12/19/20,26,21,21,1197,11137,1035,12370,135,15061,952,245,8620,2517,841,194,20,6,90,45,9572,2798,952,8620,281,2517,1233,11137,8,8,0,265
Cleburne,12/19/20,31,23,23,1017,13796,807,14845,179,25230,771,246,11669,2127,649,158,29,2,93,86,12440,2405,771,11669,278,2127,1049,13796,19,10,3,95
Cleveland,12/19/20,16,25,25,508,6048,430,6580,62,8226,366,142,5513,535,311,119,14,2,41,21,5879,701,366,5513,166,535,532,6048,6,6,0,23
Columbia,12/19/20,38,27,27,1404,12444,1249,13978,117,23892,995,409,10025,2419,904,345,28,10,63,54,11020,2958,995,10025,539,2419,1534,12444,11,12,0,186
Conway,12/19/20,10,29,29,1064,13650,819,14753,235,20906,863,201,11966,1684,701,118,10,0,152,83,12829,1924,863,11966,240,1684,1103,13650,31,18,0,162
Craighead,12/19/20,120,31,31,9052,74626,7885,83897,1046,105701,8134,918,66702,7924,7106,779,110,10,917,129,74836,9061,8134,66702,1137,7924,9271,74626,112,86,3,660
Crawford,12/19/20,53,33,33,3973,42821,3435,46844,484,62472,3492,481,41484,1337,3064,371,48,5,379,105,44976,1868,3492,41484,531,1337,4023,42821,52,35,3,324
Crittenden,12/19/20,66,35,35,3950,25742,3544,29769,339,49013,3735,215,24361,1381,3375,169,58,8,301,38,28096,1673,3735,24361,292,1381,4027,25742,41,34,1,190
Cross,12/19/20,32,37,37,1207,10413,1007,11645,168,16998,981,226,9862,551,829,178,31,1,121,47,10843,802,981,9862,251,551,1232,10413,35,19,0,180
Dallas,12/19/20,9,39,39,423,4382,353,4810,61,7432,391,32,4189,193,324,29,8,1,59,2,4580,230,391,4189,37,193,428,4382,11,4,1,108
Desha,12/19/20,11,41,41,829,7542,671,8410,147,11887,714,115,6796,746,583,88,10,1,121,26,7510,900,714,6796,154,746,868,7542,7,10,1,69
Drew,12/19/20,10,43,43,1282,12204,1049,13521,223,18502,1021,261,10574,1630,834,215,9,1,178,45,11595,1926,1021,10574,296,1630,1317,12204,34,20,1,148
Faulkner,12/19/20,73,45,45,6517,75736,5506,82516,937,122416,5493,1024,67832,7904,4751,755,61,12,680,257,73325,9191,5493,67832,1287,7904,6780,75736,95,81,2,889
Franklin,12/19/20,22,47,47,992,12616,888,13643,82,17780,835,157,12093,523,762,126,20,2,53,29,12928,715,835,12093,192,523,1027,12616,11,12,0,57
Fulton,12/19/20,21,49,49,751,4228,627,5015,103,12139,551,200,3424,804,484,143,12,9,55,48,3975,1040,551,3424,236,804,787,4228,11,-1,2,20
Garland,12/19/20,136,51,51,4996,56551,4268,61675,590,98296,4407,589,52864,3687,3846,422,121,15,438,152,57271,4404,4407,52864,717,3687,5124,56551,66,43,2,779
Grant,12/19/20,10,53,53,845,10362,707,11248,128,18086,667,178,9058,1304,573,134,9,1,85,43,9725,1523,667,9058,219,1304,886,10362,7,8,0,50
Greene,12/19/20,49,55,55,4014,30496,3469,34635,496,44623,3277,737,27183,3313,2833,636,40,9,404,92,30460,4175,3277,27183,862,3313,4139,30496,36,68,1,196
Hempstead,12/19/20,9,57,57,1099,10566,979,11704,111,22018,876,223,9976,590,796,183,7,2,73,38,10852,852,876,9976,262,590,1138,10566,8,6,0,192
HotSpring,12/19/20,52,59,59,3322,30391,3022,33766,248,33520,3144,178,26108,4283,2885,137,48,4,211,37,29252,4514,3144,26108,231,4283,3375,30391,27,14,1,273
Howard,12/19/20,17,61,61,1016,7004,888,8056,111,13389,750,266,5540,1464,682,206,16,1,52,59,6290,1766,750,5540,302,1464,1052,7004,11,5,0,103
Independence,12/19/20,82,63,63,2484,22972,2198,25560,204,37264,1817,667,19972,3000,1631,567,65,17,121,83,21789,3771,1817,19972,771,3000,2588,22972,25,14,1,142
Izard,12/19/20,8,65,65,1138,9664,1040,10833,90,13559,964,174,8180,1484,914,126,7,1,43,47,9144,1689,964,8180,205,1484,1169,9664,10,4,0,130
Jackson,12/19/20,16,67,67,2667,17358,2171,20229,480,17225,2190,477,14965,2393,1790,381,13,3,387,93,17155,3074,2190,14965,681,2393,2871,17358,111,116,1,195
Jefferson,12/19/20,123,69,69,6164,57175,5405,63573,634,70424,5411,753,53156,4019,4824,581,108,15,477,157,58567,5006,5411,53156,987,4019,6398,57175,141,44,1,629
Johnson,12/19/20,17,71,71,1610,15705,1407,17339,186,26291,1438,172,15011,694,1287,120,15,2,136,50,16449,890,1438,15011,196,694,1634,15705,26,16,0,167
Lafayette,12/19/20,4,73,73,310,2238,282,2571,23,6915,240,70,2057,181,224,58,4,0,12,11,2297,274,240,2057,93,181,333,2238,4,2,0,27
Lawrence,12/19/20,33,75,75,1391,9264,1257,10707,101,16669,1159,232,8643,621,1057,200,32,1,70,31,9802,905,1159,8643,284,621,1443,9264,5,7,0,55
Lee,12/19/20,21,77,77,1361,7627,1254,8999,86,9398,1322,39,7269,358,1224,30,20,1,78,8,8591,408,1322,7269,50,358,1372,7627,7,1,0,45
Lincoln,12/19/20,21,79,79,2723,14177,2576,16945,125,13695,2548,175,12666,1511,2436,140,18,3,93,32,15214,1731,2548,12666,220,1511,2768,14177,11,6,0,70
LittleRiver,12/19/20,37,81,81,722,4410,658,5150,27,12417,591,131,3970,440,537,121,35,2,19,8,4561,589,591,3970,149,440,740,4410,2,2,0,162
Logan,12/19/20,10,83,83,1259,16684,1089,17975,160,21757,1094,165,14657,2027,979,110,9,1,106,54,15751,2224,1094,14657,197,2027,1291,16684,21,10,0,183
Lonoke,12/19/20,71,85,85,3584,41695,3059,45484,454,72206,2700,884,35579,6116,2337,722,64,7,299,155,38279,7205,2700,35579,1089,6116,3789,41695,53,38,0,330
Madison,12/19/20,11,87,87,905,8474,773,9412,121,16076,744,161,7938,536,656,117,10,1,78,43,8682,730,744,7938,194,536,938,8474,11,8,1,82
Marion,12/19/20,12,89,89,555,6222,493,6801,50,16438,436,119,5643,579,400,93,11,1,25,25,6079,722,436,5643,143,579,579,6222,8,2,0,34
Miller,12/19/20,24,91,91,2457,13016,2312,15551,121,43759,1773,684,11806,1210,1677,635,17,7,79,42,13579,1972,1773,11806,762,1210,2535,13016,16,6,0,177
MissingCountyInfo,12/19/20,0,5,5,2825,101989,2272,104831,553,NA,2257,568,101928,61,1882,390,0,0,375,178,104185,646,2257,101928,585,61,2842,101989,11,23,0,-421
Mississippi,12/19/20,90,93,93,4023,24271,3557,28364,375,42831,3655,368,18836,5435,3254,303,76,14,324,51,22491,5873,3655,18836,438,5435,4093,24271,31,41,0,165
Monroe,12/19/20,5,95,95,403,4717,341,5130,57,7249,346,57,4536,181,305,36,5,0,36,21,4882,248,346,4536,67,181,413,4717,4,5,0,60
Montgomery,12/19/20,16,97,97,434,4783,354,5227,64,8993,364,70,3245,1538,309,45,14,2,41,23,3609,1618,364,3245,80,1538,444,4783,3,4,0,21
Nevada,12/19/20,19,99,99,546,8040,480,8595,47,8440,473,73,7768,272,421,59,18,1,34,13,8241,354,473,7768,82,272,555,8040,5,2,0,76
Newton,12/19/20,24,101,101,517,4296,465,4826,28,7848,456,61,2882,1414,412,53,20,4,24,4,3338,1488,456,2882,74,1414,530,4296,1,3,0,45
Ouachita,12/19/20,22,103,103,1176,11489,981,12716,172,24106,1044,132,10924,565,885,96,19,3,139,33,11968,748,1044,10924,183,565,1227,11489,17,25,0,111
Perry,12/19/20,5,105,105,356,7624,293,7995,58,10322,303,53,7178,446,258,35,4,1,41,17,7481,514,303,7178,68,446,371,7624,6,4,0,53
Phillips,12/19/20,19,107,107,1163,12202,1010,13396,134,19034,1082,81,11871,331,963,47,19,0,100,34,12953,443,1082,11871,112,331,1194,12202,37,5,1,89
Pike,12/19/20,7,109,109,554,4822,464,5392,83,10808,471,83,4420,402,412,52,5,2,54,29,4891,501,471,4420,99,402,570,4822,7,10,0,105
Poinsett,12/19/20,52,111,111,2125,17455,1798,19642,275,24054,1919,206,16649,806,1625,173,46,6,248,27,18568,1074,1919,16649,268,806,2187,17455,23,23,0,115
Polk,12/19/20,23,113,113,1107,8819,962,9955,121,20163,1000,107,8384,435,870,92,23,0,106,15,9384,571,1000,8384,136,435,1136,8819,9,15,1,138
Pope,12/19/20,50,115,115,4761,45291,4111,50112,600,63644,4029,732,43490,1801,3538,573,44,6,447,153,47519,2593,4029,43490,792,1801,4821,45291,104,29,0,518
Prairie,12/19/20,12,117,117,449,4438,386,4914,51,8244,359,90,3948,490,315,71,10,2,34,17,4307,607,359,3948,117,490,476,4438,7,1,0,32
Pulaski,12/19/20,340,119,119,21486,252685,18421,274748,2723,393463,19406,2080,237253,15432,16795,1626,320,20,2289,434,256659,18089,19406,237253,2657,15432,22063,252685,277,182,4,2062
Randolph,12/19/20,38,121,121,1290,11457,1095,12805,157,17603,1044,246,10129,1328,884,211,28,10,132,25,11173,1632,1044,10129,304,1328,1348,11457,12,19,1,126
Saline,12/19/20,85,125,125,6685,65956,5742,72972,857,118009,5338,1347,56699,9257,4655,1087,75,10,607,250,62037,10935,5338,56699,1678,9257,7016,65956,102,74,3,723
Scott,12/19/20,6,127,127,495,6856,441,7366,48,10442,399,96,6630,226,354,87,6,0,39,9,7029,337,399,6630,111,226,510,6856,4,20,0,25
Searcy,12/19/20,8,129,129,439,4472,358,4936,73,7923,292,147,3703,769,264,94,4,4,24,49,3995,941,292,3703,172,769,464,4472,2,2,1,10
Sebastian,12/19/20,140,131,131,8558,91639,7637,100310,778,127461,7467,1091,89128,2511,6801,836,134,6,530,248,96595,3715,7467,89128,1204,2511,8671,91639,83,86,1,655
Sevier,12/19/20,20,133,133,1951,10658,1835,12677,96,17193,1510,441,9072,1586,1443,392,19,1,48,48,10582,2095,1510,9072,509,1586,2019,10658,11,11,0,145
Sharp,12/19/20,29,135,135,971,10002,792,11039,150,17043,729,242,8753,1249,610,182,24,5,95,55,9482,1557,729,8753,308,1249,1037,10002,18,13,0,64
St.Francis,12/19/20,19,123,123,2535,20667,2217,23229,299,26294,2432,103,20342,325,2134,83,19,0,279,20,22774,455,2432,20342,130,325,2562,20667,22,20,0,106
Stone,12/19/20,26,137,137,662,6423,539,7103,97,12446,543,119,5820,603,473,66,24,2,46,51,6363,740,543,5820,137,603,680,6423,10,12,0,106
Union,12/19/20,67,139,139,2028,16713,1745,18834,216,39732,1588,440,14289,2424,1405,340,56,11,127,89,15877,2957,1588,14289,533,2424,2121,16713,34,17,2,161
VanBuren,12/19/20,6,141,141,654,9184,485,9895,163,16684,493,161,8043,1141,386,99,5,1,102,61,8536,1359,493,8043,218,1141,711,9184,20,18,0,76
Washington,12/19/20,206,143,143,19292,150141,17122,170155,1963,228529,15844,3448,132957,17184,14250,2872,178,28,1416,547,148801,21354,15844,132957,4170,17184,20014,150141,204,180,3,1397
White,12/19/20,65,145,145,3992,32076,3361,36292,565,78804,2901,1091,27218,4858,2536,825,57,8,307,258,30119,6173,2901,27218,1315,4858,4216,32076,60,49,0,234
Woodruff,12/19/20,1,147,147,296,3995,234,4320,61,6660,243,53,3780,215,199,35,1,0,43,18,4023,297,243,3780,82,215,325,3995,5,3,0,237
Yell,12/19/20,38,149,149,2134,20082,1805,22258,291,21573,1965,169,19426,656,1694,111,35,3,236,55,21391,867,1965,19426,211,656,2176,20082,40,22,0,145
Arkansas_all_counties,12/18/20,3139,5630,5630,197421,1908371,171864,2112160,22392,2990671,167434,29987,1746014,162357,147953,23911,2776,363,16682,5710,1913448,198712,167434,1746014,36355,162357,203789,1908371,2878,2119,27,18021
Arkansas_county,12/18/20,26,1,1,1158,13589,1018,14822,114,18124,893,265,10546,3043,796,222,24,2,73,41,11439,3383,893,10546,340,3043,1233,13589,15,7,0,108
Ashley,12/18/20,18,3,3,1131,9868,969,11032,144,20537,983,148,9300,568,847,122,17,1,119,25,10283,749,983,9300,181,568,1164,9868,11,11,0,111
Baxter,12/18/20,43,5,5,1794,12862,1542,14700,209,41219,1343,451,11401,1461,1174,368,39,4,130,79,12744,1956,1343,11401,495,1461,1838,12862,32,26,1,295
Benton,12/18/20,222,7,7,15247,123712,13501,139489,1523,258980,12350,2897,117125,6587,11164,2337,182,40,1003,520,129475,10014,12350,117125,3427,6587,15777,123712,237,153,3,1207
Boone,12/18/20,54,9,9,2298,21164,2001,23593,241,37288,1932,366,20078,1086,1696,305,50,4,184,57,22010,1583,1932,20078,497,1086,2429,21164,25,26,0,161
Bradley,12/18/20,9,11,11,772,6899,621,7693,142,10948,626,146,4802,2097,530,91,8,1,88,54,5428,2265,626,4802,168,2097,794,6899,16,12,0,65
Calhoun,12/18/20,1,13,13,191,2575,168,2776,22,5202,165,26,2457,118,147,21,1,0,17,5,2622,154,165,2457,36,118,201,2575,4,1,0,39
Carroll,12/18/20,24,15,15,1871,12936,1628,14847,219,27887,1665,206,12684,252,1472,156,24,0,169,50,14349,498,1665,12684,246,252,1911,12936,17,15,0,77
Chicot,12/18/20,29,17,17,1344,8844,1246,10208,69,10826,1260,84,7914,930,1178,68,28,1,54,15,9174,1034,1260,7914,104,930,1364,8844,10,13,0,132
Clark,12/18/20,16,19,19,1179,15761,947,16997,216,22385,994,185,13446,2315,810,137,13,3,171,45,14440,2557,994,13446,242,2315,1236,15761,29,16,0,124
Clay,12/18/20,26,21,21,1189,10880,1027,12105,135,15061,945,244,8490,2390,834,193,20,6,90,45,9435,2670,945,8490,280,2390,1225,10880,11,14,0,41
Cleburne,12/18/20,28,23,23,998,13720,797,14750,173,25230,764,234,11608,2112,643,154,26,2,95,78,12372,2378,764,11608,266,2112,1030,13720,19,5,0,127
Cleveland,12/18/20,16,25,25,502,6031,424,6556,62,8226,362,140,5497,534,306,118,14,2,42,20,5859,697,362,5497,163,534,525,6031,6,5,0,209
Columbia,12/18/20,38,27,27,1393,12269,1237,13789,118,23892,991,402,9860,2409,901,336,28,10,62,56,10851,2938,991,9860,529,2409,1520,12269,16,14,1,381
Conway,12/18/20,10,29,29,1033,13519,801,14590,222,20906,843,190,11851,1668,689,112,10,0,144,78,12694,1896,843,11851,228,1668,1071,13519,39,19,0,205
Craighead,12/18/20,117,31,31,8940,74078,7799,83235,1023,105701,8048,892,66187,7891,7033,766,107,10,907,116,74235,9000,8048,66187,1109,7891,9157,74078,117,108,3,549
Crawford,12/18/20,50,33,33,3921,42549,3400,46519,470,62472,3457,464,41246,1303,3033,367,45,5,378,92,44703,1816,3457,41246,513,1303,3970,42549,63,47,0,1405
Crittenden,12/18/20,65,35,35,3909,25593,3510,29579,333,49013,3698,211,24227,1366,3346,164,57,8,294,39,27925,1654,3698,24227,288,1366,3986,25593,34,29,0,205
Cross,12/18/20,32,37,37,1172,10268,988,11466,152,16998,965,207,9727,541,820,168,31,1,114,38,10692,774,965,9727,233,541,1198,10268,23,18,0,159
Dallas,12/18/20,8,39,39,412,4285,349,4702,55,7432,381,31,4093,192,321,28,7,1,53,2,4474,228,381,4093,36,192,417,4285,7,7,0,126
Desha,12/18/20,10,41,41,822,7480,661,8341,151,11887,708,114,6751,729,576,85,9,1,123,28,7459,882,708,6751,153,729,861,7480,18,11,0,82
Drew,12/18/20,9,43,43,1248,12090,1029,13371,210,18502,995,253,10464,1626,815,214,8,1,172,38,11459,1912,995,10464,286,1626,1281,12090,5,25,0,311
Faulkner,12/18/20,71,45,45,6422,74942,5425,81619,925,122416,5428,994,67207,7735,4685,740,60,11,682,243,72635,8984,5428,67207,1249,7735,6677,74942,103,78,0,888
Franklin,12/18/20,22,47,47,981,12570,876,13586,83,17780,829,152,12047,523,755,121,20,2,54,29,12876,710,829,12047,187,523,1016,12570,14,10,0,162
Fulton,12/18/20,19,49,49,740,4219,628,4993,93,12139,544,196,3420,799,484,144,11,8,49,44,3964,1029,544,3420,230,799,774,4219,25,16,1,67
Garland,12/18/20,134,51,51,4930,55838,4225,60894,569,98296,4355,575,52524,3314,3813,412,119,15,421,148,56879,4015,4355,52524,701,3314,5056,55838,97,50,2,529
Grant,12/18/20,10,53,53,838,10319,699,11198,129,18086,662,176,9027,1292,568,131,9,1,85,44,9689,1509,662,9027,217,1292,879,10319,18,12,0,92
Greene,12/18/20,48,55,55,3978,30336,3401,34440,529,44623,3254,724,27081,3255,2778,623,40,8,436,93,30335,4105,3254,27081,850,3255,4104,30336,35,69,0,187
Hempstead,12/18/20,9,57,57,1091,10382,973,11512,109,22018,871,220,9801,581,794,179,7,2,70,39,10672,840,871,9801,259,581,1130,10382,21,12,0,106
HotSpring,12/18/20,51,59,59,3295,30145,3008,33491,236,33520,3119,176,25897,4248,2871,137,48,3,200,36,29016,4475,3119,25897,227,4248,3346,30145,18,7,1,294
Howard,12/18/20,17,61,61,1005,6912,883,7953,105,13389,746,259,5492,1420,680,203,16,1,50,55,6238,1715,746,5492,295,1420,1041,6912,28,10,1,60
Independence,12/18/20,81,63,63,2459,22855,2184,25418,194,37264,1806,653,19876,2979,1625,559,64,17,117,77,21682,3736,1806,19876,757,2979,2563,22855,21,13,1,164
Izard,12/18/20,8,65,65,1128,9544,1036,10703,84,13559,963,165,8151,1393,913,123,7,1,43,41,9114,1589,963,8151,196,1393,1159,9544,11,2,0,61
Jackson,12/18/20,15,67,67,2556,17274,2055,20032,486,17225,2090,466,14888,2386,1676,379,12,3,402,84,16978,3054,2090,14888,668,2386,2758,17274,27,44,0,68
Jefferson,12/18/20,122,69,69,6023,56687,5361,62942,538,70424,5294,729,52727,3960,4785,576,107,15,400,138,58021,4921,5294,52727,961,3960,6255,56687,74,39,0,479
Johnson,12/18/20,17,71,71,1584,15564,1391,17170,176,26291,1420,164,14878,686,1275,116,15,2,130,46,16298,872,1420,14878,186,686,1606,15564,29,19,1,56
Lafayette,12/18/20,4,73,73,306,2215,280,2544,21,6915,240,66,2034,181,223,57,4,0,13,8,2274,270,240,2034,89,181,329,2215,5,2,0,31
Lawrence,12/18/20,33,75,75,1386,9214,1250,10650,103,16669,1158,228,8603,611,1052,198,32,1,74,29,9761,889,1158,8603,278,611,1436,9214,16,12,0,130
Lee,12/18/20,21,77,77,1354,7589,1253,8954,80,9398,1317,37,7233,356,1223,30,20,1,74,6,8550,404,1317,7233,48,356,1365,7589,-3,25,1,36
Lincoln,12/18/20,21,79,79,2712,14118,2570,16875,120,13695,2539,173,12614,1504,2431,139,18,3,89,31,15153,1722,2539,12614,218,1504,2757,14118,8,9,1,96
LittleRiver,12/18/20,37,81,81,720,4250,656,4987,27,12417,588,132,3856,394,537,119,35,2,16,11,4444,543,588,3856,149,394,737,4250,4,4,0,37
Logan,12/18/20,10,83,83,1238,16522,1079,17792,149,21757,1080,158,14503,2019,973,106,9,1,98,51,15583,2209,1080,14503,190,2019,1270,16522,14,16,0,702
Lonoke,12/18/20,71,85,85,3531,41418,3021,45152,439,72206,2671,860,35332,6086,2307,714,64,7,300,139,38003,7149,2671,35332,1063,6086,3734,41418,59,41,2,384
Madison,12/18/20,10,87,87,894,8403,765,9329,119,16076,739,155,7872,531,651,114,9,1,79,40,8611,718,739,7872,187,531,926,8403,25,15,0,250
Marion,12/18/20,12,89,89,547,6196,491,6766,44,16438,431,116,5618,578,399,92,11,1,21,23,6049,717,431,5618,139,578,570,6196,9,13,0,62
Miller,12/18/20,24,91,91,2441,12855,2306,15374,111,43759,1769,672,11720,1135,1672,634,17,7,80,31,13489,1885,1769,11720,750,1135,2519,12855,18,26,0,84
MissingCountyInfo,12/18/20,0,5,5,2814,102421,2249,105254,565,NA,2254,560,102360,61,1853,396,0,0,401,164,104614,640,2254,102360,579,61,2833,102421,28,35,0,-5034
Mississippi,12/18/20,90,93,93,3992,24137,3516,28197,385,42831,3628,364,18717,5420,3216,300,76,14,335,50,22345,5852,3628,18717,432,5420,4060,24137,29,48,0,231
Monroe,12/18/20,5,95,95,399,4661,336,5069,58,7249,341,58,4485,176,302,34,5,0,34,24,4826,243,341,4485,67,176,408,4661,6,8,0,11
Montgomery,12/18/20,16,97,97,431,4765,350,5206,65,8993,363,68,3232,1533,307,43,14,2,42,23,3595,1611,363,3232,78,1533,441,4765,6,2,2,30
Nevada,12/18/20,19,99,99,541,7969,478,8519,44,8440,468,73,7699,270,419,59,18,1,31,13,8167,352,468,7699,82,270,550,7969,7,3,0,30
Newton,12/18/20,24,101,101,516,4252,462,4781,30,7848,455,61,2877,1375,409,53,20,4,26,4,3332,1449,455,2877,74,1375,529,4252,6,3,0,26
Ouachita,12/18/20,22,103,103,1159,11395,956,12605,180,24106,1035,124,10839,556,863,93,19,3,152,28,11874,731,1035,10839,175,556,1210,11395,31,21,0,207
Perry,12/18/20,5,105,105,350,7577,289,7942,56,10322,296,54,7139,438,256,33,4,1,36,20,7435,507,296,7139,69,438,365,7577,13,8,0,75
Phillips,12/18/20,18,107,107,1126,12150,1005,13307,103,19034,1062,64,11822,328,958,47,18,0,86,17,12884,423,1062,11822,95,328,1157,12150,13,4,0,45
Pike,12/18/20,7,109,109,547,4724,454,5287,86,10808,469,78,4325,399,405,49,5,2,59,27,4794,493,469,4325,94,399,563,4724,14,13,0,38
Poinsett,12/18/20,52,111,111,2102,17363,1775,19528,275,24054,1900,202,16564,799,1605,170,46,6,249,26,18464,1064,1900,16564,265,799,2165,17363,29,26,0,133
Polk,12/18/20,22,113,113,1098,8690,947,9817,128,20163,993,105,8263,427,855,92,22,0,115,13,9256,561,993,8263,134,427,1127,8690,13,12,0,69
Pope,12/18/20,50,115,115,4657,44877,4082,49588,525,63644,3936,721,43108,1769,3517,565,44,6,375,150,47044,2544,3936,43108,775,1769,4711,44877,110,52,0,1876
Prairie,12/18/20,12,117,117,442,4413,385,4881,45,8244,353,89,3930,483,314,71,10,2,29,16,4283,598,353,3930,115,483,468,4413,7,1,0,40
Pulaski,12/18/20,336,119,119,21209,250900,18239,272683,2632,393463,19181,2028,235608,15292,16651,1588,316,20,2212,420,254789,17894,19181,235608,2602,15292,21783,250900,375,212,2,2187
Randolph,12/18/20,37,121,121,1278,11343,1076,12679,165,17603,1035,243,10023,1320,869,207,27,10,139,26,11058,1621,1035,10023,301,1320,1336,11343,22,18,0,594
Saline,12/18/20,82,125,125,6583,65335,5668,72252,832,118009,5272,1311,56163,9172,4608,1060,73,9,590,242,61435,10817,5272,56163,1645,9172,6917,65335,98,78,0,651
Scott,12/18/20,6,127,127,491,6835,421,7341,64,10442,395,96,6609,226,336,85,6,0,53,11,7004,337,395,6609,111,226,506,6835,4,5,0,85
Searcy,12/18/20,7,129,129,437,4464,356,4927,74,7923,292,145,3699,765,262,94,4,3,26,48,3991,936,292,3699,171,765,463,4464,7,6,0,38
Sebastian,12/18/20,139,131,131,8475,91067,7551,99650,782,127461,7416,1059,88613,2454,6739,812,133,6,542,240,96029,3621,7416,88613,1167,2454,8583,91067,93,75,1,1243
Sevier,12/18/20,20,133,133,1940,10524,1824,12530,96,17193,1503,437,8963,1561,1437,387,19,1,47,49,10466,2064,1503,8963,503,1561,2006,10524,19,5,0,132
Sharp,12/18/20,29,135,135,953,9956,779,10974,145,17043,718,235,8719,1237,603,176,24,5,91,54,9437,1537,718,8719,300,1237,1018,9956,6,8,0,101
St.Francis,12/18/20,19,123,123,2513,20583,2197,23123,297,26294,2421,92,20281,302,2119,78,19,0,283,14,22702,421,2421,20281,119,302,2540,20583,29,44,1,118
Stone,12/18/20,26,137,137,652,6327,527,6997,99,12446,538,114,5750,577,465,62,24,2,49,50,6288,709,538,5750,132,577,670,6327,15,8,1,132
Union,12/18/20,65,139,139,1994,16586,1728,18672,201,39732,1568,426,14218,2368,1394,334,55,10,119,82,15786,2886,1568,14218,518,2368,2086,16586,45,21,0,507
VanBuren,12/18/20,6,141,141,634,9128,467,9819,161,16684,486,148,8001,1127,375,92,5,1,106,55,8487,1332,486,8001,205,1127,691,9128,35,9,0,187
Washington,12/18/20,203,143,143,19088,148948,16942,168748,1942,228529,15727,3361,131880,17068,14132,2810,175,28,1420,522,147607,21141,15727,131880,4073,17068,19800,148948,245,197,1,2312
White,12/18/20,65,145,145,3932,31902,3312,36058,553,78804,2871,1061,27077,4825,2504,808,57,8,308,245,29948,6110,2871,27077,1285,4825,4156,31902,97,39,0,395
Woodruff,12/18/20,1,147,147,291,3763,231,4080,59,6660,240,51,3558,205,196,35,1,0,43,16,3798,282,240,3558,77,205,317,3763,6,2,0,261
Yell,12/18/20,38,149,149,2094,19977,1783,22112,273,21573,1937,157,19337,640,1683,100,35,3,219,54,21274,838,1937,19337,198,640,2135,19977,40,30,0,157
Arkansas_all_counties,12/17/20,3112,5630,5630,194543,1893228,169745,2093973,21659,2990671,165512,29031,1734262,158966,146287,23458,2755,357,16446,5213,1899774,194199,165512,1734262,35233,158966,200745,1893228,3039,2114,38,19882
Arkansas_county,12/17/20,26,1,1,1143,13496,1011,14713,106,18124,883,260,10470,3026,790,221,24,2,69,37,11353,3360,883,10470,334,3026,1217,13496,11,15,0,171
Ashley,12/17/20,18,3,3,1120,9768,958,10921,144,20537,976,144,9228,540,837,121,17,1,122,22,10204,717,976,9228,177,540,1153,9768,31,16,0,182
Baxter,12/17/20,42,5,5,1762,12599,1516,14405,204,41219,1322,440,11196,1403,1158,358,38,4,126,78,12518,1887,1322,11196,484,1403,1806,12599,26,20,0,192
Benton,12/17/20,219,7,7,15010,122742,13348,138274,1441,258980,12178,2832,116256,6486,11059,2289,180,39,937,504,128434,9840,12178,116256,3354,6486,15532,122742,233,143,4,1500
Boone,12/17/20,54,9,9,2273,21028,1975,23433,242,37288,1920,353,20015,1013,1671,304,50,4,197,45,21935,1498,1920,20015,485,1013,2405,21028,49,23,1,288
Bradley,12/17/20,9,11,11,756,6850,609,7628,138,10948,618,138,4776,2074,520,89,8,1,90,48,5394,2234,618,4776,160,2074,778,6850,19,25,0,88
Calhoun,12/17/20,1,13,13,187,2540,167,2737,19,5202,163,24,2430,110,146,21,1,0,16,3,2593,144,163,2430,34,110,197,2540,6,5,0,38
Carroll,12/17/20,24,15,15,1854,12876,1613,14770,217,27887,1655,199,12640,236,1458,155,24,0,173,44,14295,475,1655,12640,239,236,1894,12876,41,24,0,238
Chicot,12/17/20,29,17,17,1334,8722,1233,10076,72,10826,1253,81,7834,888,1169,64,28,1,56,16,9087,989,1253,7834,101,888,1354,8722,7,12,0,72
Clark,12/17/20,16,19,19,1150,15666,931,16873,203,22385,978,172,13385,2281,800,131,13,3,165,38,14363,2510,978,13385,229,2281,1207,15666,23,13,0,218
Clay,12/17/20,26,21,21,1178,10850,1013,12064,138,15061,939,239,8466,2384,824,189,20,6,94,44,9405,2659,939,8466,275,2384,1214,10850,16,17,1,191
Cleburne,12/17/20,28,23,23,979,13612,792,14619,159,25230,757,222,11537,2075,640,152,26,2,91,68,12294,2325,757,11537,250,2075,1007,13612,26,9,1,163
Cleveland,12/17/20,16,25,25,496,5828,419,6343,61,8226,358,138,5428,400,303,116,14,2,41,20,5786,557,358,5428,157,400,515,5828,6,6,0,38
Columbia,12/17/20,37,27,27,1377,11904,1223,13408,117,23892,984,393,9518,2386,894,329,27,10,63,54,10502,2906,984,9518,520,2386,1504,11904,18,17,2,95
Conway,12/17/20,10,29,29,994,13353,782,14383,202,20906,818,176,11730,1623,675,107,10,0,133,69,12548,1835,818,11730,212,1623,1030,13353,25,11,0,158
Craighead,12/17/20,114,31,31,8823,73646,7691,82679,1017,105701,7951,872,65816,7830,6941,750,105,9,904,113,73767,8912,7951,65816,1082,7830,9033,73646,156,105,2,1124
Crawford,12/17/20,50,33,33,3858,41207,3353,45109,453,62472,3406,452,39924,1283,2997,356,45,5,362,91,43330,1779,3406,39924,496,1283,3902,41207,46,54,0,345
Crittenden,12/17/20,65,35,35,3875,25422,3481,29374,328,49013,3671,204,24064,1358,3317,164,57,8,296,32,27735,1639,3671,24064,281,1358,3952,25422,43,35,0,1034
Cross,12/17/20,32,37,37,1149,10132,970,11306,147,16998,955,194,9598,534,804,166,31,1,120,27,10553,753,955,9598,219,534,1174,10132,24,13,0,216
Dallas,12/17/20,8,39,39,405,4166,342,4575,55,7432,374,31,3978,188,315,27,7,1,52,3,4352,223,374,3978,35,188,409,4166,6,6,0,46
Desha,12/17/20,10,41,41,804,7416,650,8259,144,11887,693,111,6705,711,568,82,9,1,116,28,7398,861,693,6705,150,711,843,7416,20,22,0,90
Drew,12/17/20,9,43,43,1243,11784,1004,13060,230,18502,991,252,10181,1603,792,212,8,1,191,39,11172,1888,991,10181,285,1603,1276,11784,39,50,0,109
Faulkner,12/17/20,71,45,45,6319,74157,5347,80728,901,122416,5354,965,66692,7465,4630,717,60,11,664,237,72046,8682,5354,66692,1217,7465,6571,74157,109,67,1,624
Franklin,12/17/20,22,47,47,967,12422,866,13423,79,17780,821,146,11918,504,748,118,20,2,53,26,12739,684,821,11918,180,504,1001,12422,9,12,0,166
Fulton,12/17/20,18,49,49,715,4177,612,4923,85,12139,537,178,3399,778,477,135,11,7,49,36,3936,987,537,3399,209,778,746,4177,32,18,0,83
Garland,12/17/20,132,51,51,4833,55406,4175,60350,524,98296,4288,545,52226,3180,3773,402,118,14,395,129,56514,3836,4288,52226,656,3180,4944,55406,58,53,1,635
Grant,12/17/20,10,53,53,820,10245,687,11097,123,18086,648,172,8985,1260,558,129,9,1,81,42,9633,1464,648,8985,204,1260,852,10245,28,8,0,211
Greene,12/17/20,48,55,55,3943,30184,3332,34252,563,44623,3233,710,26976,3208,2722,610,40,8,471,92,30209,4043,3233,26976,835,3208,4068,30184,54,48,1,487
Hempstead,12/17/20,9,57,57,1070,10297,961,11405,100,22018,857,213,9728,569,786,175,7,2,64,36,10585,820,857,9728,251,569,1108,10297,21,16,0,100
HotSpring,12/17/20,50,59,59,3277,29869,3001,33196,226,33520,3105,172,25725,4144,2866,135,47,3,192,34,28830,4366,3105,25725,222,4144,3327,29869,39,13,2,1138
Howard,12/17/20,16,61,61,977,6880,873,7891,88,13389,735,242,5465,1415,675,198,16,0,44,44,6200,1691,735,5465,276,1415,1011,6880,12,8,0,143
Independence,12/17/20,80,63,63,2438,22712,2171,25253,187,37264,1798,640,19750,2962,1613,558,63,17,122,65,21548,3705,1798,19750,743,2962,2541,22712,43,21,1,306
Izard,12/17/20,8,65,65,1117,9494,1034,10637,75,13559,955,162,8122,1372,913,121,7,1,35,40,9077,1560,955,8122,188,1372,1143,9494,20,2,1,180
Jackson,12/17/20,15,67,67,2529,17233,2011,19945,503,17225,2065,464,14853,2380,1633,378,12,3,420,83,16918,3027,2065,14853,647,2380,2712,17233,52,35,1,465
Jefferson,12/17/20,122,69,69,5949,56282,5322,62459,503,70424,5234,715,52363,3919,4763,559,107,15,362,141,57597,4862,5234,52363,943,3919,6177,56282,129,37,1,811
Johnson,12/17/20,16,71,71,1555,15537,1372,17113,167,26291,1406,149,14881,656,1261,111,14,2,131,36,16287,826,1406,14881,170,656,1576,15537,34,16,1,397
Lafayette,12/17/20,4,73,73,301,2189,278,2512,18,6915,236,65,2012,177,222,56,4,0,10,8,2248,264,236,2012,87,177,323,2189,6,0,0,25
Lawrence,12/17/20,33,75,75,1370,9100,1238,10520,99,16669,1150,220,8494,606,1043,195,32,1,75,24,9644,876,1150,8494,270,606,1420,9100,14,12,0,94
Lee,12/17/20,20,77,77,1357,7550,1228,8918,109,9398,1317,40,7195,355,1195,33,19,1,103,6,8512,406,1317,7195,51,355,1368,7550,17,14,0,255
Lincoln,12/17/20,20,79,79,2704,14030,2561,16779,122,13695,2533,171,12542,1488,2423,138,18,2,91,31,15075,1704,2533,12542,216,1488,2749,14030,8,8,0,75
LittleRiver,12/17/20,37,81,81,716,4217,652,4950,27,12417,585,131,3826,391,534,118,35,2,16,11,4411,539,585,3826,148,391,733,4217,6,3,0,85
Logan,12/17/20,10,83,83,1224,15834,1063,17089,151,21757,1069,155,14052,1782,960,103,9,1,100,51,15121,1968,1069,14052,186,1782,1255,15834,10,17,1,154
Lonoke,12/17/20,69,85,85,3472,41093,2980,44759,423,72206,2636,836,35106,5987,2280,700,62,7,294,129,37742,7017,2636,35106,1030,5987,3666,41093,60,51,0,286
Madison,12/17/20,10,87,87,869,8178,750,9079,109,16076,724,145,7655,523,639,111,9,1,76,33,8379,700,724,7655,177,523,901,8178,17,25,1,124
Marion,12/17/20,12,89,89,538,6143,478,6704,48,16438,429,109,5585,558,391,87,11,1,27,21,6014,690,429,5585,132,558,561,6143,4,1,1,74
Miller,12/17/20,24,91,91,2423,12789,2280,15290,119,43759,1761,662,11695,1094,1658,622,17,7,86,33,13456,1834,1761,11695,740,1094,2501,12789,29,13,0,66
MissingCountyInfo,12/17/20,0,5,5,2786,107483,2214,110282,572,NA,2289,497,107424,59,1822,392,0,0,467,105,109713,569,2289,107424,510,59,2799,107483,-36,27,0,-4470
Mississippi,12/17/20,90,93,93,3963,23935,3468,27966,404,42831,3607,356,18662,5273,3179,289,76,14,351,53,22269,5697,3607,18662,424,5273,4031,23935,45,55,0,255
Monroe,12/17/20,5,95,95,393,4656,328,5058,60,7249,338,55,4483,173,294,34,5,0,39,21,4821,237,338,4483,64,173,402,4656,13,2,0,188
Montgomery,12/17/20,14,97,97,425,4741,348,5176,63,8993,358,67,3211,1530,307,41,12,2,39,24,3569,1607,358,3211,77,1530,435,4741,5,9,1,130
Nevada,12/17/20,19,99,99,534,7946,475,8489,40,8440,463,71,7676,270,416,59,18,1,29,11,8139,350,463,7676,80,270,543,7946,6,5,0,98
Newton,12/17/20,24,101,101,510,4232,459,4755,27,7848,451,59,2864,1368,406,53,20,4,25,2,3315,1440,451,2864,72,1368,523,4232,6,5,0,86
Ouachita,12/17/20,22,103,103,1128,11219,935,12398,170,24106,1017,111,10677,542,846,89,19,3,151,19,11694,704,1017,10677,162,542,1179,11219,25,28,1,86
Perry,12/17/20,5,105,105,337,7515,281,7867,51,10322,289,48,7086,429,248,33,4,1,37,14,7375,492,289,7086,63,429,352,7515,11,4,0,67
Phillips,12/17/20,18,107,107,1113,12118,1001,13261,94,19034,1052,61,11790,328,955,46,18,0,79,15,12842,419,1052,11790,91,328,1143,12118,24,11,0,96
Pike,12/17/20,7,109,109,533,4700,441,5248,85,10808,461,72,4306,394,395,46,5,2,61,24,4767,481,461,4306,87,394,548,4700,9,9,1,68
Poinsett,12/17/20,52,111,111,2073,17259,1749,19394,272,24054,1877,196,16468,791,1578,171,46,6,253,19,18345,1049,1877,16468,258,791,2135,17259,37,18,0,198
Polk,12/17/20,22,113,113,1085,8634,935,9746,127,20163,981,104,8209,425,845,90,22,0,113,14,9190,556,981,8209,131,425,1112,8634,16,14,1,119
Pope,12/17/20,50,115,115,4547,43111,4030,47710,467,63644,3843,704,41365,1746,3478,552,44,6,321,146,45208,2502,3843,41365,756,1746,4599,43111,62,55,0,756
Prairie,12/17/20,12,117,117,435,4380,384,4840,39,8244,348,87,3901,479,313,71,10,2,25,14,4249,591,348,3901,112,479,460,4380,2,1,0,192
Pulaski,12/17/20,334,119,119,20834,249088,18027,270484,2471,393463,18889,1945,234090,14998,16469,1558,314,20,2104,367,252979,17505,18889,234090,2507,14998,21396,249088,288,195,4,2280
Randolph,12/17/20,37,121,121,1256,10771,1058,12085,161,17603,1015,241,9457,1314,852,206,27,10,136,25,10472,1613,1015,9457,299,1314,1314,10771,20,13,0,91
Saline,12/17/20,82,125,125,6485,64782,5590,71599,812,118009,5222,1263,55847,8935,4552,1038,73,9,596,216,61069,10530,5222,55847,1595,8935,6817,64782,112,108,-1,957
Scott,12/17/20,6,127,127,487,6754,416,7256,65,10442,394,93,6540,214,331,85,6,0,57,8,6934,322,394,6540,108,214,502,6754,5,3,1,20
Searcy,12/17/20,7,129,129,430,4433,350,4887,73,7923,289,141,3684,749,260,90,4,3,25,48,3973,914,289,3684,165,749,454,4433,6,8,0,73
Sebastian,12/17/20,138,131,131,8382,89917,7476,98407,765,127461,7359,1023,87556,2361,6678,798,132,6,547,218,94915,3492,7359,87556,1131,2361,8490,89917,85,68,2,644
Sevier,12/17/20,20,133,133,1921,10411,1819,12391,82,17193,1489,432,8868,1543,1431,388,19,1,39,43,10357,2034,1489,8868,491,1543,1980,10411,11,10,0,70
Sharp,12/17/20,29,135,135,947,9861,771,10873,147,17043,714,233,8684,1177,598,173,24,5,92,55,9398,1475,714,8684,298,1177,1012,9861,30,14,1,234
St.Francis,12/17/20,18,123,123,2484,20494,2153,23003,313,26294,2397,87,20202,292,2077,76,18,0,302,11,22599,404,2397,20202,112,292,2509,20494,13,27,0,244
Stone,12/17/20,25,137,137,637,6210,519,6865,93,12446,534,103,5659,551,461,58,23,2,50,43,6193,672,534,5659,121,551,655,6210,10,13,0,108
Union,12/17/20,65,139,139,1949,16124,1707,18162,177,39732,1538,411,13830,2294,1381,326,55,10,102,75,15368,2794,1538,13830,500,2294,2038,16124,40,21,0,236
VanBuren,12/17/20,6,141,141,599,8976,458,9629,135,16684,471,128,7873,1103,368,90,5,1,98,37,8344,1285,471,7873,182,1103,653,8976,15,7,0,350
Washington,12/17/20,202,143,143,18843,146881,16745,166434,1895,228529,15559,3284,130045,16836,13988,2757,174,28,1397,498,145604,20830,15559,130045,3994,16836,19553,146881,346,180,1,2250
White,12/17/20,65,145,145,3835,31604,3273,35659,495,78804,2815,1020,26830,4774,2468,805,57,8,288,207,29645,6014,2815,26830,1240,4774,4055,31604,104,36,0,401
Woodruff,12/17/20,1,147,147,285,3508,229,3816,55,6660,235,50,3309,199,195,34,1,0,39,16,3544,272,235,3309,73,199,308,3508,6,5,0,65
Yell,12/17/20,38,149,149,2054,19860,1753,21952,263,21573,1899,155,19246,614,1655,98,35,3,209,54,21145,807,1899,19246,193,614,2092,19860,41,24,2,410
Arkansas_all_counties,12/16/20,3074,5630,5630,191504,1876385,167631,2073959,20774,2990671,163230,28274,1722858,153527,144621,23010,2725,349,15862,4912,1886088,187871,163230,1722858,34344,153527,197574,1876385,2306,2164,58,16059
Arkansas_county,12/16/20,26,1,1,1132,13336,996,14542,110,18124,874,258,10375,2961,777,219,24,2,73,37,11249,3293,874,10375,332,2961,1206,13336,20,6,0,102
Ashley,12/16/20,18,3,3,1089,9617,942,10739,129,20537,953,136,9091,526,826,116,17,1,110,19,10044,695,953,9091,169,526,1122,9617,8,11,0,107
Baxter,12/16/20,42,5,5,1736,12433,1496,14213,198,41219,1300,436,11037,1396,1142,354,38,4,120,78,12337,1876,1300,11037,480,1396,1780,12433,29,12,2,178
Benton,12/16/20,215,7,7,14777,121475,13205,136767,1356,258980,12015,2762,115158,6317,10961,2244,176,39,877,479,127173,9594,12015,115158,3277,6317,15292,121475,191,178,3,769
Boone,12/16/20,53,9,9,2224,20789,1952,23144,217,37288,1884,340,19860,929,1650,302,50,3,182,35,21744,1400,1884,19860,471,929,2355,20789,24,34,1,169
Bradley,12/16/20,9,11,11,737,6781,584,7539,144,10948,606,131,4729,2052,498,86,8,1,100,44,5335,2204,606,4729,152,2052,758,6781,31,16,1,70
Calhoun,12/16/20,1,13,13,181,2508,162,2698,18,5202,158,23,2398,110,141,21,1,0,16,2,2556,142,158,2398,32,110,190,2508,1,0,0,10
Carroll,12/16/20,24,15,15,1813,12679,1589,14530,200,27887,1622,191,12459,220,1442,147,24,0,156,44,14081,449,1622,12459,229,220,1851,12679,20,32,0,112
Chicot,12/16/20,29,17,17,1327,8657,1221,10001,77,10826,1244,83,7776,881,1158,63,28,1,58,19,9020,981,1244,7776,100,881,1344,8657,9,12,0,168
Clark,12/16/20,16,19,19,1127,15471,918,16654,193,22385,958,169,13266,2205,789,129,13,3,156,37,14224,2430,958,13266,225,2205,1183,15471,39,14,0,263
Clay,12/16/20,25,21,21,1162,10675,996,11872,140,15061,930,232,8380,2295,811,185,19,6,99,41,9310,2562,930,8380,267,2295,1197,10675,16,18,0,497
Cleburne,12/16/20,27,23,23,953,13475,783,14453,143,25230,741,212,11417,2058,633,150,25,2,83,60,12158,2295,741,11417,237,2058,978,13475,29,17,0,276
Cleveland,12/16/20,16,25,25,490,5796,413,6305,61,8226,355,135,5402,394,301,112,14,2,40,21,5757,548,355,5402,154,394,509,5796,12,14,0,55
Columbia,12/16/20,35,27,27,1359,11827,1206,13310,118,23892,972,387,9468,2359,881,325,26,9,65,53,10440,2870,972,9468,511,2359,1483,11827,11,17,0,115
Conway,12/16/20,10,29,29,969,13220,771,14226,188,20906,800,169,11624,1596,667,104,10,0,123,65,12424,1802,800,11624,206,1596,1006,13220,19,21,0,169
Craighead,12/16/20,112,31,31,8667,72678,7586,81554,968,105701,7816,851,64909,7769,6854,732,103,9,858,110,72725,8829,7816,64909,1060,7769,8876,72678,111,85,6,1035
Crawford,12/16/20,50,33,33,3812,40908,3299,44762,461,62472,3377,435,39644,1264,2957,342,45,5,373,88,43021,1741,3377,39644,477,1264,3854,40908,44,46,2,303
Crittenden,12/16/20,65,35,35,3832,24431,3446,28339,320,49013,3637,195,23390,1041,3286,160,57,8,293,27,27027,1312,3637,23390,271,1041,3908,24431,80,41,1,210
Cross,12/16/20,32,37,37,1125,9940,957,11088,136,16998,939,186,9411,529,790,167,31,1,118,18,10350,738,939,9411,209,529,1148,9940,10,10,1,148
Dallas,12/16/20,8,39,39,399,4126,336,4530,55,7432,369,30,3939,187,311,25,7,1,51,4,4308,222,369,3939,35,187,404,4126,8,8,0,37
Desha,12/16/20,10,41,41,784,7346,628,8168,146,11887,674,110,6650,696,549,79,9,1,116,30,7324,844,674,6650,148,696,822,7346,10,8,0,83
Drew,12/16/20,9,43,43,1204,11714,954,12950,241,18502,955,249,10134,1580,752,202,8,1,195,46,11089,1861,955,10134,281,1580,1236,11714,29,37,1,167
Faulkner,12/16/20,70,45,45,6210,73642,5280,80096,860,122416,5268,942,66260,7382,4581,699,59,11,628,232,71528,8568,5268,66260,1186,7382,6454,73642,109,89,2,905
Franklin,12/16/20,22,47,47,958,12265,854,13257,82,17780,813,145,11779,486,737,117,20,2,56,26,12592,665,813,11779,179,486,992,12265,11,18,1,63
Fulton,12/16/20,18,49,49,683,4126,594,4839,71,12139,513,170,3362,764,462,132,11,7,40,31,3875,964,513,3362,200,764,713,4126,25,18,0,48
Garland,12/16/20,131,51,51,4775,54829,4122,59711,520,98296,4249,526,51699,3130,3732,390,118,13,397,123,55948,3763,4249,51699,633,3130,4882,54829,93,66,0,538
Grant,12/16/20,10,53,53,792,10062,679,10884,103,18086,622,170,8814,1248,553,126,9,1,60,43,9436,1448,622,8814,200,1248,822,10062,21,7,0,151
Greene,12/16/20,47,55,55,3889,29751,3284,33762,558,44623,3180,709,26586,3165,2684,600,39,8,457,101,29766,3996,3180,26586,831,3165,4011,29751,46,47,2,144
Hempstead,12/16/20,9,57,57,1049,10218,945,11303,95,22018,844,205,9661,557,773,172,7,2,64,31,10505,798,844,9661,241,557,1085,10218,5,13,0,146
HotSpring,12/16/20,48,59,59,3238,28770,2988,32056,202,33520,3072,166,25421,3349,2856,132,45,3,171,31,28493,3563,3072,25421,214,3349,3286,28770,42,15,0,390
Howard,12/16/20,16,61,61,965,6749,865,7748,84,13389,732,233,5420,1329,672,193,16,0,44,40,6152,1596,732,5420,267,1329,999,6749,10,12,0,356
Independence,12/16/20,79,63,63,2395,22449,2150,24944,166,37264,1772,623,19516,2933,1597,553,63,16,112,54,21288,3656,1772,19516,723,2933,2495,22449,16,13,2,198
Izard,12/16/20,7,65,65,1097,9334,1032,10455,58,13559,946,151,7969,1365,911,121,7,0,28,30,8915,1540,946,7969,175,1365,1121,9334,4,3,0,104
Jackson,12/16/20,14,67,67,2477,16820,1976,19477,487,17225,2048,429,14741,2079,1604,372,11,3,433,54,16789,2688,2048,14741,609,2079,2657,16820,17,60,1,139
Jefferson,12/16/20,121,69,69,5820,55600,5285,61642,412,70424,5121,699,52105,3495,4735,550,107,14,277,135,57226,4416,5121,52105,921,3495,6042,55600,54,50,0,526
Johnson,12/16/20,15,71,71,1521,15174,1356,16715,150,26291,1377,144,14543,631,1251,105,13,2,113,37,15920,795,1377,14543,164,631,1541,15174,31,17,1,194
Lafayette,12/16/20,4,73,73,295,2170,278,2486,12,6915,234,61,1997,173,222,56,4,0,8,4,2231,255,234,1997,82,173,316,2170,1,1,0,20
Lawrence,12/16/20,33,75,75,1356,9020,1226,10425,97,16669,1140,216,8426,594,1038,188,32,1,70,27,9566,859,1140,8426,265,594,1405,9020,6,14,0,47
Lee,12/16/20,20,77,77,1340,7312,1214,8663,106,9398,1307,33,7151,161,1189,25,19,1,99,7,8458,205,1307,7151,44,161,1351,7312,5,5,0,49
Lincoln,12/16/20,20,79,79,2696,13963,2553,16704,123,13695,2527,169,12497,1466,2415,138,18,2,94,29,15024,1680,2527,12497,214,1466,2741,13963,16,20,0,152
LittleRiver,12/16/20,37,81,81,710,4138,649,4864,24,12417,583,127,3807,331,532,117,35,2,16,8,4390,474,583,3807,143,331,726,4138,9,8,0,628
Logan,12/16/20,9,83,83,1214,15690,1046,16935,159,21757,1063,151,13928,1762,947,99,9,0,107,52,14991,1944,1063,13928,182,1762,1245,15690,21,17,1,200
Lonoke,12/16/20,69,85,85,3412,40867,2929,44467,414,72206,2592,820,34946,5921,2242,687,62,7,288,126,37538,6929,2592,34946,1008,5921,3600,40867,57,36,3,290
Madison,12/16/20,9,87,87,852,8071,725,8953,118,16076,713,139,7558,513,613,112,9,0,91,27,8271,682,713,7558,169,513,882,8071,11,13,0,60
Marion,12/16/20,11,89,89,534,6073,477,6630,46,16438,427,107,5524,549,390,87,10,1,27,19,5951,679,427,5524,130,549,557,6073,7,5,2,53
Miller,12/16/20,24,91,91,2394,12752,2267,15224,103,43759,1749,645,11660,1092,1653,614,17,7,79,24,13409,1815,1749,11660,723,1092,2472,12752,35,29,0,554
MissingCountyInfo,12/16/20,0,5,5,2822,111917,2187,114753,635,NA,2303,519,111859,58,1778,409,0,0,525,110,114162,591,2303,111859,533,58,2836,111917,-259,-30,0,-3977
Mississippi,12/16/20,90,93,93,3918,23725,3413,27708,414,42831,3567,351,18538,5187,3129,284,76,14,361,53,22105,5603,3567,18538,416,5187,3983,23725,54,40,1,456
Monroe,12/16/20,5,95,95,380,4481,326,4870,49,7249,332,48,4309,172,293,33,5,0,34,15,4641,229,332,4309,57,172,389,4481,5,4,0,173
Montgomery,12/16/20,13,97,97,420,4616,339,5046,68,8993,353,67,3198,1418,301,38,11,2,41,27,3551,1495,353,3198,77,1418,430,4616,9,9,0,108
Nevada,12/16/20,19,99,99,528,7854,470,8390,39,8440,459,69,7589,265,410,60,18,1,31,8,8048,342,459,7589,77,265,536,7854,6,9,0,99
Newton,12/16/20,24,101,101,504,4152,454,4669,26,7848,446,58,2838,1314,403,51,20,4,23,3,3284,1385,446,2838,71,1314,517,4152,1,4,0,16
Ouachita,12/16/20,21,103,103,1103,11158,907,12310,174,24106,995,108,10619,539,818,89,18,3,158,16,11614,696,995,10619,157,539,1152,11158,22,13,4,104
Perry,12/16/20,5,105,105,326,7459,277,7800,44,10322,282,44,7036,423,244,33,4,1,34,10,7318,482,282,7036,59,423,341,7459,6,5,1,163
Phillips,12/16/20,18,107,107,1089,12046,990,13165,81,19034,1033,56,11732,314,944,46,18,0,71,10,12765,400,1033,11732,86,314,1119,12046,4,6,1,128
Pike,12/16/20,6,109,109,524,4641,432,5180,86,10808,459,65,4274,367,388,44,4,2,67,19,4733,447,459,4274,80,367,539,4641,21,10,0,477
Poinsett,12/16/20,52,111,111,2036,17098,1731,19195,253,24054,1847,189,16323,775,1567,164,46,6,234,19,18170,1025,1847,16323,250,775,2097,17098,21,15,1,272
Polk,12/16/20,21,113,113,1069,8531,921,9627,126,20163,971,98,8111,420,838,83,21,0,111,15,9082,545,971,8111,125,420,1096,8531,23,12,1,69
Pope,12/16/20,50,115,115,4485,42417,3975,46950,460,63644,3807,678,40708,1709,3432,543,44,6,331,129,44515,2435,3807,40708,726,1709,4533,42417,51,52,0,275
Prairie,12/16/20,12,117,117,433,4190,383,4648,38,8244,347,86,3715,475,313,70,10,2,24,14,4062,586,347,3715,111,475,458,4190,6,1,1,41
Pulaski,12/16/20,330,119,119,20546,247096,17832,268192,2382,393463,18651,1895,232416,14680,16311,1521,310,20,2028,354,251067,17125,18651,232416,2445,14680,21096,247096,276,216,5,2092
Randolph,12/16/20,37,121,121,1236,10700,1045,11993,154,17603,996,240,9407,1293,840,205,27,10,129,25,10403,1590,996,9407,297,1293,1293,10700,13,18,0,48
Saline,12/16/20,83,125,125,6373,63937,5482,70633,807,118009,5132,1241,55276,8661,4461,1021,74,9,596,211,60408,10225,5132,55276,1564,8661,6696,63937,77,96,4,867
Scott,12/16/20,5,127,127,482,6739,413,7235,64,10442,388,94,6528,211,330,83,5,0,53,11,6916,319,388,6528,108,211,496,6739,7,4,1,44
Searcy,12/16/20,7,129,129,424,4366,342,4814,75,7923,287,137,3651,715,258,84,4,3,25,50,3938,876,287,3651,161,715,448,4366,4,6,1,16
Sebastian,12/16/20,136,131,131,8297,89358,7408,97763,750,127461,7300,997,87040,2318,6628,780,130,6,540,210,94340,3423,7300,87040,1105,2318,8405,89358,96,89,2,594
Sevier,12/16/20,20,133,133,1910,10352,1809,12317,81,17193,1480,430,8853,1499,1426,383,19,1,35,46,10333,1984,1480,8853,485,1499,1965,10352,17,18,0,240
Sharp,12/16/20,28,135,135,917,9657,757,10638,132,17043,690,227,8571,1086,585,172,23,5,82,50,9261,1377,690,8571,291,1086,981,9657,20,10,1,221
St.Francis,12/16/20,18,123,123,2471,20263,2126,22758,327,26294,2386,85,19976,287,2050,76,18,0,318,9,22362,396,2386,19976,109,287,2495,20263,17,11,0,163
Stone,12/16/20,25,137,137,627,6112,506,6756,96,12446,525,102,5588,524,450,56,23,2,52,44,6113,643,525,5588,119,524,644,6112,19,9,0,60
Union,12/16/20,65,139,139,1909,15928,1686,17925,158,39732,1528,381,13693,2235,1370,316,55,10,103,55,15221,2704,1528,13693,469,2235,1997,15928,46,36,1,91
VanBuren,12/16/20,6,141,141,584,8641,451,9277,127,16684,456,128,7555,1086,365,86,5,1,86,41,8011,1266,456,7555,180,1086,636,8641,14,8,0,64
Washington,12/16/20,201,143,143,18497,144977,16565,164178,1730,228529,15313,3184,128713,16264,13859,2706,173,28,1281,449,144026,20152,15313,128713,3888,16264,19201,144977,192,214,0,1706
White,12/16/20,65,145,145,3731,31307,3237,35256,427,78804,2736,995,26699,4608,2442,795,57,8,235,192,29435,5821,2736,26699,1213,4608,3949,31307,82,40,0,303
Woodruff,12/16/20,1,147,147,279,3449,224,3747,54,6660,226,53,3262,187,191,33,1,0,34,20,3488,259,226,3262,72,187,298,3449,7,2,0,43
Yell,12/16/20,36,149,149,2013,19491,1729,21542,248,21573,1864,149,18894,597,1632,97,33,3,199,49,20758,784,1864,18894,187,597,2051,19491,46,24,0,105
Arkansas_all_counties,12/15/20,3016,5630,5630,189198,1862632,165467,2057817,20690,2990671,161592,27606,1712879,149753,142886,22581,2672,344,16012,4678,1874471,183346,161592,1712879,33593,149753,195185,1862632,2141,2116,26,12388
Arkansas_county,12/15/20,26,1,1,1112,13254,990,14439,96,18124,866,246,10316,2938,771,219,24,2,71,25,11182,3257,866,10316,319,2938,1185,13254,11,11,0,94
Ashley,12/15/20,18,3,3,1081,9518,931,10631,132,20537,947,134,8995,523,819,112,17,1,111,21,9942,689,947,8995,166,523,1113,9518,6,18,0,65
Baxter,12/15/20,40,5,5,1707,12284,1484,14033,183,41219,1277,430,10897,1387,1136,348,36,4,105,78,12174,1859,1277,10897,472,1387,1749,12284,31,24,0,138
Benton,12/15/20,212,7,7,14586,120897,13027,135995,1346,258980,11894,2692,114716,6181,10847,2180,174,38,872,474,126610,9385,11894,114716,3204,6181,15098,120897,192,156,3,624
Boone,12/15/20,52,9,9,2200,20644,1918,22974,228,37288,1864,336,19737,907,1625,293,49,3,188,40,21601,1373,1864,19737,466,907,2330,20644,18,26,0,166
Bradley,12/15/20,8,11,11,706,6742,568,7469,130,10948,586,120,4702,2040,487,81,8,0,91,39,5288,2181,586,4702,141,2040,727,6742,11,25,0,186
Calhoun,12/15/20,1,13,13,180,2499,162,2688,17,5202,158,22,2389,110,141,21,1,0,16,1,2547,141,158,2389,31,110,189,2499,3,2,0,19
Carroll,12/15/20,24,15,15,1793,12587,1557,14415,212,27887,1611,182,12372,215,1413,144,24,0,174,38,13983,432,1611,12372,217,215,1828,12587,33,33,0,94
Chicot,12/15/20,29,17,17,1318,8498,1209,9833,80,10826,1239,79,7628,870,1150,59,28,1,61,19,8867,966,1239,7628,96,870,1335,8498,3,8,-1,24
Clark,12/15/20,16,19,19,1088,15247,904,16389,168,22385,925,163,13055,2192,778,126,13,3,134,34,13980,2409,925,13055,217,2192,1142,15247,11,20,0,80
Clay,12/15/20,25,21,21,1146,10194,978,11375,142,15061,919,227,7916,2278,797,181,19,6,102,40,8835,2540,919,7916,262,2278,1181,10194,14,29,0,62
Cleburne,12/15/20,27,23,23,924,13228,766,14177,131,25230,722,202,11343,1885,624,142,25,2,73,58,12065,2112,722,11343,227,1885,949,13228,23,9,0,198
Cleveland,12/15/20,16,25,25,478,5753,399,6249,63,8226,350,128,5390,363,295,104,14,2,41,22,5740,509,350,5390,146,363,496,5753,6,8,0,44
Columbia,12/15/20,35,27,27,1348,11723,1189,13194,124,23892,968,380,9453,2270,870,319,26,9,72,52,10421,2773,968,9453,503,2270,1471,11723,14,16,2,223
Conway,12/15/20,10,29,29,950,13070,750,14057,190,20906,790,160,11487,1583,658,92,10,0,122,68,12277,1780,790,11487,197,1583,987,13070,10,13,0,66
Craighead,12/15/20,106,31,31,8556,71754,7501,80518,948,105701,7722,834,64087,7667,6776,725,98,8,847,101,71809,8709,7722,64087,1042,7667,8764,71754,95,88,1,588
Crawford,12/15/20,48,33,33,3768,40649,3253,44459,465,62472,3345,423,39419,1230,2919,334,43,5,381,84,42764,1695,3345,39419,465,1230,3810,40649,51,42,0,176
Crittenden,12/15/20,64,35,35,3752,24301,3405,28122,282,49013,3564,188,23270,1031,3246,159,56,8,261,21,26834,1288,3564,23270,257,1031,3821,24301,31,31,0,116
Cross,12/15/20,31,37,37,1115,9802,947,10941,137,16998,932,183,9299,503,782,165,30,1,120,17,10231,710,932,9299,207,503,1139,9802,15,18,0,42
Dallas,12/15/20,8,39,39,391,4097,328,4493,55,7432,361,30,3910,187,305,23,7,1,49,6,4271,222,361,3910,35,187,396,4097,0,11,0,25
Desha,12/15/20,10,41,41,774,7273,620,8085,144,11887,669,105,6592,681,542,78,9,1,118,26,7261,824,669,6592,143,681,812,7273,13,16,0,123
Drew,12/15/20,8,43,43,1175,11576,917,12782,250,18502,930,245,10013,1563,721,196,7,1,202,48,10943,1839,930,10013,276,1563,1206,11576,23,25,0,139
Faulkner,12/15/20,68,45,45,6101,72846,5191,79182,842,122416,5189,912,65651,7195,4514,677,57,11,618,224,70840,8342,5189,65651,1147,7195,6336,72846,69,89,0,470
Franklin,12/15/20,21,47,47,947,12213,836,13194,90,17780,807,140,11746,467,720,116,19,2,68,22,12553,641,807,11746,174,467,981,12213,10,14,0,42
Fulton,12/15/20,18,49,49,658,4103,576,4790,64,12139,500,158,3345,758,447,129,11,7,42,22,3845,945,500,3345,187,758,687,4103,19,12,0,53
Garland,12/15/20,131,51,51,4682,54384,4056,59169,493,98296,4169,513,51404,2980,3675,381,118,13,374,119,55573,3596,4169,51404,616,2980,4785,54384,67,70,1,240
Grant,12/15/20,10,53,53,771,9932,672,10732,89,18086,615,156,8778,1154,548,124,9,1,58,31,9393,1339,615,8778,185,1154,800,9932,14,8,0,51
Greene,12/15/20,45,55,55,3843,29653,3237,33617,561,44623,3151,692,26537,3116,2645,592,37,8,469,92,29688,3929,3151,26537,813,3116,3964,29653,60,51,3,221
Hempstead,12/15/20,9,57,57,1044,10077,932,11156,103,22018,839,205,9533,544,762,170,7,2,70,33,10372,784,839,9533,240,544,1079,10077,12,16,0,90
HotSpring,12/15/20,48,59,59,3196,28422,2973,31666,175,33520,3033,163,25168,3254,2842,131,45,3,146,29,28201,3465,3033,25168,211,3254,3244,28422,24,15,0,248
Howard,12/15/20,16,61,61,955,6403,853,7391,86,13389,725,230,5085,1318,665,188,16,0,44,42,5810,1581,725,5085,263,1318,988,6403,13,9,0,38
Independence,12/15/20,77,63,63,2379,22267,2137,24745,165,37264,1757,622,19376,2891,1584,553,62,15,111,54,21133,3612,1757,19376,721,2891,2478,22267,24,21,0,149
Izard,12/15/20,7,65,65,1093,9234,1029,10350,57,13559,945,148,7884,1350,910,119,7,0,28,29,8829,1521,945,7884,171,1350,1116,9234,20,6,0,63
Jackson,12/15/20,13,67,67,2460,16698,1916,19337,531,17225,2035,425,14623,2075,1545,371,10,3,480,51,16658,2679,2035,14623,604,2075,2639,16698,29,36,0,128
Jefferson,12/15/20,121,69,69,5766,55128,5235,61112,408,70424,5100,666,51684,3444,4698,537,107,14,293,115,56784,4328,5100,51684,884,3444,5984,55128,26,27,0,278
Johnson,12/15/20,14,71,71,1490,15011,1339,16520,137,26291,1356,134,14412,599,1237,102,12,2,107,30,15768,752,1356,14412,153,599,1509,15011,14,18,0,75
Lafayette,12/15/20,4,73,73,294,2151,277,2466,12,6915,234,60,1980,171,222,55,4,0,8,4,2214,252,234,1980,81,171,315,2151,2,3,0,30
Lawrence,12/15/20,33,75,75,1350,8979,1212,10378,105,16669,1136,214,8394,585,1027,185,32,1,77,28,9530,848,1136,8394,263,585,1399,8979,12,5,0,54
Lee,12/15/20,20,77,77,1335,7268,1209,8614,106,9398,1306,29,7112,156,1185,24,19,1,102,4,8418,196,1306,7112,40,156,1346,7268,3,7,0,11
Lincoln,12/15/20,20,79,79,2680,13827,2533,16551,127,13695,2512,168,12374,1453,2398,135,18,2,96,31,14886,1665,2512,12374,212,1453,2724,13827,11,15,0,71
LittleRiver,12/15/20,37,81,81,701,3519,641,4236,23,12417,576,125,3204,315,526,115,35,2,15,8,3780,456,576,3204,141,315,717,3519,6,2,0,20
Logan,12/15/20,8,83,83,1193,15511,1029,16735,156,21757,1051,142,13761,1750,937,92,8,0,106,50,14812,1923,1051,13761,173,1750,1224,15511,26,15,0,92
Lonoke,12/15/20,66,85,85,3355,40634,2893,44177,396,72206,2560,795,34782,5852,2217,676,59,7,284,112,37342,6835,2560,34782,983,5852,3543,40634,69,43,0,425
Madison,12/15/20,9,87,87,841,8022,712,8892,120,16076,709,132,7521,501,603,109,9,0,97,23,8230,662,709,7521,161,501,870,8022,10,12,0,52
Marion,12/15/20,9,89,89,527,6027,472,6577,46,16438,422,105,5485,542,386,86,8,1,28,18,5907,670,422,5485,128,542,550,6027,3,2,1,46
Miller,12/15/20,24,91,91,2359,12233,2238,14670,97,43759,1733,626,11145,1088,1641,597,17,7,75,22,12878,1792,1733,11145,704,1088,2437,12233,10,9,0,60
MissingCountyInfo,12/15/20,0,5,5,3081,115635,2217,118740,864,NA,2483,598,115577,58,1759,458,0,0,724,140,118060,680,2483,115577,622,58,3105,115635,-54,64,0,763
Mississippi,12/15/20,89,93,93,3864,23323,3373,27252,401,42831,3521,343,18422,4901,3092,281,75,14,353,48,21943,5309,3521,18422,408,4901,3929,23323,45,40,1,171
Monroe,12/15/20,5,95,95,375,4313,322,4697,48,7249,329,46,4144,169,290,32,5,0,34,14,4473,224,329,4144,55,169,384,4313,3,2,0,17
Montgomery,12/15/20,13,97,97,411,4517,330,4937,68,8993,347,64,3178,1339,296,34,11,2,40,28,3525,1412,347,3178,73,1339,420,4517,12,3,1,22
Nevada,12/15/20,19,99,99,522,7761,461,8291,42,8440,455,67,7497,264,403,58,18,1,34,8,7952,339,455,7497,75,264,530,7761,3,-1,1,40
Newton,12/15/20,24,101,101,503,4137,450,4651,29,7848,445,58,2824,1313,399,51,20,4,26,3,3269,1382,445,2824,69,1313,514,4137,1,4,0,97
Ouachita,12/15/20,17,103,103,1081,11076,894,12207,169,24106,977,104,10542,534,808,86,15,2,153,16,11519,688,977,10542,154,534,1131,11076,17,29,0,72
Perry,12/15/20,4,105,105,320,7302,272,7637,44,10322,277,43,6887,415,240,32,3,1,34,10,7164,473,277,6887,58,415,335,7302,3,6,0,15
Phillips,12/15/20,17,107,107,1085,11922,984,13037,84,19034,1031,54,11610,312,939,45,17,0,75,9,12641,396,1031,11610,84,312,1115,11922,4,9,0,25
Pike,12/15/20,6,109,109,503,4185,422,4701,75,10808,445,58,3825,360,379,43,4,2,62,13,4270,431,445,3825,71,360,516,4185,5,1,1,36
Poinsett,12/15/20,51,111,111,2015,16847,1716,18919,248,24054,1833,182,16085,762,1552,164,45,6,236,12,17918,1001,1833,16085,239,762,2072,16847,28,20,0,96
Polk,12/15/20,20,113,113,1046,8485,909,9557,116,20163,952,94,8069,416,831,78,20,0,100,16,9021,536,952,8069,120,416,1072,8485,20,29,1,62
Pope,12/15/20,50,115,115,4434,42193,3923,46675,461,63644,3778,656,40514,1679,3393,530,44,6,341,120,44292,2383,3778,40514,704,1679,4482,42193,46,32,1,205
Prairie,12/15/20,11,117,117,427,4155,382,4607,34,8244,343,84,3684,471,312,70,9,2,22,12,4027,580,343,3684,109,471,452,4155,9,3,0,25
Pulaski,12/15/20,325,119,119,20270,245280,17616,266089,2327,393463,18402,1868,230954,14326,16111,1505,305,20,1984,343,249356,16733,18402,230954,2407,14326,20809,245280,284,228,3,1711
Randolph,12/15/20,37,121,121,1223,10665,1027,11945,159,17603,984,239,9388,1277,825,202,27,10,132,27,10372,1573,984,9388,296,1277,1280,10665,15,7,1,58
Saline,12/15/20,79,125,125,6296,63147,5386,69762,830,118009,5076,1220,54800,8347,4389,997,70,9,616,214,59876,9886,5076,54800,1539,8347,6615,63147,103,92,1,516
Scott,12/15/20,4,127,127,475,6702,409,7191,62,10442,383,92,6497,205,326,83,4,0,53,9,6880,311,383,6497,106,205,489,6702,5,4,0,39
Searcy,12/15/20,6,129,129,420,4354,336,4797,78,7923,285,135,3641,713,257,79,3,3,25,53,3926,871,285,3641,158,713,443,4354,13,20,0,23
Sebastian,12/15/20,134,131,131,8201,88860,7319,97168,745,127461,7246,955,86623,2237,6559,760,128,6,557,188,93869,3299,7246,86623,1062,2237,8308,88860,62,78,0,379
Sevier,12/15/20,20,133,133,1893,10129,1791,12077,82,17193,1475,418,8633,1496,1422,369,19,1,34,48,10108,1969,1475,8633,473,1496,1948,10129,19,14,0,146
Sharp,12/15/20,27,135,135,897,9456,747,10416,123,17043,678,219,8382,1074,575,172,22,5,81,42,9060,1356,678,8382,282,1074,960,9456,18,12,1,99
St.Francis,12/15/20,18,123,123,2454,20117,2115,22593,321,26294,2371,83,19852,265,2038,77,18,0,315,6,22223,370,2371,19852,105,265,2476,20117,16,12,0,48
Stone,12/15/20,25,137,137,608,6071,497,6695,86,12446,522,86,5571,500,447,50,23,2,52,34,6093,602,522,5571,102,500,624,6071,10,7,0,72
Union,12/15/20,64,139,139,1863,15883,1650,17833,149,39732,1507,356,13654,2229,1349,301,54,10,104,45,15161,2672,1507,13654,443,2229,1950,15883,24,19,0,165
VanBuren,12/15/20,6,141,141,570,8591,443,9213,121,16684,447,123,7516,1075,358,85,5,1,84,37,7963,1250,447,7516,175,1075,622,8591,9,6,0,108
Washington,12/15/20,201,143,143,18305,143463,16351,162466,1752,228529,15170,3135,127888,15575,13684,2667,173,28,1313,439,143058,19408,15170,127888,3833,15575,19003,143463,165,172,3,785
White,12/15/20,65,145,145,3649,31086,3197,34951,385,78804,2677,972,26566,4520,2417,780,57,8,201,184,29243,5708,2677,26566,1188,4520,3865,31086,70,44,1,207
Woodruff,12/15/20,1,147,147,272,3413,222,3703,49,6660,222,50,3238,175,189,33,1,0,32,17,3460,243,222,3238,68,175,290,3413,6,3,0,23
Yell,12/15/20,36,149,149,1967,19432,1705,21435,226,21573,1832,135,18848,584,1611,94,33,3,188,38,20680,755,1832,18848,171,584,2003,19432,13,23,0,64
Arkansas_all_counties,12/14/20,2990,5630,5630,187057,1852385,163351,2045357,20691,2990671,160356,26701,1705843,146542,141264,22087,2656,334,16414,4277,1866199,179158,160356,1705843,32616,146542,192972,1852385,1355,2014,45,11358
Arkansas_county,12/14/20,26,1,1,1101,13171,979,14343,96,18124,861,240,10293,2878,765,214,24,2,72,24,11154,3189,861,10293,311,2878,1172,13171,2,14,2,14
Ashley,12/14/20,18,3,3,1075,9459,913,10566,144,20537,943,132,8953,506,803,110,17,1,123,21,9896,670,943,8953,164,506,1107,9459,19,11,0,104
Baxter,12/14/20,40,5,5,1676,12177,1460,13895,176,41219,1267,409,10794,1383,1118,342,36,4,113,63,12061,1834,1267,10794,451,1383,1718,12177,13,18,0,166
Benton,12/14/20,209,7,7,14394,120465,12871,135369,1313,258980,11788,2606,114364,6101,10739,2132,173,36,875,438,126152,9217,11788,114364,3116,6101,14904,120465,92,146,0,1289
Boone,12/14/20,52,9,9,2182,20496,1892,22807,236,37288,1851,331,19658,838,1604,288,49,3,196,40,21509,1298,1851,19658,460,838,2311,20496,17,28,0,149
Bradley,12/14/20,8,11,11,695,6567,543,7282,144,10948,581,114,4691,1876,467,76,8,0,106,38,5272,2010,581,4691,134,1876,715,6567,6,14,1,39
Calhoun,12/14/20,1,13,13,177,2483,160,2669,16,5202,156,21,2376,107,139,21,1,0,16,0,2532,137,156,2376,30,107,186,2483,0,0,0,15
Carroll,12/14/20,24,15,15,1760,12526,1524,14321,212,27887,1583,177,12319,207,1387,137,24,0,172,40,13902,419,1583,12319,212,207,1795,12526,7,30,0,139
Chicot,12/14/20,30,17,17,1315,8477,1201,9809,84,10826,1240,75,7623,854,1143,58,29,1,68,16,8863,946,1240,7623,92,854,1332,8477,5,5,0,79
Clark,12/14/20,16,19,19,1077,15178,884,16309,177,22385,918,159,13031,2147,762,122,13,3,143,34,13949,2360,918,13031,213,2147,1131,15178,9,15,1,238
Clay,12/14/20,25,21,21,1132,10146,949,11312,157,15061,911,221,7879,2267,776,173,19,6,115,42,8790,2522,911,7879,255,2267,1166,10146,7,22,0,95
Cleburne,12/14/20,27,23,23,901,13053,757,13979,117,25230,711,190,11187,1866,618,139,25,2,68,49,11898,2081,711,11187,215,1866,926,13053,2,13,0,55
Cleveland,12/14/20,16,25,25,472,5715,391,6205,65,8226,346,126,5380,335,289,102,14,2,43,22,5726,479,346,5380,144,335,490,5715,4,6,0,26
Columbia,12/14/20,33,27,27,1334,11514,1173,12971,128,23892,965,369,9318,2196,857,316,26,7,82,46,10283,2688,965,9318,492,2196,1457,11514,12,12,1,122
Conway,12/14/20,10,29,29,940,13014,737,13990,193,20906,787,153,11461,1553,646,91,10,0,131,62,12248,1742,787,11461,189,1553,976,13014,13,15,0,113
Craighead,12/14/20,105,31,31,8461,71261,7413,79927,942,105701,7646,815,63749,7512,6705,708,97,8,843,99,71395,8532,7646,63749,1020,7512,8666,71261,48,97,6,640
Crawford,12/14/20,48,33,33,3717,40524,3211,44280,456,62472,3312,405,39327,1197,2885,326,43,5,382,74,42639,1641,3312,39327,444,1197,3756,40524,39,47,1,535
Crittenden,12/14/20,64,35,35,3721,24216,3374,28005,282,49013,3537,184,23192,1024,3216,158,56,8,264,18,26729,1276,3537,23192,252,1024,3789,24216,12,47,1,232
Cross,12/14/20,31,37,37,1100,9775,929,10898,140,16998,919,181,9277,498,767,162,30,1,122,18,10196,702,919,9277,204,498,1123,9775,9,19,0,114
Dallas,12/14/20,8,39,39,391,4072,317,4468,66,7432,361,30,3893,179,294,23,7,1,60,6,4254,214,361,3893,35,179,396,4072,3,6,1,18
Desha,12/14/20,10,41,41,761,7163,604,7962,147,11887,659,102,6529,634,527,77,9,1,123,24,7188,774,659,6529,140,634,799,7163,12,15,0,63
Drew,12/14/20,8,43,43,1152,11460,892,12643,252,18502,911,241,9988,1472,696,196,7,1,208,44,10899,1744,911,9988,272,1472,1183,11460,16,29,0,161
Faulkner,12/14/20,68,45,45,6032,72445,5102,78711,862,122416,5162,870,65409,7036,4446,656,57,11,659,203,70571,8140,5162,65409,1104,7036,6266,72445,60,82,1,494
Franklin,12/14/20,21,47,47,937,12181,822,13152,94,17780,804,133,11723,458,708,114,19,2,77,17,12527,625,804,11723,167,458,971,12181,2,8,0,88
Fulton,12/14/20,18,49,49,639,4069,564,4735,57,12139,487,152,3329,740,436,128,11,7,40,17,3816,919,487,3329,179,740,666,4069,3,1,2,38
Garland,12/14/20,130,51,51,4615,54211,3986,58927,497,98296,4147,468,51276,2935,3621,365,117,13,407,90,55423,3504,4147,51276,569,2935,4716,54211,32,57,1,387
Grant,12/14/20,10,53,53,757,9895,664,10680,83,18086,607,150,8757,1138,544,120,9,1,54,29,9364,1316,607,8757,178,1138,785,9895,9,9,2,63
Greene,12/14/20,42,55,55,3783,29492,3186,33393,555,44623,3104,679,26419,3073,2612,574,36,6,456,99,29523,3870,3104,26419,797,3073,3901,29492,34,41,2,315
Hempstead,12/14/20,9,57,57,1032,9999,916,11065,107,22018,832,200,9486,513,751,165,7,2,74,33,10318,747,832,9486,234,513,1066,9999,13,13,0,114
HotSpring,12/14/20,48,59,59,3172,28198,2958,31420,166,33520,3019,153,24987,3211,2831,127,45,3,143,23,28006,3414,3019,24987,203,3211,3222,28198,9,20,1,224
Howard,12/14/20,16,61,61,942,6378,844,7353,82,13389,721,221,5068,1310,660,184,16,0,45,37,5789,1564,721,5068,254,1310,975,6378,13,3,0,29
Independence,12/14/20,77,63,63,2355,22142,2116,24593,162,37264,1740,615,19341,2801,1575,541,62,15,103,59,21081,3512,1740,19341,711,2801,2451,22142,4,28,0,162
Izard,12/14/20,7,65,65,1073,9191,1023,10285,43,13559,942,131,7861,1330,904,119,7,0,31,12,8803,1482,942,7861,152,1330,1094,9191,3,7,0,162
Jackson,12/14/20,13,67,67,2431,16599,1880,19211,538,17225,2014,417,14535,2064,1515,365,10,3,489,49,16549,2662,2014,14535,598,2064,2612,16599,10,25,0,128
Jefferson,12/14/20,121,69,69,5740,54876,5208,60832,409,70424,5092,648,51596,3280,4687,521,107,14,296,113,56688,4144,5092,51596,864,3280,5956,54876,49,34,3,235
Johnson,12/14/20,14,71,71,1476,14950,1321,16445,141,26291,1349,127,14361,589,1226,95,12,2,111,30,15710,735,1349,14361,146,589,1495,14950,1,16,0,79
Lafayette,12/14/20,4,73,73,292,2123,274,2436,13,6915,234,58,1960,163,221,53,4,0,9,4,2194,242,234,1960,79,163,313,2123,1,0,0,10
Lawrence,12/14/20,33,75,75,1338,8937,1207,10325,98,16669,1133,205,8367,570,1026,181,32,1,75,23,9500,825,1133,8367,255,570,1388,8937,5,19,0,194
Lee,12/14/20,20,77,77,1332,7260,1202,8603,110,9398,1303,29,7106,154,1180,22,19,1,104,6,8409,194,1303,7106,40,154,1343,7260,7,14,0,74
Lincoln,12/14/20,20,79,79,2669,13767,2518,16480,131,13695,2504,165,12334,1433,2386,132,18,2,100,31,14838,1642,2504,12334,209,1433,2713,13767,4,18,0,41
LittleRiver,12/14/20,37,81,81,695,3505,639,4216,19,12417,573,122,3194,311,525,114,35,2,13,6,3767,449,573,3194,138,311,711,3505,1,0,0,26
Logan,12/14/20,8,83,83,1167,15445,1014,16641,145,21757,1042,125,13702,1743,921,93,8,0,113,32,14744,1897,1042,13702,154,1743,1196,15445,14,17,0,165
Lonoke,12/14/20,66,85,85,3286,40278,2850,43748,370,72206,2519,767,34618,5660,2186,664,59,7,274,96,37137,6611,2519,34618,951,5660,3470,40278,30,43,1,262
Madison,12/14/20,9,87,87,831,7980,700,8840,122,16076,700,131,7485,495,595,105,9,0,96,26,8185,655,700,7485,160,495,860,7980,10,16,0,46
Marion,12/14/20,8,89,89,524,5984,470,6530,46,16438,419,105,5446,538,385,85,7,1,27,19,5865,665,419,5446,127,538,546,5984,0,7,0,35
Miller,12/14/20,24,91,91,2349,12183,2229,14610,96,43759,1730,619,11126,1057,1635,594,17,7,78,18,12856,1754,1730,11126,697,1057,2427,12183,8,6,0,63
MissingCountyInfo,12/14/20,0,5,5,3135,114818,2153,117979,982,NA,2565,570,114761,57,1695,458,0,0,870,112,117326,653,2565,114761,596,57,3161,114818,39,49,0,-3770
Mississippi,12/14/20,88,93,93,3819,23197,3333,27081,397,42831,3487,332,18349,4848,3058,275,74,14,354,43,21836,5245,3487,18349,397,4848,3884,23197,23,39,1,175
Monroe,12/14/20,5,95,95,372,4299,320,4680,47,7249,329,43,4137,162,289,31,5,0,35,12,4466,214,329,4137,52,162,381,4299,0,3,0,16
Montgomery,12/14/20,12,97,97,399,4507,327,4915,60,8993,343,56,3177,1330,293,34,10,2,40,20,3520,1395,343,3177,65,1330,408,4507,2,7,0,18
Nevada,12/14/20,18,99,99,519,7724,462,8251,39,8440,455,64,7466,258,404,58,17,1,34,5,7921,330,455,7466,72,258,527,7724,1,0,0,207
Newton,12/14/20,24,101,101,502,4041,446,4554,32,7848,444,58,2819,1222,396,50,20,4,28,4,3263,1291,444,2819,69,1222,513,4041,4,9,0,30
Ouachita,12/14/20,17,103,103,1064,11021,865,12135,181,24106,967,97,10509,512,783,82,15,2,168,13,11476,659,967,10509,147,512,1114,11021,12,18,1,127
Perry,12/14/20,4,105,105,317,7290,266,7622,47,10322,275,42,6875,415,236,30,3,1,36,11,7150,472,275,6875,57,415,332,7290,3,4,0,36
Phillips,12/14/20,17,107,107,1081,11901,975,13012,89,19034,1028,53,11599,302,931,44,17,0,80,9,12627,385,1028,11599,83,302,1111,11901,6,11,0,76
Pike,12/14/20,5,109,109,498,4154,421,4665,72,10808,442,56,3796,358,378,43,4,1,60,12,4238,427,442,3796,69,358,511,4154,4,3,1,46
Poinsett,12/14/20,51,111,111,1987,16779,1696,18822,240,24054,1806,181,16026,753,1535,161,45,6,226,14,17832,990,1806,16026,237,753,2043,16779,14,21,0,180
Polk,12/14/20,19,113,113,1026,8443,880,9495,126,20163,940,86,8028,415,807,73,19,0,113,13,8968,527,940,8028,112,415,1052,8443,6,18,0,45
Pope,12/14/20,49,115,115,4388,42034,3891,46469,448,63644,3753,635,40378,1656,3368,523,43,6,342,106,44131,2338,3753,40378,682,1656,4435,42034,14,37,0,335
Prairie,12/14/20,11,117,117,418,4139,379,4582,28,8244,341,77,3669,470,309,70,9,2,23,5,4010,572,341,3669,102,470,443,4139,2,4,1,19
Pulaski,12/14/20,322,119,119,19986,243853,17388,264361,2274,393463,18192,1794,229802,14051,15918,1470,302,20,1970,304,247994,16367,18192,229802,2316,14051,20508,243853,191,210,4,1602
Randolph,12/14/20,36,121,121,1208,10622,1020,11887,152,17603,969,239,9360,1262,819,201,27,9,123,29,10329,1558,969,9360,296,1262,1265,10622,9,14,1,78
Saline,12/14/20,78,125,125,6193,62734,5294,69239,820,118009,5022,1171,54561,8173,4319,975,70,8,632,188,59583,9656,5022,54561,1483,8173,6505,62734,54,89,2,532
Scott,12/14/20,4,127,127,470,6668,405,7151,61,10442,380,90,6467,201,323,82,4,0,53,8,6847,304,380,6467,103,201,483,6668,1,17,0,28
Searcy,12/14/20,6,129,129,407,4344,316,4774,85,7923,282,125,3632,712,255,61,3,3,24,61,3914,860,282,3632,148,712,430,4344,1,3,0,21
Sebastian,12/14/20,134,131,131,8139,88543,7241,96787,761,127461,7215,924,86404,2139,6492,749,128,6,593,168,93619,3168,7215,86404,1029,2139,8244,88543,60,66,1,1003
Sevier,12/14/20,20,133,133,1874,10002,1777,11930,77,17193,1468,406,8611,1391,1419,358,19,1,30,47,10079,1851,1468,8611,460,1391,1928,10002,11,8,0,149
Sharp,12/14/20,26,135,135,879,9375,735,10313,118,17043,666,213,8349,1026,565,170,21,5,80,38,9015,1298,666,8349,272,1026,938,9375,9,7,1,123
St.Francis,12/14/20,18,123,123,2438,20085,2103,22545,317,26294,2357,81,19828,257,2028,75,18,0,311,6,22185,360,2357,19828,103,257,2460,20085,86,8,0,714
Stone,12/14/20,25,137,137,598,6009,490,6622,83,12446,520,78,5530,479,445,45,23,2,52,31,6050,572,520,5530,93,479,613,6009,4,12,0,88
Union,12/14/20,64,139,139,1839,15742,1631,17667,144,39732,1498,341,13606,2136,1335,296,54,10,109,35,15104,2563,1498,13606,427,2136,1925,15742,3,16,1,37
VanBuren,12/14/20,6,141,141,561,8492,437,9105,118,16684,443,118,7440,1052,355,82,5,1,83,35,7883,1222,443,7440,170,1052,613,8492,1,5,0,46
Washington,12/14/20,198,143,143,18140,142843,16179,161681,1762,228529,15051,3089,127376,15467,13557,2622,170,28,1324,438,142427,19254,15051,127376,3787,15467,18838,142843,99,173,3,1105
White,12/14/20,64,145,145,3579,30949,3153,34743,360,78804,2639,940,26465,4484,2396,757,57,7,184,176,29104,5639,2639,26465,1155,4484,3794,30949,19,47,1,166
Woodruff,12/14/20,1,147,147,266,3396,219,3680,46,6660,221,45,3232,164,186,33,1,0,34,12,3453,227,221,3232,63,164,284,3396,1,3,0,26
Yell,12/14/20,36,149,149,1954,19381,1682,21369,236,21573,1828,126,18823,558,1591,91,33,3,204,32,20651,718,1828,18823,160,558,1988,19381,7,20,0,260
Arkansas_all_counties,12/13/20,2945,5630,5630,185702,1842382,161337,2033887,21395,2990671,159123,26579,1696581,145801,139822,21515,2633,312,16646,4749,1855704,178183,159123,1696581,32382,145801,191505,1842382,1450,1510,34,13473
Arkansas_county,12/13/20,24,1,1,1099,13159,965,14326,110,18124,859,240,10282,2877,757,208,22,2,80,30,11141,3185,859,10282,308,2877,1167,13159,6,5,0,81
Ashley,12/13/20,18,3,3,1056,9374,902,10462,136,20537,925,131,8869,505,796,106,17,1,112,24,9794,668,925,8869,163,505,1088,9374,4,4,0,48
Baxter,12/13/20,40,5,5,1663,12024,1442,13726,181,41219,1257,406,10642,1382,1105,337,36,4,116,65,11899,1827,1257,10642,445,1382,1702,12024,9,14,0,60
Benton,12/13/20,209,7,7,14302,119268,12725,134070,1367,258980,11706,2596,113182,6086,10642,2083,173,36,890,477,124888,9182,11706,113182,3096,6086,14802,119268,93,131,5,472
Boone,12/13/20,52,9,9,2165,20364,1864,22657,247,37288,1834,331,19529,835,1586,278,49,3,197,50,21363,1294,1834,19529,459,835,2293,20364,11,15,0,145
Bradley,12/13/20,7,11,11,689,6534,529,7243,153,10948,575,114,4658,1876,458,71,7,0,110,43,5233,2010,575,4658,134,1876,709,6534,17,10,0,66
Calhoun,12/13/20,1,13,13,177,2468,160,2654,16,5202,156,21,2362,106,139,21,1,0,16,0,2518,136,156,2362,30,106,186,2468,2,2,0,11
Carroll,12/13/20,24,15,15,1753,12394,1494,14182,235,27887,1576,177,12187,207,1368,126,24,0,184,51,13763,419,1576,12187,212,207,1788,12394,10,18,0,45
Chicot,12/13/20,30,17,17,1310,8403,1196,9729,84,10826,1235,75,7550,853,1139,57,29,1,67,17,8785,944,1235,7550,91,853,1326,8403,10,3,0,50
Clark,12/13/20,15,19,19,1068,14949,869,16070,184,22385,909,159,12804,2145,748,121,13,2,148,36,13713,2357,909,12804,212,2145,1121,14949,10,34,0,102
Clay,12/13/20,25,21,21,1125,10058,927,11216,172,15061,904,221,7797,2261,759,168,19,6,125,47,8701,2515,904,7797,254,2261,1158,10058,8,12,1,26
Cleburne,12/13/20,27,23,23,899,13000,744,13922,128,25230,708,191,11135,1865,607,137,25,2,76,52,11843,2079,708,11135,214,1865,922,13000,12,12,1,99
Cleveland,12/13/20,16,25,25,468,5693,385,6179,67,8226,342,126,5358,335,288,97,14,2,40,27,5700,479,342,5358,144,335,486,5693,2,10,0,17
Columbia,12/13/20,32,27,27,1322,11404,1161,12848,129,23892,960,362,9258,2146,847,314,26,6,87,42,10218,2630,960,9258,484,2146,1444,11404,1,9,3,21
Conway,12/13/20,10,29,29,927,12914,722,13877,195,20906,776,151,11364,1550,633,89,10,0,133,62,12140,1737,776,11364,187,1550,963,12914,17,15,0,64
Craighead,12/13/20,99,31,31,8413,70669,7316,79282,997,105701,7595,818,63209,7460,6623,693,92,7,879,118,70804,8478,7595,63209,1018,7460,8613,70669,80,70,2,571
Crawford,12/13/20,47,33,33,3678,40028,3164,43746,465,62472,3275,403,38834,1194,2850,314,42,5,381,84,42109,1637,3275,38834,443,1194,3718,40028,25,29,1,268
Crittenden,12/13/20,63,35,35,3709,23996,3327,27773,318,49013,3525,184,22974,1022,3169,158,56,7,299,19,26499,1274,3525,22974,252,1022,3777,23996,16,14,1,114
Cross,12/13/20,31,37,37,1091,9670,910,10784,150,16998,910,181,9180,490,753,157,30,1,127,23,10090,694,910,9180,204,490,1114,9670,7,11,0,79
Dallas,12/13/20,7,39,39,388,4057,311,4450,70,7432,358,30,3878,179,288,23,6,1,64,6,4236,214,358,3878,35,179,393,4057,5,4,0,28
Desha,12/13/20,10,41,41,749,7112,589,7899,150,11887,649,100,6480,632,518,71,9,1,122,28,7129,770,649,6480,138,632,787,7112,9,6,0,36
Drew,12/13/20,8,43,43,1136,11315,863,12482,265,18502,897,239,9846,1469,671,192,7,1,219,46,10743,1739,897,9846,270,1469,1167,11315,8,29,0,74
Faulkner,12/13/20,67,45,45,5972,72011,5020,78207,885,122416,5102,870,65030,6981,4387,633,57,10,658,227,70132,8075,5102,65030,1094,6981,6196,72011,46,56,0,291
Franklin,12/13/20,21,47,47,935,12095,814,13064,100,17780,802,133,11639,456,701,113,19,2,82,18,12441,623,802,11639,167,456,969,12095,2,9,0,18
Fulton,12/13/20,16,49,49,636,4034,563,4696,57,12139,484,152,3300,734,435,128,11,5,38,19,3784,912,484,3300,178,734,662,4034,3,5,1,24
Garland,12/13/20,129,51,51,4583,53856,3929,58540,523,98296,4118,465,50924,2932,3575,354,117,12,424,99,55042,3498,4118,50924,566,2932,4684,53856,24,51,2,102
Grant,12/13/20,8,53,53,748,9841,655,10617,85,18086,602,146,8706,1135,536,119,7,1,59,26,9308,1309,602,8706,174,1135,776,9841,9,9,0,98
Greene,12/13/20,40,55,55,3749,29211,3145,33076,564,44623,3070,679,26151,3060,2586,559,36,4,448,116,29221,3855,3070,26151,795,3060,3865,29211,20,44,1,108
Hempstead,12/13/20,9,57,57,1019,9898,903,10946,107,22018,819,200,9392,506,741,162,7,2,71,36,10211,735,819,9392,229,506,1048,9898,6,8,0,30
HotSpring,12/13/20,47,59,59,3163,27983,2938,31196,178,33520,3011,152,24775,3208,2814,124,44,3,153,25,27786,3410,3011,24775,202,3208,3213,27983,15,21,0,118
Howard,12/13/20,16,61,61,929,6362,841,7320,72,13389,713,216,5051,1311,659,182,16,0,38,34,5764,1556,713,5051,245,1311,958,6362,5,6,0,22
Independence,12/13/20,77,63,63,2351,21984,2088,24431,186,37264,1734,617,19192,2792,1563,525,62,15,109,77,20926,3505,1734,19192,713,2792,2447,21984,12,18,0,210
Izard,12/13/20,7,65,65,1070,9032,1016,10123,47,13559,939,131,7703,1329,901,115,7,0,31,16,8642,1481,939,7703,152,1329,1091,9032,1,7,0,19
Jackson,12/13/20,13,67,67,2421,16481,1855,19078,553,17225,2007,414,14419,2062,1506,349,10,3,491,62,16426,2652,2007,14419,590,2062,2597,16481,7,9,0,27
Jefferson,12/13/20,118,69,69,5691,54690,5174,60596,397,70424,5048,643,51417,3273,4671,503,107,11,268,129,56465,4131,5048,51417,858,3273,5906,54690,33,21,2,197
Johnson,12/13/20,14,71,71,1475,14872,1305,16365,156,26291,1347,128,14284,588,1212,93,12,2,123,33,15631,734,1347,14284,146,588,1493,14872,13,15,0,52
Lafayette,12/13/20,4,73,73,291,2114,274,2426,12,6915,234,57,1952,162,221,53,4,0,9,3,2186,240,234,1952,78,162,312,2114,2,1,0,7
Lawrence,12/13/20,33,75,75,1333,8748,1188,10129,112,16669,1128,205,8187,561,1012,176,32,1,84,28,9315,814,1128,8187,253,561,1381,8748,15,7,0,76
Lee,12/13/20,20,77,77,1325,7193,1188,8529,117,9398,1296,29,7040,153,1169,19,19,1,108,9,8336,193,1296,7040,40,153,1336,7193,6,3,0,44
Lincoln,12/13/20,20,79,79,2665,13730,2500,16438,145,13695,2500,165,12297,1433,2383,117,18,2,99,46,14797,1641,2500,12297,208,1433,2708,13730,7,12,0,31
LittleRiver,12/13/20,37,81,81,694,3480,639,4190,18,12417,573,121,3169,311,525,114,35,2,13,5,3742,448,573,3169,137,311,710,3480,2,5,0,12
Logan,12/13/20,8,83,83,1153,15294,997,16476,148,21757,1032,121,13558,1736,906,91,8,0,118,30,14590,1886,1032,13558,150,1736,1182,15294,8,8,0,98
Lonoke,12/13/20,65,85,85,3256,40046,2807,43483,384,72206,2487,769,34446,5600,2157,650,58,7,272,112,36933,6550,2487,34446,950,5600,3437,40046,20,21,1,168
Madison,12/13/20,9,87,87,821,7944,684,8794,128,16076,692,129,7449,495,582,102,9,0,101,27,8141,653,692,7449,158,495,850,7944,6,20,0,44
Marion,12/13/20,8,89,89,524,5949,463,6495,53,16438,419,105,5413,536,378,85,7,1,34,19,5832,663,419,5413,127,536,546,5949,3,10,0,15
Miller,12/13/20,24,91,91,2341,12128,2223,14547,94,43759,1724,617,11071,1057,1634,589,17,7,73,21,12795,1752,1724,11071,695,1057,2419,12128,4,7,2,29
MissingCountyInfo,12/13/20,0,5,5,3096,118627,2104,121749,992,NA,2537,559,118566,61,1675,429,0,0,862,130,121103,646,2537,118566,585,61,3122,118627,172,8,0,4254
Mississippi,12/13/20,87,93,93,3796,23045,3294,26902,414,42831,3471,325,18207,4838,3025,269,73,14,372,42,21678,5224,3471,18207,386,4838,3857,23045,16,32,0,122
Monroe,12/13/20,5,95,95,372,4283,317,4665,50,7249,329,43,4121,162,287,30,5,0,37,13,4450,215,329,4121,53,162,382,4283,3,1,0,31
Montgomery,12/13/20,12,97,97,397,4491,320,4895,65,8993,340,57,3170,1321,287,33,10,2,43,22,3510,1385,340,3170,64,1321,404,4491,4,7,0,14
Nevada,12/13/20,18,99,99,518,7518,462,8042,38,8440,452,66,7261,257,403,59,17,1,32,6,7713,329,452,7261,72,257,524,7518,4,3,1,17
Newton,12/13/20,24,101,101,498,4015,437,4524,37,7848,440,58,2793,1222,388,49,20,4,32,5,3233,1291,440,2793,69,1222,509,4015,1,5,0,17
Ouachita,12/13/20,16,103,103,1052,10906,847,12008,188,24106,955,97,10396,510,767,80,14,2,173,15,11351,657,955,10396,147,510,1102,10906,4,10,0,34
Perry,12/13/20,4,105,105,314,7257,262,7585,48,10322,273,41,6849,408,233,29,3,1,37,11,7122,463,273,6849,55,408,328,7257,4,2,0,30
Phillips,12/13/20,17,107,107,1075,11831,964,12936,94,19034,1022,53,11529,302,921,43,17,0,84,10,12551,385,1022,11529,83,302,1105,11831,7,5,0,36
Pike,12/13/20,4,109,109,494,4112,418,4618,72,10808,439,55,3754,358,375,43,3,1,61,11,4193,425,439,3754,67,358,506,4112,7,4,0,41
Poinsett,12/13/20,51,111,111,1973,16613,1675,18642,247,24054,1793,180,15868,745,1516,159,45,6,232,15,17661,981,1793,15868,236,745,2029,16613,20,18,0,97
Polk,12/13/20,19,113,113,1020,8404,862,9450,138,20163,934,86,7990,414,790,72,19,0,124,14,8924,526,934,7990,112,414,1046,8404,13,18,0,34
Pope,12/13/20,49,115,115,4374,41713,3854,46132,471,63644,3742,632,40063,1650,3344,510,43,6,355,116,43805,2327,3742,40063,677,1650,4419,41713,46,29,0,165
Prairie,12/13/20,10,117,117,416,4122,375,4563,31,8244,339,77,3656,466,307,68,8,2,24,7,3995,568,339,3656,102,466,441,4122,4,-1,1,24
Pulaski,12/13/20,318,119,119,19795,242442,17178,262746,2297,393463,18003,1792,228479,13963,15751,1427,298,20,1952,345,246482,16264,18003,228479,2301,13963,20304,242442,184,196,1,2008
Randolph,12/13/20,35,121,121,1199,10553,1006,11809,158,17603,960,239,9296,1257,807,199,27,8,126,32,10256,1553,960,9296,296,1257,1256,10553,3,15,0,55
Saline,12/13/20,76,125,125,6139,62256,5205,68700,857,118009,4978,1161,54102,8154,4253,952,70,6,654,203,59080,9620,4978,54102,1466,8154,6444,62256,45,53,1,292
Scott,12/13/20,4,127,127,469,6641,388,7123,77,10442,379,90,6441,200,309,79,4,0,66,11,6820,303,379,6441,103,200,482,6641,4,6,0,10
Searcy,12/13/20,6,129,129,406,4324,313,4753,87,7923,281,125,3614,710,255,58,3,3,23,64,3895,858,281,3614,148,710,429,4324,1,10,1,13
Sebastian,12/13/20,133,131,131,8079,87600,7175,95784,768,127461,7160,919,85497,2103,6442,733,127,6,589,179,92657,3127,7160,85497,1024,2103,8184,87600,38,56,1,442
Sevier,12/13/20,20,133,133,1863,9864,1769,11782,74,17193,1466,397,8582,1282,1417,352,19,1,30,44,10048,1734,1466,8582,452,1282,1918,9864,7,6,0,56
Sharp,12/13/20,25,135,135,870,9261,728,10186,117,17043,659,211,8239,1022,559,169,21,4,79,38,8898,1288,659,8239,266,1022,925,9261,16,2,1,60
St.Francis,12/13/20,18,123,123,2352,19457,2095,21831,239,26294,2271,81,19201,256,2020,75,18,0,233,6,21472,359,2271,19201,103,256,2374,19457,13,8,0,150
Stone,12/13/20,25,137,137,594,5925,478,6533,91,12446,518,76,5453,472,442,36,23,2,53,38,5971,562,518,5453,90,472,608,5925,2,6,0,12
Union,12/13/20,63,139,139,1836,15708,1615,17630,158,39732,1495,341,13574,2134,1324,291,54,9,117,41,15069,2561,1495,13574,427,2134,1922,15708,10,14,2,33
VanBuren,12/13/20,6,141,141,560,8447,432,9059,122,16684,442,118,7401,1046,354,78,5,1,83,39,7843,1216,442,7401,170,1046,612,8447,14,5,0,41
Washington,12/13/20,195,143,143,18041,141837,16006,160572,1839,228529,14966,3075,126392,15445,13444,2562,170,25,1352,487,141358,19214,14966,126392,3769,15445,18735,141837,126,120,1,789
White,12/13/20,63,145,145,3560,30802,3106,34574,389,78804,2626,934,26329,4473,2369,737,57,6,198,191,28955,5619,2626,26329,1146,4473,3772,30802,37,21,1,132
Woodruff,12/13/20,1,147,147,265,3371,216,3653,48,6660,219,46,3207,164,184,32,1,0,34,14,3426,227,219,3207,63,164,282,3371,3,3,0,15
Yell,12/13/20,36,149,149,1947,19128,1662,21102,249,21573,1822,125,18608,520,1576,86,33,3,213,36,20430,672,1822,18608,152,520,1974,19128,11,18,0,132
Arkansas_all_counties,12/12/20,2911,5630,5630,184252,1830359,159827,2020348,21489,2990671,157875,26377,1685156,145203,138686,21141,2619,292,16548,4941,1843031,177317,157875,1685156,32114,145203,189989,1830359,2628,1809,36,18809
Arkansas_county,12/12/20,24,1,1,1093,13084,960,14245,109,18124,856,237,10210,2874,756,204,22,2,78,31,11066,3179,856,10210,305,2874,1161,13084,17,13,0,96
Ashley,12/12/20,18,3,3,1052,9330,898,10414,136,20537,922,130,8838,492,791,107,17,1,114,22,9760,654,922,8838,162,492,1084,9330,23,10,0,138
Baxter,12/12/20,40,5,5,1654,11973,1428,13664,186,41219,1245,409,10591,1382,1095,333,36,4,114,72,11836,1828,1245,10591,446,1382,1691,11973,20,21,0,131
Benton,12/12/20,204,7,7,14209,118889,12594,133597,1410,258980,11631,2578,112883,6006,10549,2045,173,31,908,502,124514,9083,11631,112883,3077,6006,14708,118889,221,138,4,843
Boone,12/12/20,52,9,9,2154,20230,1849,22510,251,37288,1820,334,19395,835,1575,274,49,3,194,57,21215,1295,1820,19395,460,835,2280,20230,30,37,0,162
Bradley,12/12/20,7,11,11,672,6485,519,7176,146,10948,558,114,4609,1876,449,70,7,0,102,44,5167,2009,558,4609,133,1876,691,6485,21,11,0,44
Calhoun,12/12/20,1,13,13,175,2459,158,2644,16,5202,156,19,2353,106,139,19,1,0,16,0,2509,135,156,2353,29,106,185,2459,1,1,0,6
Carroll,12/12/20,24,15,15,1743,12359,1476,14136,243,27887,1565,178,12152,207,1356,120,24,0,185,58,13717,419,1565,12152,212,207,1777,12359,22,19,0,104
Chicot,12/12/20,30,17,17,1300,8363,1193,9679,77,10826,1226,74,7511,852,1136,57,29,1,61,16,8737,942,1226,7511,90,852,1316,8363,7,10,0,130
Clark,12/12/20,15,19,19,1058,14857,835,15963,208,22385,898,160,12713,2144,714,121,13,2,171,37,13611,2352,898,12713,208,2144,1106,14857,17,10,0,92
Clay,12/12/20,24,21,21,1117,10040,915,11190,177,15061,897,220,7782,2258,751,164,19,5,126,51,8679,2511,897,7782,253,2258,1150,10040,17,17,0,197
Cleburne,12/12/20,26,23,23,887,12913,732,13823,129,25230,702,185,11054,1859,598,134,25,1,79,50,11756,2067,702,11054,208,1859,910,12913,18,8,1,98
Cleveland,12/12/20,16,25,25,466,5678,375,6160,75,8226,338,128,5344,334,286,89,14,2,38,37,5682,478,338,5344,144,334,482,5678,6,2,0,96
Columbia,12/12/20,29,27,27,1321,11384,1152,12825,140,23892,959,362,9239,2145,839,313,26,3,94,46,10198,2627,959,9239,482,2145,1441,11384,18,11,0,153
Conway,12/12/20,10,29,29,910,12867,707,13813,193,20906,762,148,11327,1540,620,87,10,0,132,61,12089,1724,762,11327,184,1540,946,12867,23,12,0,116
Craighead,12/12/20,97,31,31,8333,70178,7246,78711,989,105701,7523,810,62724,7454,6564,682,90,7,868,121,70247,8464,7523,62724,1010,7454,8533,70178,93,67,2,936
Crawford,12/12/20,46,33,33,3653,39785,3135,43477,470,62472,3250,403,38605,1180,2828,307,41,5,379,91,41855,1622,3250,38605,442,1180,3692,39785,62,29,1,320
Crittenden,12/12/20,62,35,35,3693,23898,3313,27659,317,49013,3509,184,22877,1021,3156,157,55,7,297,20,26386,1273,3509,22877,252,1021,3761,23898,27,21,1,198
Cross,12/12/20,31,37,37,1084,9598,899,10705,154,16998,905,179,9108,490,746,153,30,1,129,25,10013,692,905,9108,202,490,1107,9598,23,9,2,176
Dallas,12/12/20,7,39,39,383,4034,307,4422,69,7432,353,30,3855,179,285,22,6,1,62,7,4208,214,353,3855,35,179,388,4034,8,5,0,34
Desha,12/12/20,10,41,41,740,7085,583,7862,147,11887,639,101,6453,632,514,69,9,1,116,31,7092,770,639,6453,138,632,777,7085,29,10,0,71
Drew,12/12/20,8,43,43,1128,11249,834,12408,286,18502,890,238,9780,1469,643,191,7,1,240,46,10670,1738,890,9780,269,1469,1159,11249,26,17,0,63
Faulkner,12/12/20,67,45,45,5926,71766,4964,77908,895,122416,5071,855,64807,6959,4354,610,57,10,660,235,69878,8030,5071,64807,1071,6959,6142,71766,102,64,1,841
Franklin,12/12/20,21,47,47,933,12079,805,13044,107,17780,799,134,11622,457,694,111,19,2,86,21,12421,623,799,11622,166,457,965,12079,11,11,1,92
Fulton,12/12/20,15,49,49,633,4013,558,4672,60,12139,481,152,3279,734,430,128,11,4,40,20,3760,912,481,3279,178,734,659,4013,13,6,1,28
Garland,12/12/20,127,51,51,4559,53778,3878,58438,552,98296,4095,464,50849,2929,3532,346,116,11,445,107,54944,3494,4095,50849,565,2929,4660,53778,75,67,1,473
Grant,12/12/20,8,53,53,739,9752,646,10519,85,18086,596,143,8620,1132,531,115,7,1,58,27,9216,1303,596,8620,171,1132,767,9752,6,13,0,62
Greene,12/12/20,39,55,55,3729,29123,3101,32968,589,44623,3049,680,26065,3058,2550,551,36,3,463,126,29114,3854,3049,26065,796,3058,3845,29123,59,46,1,304
Hempstead,12/12/20,9,57,57,1013,9874,895,10916,109,22018,814,199,9378,496,738,157,7,2,69,40,10192,724,814,9378,228,496,1042,9874,15,6,0,135
HotSpring,12/12/20,47,59,59,3148,27880,2917,31078,184,33520,2997,151,24677,3203,2795,122,44,3,158,26,27674,3404,2997,24677,201,3203,3198,27880,28,25,0,280
Howard,12/12/20,16,61,61,924,6345,835,7297,73,13389,711,213,5037,1308,658,177,16,0,37,36,5748,1549,711,5037,241,1308,952,6345,10,6,0,50
Independence,12/12/20,77,63,63,2339,21786,2070,24222,192,37264,1723,616,18994,2792,1552,518,62,15,109,83,20717,3505,1723,18994,713,2792,2436,21786,21,12,1,192
Izard,12/12/20,7,65,65,1069,9014,1009,10104,53,13559,938,131,7685,1329,898,111,7,0,33,20,8623,1481,938,7685,152,1329,1090,9014,8,10,0,42
Jackson,12/12/20,13,67,67,2414,16461,1846,19051,555,17225,2002,412,14399,2062,1502,344,10,3,490,65,16401,2650,2002,14399,588,2062,2590,16461,42,47,0,93
Jefferson,12/12/20,116,69,69,5658,54526,5153,60398,387,70424,5019,639,51254,3272,4659,494,107,9,251,136,56273,4125,5019,51254,853,3272,5872,54526,27,32,0,422
Johnson,12/12/20,14,71,71,1462,14833,1290,16312,158,26291,1332,130,14246,587,1199,91,12,2,121,37,15578,734,1332,14246,147,587,1479,14833,18,12,0,167
Lafayette,12/12/20,4,73,73,289,2109,273,2419,11,6915,232,57,1948,161,220,53,4,0,8,3,2180,239,232,1948,78,161,310,2109,4,1,0,28
Lawrence,12/12/20,33,75,75,1318,8687,1181,10053,104,16669,1114,204,8128,559,1007,174,32,1,75,29,9242,811,1114,8128,252,559,1366,8687,18,5,0,69
Lee,12/12/20,20,77,77,1319,7155,1185,8485,114,9398,1290,29,7002,153,1166,19,19,1,105,9,8292,193,1290,7002,40,153,1330,7155,15,13,0,119
Lincoln,12/12/20,20,79,79,2658,13706,2488,16407,150,13695,2498,160,12278,1428,2378,110,18,2,102,48,14776,1631,2498,12278,203,1428,2701,13706,13,13,0,55
LittleRiver,12/12/20,37,81,81,692,3470,634,4178,21,12417,573,119,3165,305,523,111,35,2,15,6,3738,440,573,3165,135,305,708,3470,1,6,0,25
Logan,12/12/20,8,83,83,1145,15204,989,16377,148,21757,1024,121,13472,1732,898,91,8,0,118,30,14496,1881,1024,13472,149,1732,1173,15204,22,7,0,336
Lonoke,12/12/20,64,85,85,3236,39898,2786,43311,386,72206,2466,770,34310,5588,2145,641,57,7,264,122,36776,6535,2466,34310,947,5588,3413,39898,57,29,0,285
Madison,12/12/20,9,87,87,815,7906,664,8750,142,16076,686,129,7412,494,572,92,9,0,105,37,8098,652,686,7412,158,494,844,7906,7,5,0,134
Marion,12/12/20,8,89,89,521,5937,453,6480,60,16438,416,105,5401,536,370,83,7,1,39,21,5817,663,416,5401,127,536,543,5937,7,12,0,42
Miller,12/12/20,22,91,91,2337,12103,2216,14518,99,43759,1721,616,11047,1056,1630,586,16,6,75,24,12768,1750,1721,11047,694,1056,2415,12103,11,12,0,95
MissingCountyInfo,12/12/20,0,5,5,2924,114545,2096,117495,828,NA,2409,515,114484,61,1657,439,0,0,752,76,116893,602,2409,114484,541,61,2950,114545,26,26,0,3053
Mississippi,12/12/20,87,93,93,3780,22939,3262,26779,430,42831,3455,325,18101,4838,2994,268,73,14,387,43,21556,5223,3455,18101,385,4838,3840,22939,56,29,0,319
Monroe,12/12/20,5,95,95,369,4255,316,4634,48,7249,326,43,4094,161,287,29,5,0,34,14,4420,214,326,4094,53,161,379,4255,7,4,0,31
Montgomery,12/12/20,12,97,97,393,4481,313,4880,68,8993,335,58,3159,1322,280,33,10,2,45,23,3494,1386,335,3159,64,1322,399,4481,4,5,0,21
Nevada,12/12/20,17,99,99,514,7505,459,8024,38,8440,448,66,7249,256,401,58,16,1,31,7,7697,327,448,7249,71,256,519,7505,6,5,0,65
Newton,12/12/20,24,101,101,497,3999,432,4507,41,7848,439,58,2777,1222,383,49,20,4,36,5,3216,1291,439,2777,69,1222,508,3999,4,6,0,74
Ouachita,12/12/20,16,103,103,1048,10876,837,11974,194,24106,951,97,10368,508,758,79,14,2,178,16,11319,655,951,10368,147,508,1098,10876,24,24,1,92
Perry,12/12/20,4,105,105,310,7231,260,7555,46,10322,270,40,6822,409,232,28,3,1,35,11,7092,463,270,6822,54,409,324,7231,1,4,0,44
Phillips,12/12/20,17,107,107,1068,11802,959,12900,92,19034,1015,53,11500,302,916,43,17,0,82,10,12515,385,1015,11500,83,302,1098,11802,21,4,0,89
Pike,12/12/20,4,109,109,487,4078,414,4575,69,10808,434,53,3720,358,372,42,3,1,59,10,4154,421,434,3720,63,358,497,4078,7,7,0,70
Poinsett,12/12/20,51,111,111,1953,16536,1657,18545,245,24054,1775,178,15793,743,1499,158,45,6,231,14,17568,977,1775,15793,234,743,2009,16536,29,15,0,130
Polk,12/12/20,19,113,113,1007,8383,844,9416,143,20163,921,86,7969,414,773,71,19,0,128,15,8890,526,921,7969,112,414,1033,8383,14,16,0,92
Pope,12/12/20,49,115,115,4328,41594,3825,45967,454,63644,3700,628,39938,1656,3324,501,43,6,333,121,43638,2329,3700,39938,673,1656,4373,41594,73,37,1,377
Prairie,12/12/20,9,117,117,412,4102,376,4539,27,8244,335,77,3637,465,307,69,8,1,20,7,3972,567,335,3637,102,465,437,4102,16,22,0,45
Pulaski,12/12/20,317,119,119,19611,240618,16982,260731,2310,393463,17823,1788,226793,13825,15582,1400,298,19,1941,369,244616,16115,17823,226793,2290,13825,20113,240618,258,179,4,2120
Randolph,12/12/20,35,121,121,1196,10501,991,11754,170,17603,958,238,9246,1255,797,194,27,8,134,36,10204,1550,958,9246,295,1255,1253,10501,13,16,0,86
Saline,12/12/20,75,125,125,6094,62009,5152,68407,866,118009,4935,1159,53860,8149,4216,936,69,6,649,217,58795,9612,4935,53860,1463,8149,6398,62009,118,123,3,609
Scott,12/12/20,4,127,127,465,6635,382,7113,79,10442,377,88,6435,200,303,79,4,0,70,9,6812,301,377,6435,101,200,478,6635,9,4,1,68
Searcy,12/12/20,5,129,129,405,4312,303,4740,97,7923,280,125,3606,706,250,53,3,2,27,70,3886,854,280,3606,148,706,428,4312,10,3,4,43
Sebastian,12/12/20,132,131,131,8041,87196,7119,95342,787,127461,7132,909,85111,2085,6401,718,126,6,603,184,92243,3099,7132,85111,1014,2085,8146,87196,123,85,1,634
Sevier,12/12/20,20,133,133,1856,9815,1763,11726,73,17193,1464,392,8547,1268,1417,346,19,1,28,45,10011,1715,1464,8547,447,1268,1911,9815,9,13,0,49
Sharp,12/12/20,24,135,135,854,9217,726,10125,104,17043,647,207,8198,1019,557,169,20,4,70,34,8845,1280,647,8198,261,1019,908,9217,15,14,2,84
St.Francis,12/12/20,18,123,123,2339,19320,2087,21681,234,26294,2258,81,19066,254,2014,73,18,0,226,8,21324,357,2258,19066,103,254,2361,19320,26,9,0,134
Stone,12/12/20,25,137,137,592,5915,472,6521,95,12446,516,76,5448,467,436,36,23,2,57,38,5964,557,516,5448,90,467,606,5915,9,8,0,39
Union,12/12/20,61,139,139,1826,15685,1601,17597,164,39732,1493,333,13551,2134,1317,284,52,9,124,40,15044,2553,1493,13551,419,2134,1912,15685,28,14,0,117
VanBuren,12/12/20,6,141,141,546,8420,427,9018,113,16684,429,117,7380,1040,353,74,5,1,71,42,7809,1209,429,7380,169,1040,598,8420,21,3,0,76
Washington,12/12/20,194,143,143,17915,141174,15886,159773,1834,228529,14855,3060,125874,15300,13362,2524,170,24,1323,511,140729,19044,14855,125874,3744,15300,18599,141174,263,161,2,1271
White,12/12/20,62,145,145,3523,30707,3085,34436,374,78804,2615,908,26272,4435,2364,721,56,6,193,181,28887,5549,2615,26272,1114,4435,3729,30707,65,25,0,165
Woodruff,12/12/20,1,147,147,262,3359,213,3637,48,6660,216,46,3195,164,182,31,1,0,33,15,3411,226,216,3195,62,164,278,3359,6,3,0,54
Yell,12/12/20,36,149,149,1936,19007,1644,20969,256,21573,1813,123,18485,522,1561,83,33,3,219,37,20298,671,1813,18485,149,522,1962,19007,48,7,0,185
Arkansas_all_counties,12/11/20,2875,5630,5630,181624,1814178,158018,2001369,20706,2990671,156011,25613,1672168,142010,137401,20617,2588,287,16000,4706,1828179,173190,156011,1672168,31180,142010,187191,1814178,2770,1732,55,18876
Arkansas_county,12/11/20,24,1,1,1076,13005,947,14148,105,18124,843,233,10158,2847,750,197,22,2,71,34,11001,3147,843,10158,300,2847,1143,13005,16,6,1,108
Ashley,12/11/20,18,3,3,1029,9215,888,10275,123,20537,899,130,8734,481,784,104,17,1,98,25,9633,642,899,8734,161,481,1060,9215,25,14,0,97
Baxter,12/11/20,40,5,5,1634,11862,1407,13534,187,41219,1234,400,10485,1377,1083,324,36,4,115,72,11719,1815,1234,10485,438,1377,1672,11862,16,12,2,156
Benton,12/11/20,200,7,7,13988,118267,12456,132733,1331,258980,11491,2497,112327,5940,10470,1986,169,31,851,480,123818,8915,11491,112327,2975,5940,14466,118267,213,124,7,1110
Boone,12/11/20,52,9,9,2124,20098,1812,22348,258,37288,1796,328,19320,778,1551,261,49,3,194,64,21116,1232,1796,19320,454,778,2250,20098,45,31,1,162
Bradley,12/11/20,7,11,11,651,6462,508,7130,136,10948,544,107,4591,1871,439,69,7,0,98,38,5135,1995,544,4591,124,1871,668,6462,11,15,0,66
Calhoun,12/11/20,1,13,13,174,2454,157,2637,16,5202,154,20,2350,104,137,20,1,0,16,0,2504,133,154,2350,29,104,183,2454,3,1,0,17
Carroll,12/11/20,24,15,15,1721,12277,1457,14031,240,27887,1550,171,12078,199,1342,115,24,0,184,56,13628,403,1550,12078,204,199,1754,12277,37,18,1,117
Chicot,12/11/20,30,17,17,1293,8240,1183,9548,80,10826,1220,73,7424,816,1131,52,29,1,60,20,8644,904,1220,7424,88,816,1308,8240,6,6,0,50
Clark,12/11/20,15,19,19,1041,14782,825,15865,201,22385,877,164,12651,2131,707,118,13,2,157,44,13528,2337,877,12651,206,2131,1083,14782,41,11,1,198
Clay,12/11/20,24,21,21,1100,9860,898,10994,177,15061,883,217,7720,2140,742,156,19,5,121,56,8603,2391,883,7720,251,2140,1134,9860,15,13,0,76
Cleburne,12/11/20,25,23,23,869,12833,724,13725,120,25230,694,175,10996,1837,590,134,24,1,80,40,11690,2035,694,10996,198,1837,892,12833,15,9,0,160
Cleveland,12/11/20,16,25,25,460,5588,373,6064,71,8226,332,128,5259,329,285,88,14,2,33,38,5591,473,332,5259,144,329,476,5588,13,12,1,87
Columbia,12/11/20,29,27,27,1303,11249,1141,12668,133,23892,950,353,9135,2114,836,305,26,3,88,45,10085,2583,950,9135,469,2114,1419,11249,38,17,1,314
Conway,12/11/20,10,29,29,887,12774,695,13697,182,20906,745,142,11246,1528,614,81,10,0,121,61,11991,1706,745,11246,178,1528,923,12774,28,13,2,229
Craighead,12/11/20,95,31,31,8240,69335,7179,77771,965,105701,7441,799,62226,7109,6503,676,88,7,849,116,69667,8104,7441,62226,995,7109,8436,69335,103,72,0,620
Crawford,12/11/20,45,33,33,3591,39527,3106,43157,438,62472,3200,391,38372,1155,2806,300,40,5,352,86,41572,1585,3200,38372,430,1155,3630,39527,45,39,0,415
Crittenden,12/11/20,61,35,35,3666,23727,3292,27460,312,49013,3485,181,22734,993,3136,156,54,7,294,18,26219,1241,3485,22734,248,993,3733,23727,61,25,1,293
Cross,12/11/20,29,37,37,1061,9445,890,10531,142,16998,891,170,8980,465,744,146,28,1,119,23,9871,660,891,8980,195,465,1086,9445,32,22,0,149
Dallas,12/11/20,7,39,39,375,4008,302,4388,66,7432,346,29,3832,176,280,22,6,1,60,6,4178,210,346,3832,34,176,380,4008,8,3,1,67
Desha,12/11/20,10,41,41,711,7043,573,7789,128,11887,613,98,6414,629,506,67,9,1,98,30,7027,762,613,6414,133,629,746,7043,7,8,0,98
Drew,12/11/20,8,43,43,1102,11212,817,12342,277,18502,865,237,9750,1462,630,187,7,1,228,49,10615,1727,865,9750,265,1462,1130,11212,32,21,0,198
Faulkner,12/11/20,66,45,45,5824,71027,4900,77061,858,122416,4986,838,64163,6864,4314,586,56,10,616,242,69149,7912,4986,64163,1048,6864,6034,71027,143,73,1,932
Franklin,12/11/20,20,47,47,922,11998,794,12952,108,17780,789,133,11558,440,685,109,18,2,86,22,12347,605,789,11558,165,440,954,11998,15,10,2,129
Fulton,12/11/20,14,49,49,620,3998,552,4643,54,12139,474,146,3267,731,424,128,11,3,39,15,3741,902,474,3267,171,731,645,3998,5,3,1,31
Garland,12/11/20,126,51,51,4484,53380,3811,57963,545,98296,4049,435,50683,2697,3484,327,115,11,448,97,54732,3231,4049,50683,534,2697,4583,53380,57,48,2,438
Grant,12/11/20,8,53,53,733,9696,633,10453,92,18086,591,142,8589,1107,521,112,7,1,63,29,9180,1273,591,8589,166,1107,757,9696,18,19,1,83
Greene,12/11/20,38,55,55,3670,28878,3055,32661,577,44623,3001,669,25893,2985,2512,543,35,3,454,123,28894,3767,3001,25893,782,2985,3783,28878,42,41,2,247
Hempstead,12/11/20,9,57,57,998,9754,889,10780,100,22018,808,190,9263,491,737,152,7,2,64,36,10071,709,808,9263,218,491,1026,9754,22,10,0,130
HotSpring,12/11/20,47,59,59,3120,27628,2892,30797,181,33520,2974,146,24493,3135,2775,117,44,3,155,26,27467,3330,2974,24493,195,3135,3169,27628,21,19,0,306
Howard,12/11/20,16,61,61,914,6305,829,7246,69,13389,707,207,5013,1292,658,171,16,0,33,36,5720,1526,707,5013,234,1292,941,6305,18,6,0,52
Independence,12/11/20,76,63,63,2318,21615,2058,24027,184,37264,1711,607,18904,2711,1544,514,62,14,105,79,20615,3412,1711,18904,701,2711,2412,21615,20,25,2,142
Izard,12/11/20,7,65,65,1061,8980,999,10062,55,13559,933,128,7673,1307,889,110,7,0,37,18,8606,1456,933,7673,149,1307,1082,8980,4,3,0,59
Jackson,12/11/20,13,67,67,2372,16410,1799,18954,560,17225,1964,408,14367,2043,1462,337,10,3,492,68,16331,2623,1964,14367,580,2043,2544,16410,33,50,1,132
Jefferson,12/11/20,116,69,69,5631,54131,5121,59974,392,70424,5007,624,51008,3123,4641,480,107,9,257,135,56015,3959,5007,51008,836,3123,5843,54131,74,21,0,391
Johnson,12/11/20,14,71,71,1444,14684,1278,16145,152,26291,1319,125,14101,583,1188,90,12,2,119,33,15420,725,1319,14101,142,583,1461,14684,27,9,1,221
Lafayette,12/11/20,4,73,73,285,2085,272,2391,8,6915,230,55,1928,157,219,53,4,0,7,1,2158,233,230,1928,76,157,306,2085,2,1,1,28
Lawrence,12/11/20,33,75,75,1300,8636,1176,9983,91,16669,1101,199,8084,552,1002,174,32,1,67,24,9185,798,1101,8084,246,552,1347,8636,18,7,1,96
Lee,12/11/20,20,77,77,1304,7051,1172,8366,112,9398,1276,28,6905,146,1155,17,19,1,102,10,8181,185,1276,6905,39,146,1315,7051,13,7,0,79
Lincoln,12/11/20,20,79,79,2645,13664,2475,16351,150,13695,2490,155,12245,1419,2367,108,18,2,105,45,14735,1616,2490,12245,197,1419,2687,13664,13,14,0,173
LittleRiver,12/11/20,37,81,81,691,3446,628,4153,26,12417,572,119,3145,301,521,107,35,2,16,10,3717,436,572,3145,135,301,707,3446,3,5,0,20
Logan,12/11/20,8,83,83,1123,14890,982,16040,133,21757,1009,114,13385,1505,895,87,8,0,106,27,14394,1646,1009,13385,141,1505,1150,14890,18,26,0,115
Lonoke,12/11/20,64,85,85,3179,39670,2757,43023,358,72206,2436,743,34101,5569,2126,631,57,7,253,105,36537,6486,2436,34101,917,5569,3353,39670,55,35,1,446
Madison,12/11/20,9,87,87,808,7779,659,8616,140,16076,680,128,7302,477,569,90,9,0,102,38,7982,634,680,7302,157,477,837,7779,21,14,0,70
Marion,12/11/20,8,89,89,514,5902,441,6438,65,16438,414,100,5372,530,360,81,7,1,47,18,5786,652,414,5372,122,530,536,5902,11,8,0,109
Miller,12/11/20,22,91,91,2326,12019,2204,14423,100,43759,1714,612,11000,1019,1623,581,16,6,75,25,12714,1709,1714,11000,690,1019,2404,12019,18,22,0,66
MissingCountyInfo,12/11/20,0,5,5,2898,111518,2070,114436,828,NA,2424,474,111456,62,1657,413,0,0,767,61,113880,556,2424,111456,494,62,2918,111518,40,36,0,1606
Mississippi,12/11/20,87,93,93,3724,22676,3233,26458,403,42831,3407,317,17957,4719,2970,263,73,14,363,40,21364,5094,3407,17957,375,4719,3782,22676,45,51,0,372
Monroe,12/11/20,5,95,95,362,4231,312,4603,45,7249,320,42,4073,158,285,27,5,0,30,15,4393,210,320,4073,52,158,372,4231,10,5,0,50
Montgomery,12/11/20,12,97,97,389,4464,308,4858,69,8993,333,56,3149,1315,278,30,10,2,45,24,3482,1376,333,3149,61,1315,394,4464,8,6,1,44
Nevada,12/11/20,17,99,99,508,7446,454,7959,37,8440,445,63,7190,256,397,57,16,1,32,5,7635,324,445,7190,68,256,513,7446,3,4,0,95
Newton,12/11/20,24,101,101,493,3929,426,4433,43,7848,436,57,2765,1164,379,47,20,4,37,6,3201,1232,436,2765,68,1164,504,3929,1,0,1,22
Ouachita,12/11/20,15,103,103,1024,10808,813,11881,195,24106,929,95,10308,500,738,75,14,1,176,19,11237,644,929,10308,144,500,1073,10808,19,14,1,164
Perry,12/11/20,4,105,105,309,7188,256,7511,49,10322,269,40,6784,404,229,27,3,1,37,12,7053,458,269,6784,54,404,323,7188,6,3,0,65
Phillips,12/11/20,17,107,107,1047,11734,955,12811,75,19034,995,52,11443,291,912,43,17,0,66,9,12438,373,995,11443,82,291,1077,11734,7,6,0,178
Pike,12/11/20,4,109,109,480,4015,407,4504,69,10808,429,51,3702,313,367,40,3,1,59,10,4131,373,429,3702,60,313,489,4015,9,9,0,51
Poinsett,12/11/20,51,111,111,1924,16435,1642,18413,231,24054,1748,176,15709,726,1485,157,45,6,218,13,17457,956,1748,15709,230,726,1978,16435,34,8,1,228
Polk,12/11/20,19,113,113,993,8305,828,9324,145,20163,907,86,7892,413,758,70,19,0,129,16,8799,525,907,7892,112,413,1019,8305,6,23,0,81
Pope,12/11/20,48,115,115,4255,41290,3788,45588,419,63644,3642,613,39668,1622,3300,488,42,6,300,119,43310,2278,3642,39668,656,1622,4298,41290,69,22,0,311
Prairie,12/11/20,9,117,117,396,4073,354,4494,33,8244,322,74,3611,462,290,64,8,1,24,9,3933,561,322,3611,99,462,421,4073,4,3,0,28
Pulaski,12/11/20,313,119,119,19353,238756,16803,258594,2235,393463,17613,1740,225153,13603,15428,1375,294,19,1889,346,242766,15828,17613,225153,2225,13603,19838,238756,280,159,6,1822
Randolph,12/11/20,35,121,121,1183,10428,975,11666,173,17603,946,237,9187,1241,785,190,27,8,134,39,10133,1533,946,9187,292,1241,1238,10428,16,9,1,201
Saline,12/11/20,72,125,125,5976,61518,5029,67781,874,118009,4848,1128,53581,7937,4122,907,66,6,659,215,58429,9352,4848,53581,1415,7937,6263,61518,147,75,4,644
Scott,12/11/20,3,127,127,456,6576,378,7045,75,10442,370,86,6387,189,300,78,3,0,67,8,6757,288,370,6387,99,189,469,6576,2,8,0,50
Searcy,12/11/20,1,129,129,395,4279,300,4696,94,7923,276,119,3588,691,251,49,1,0,24,70,3864,832,276,3588,141,691,417,4279,18,2,0,48
Sebastian,12/11/20,131,131,131,7918,86685,7034,94704,750,127461,7043,875,84667,2018,6343,691,125,6,573,177,91710,2994,7043,84667,976,2018,8019,86685,90,89,2,729
Sevier,12/11/20,20,133,133,1847,9775,1750,11677,77,17193,1461,386,8525,1250,1412,338,19,1,30,47,9986,1691,1461,8525,441,1250,1902,9775,11,12,0,76
Sharp,12/11/20,22,135,135,839,9148,712,10039,105,17043,639,200,8152,996,542,170,18,4,79,26,8791,1248,639,8152,252,996,891,9148,17,10,0,104
St.Francis,12/11/20,18,123,123,2313,19212,2078,21547,217,26294,2235,78,18979,233,2009,69,18,0,208,9,21214,333,2235,18979,100,233,2335,19212,32,15,1,222
Stone,12/11/20,25,137,137,583,5885,464,6482,94,12446,509,74,5426,459,433,31,23,2,53,41,5935,547,509,5426,88,459,597,5885,10,4,0,121
Union,12/11/20,61,139,139,1798,15596,1587,17477,150,39732,1473,325,13486,2110,1310,277,52,9,111,39,14959,2518,1473,13486,408,2110,1881,15596,23,14,0,339
VanBuren,12/11/20,6,141,141,525,8365,424,8939,95,16684,415,110,7333,1032,350,74,5,1,60,35,7748,1191,415,7333,159,1032,574,8365,18,6,1,123
Washington,12/11/20,192,143,143,17652,140166,15725,158488,1734,228529,14712,2940,125062,15104,13248,2477,168,24,1296,438,139774,18714,14712,125062,3610,15104,18322,140166,275,123,0,1346
White,12/11/20,62,145,145,3458,30607,3060,34265,334,78804,2590,868,26187,4420,2351,709,56,6,181,153,28777,5488,2590,26187,1068,4420,3658,30607,59,31,0,313
Woodruff,12/11/20,1,147,147,256,3311,210,3583,45,6660,212,44,3149,162,181,29,1,0,30,15,3361,222,212,3149,60,162,272,3311,6,4,0,49
Yell,12/11/20,36,149,149,1888,18870,1637,20776,215,21573,1775,113,18375,495,1554,83,33,3,188,27,20150,626,1775,18375,131,495,1906,18870,24,13,1,112
Arkansas_all_counties,12/10/20,2820,5630,5630,178854,1798072,156286,1982317,19723,2990671,154073,24781,1658925,139147,136150,20136,2559,261,15342,4381,1812998,169319,154073,1658925,30172,139147,184245,1798072,2202,1209,34,14539
Arkansas_county,12/10/20,23,1,1,1060,12913,941,14038,96,18124,831,229,10078,2835,744,197,22,1,65,31,10909,3129,831,10078,294,2835,1125,12913,6,5,0,90
Ashley,12/10/20,18,3,3,1004,9143,874,10175,112,20537,879,125,8673,470,772,102,17,1,90,22,9552,623,879,8673,153,470,1032,9143,16,18,0,58
Baxter,12/10/20,38,5,5,1618,11722,1395,13377,185,41219,1229,389,10391,1331,1076,319,36,2,117,68,11620,1757,1229,10391,426,1331,1655,11722,22,8,1,146
Benton,12/10/20,193,7,7,13775,117370,12332,131602,1249,258980,11345,2430,111562,5808,10367,1965,165,28,812,437,122907,8695,11345,111562,2887,5808,14232,117370,141,111,3,674
Boone,12/10/20,51,9,9,2079,19981,1781,22187,245,37288,1779,300,19217,764,1532,249,48,3,197,48,20996,1191,1779,19217,427,764,2206,19981,17,20,1,205
Bradley,12/10/20,7,11,11,640,6407,493,7064,140,10948,538,102,4547,1860,426,67,7,0,105,35,5085,1979,538,4547,119,1860,657,6407,15,7,0,30
Calhoun,12/10/20,1,13,13,171,2440,156,2619,14,5202,151,20,2338,102,136,20,1,0,14,0,2489,130,151,2338,28,102,179,2440,4,5,0,22
Carroll,12/10/20,23,15,15,1684,12197,1439,13914,222,27887,1522,162,11999,198,1329,110,23,0,170,52,13521,393,1522,11999,195,198,1717,12197,18,13,0,93
Chicot,12/10/20,30,17,17,1287,8196,1177,9497,80,10826,1216,71,7397,799,1125,52,29,1,62,18,8613,884,1216,7397,85,799,1301,8196,8,6,0,21
Clark,12/10/20,14,19,19,1000,14625,814,15663,172,22385,860,140,12561,2064,696,118,12,2,152,20,13421,2242,860,12561,178,2064,1038,14625,20,6,1,186
Clay,12/10/20,24,21,21,1085,9799,885,10919,175,15061,875,210,7668,2131,731,154,19,5,124,51,8543,2376,875,7668,245,2131,1120,9799,14,11,0,82
Cleburne,12/10/20,25,23,23,854,12688,715,13564,114,25230,686,168,10920,1768,586,129,24,1,76,38,11606,1958,686,10920,190,1768,876,12688,10,11,0,55
Cleveland,12/10/20,15,25,25,447,5514,361,5977,71,8226,329,118,5222,292,279,82,14,1,36,35,5551,426,329,5222,134,292,463,5514,8,4,0,21
Columbia,12/10/20,28,27,27,1265,10973,1124,12335,113,23892,920,345,8975,1998,823,301,26,2,71,42,9895,2440,920,8975,442,1998,1362,10973,12,14,1,42
Conway,12/10/20,8,29,29,859,12573,682,13468,169,20906,736,123,11171,1402,607,75,8,0,121,48,11907,1561,736,11171,159,1402,895,12573,22,10,0,119
Craighead,12/10/20,95,31,31,8137,68818,7107,77150,934,105701,7360,777,61752,7066,6437,670,88,7,834,100,69112,8038,7360,61752,972,7066,8332,68818,90,57,0,517
Crawford,12/10/20,45,33,33,3546,39157,3067,42741,432,62472,3173,373,38060,1097,2777,290,40,5,354,78,41233,1508,3173,38060,411,1097,3584,39157,48,19,1,207
Crittenden,12/10/20,60,35,35,3605,23495,3267,27164,277,49013,3425,180,22513,982,3111,156,53,7,260,17,25938,1226,3425,22513,244,982,3669,23495,17,18,1,216
Cross,12/10/20,29,37,37,1029,9328,868,10382,132,16998,865,164,8869,459,729,139,28,1,108,24,9734,648,865,8869,189,459,1054,9328,40,12,0,136
Dallas,12/10/20,6,39,39,367,3949,299,4321,62,7432,339,28,3777,172,278,21,6,0,55,7,4116,205,339,3777,33,172,372,3949,4,4,0,44
Desha,12/10/20,10,41,41,704,6952,565,7691,129,11887,610,94,6364,588,503,62,9,1,98,31,6974,717,610,6364,129,588,739,6952,13,6,1,43
Drew,12/10/20,8,43,43,1070,11046,796,12141,266,18502,841,229,9613,1433,610,186,7,1,224,42,10454,1687,841,9613,254,1433,1095,11046,19,25,0,82
Faulkner,12/10/20,65,45,45,5681,70238,4827,76123,789,122416,4887,794,63634,6604,4270,557,56,9,561,228,68521,7602,4887,63634,998,6604,5885,70238,94,42,2,431
Franklin,12/10/20,18,47,47,907,11884,784,12822,105,17780,777,130,11451,433,678,106,17,1,82,23,12228,594,777,11451,161,433,938,11884,9,6,1,117
Fulton,12/10/20,13,49,49,615,3972,549,4612,53,12139,470,145,3244,728,421,128,11,2,38,15,3714,898,470,3244,170,728,640,3972,6,3,0,30
Garland,12/10/20,124,51,51,4427,52999,3763,57516,538,98296,4005,422,50381,2618,3442,321,114,10,447,91,54386,3130,4005,50381,512,2618,4517,52999,38,32,4,424
Grant,12/10/20,7,53,53,715,9631,614,10369,94,18086,579,136,8535,1096,509,105,6,1,64,30,9114,1255,579,8535,159,1096,738,9631,9,8,0,43
Greene,12/10/20,36,55,55,3628,28673,3014,32411,578,44623,2966,662,25732,2941,2474,540,34,2,458,120,28698,3713,2966,25732,772,2941,3738,28673,24,34,1,228
Hempstead,12/10/20,9,57,57,976,9646,879,10650,88,22018,795,181,9180,466,733,146,7,2,55,33,9975,675,795,9180,209,466,1004,9646,10,2,0,53
HotSpring,12/10/20,47,59,59,3099,27343,2873,30491,179,33520,2957,142,24236,3107,2763,110,44,3,150,29,27193,3298,2957,24236,191,3107,3148,27343,33,12,1,293
Howard,12/10/20,16,61,61,896,6271,823,7192,57,13389,696,200,4987,1284,655,168,16,0,25,32,5683,1509,696,4987,225,1284,921,6271,5,7,0,60
Independence,12/10/20,74,63,63,2298,21493,2033,23884,191,37264,1698,600,18797,2696,1532,501,62,12,104,87,20495,3389,1698,18797,693,2696,2391,21493,16,16,0,90
Izard,12/10/20,7,65,65,1057,8925,996,10002,54,13559,929,128,7633,1292,886,110,7,0,36,18,8562,1440,929,7633,148,1292,1077,8925,7,6,0,100
Jackson,12/10/20,12,67,67,2339,16311,1749,18811,578,17225,1938,401,14270,2041,1416,333,10,2,512,66,16208,2603,1938,14270,562,2041,2500,16311,137,4,0,322
Jefferson,12/10/20,116,69,69,5557,53814,5100,59581,339,70424,4941,616,50812,3002,4634,466,107,9,198,141,55753,3828,4941,50812,826,3002,5767,53814,38,16,0,327
Johnson,12/10/20,13,71,71,1417,14490,1269,15923,135,26291,1298,119,13922,568,1180,89,12,1,106,29,15220,703,1298,13922,135,568,1433,14490,20,3,0,462
Lafayette,12/10/20,3,73,73,283,2059,271,2363,8,6915,228,55,1910,149,219,52,3,0,6,2,2138,225,228,1910,76,149,304,2059,2,0,0,15
Lawrence,12/10/20,32,75,75,1282,8558,1169,9887,81,16669,1087,195,8013,545,997,172,32,0,58,23,9100,787,1087,8013,242,545,1329,8558,3,7,0,60
Lee,12/10/20,20,77,77,1291,6985,1165,8287,106,9398,1265,26,6841,144,1148,17,19,1,98,8,8106,181,1265,6841,37,144,1302,6985,17,-1,0,40
Lincoln,12/10/20,20,79,79,2632,13504,2461,16175,151,13695,2479,153,12117,1387,2362,99,18,2,99,52,14596,1579,2479,12117,192,1387,2671,13504,8,8,1,32
LittleRiver,12/10/20,37,81,81,688,3429,623,4133,28,12417,571,117,3137,292,519,104,35,2,17,11,3708,425,571,3137,133,292,704,3429,3,5,0,15
Logan,12/10/20,8,83,83,1105,14793,956,15925,141,21757,996,109,13297,1496,870,86,8,0,118,23,14293,1632,996,13297,136,1496,1132,14793,11,15,0,182
Lonoke,12/10/20,63,85,85,3124,39279,2722,42576,339,72206,2394,730,33840,5439,2104,618,56,7,234,105,36234,6342,2394,33840,903,5439,3297,39279,39,30,3,170
Madison,12/10/20,9,87,87,787,7730,645,8545,133,16076,667,120,7254,476,559,86,9,0,99,34,7921,624,667,7254,148,476,815,7730,13,13,0,105
Marion,12/10/20,8,89,89,503,5804,433,6329,62,16438,408,95,5289,515,354,79,7,1,47,15,5697,632,408,5289,117,515,525,5804,4,3,0,68
Miller,12/10/20,22,91,91,2308,11971,2182,14356,104,43759,1705,603,10969,1002,1615,567,16,6,74,30,12674,1682,1705,10969,680,1002,2385,11971,19,9,0,64
MissingCountyInfo,12/10/20,0,5,5,2858,109952,2034,112824,824,NA,2407,451,109891,61,1661,373,0,0,746,78,112298,526,2407,109891,465,61,2872,109952,121,39,0,1596
Mississippi,12/10/20,87,93,93,3679,22349,3182,26084,409,42831,3376,303,17833,4516,2929,253,73,14,373,36,21209,4875,3376,17833,359,4516,3735,22349,29,24,0,167
Monroe,12/10/20,5,95,95,352,4191,307,4553,40,7249,314,38,4034,157,281,26,5,0,28,12,4348,205,314,4034,48,157,362,4191,2,3,0,22
Montgomery,12/10/20,11,97,97,381,4428,302,4814,68,8993,327,54,3121,1307,274,28,10,1,43,25,3448,1366,327,3121,59,1307,386,4428,8,2,0,14
Nevada,12/10/20,17,99,99,505,7354,450,7864,38,8440,444,61,7107,247,395,55,16,1,33,5,7551,313,444,7107,66,247,510,7354,4,7,1,86
Newton,12/10/20,23,101,101,492,3908,426,4411,43,7848,435,57,2750,1158,378,48,20,3,37,6,3185,1226,435,2750,68,1158,503,3908,1,1,0,28
Ouachita,12/10/20,14,103,103,1005,10663,799,11716,191,24106,915,90,10193,470,724,75,14,0,176,15,11108,608,915,10193,138,470,1053,10663,20,19,0,98
Perry,12/10/20,4,105,105,303,7129,253,7445,46,10322,265,38,6739,390,227,26,3,1,35,11,7004,441,265,6739,51,390,316,7129,4,1,0,26
Phillips,12/10/20,17,107,107,1040,11563,949,12632,74,19034,989,51,11273,290,908,41,17,0,64,10,12262,370,989,11273,80,290,1069,11563,10,4,0,58
Pike,12/10/20,4,109,109,471,3973,398,4452,69,10808,424,47,3664,309,359,39,3,1,62,7,4088,364,424,3664,55,309,479,3973,2,5,0,32
Poinsett,12/10/20,50,111,111,1890,16241,1634,18183,206,24054,1714,176,15535,706,1478,156,44,6,192,14,17249,934,1714,15535,228,706,1942,16241,29,8,1,151
Polk,12/10/20,19,113,113,987,8230,805,9243,162,20163,903,84,7824,406,740,65,19,0,143,19,8727,516,903,7824,110,406,1013,8230,18,6,0,70
Pope,12/10/20,48,115,115,4186,41048,3766,45272,372,63644,3603,583,39466,1582,3284,482,42,6,277,95,43069,2203,3603,39466,621,1582,4224,41048,28,25,1,863
Prairie,12/10/20,9,117,117,392,4049,351,4466,32,8244,318,74,3594,455,287,64,8,1,23,9,3912,554,318,3594,99,455,417,4049,2,0,0,11
Pulaski,12/10/20,307,119,119,19073,237214,16644,256761,2120,393463,17380,1693,223774,13440,15301,1343,289,18,1788,332,241154,15607,17380,223774,2167,13440,19547,237214,240,116,0,1205
Randolph,12/10/20,34,121,121,1167,10243,966,11463,167,17603,932,235,9010,1233,775,191,27,7,130,37,9942,1521,932,9010,288,1233,1220,10243,25,2,1,106
Saline,12/10/20,68,125,125,5829,61021,4954,67127,806,118009,4743,1086,53181,7840,4068,886,63,5,611,195,57924,9203,4743,53181,1363,7840,6106,61021,82,74,0,312
Scott,12/10/20,3,127,127,454,6528,370,6995,81,10442,368,86,6339,189,294,76,3,0,71,10,6707,288,368,6339,99,189,467,6528,6,0,0,48
Searcy,12/10/20,1,129,129,377,4249,298,4648,78,7923,268,109,3563,686,249,49,1,0,18,60,3831,817,268,3563,131,686,399,4249,4,1,0,25
Sebastian,12/10/20,129,131,131,7828,86046,6945,93973,751,127461,7010,818,84094,1952,6292,653,124,5,592,159,91104,2869,7010,84094,917,1952,7927,86046,89,41,2,475
Sevier,12/10/20,20,133,133,1836,9710,1738,11601,78,17193,1459,377,8505,1205,1411,327,19,1,29,49,9964,1637,1459,8505,432,1205,1891,9710,8,5,0,122
Sharp,12/10/20,22,135,135,822,9061,702,9935,98,17043,628,194,8076,985,536,166,18,4,74,24,8704,1231,628,8076,246,985,874,9061,11,1,0,99
St.Francis,12/10/20,17,123,123,2281,19022,2063,21325,201,26294,2204,77,18798,224,1996,67,17,0,191,10,21002,323,2204,18798,99,224,2303,19022,41,7,0,278
Stone,12/10/20,25,137,137,573,5774,460,6358,88,12446,499,74,5330,444,429,31,23,2,47,41,5829,529,499,5330,85,444,584,5774,7,6,0,39
Union,12/10/20,61,139,139,1775,15280,1573,17135,141,39732,1461,314,13345,1935,1301,272,52,9,108,33,14806,2329,1461,13345,394,1935,1855,15280,26,14,1,171
VanBuren,12/10/20,5,141,141,507,8260,418,8815,84,16684,404,103,7250,1010,348,70,4,1,52,32,7654,1161,404,7250,151,1010,555,8260,23,7,0,89
Washington,12/10/20,192,143,143,17377,139095,15602,157122,1582,228529,14526,2851,124068,15027,13161,2441,168,24,1197,385,138594,18528,14526,124068,3501,15027,18027,139095,180,97,3,980
White,12/10/20,62,145,145,3399,30353,3029,33950,306,78804,2551,848,26019,4334,2325,704,56,6,168,138,28570,5380,2551,26019,1046,4334,3597,30353,10,11,1,119
Woodruff,12/10/20,1,147,147,250,3268,206,3533,43,6660,207,43,3109,159,178,28,1,0,28,15,3316,217,207,3109,58,159,265,3268,13,1,0,45
Yell,12/10/20,35,149,149,1864,18782,1624,20665,205,21573,1754,110,18292,490,1547,77,32,3,175,30,20046,619,1754,18292,129,490,1883,18782,30,12,0,384
Arkansas_all_counties,12/9/20,2786,5630,5630,176652,1785735,155077,1967643,18765,2990671,152369,24283,1647665,138070,135214,19863,2552,234,14581,4184,1800034,167609,152369,1647665,29539,138070,181908,1785735,2327,1989,34,21085
Arkansas_county,12/9/20,23,1,1,1054,12829,936,13945,95,18124,823,231,9997,2832,741,195,22,1,60,35,10820,3125,823,9997,293,2832,1116,12829,8,8,0,55
Ashley,12/9/20,18,3,3,988,9101,856,10117,114,20537,869,119,8631,470,759,97,17,1,93,21,9500,617,869,8631,147,470,1016,9101,13,22,2,125
Baxter,12/9/20,37,5,5,1596,11598,1387,13230,172,41219,1218,378,10272,1326,1071,316,36,1,111,61,11490,1740,1218,10272,414,1326,1632,11598,20,24,3,140
Benton,12/9/20,190,7,7,13634,116837,12221,130917,1222,258980,11259,2375,111127,5710,10281,1940,164,26,813,409,122386,8531,11259,111127,2821,5710,14080,116837,197,163,2,1121
Boone,12/9/20,50,9,9,2062,19793,1761,21982,249,37288,1766,296,19059,734,1514,247,48,2,202,47,20825,1157,1766,19059,423,734,2189,19793,29,29,0,203
Bradley,12/9/20,7,11,11,625,6392,486,7033,132,10948,526,99,4535,1857,419,67,7,0,100,32,5061,1972,526,4535,115,1857,641,6392,14,5,0,68
Calhoun,12/9/20,1,13,13,167,2422,151,2597,15,5202,148,19,2322,100,132,19,1,0,15,0,2470,127,148,2322,27,100,175,2422,0,1,0,14
Carroll,12/9/20,23,15,15,1666,12122,1426,13821,217,27887,1508,158,11926,196,1317,109,23,0,168,49,13434,387,1508,11926,191,196,1699,12122,20,23,0,185
Chicot,12/9/20,30,17,17,1279,8183,1171,9476,78,10826,1210,69,7384,799,1120,51,29,1,61,17,8594,882,1210,7384,83,799,1293,8183,6,9,0,160
Clark,12/9/20,13,19,19,980,14459,808,15475,159,22385,846,134,12501,1958,689,119,12,1,145,14,13347,2128,846,12501,170,1958,1016,14459,27,7,0,253
Clay,12/9/20,24,21,21,1071,9731,874,10837,172,15061,868,203,7604,2127,722,152,19,5,126,46,8472,2365,868,7604,238,2127,1106,9731,16,18,0,154
Cleburne,12/9/20,25,23,23,844,12643,704,13510,115,25230,683,161,10883,1760,578,126,24,1,81,34,11566,1944,683,10883,184,1760,867,12643,13,10,0,177
Cleveland,12/9/20,15,25,25,439,5501,357,5951,67,8226,320,119,5210,291,277,80,14,1,29,38,5530,421,320,5210,130,291,450,5501,7,7,0,39
Columbia,12/9/20,27,27,27,1253,10943,1110,12292,116,23892,915,338,8945,1998,813,297,26,1,76,40,9860,2432,915,8945,434,1998,1349,10943,31,24,0,226
Conway,12/9/20,8,29,29,837,12476,672,13345,157,20906,716,121,11080,1396,599,73,8,0,109,48,11796,1549,716,11080,153,1396,869,12476,16,9,0,174
Craighead,12/9/20,95,31,31,8047,68391,7050,76632,901,105701,7277,770,61341,7050,6384,666,88,7,804,97,68618,8014,7277,61341,964,7050,8241,68391,123,97,2,877
Crawford,12/9/20,44,33,33,3498,38998,3048,42531,404,62472,3135,363,37912,1086,2762,286,39,5,332,72,41047,1484,3135,37912,398,1086,3533,38998,67,33,0,361
Crittenden,12/9/20,59,35,35,3588,23296,3249,26947,279,49013,3414,174,22324,972,3092,157,53,6,268,11,25738,1209,3414,22324,237,972,3651,23296,50,24,0,379
Cross,12/9/20,29,37,37,989,9232,856,10245,104,16998,829,160,8777,455,721,135,28,1,80,24,9606,639,829,8777,184,455,1013,9232,18,11,1,196
Dallas,12/9/20,6,39,39,363,3909,295,4277,62,7432,336,27,3744,165,276,19,6,0,54,8,4080,197,336,3744,32,165,368,3909,6,2,0,30
Desha,12/9/20,9,41,41,691,6922,559,7648,123,11887,598,93,6337,585,499,60,8,1,91,32,6935,713,598,6337,128,585,726,6922,9,10,0,85
Drew,12/9/20,8,43,43,1051,10983,771,12059,272,18502,829,222,9553,1430,586,185,7,1,236,36,10382,1677,829,9553,247,1430,1076,10983,37,46,0,186
Faulkner,12/9/20,63,45,45,5587,69901,4785,75682,739,122416,4812,775,63299,6602,4236,549,56,7,520,219,68111,7571,4812,63299,969,6602,5781,69901,93,69,0,884
Franklin,12/9/20,17,47,47,898,11776,778,12705,103,17780,772,126,11346,430,675,103,17,0,80,23,12118,587,772,11346,157,430,929,11776,9,9,0,54
Fulton,12/9/20,13,49,49,609,3948,546,4582,50,12139,465,144,3222,726,419,127,11,2,35,15,3687,895,465,3222,169,726,634,3948,14,8,0,42
Garland,12/9/20,120,51,51,4389,52613,3731,57092,536,98296,3969,420,50150,2463,3412,319,114,6,441,95,54119,2973,3969,50150,510,2463,4479,52613,89,43,0,591
Grant,12/9/20,7,53,53,706,9597,606,10326,93,18086,572,134,8508,1089,504,102,6,1,62,31,9080,1246,572,8508,157,1089,729,9597,13,13,0,197
Greene,12/9/20,35,55,55,3604,28469,2980,32179,589,44623,2950,654,25534,2935,2444,536,33,2,473,116,28484,3695,2950,25534,760,2935,3710,28469,83,78,1,411
Hempstead,12/9/20,9,57,57,966,9603,877,10597,80,22018,790,176,9137,466,732,145,7,2,51,29,9927,670,790,9137,204,466,994,9603,6,9,1,143
HotSpring,12/9/20,46,59,59,3066,27083,2861,30197,159,33520,2929,137,24006,3077,2754,107,44,2,131,28,26935,3262,2929,24006,185,3077,3114,27083,14,13,1,458
Howard,12/9/20,16,61,61,891,6216,816,7132,59,13389,694,197,4969,1247,653,163,16,0,25,34,5663,1469,694,4969,222,1247,916,6216,8,3,1,79
Independence,12/9/20,74,63,63,2282,21419,2017,23790,191,37264,1692,590,18744,2675,1523,494,62,12,107,84,20436,3354,1692,18744,679,2675,2371,21419,21,24,0,190
Izard,12/9/20,7,65,65,1050,8832,990,9902,53,13559,924,126,7542,1290,883,107,7,0,34,19,8466,1436,924,7542,146,1290,1070,8832,5,14,0,52
Jackson,12/9/20,12,67,67,2202,16126,1745,18482,445,17225,1808,394,14088,2038,1413,332,10,2,385,60,15896,2586,1808,14088,548,2038,2356,16126,18,43,1,196
Jefferson,12/9/20,116,69,69,5519,53525,5084,59234,317,70424,4904,615,50532,2993,4624,460,107,9,171,146,55436,3798,4904,50532,805,2993,5709,53525,7,44,1,227
Johnson,12/9/20,13,71,71,1397,14048,1266,15460,118,26291,1285,112,13484,564,1178,88,12,1,95,23,14769,691,1285,13484,127,564,1412,14048,24,6,0,68
Lafayette,12/9/20,3,73,73,281,2046,271,2348,7,6915,226,55,1897,149,219,52,3,0,4,3,2123,225,226,1897,76,149,302,2046,3,3,0,31
Lawrence,12/9/20,32,75,75,1279,8501,1162,9826,85,16669,1085,194,7960,541,992,170,32,0,61,24,9045,781,1085,7960,240,541,1325,8501,2,17,0,60
Lee,12/9/20,20,77,77,1274,6962,1166,8246,88,9398,1247,27,6818,144,1148,18,19,1,80,8,8065,181,1247,6818,37,144,1284,6962,6,6,1,109
Lincoln,12/9/20,19,79,79,2624,13480,2453,16138,152,13695,2471,153,12096,1384,2358,95,18,1,95,57,14567,1571,2471,12096,187,1384,2658,13480,30,12,0,157
LittleRiver,12/9/20,37,81,81,685,3417,618,4118,30,12417,570,115,3127,290,516,102,35,2,19,11,3697,421,570,3127,131,290,701,3417,5,1,0,86
Logan,12/9/20,8,83,83,1094,14622,941,15742,145,21757,987,107,13132,1490,861,80,8,0,118,27,14119,1623,987,13132,133,1490,1120,14622,2,14,1,68
Lonoke,12/9/20,60,85,85,3085,39148,2692,42405,333,72206,2368,717,33757,5391,2082,610,56,4,230,103,36125,6280,2368,33757,889,5391,3257,39148,35,52,1,393
Madison,12/9/20,9,87,87,774,7638,632,8440,133,16076,657,117,7164,474,553,79,9,0,95,38,7821,619,657,7164,145,474,802,7638,13,11,0,107
Marion,12/9/20,8,89,89,499,5740,430,6261,61,16438,405,94,5228,512,350,80,7,1,48,13,5633,628,405,5228,116,512,521,5740,9,3,0,77
Miller,12/9/20,22,91,91,2289,11926,2173,14293,94,43759,1689,600,10926,1000,1610,563,16,6,63,31,12615,1678,1689,10926,678,1000,2367,11926,12,14,0,162
MissingCountyInfo,12/9/20,0,5,5,2737,108477,1995,111227,742,NA,2309,428,108416,61,1646,349,0,0,663,79,110725,502,2309,108416,441,61,2750,108477,15,75,0,1847
Mississippi,12/9/20,87,93,93,3650,22211,3158,25915,404,42831,3347,303,17697,4514,2908,250,73,14,365,39,21044,4871,3347,17697,357,4514,3704,22211,58,41,0,612
Monroe,12/9/20,5,95,95,350,4171,304,4531,41,7249,314,36,4015,156,278,26,5,0,31,10,4329,202,314,4015,46,156,360,4171,0,3,1,37
Montgomery,12/9/20,11,97,97,373,4422,300,4800,62,8993,324,49,3118,1304,272,28,10,1,42,20,3442,1358,324,3118,54,1304,378,4422,9,16,0,160
Nevada,12/9/20,16,99,99,501,7272,443,7778,42,8440,441,60,7027,245,388,55,15,1,38,4,7468,310,441,7027,65,245,506,7272,4,7,0,44
Newton,12/9/20,23,101,101,491,3881,425,4383,43,7848,434,57,2723,1158,377,48,20,3,37,6,3157,1226,434,2723,68,1158,502,3881,3,1,0,88
Ouachita,12/9/20,14,103,103,985,10585,780,11617,190,24106,901,84,10120,465,709,71,14,0,177,13,11021,596,901,10120,131,465,1032,10585,19,29,0,72
Perry,12/9/20,4,105,105,299,7107,252,7419,43,10322,263,36,6712,395,226,26,3,1,34,9,6975,444,263,6712,49,395,312,7107,1,2,0,105
Phillips,12/9/20,17,107,107,1030,11515,945,12573,68,19034,977,53,11225,290,904,41,17,0,56,12,12202,371,977,11225,81,290,1058,11515,8,7,0,124
Pike,12/9/20,4,109,109,469,3943,393,4420,72,10808,422,47,3646,297,354,39,3,1,65,7,4068,352,422,3646,55,297,477,3943,23,12,0,75
Poinsett,12/9/20,49,111,111,1861,16119,1626,18031,186,24054,1687,174,15418,701,1469,157,44,5,174,12,17105,926,1687,15418,225,701,1912,16119,31,14,1,217
Polk,12/9/20,19,113,113,969,8178,799,9173,150,20163,887,82,7772,406,734,65,19,0,133,17,8659,514,887,7772,108,406,995,8178,22,8,1,85
Pope,12/9/20,47,115,115,4158,40213,3741,44410,370,63644,3586,572,38633,1580,3267,474,41,6,278,92,42219,2191,3586,38633,611,1580,4197,40213,67,40,1,256
Prairie,12/9/20,9,117,117,390,4040,351,4455,30,8244,316,74,3585,455,287,64,8,1,21,9,3901,554,316,3585,99,455,415,4040,1,2,0,21
Pulaski,12/9/20,307,119,119,18833,236249,16528,255546,1996,393463,17190,1643,222890,13359,15204,1324,289,18,1695,301,240080,15466,17190,222890,2107,13359,19297,236249,291,225,5,3187
Randolph,12/9/20,33,121,121,1142,10162,964,11357,145,17603,915,227,8931,1231,772,192,27,6,116,29,9846,1511,915,8931,280,1231,1195,10162,21,8,0,99
Saline,12/9/20,68,125,125,5747,60791,4880,66806,798,118009,4689,1058,52969,7822,4022,858,63,5,603,195,57658,9148,4689,52969,1326,7822,6015,60791,74,86,0,839
Scott,12/9/20,3,127,127,448,6486,370,6947,75,10442,362,86,6298,188,294,76,3,0,65,10,6660,287,362,6298,99,188,461,6486,11,4,0,137
Searcy,12/9/20,1,129,129,373,4228,297,4623,75,7923,267,106,3544,684,249,48,1,0,17,58,3811,812,267,3544,128,684,395,4228,7,2,0,28
Sebastian,12/9/20,127,131,131,7739,85660,6904,93493,705,127461,6945,794,83722,1938,6258,646,123,4,562,143,90667,2826,6945,83722,888,1938,7833,85660,86,66,0,653
Sevier,12/9/20,20,133,133,1828,9596,1733,11479,75,17193,1454,374,8406,1190,1408,325,19,1,27,48,9860,1619,1454,8406,429,1190,1883,9596,8,12,0,51
Sharp,12/9/20,22,135,135,811,8973,701,9836,88,17043,619,192,7994,979,536,165,18,4,65,23,8613,1223,619,7994,244,979,863,8973,11,13,0,97
St.Francis,12/9/20,17,123,123,2240,18785,2056,21046,167,26294,2163,77,18563,222,1990,66,17,0,156,11,20726,320,2163,18563,98,222,2261,18785,34,13,1,190
Stone,12/9/20,25,137,137,566,5742,454,6318,87,12446,495,71,5306,436,425,29,23,2,47,40,5801,517,495,5306,81,436,576,5742,10,2,0,57
Union,12/9/20,60,139,139,1749,15135,1559,16961,130,39732,1444,305,13205,1930,1292,267,52,8,100,30,14649,2312,1444,13205,382,1930,1826,15135,30,12,1,82
VanBuren,12/9/20,5,141,141,484,8194,411,8725,68,16684,388,96,7226,968,342,69,4,1,42,26,7614,1111,388,7226,143,968,531,8194,18,5,0,195
Washington,12/9/20,189,143,143,17197,138295,15505,156135,1502,228529,14394,2803,123422,14873,13082,2423,168,21,1144,358,137816,18319,14394,123422,3446,14873,17840,138295,141,144,3,1194
White,12/9/20,61,145,145,3389,30244,3018,33827,308,78804,2545,844,25926,4318,2318,700,56,5,169,139,28471,5356,2545,25926,1038,4318,3583,30244,46,35,1,307
Woodruff,12/9/20,1,147,147,237,3236,205,3487,31,6660,199,38,3080,156,177,28,1,0,21,10,3279,208,199,3080,52,156,251,3236,8,5,0,60
Yell,12/9/20,35,149,149,1834,18428,1612,20281,187,21573,1728,106,17946,482,1535,77,32,3,161,26,19674,607,1728,17946,125,482,1853,18428,22,9,0,116
Arkansas_all_counties,12/8/20,2752,5630,5630,174325,1766977,153088,1946433,18461,2990671,150612,23713,1632886,134091,133811,19277,2521,231,14258,4203,1783498,162935,150612,1632886,28844,134091,179456,1766977,2283,1840,39,16442
Arkansas_county,12/8/20,23,1,1,1046,12782,928,13889,95,18124,818,228,9963,2819,734,194,22,1,62,33,10781,3108,818,9963,289,2819,1107,12782,7,6,0,93
Ashley,12/8/20,16,3,3,975,8989,834,9992,125,20537,861,114,8538,451,741,93,15,1,105,20,9399,593,861,8538,142,451,1003,8989,20,13,0,114
Baxter,12/8/20,34,5,5,1576,11478,1363,13087,179,41219,1205,371,10164,1314,1062,301,33,1,110,69,11369,1718,1205,10164,404,1314,1609,11478,27,8,2,156
Benton,12/8/20,188,7,7,13437,115913,12058,129782,1190,258980,11112,2325,110299,5614,10192,1866,162,26,757,433,121411,8371,11112,110299,2757,5614,13869,115913,158,160,3,747
Boone,12/8/20,50,9,9,2033,19619,1732,21778,249,37288,1742,291,18918,701,1488,244,48,2,204,45,20660,1118,1742,18918,417,701,2159,19619,23,39,1,132
Bradley,12/8/20,7,11,11,611,6338,481,6965,123,10948,518,93,4505,1833,416,65,7,0,95,28,5023,1942,518,4505,109,1833,627,6338,23,18,0,204
Calhoun,12/8/20,1,13,13,167,2408,150,2583,16,5202,148,19,2312,96,131,19,1,0,16,0,2460,123,148,2312,27,96,175,2408,5,5,0,19
Carroll,12/8/20,23,15,15,1646,11957,1403,13635,220,27887,1494,152,11771,186,1300,103,23,0,171,49,13265,370,1494,11771,184,186,1678,11957,40,23,0,127
Chicot,12/8/20,30,17,17,1273,8029,1162,9315,81,10826,1205,68,7244,785,1114,48,29,1,62,19,8449,866,1205,7244,81,785,1286,8029,11,9,2,42
Clark,12/8/20,13,19,19,953,14233,801,15222,139,22385,820,133,12309,1924,683,118,12,1,125,14,13129,2093,820,12309,169,1924,989,14233,15,15,1,67
Clay,12/8/20,24,21,21,1055,9593,856,10681,174,15061,853,202,7516,2077,709,147,19,5,124,50,8369,2312,853,7516,235,2077,1088,9593,15,15,0,68
Cleburne,12/8/20,25,23,23,831,12479,694,13332,112,25230,674,157,10783,1696,572,122,24,1,78,34,11457,1875,674,10783,179,1696,853,12479,10,12,0,146
Cleveland,12/8/20,15,25,25,432,5469,350,5912,67,8226,314,118,5194,275,276,74,14,1,24,43,5508,404,314,5194,129,275,443,5469,15,7,0,67
Columbia,12/8/20,27,27,27,1222,10748,1086,12064,109,23892,897,325,8785,1963,804,282,26,1,67,42,9682,2382,897,8785,419,1963,1316,10748,19,21,0,65
Conway,12/8/20,8,29,29,821,12318,663,13169,150,20906,705,116,10987,1331,592,71,8,0,105,45,11692,1477,705,10987,146,1331,851,12318,20,14,0,188
Craighead,12/8/20,93,31,31,7924,67637,6953,75751,877,105701,7172,752,60823,6814,6297,656,86,7,788,89,67995,7756,7172,60823,942,6814,8114,67637,104,77,2,562
Crawford,12/8/20,44,33,33,3431,38704,3015,42170,370,62472,3079,352,37647,1057,2734,281,39,5,304,66,40726,1444,3079,37647,387,1057,3466,38704,42,36,0,184
Crittenden,12/8/20,59,35,35,3538,22967,3225,26563,253,49013,3372,166,22012,955,3072,153,53,6,246,7,25384,1179,3372,22012,224,955,3596,22967,32,34,1,153
Cross,12/8/20,28,37,37,971,9054,845,10049,98,16998,821,150,8609,445,714,131,27,1,80,18,9430,619,821,8609,174,445,995,9054,18,19,0,48
Dallas,12/8/20,6,39,39,357,3885,293,4247,58,7432,331,26,3721,164,274,19,6,0,51,7,4052,195,331,3721,31,164,362,3885,8,7,0,46
Desha,12/8/20,9,41,41,682,6846,549,7562,124,11887,589,93,6293,553,493,56,8,1,88,36,6882,680,589,6293,127,553,716,6846,19,7,1,114
Drew,12/8/20,8,43,43,1014,10834,725,11873,281,18502,797,217,9426,1408,555,170,7,1,235,46,10223,1650,797,9426,242,1408,1039,10834,40,24,0,197
Faulkner,12/8/20,63,45,45,5494,69110,4716,74783,715,122416,4746,748,62815,6295,4190,526,56,7,500,215,67561,7222,4746,62815,927,6295,5673,69110,116,79,2,787
Franklin,12/8/20,17,47,47,889,11731,769,12651,103,17780,767,122,11311,420,667,102,17,0,83,20,12078,573,767,11311,153,420,920,11731,9,9,0,56
Fulton,12/8/20,13,49,49,595,3920,538,4538,44,12139,455,140,3203,717,412,126,11,2,32,12,3658,880,455,3203,163,717,618,3920,4,10,0,28
Garland,12/8/20,120,51,51,4300,52111,3688,56499,490,98296,3885,415,49831,2280,3379,309,114,6,390,100,53716,2783,3885,49831,503,2280,4388,52111,124,38,3,305
Grant,12/8/20,7,53,53,693,9413,593,10127,93,18086,566,127,8392,1021,495,98,6,1,65,28,8958,1169,566,8392,148,1021,714,9413,12,6,0,70
Greene,12/8/20,34,55,55,3521,28141,2902,31767,585,44623,2900,621,25285,2856,2389,513,32,2,479,106,28185,3582,2900,25285,726,2856,3626,28141,72,44,0,252
Hempstead,12/8/20,8,57,57,960,9466,868,10454,84,22018,786,174,9014,452,729,139,6,2,51,33,9800,654,786,9014,202,452,988,9466,29,8,0,49
HotSpring,12/8/20,45,59,59,3052,26639,2848,29738,159,33520,2917,135,23637,3002,2742,106,43,2,132,27,26554,3184,2917,23637,182,3002,3099,26639,21,22,0,534
Howard,12/8/20,15,61,61,883,6145,813,7053,55,13389,691,192,4911,1234,653,160,15,0,23,32,5602,1451,691,4911,217,1234,908,6145,12,7,0,136
Independence,12/8/20,74,63,63,2261,21250,1993,23600,194,37264,1679,582,18620,2630,1510,483,62,12,107,87,20299,3301,1679,18620,671,2630,2350,21250,18,20,0,295
Izard,12/8/20,7,65,65,1045,8785,976,9850,62,13559,923,122,7512,1273,871,105,7,0,45,17,8435,1415,923,7512,142,1273,1065,8785,13,8,0,234
Jackson,12/8/20,11,67,67,2184,15948,1702,18284,471,17225,1800,384,13919,2029,1383,319,9,2,408,63,15719,2565,1800,13919,536,2029,2336,15948,37,82,0,319
Jefferson,12/8/20,115,69,69,5512,53305,5040,59007,355,70424,4899,613,50357,2948,4602,438,107,8,188,167,55256,3751,4899,50357,803,2948,5702,53305,26,34,3,667
Johnson,12/8/20,13,71,71,1373,14004,1260,15391,100,26291,1265,108,13456,548,1172,88,12,1,81,19,14721,670,1265,13456,122,548,1387,14004,16,11,0,116
Lafayette,12/8/20,3,73,73,278,2018,268,2317,7,6915,225,53,1873,145,218,50,3,0,4,3,2098,219,225,1873,74,145,299,2018,4,6,0,11
Lawrence,12/8/20,32,75,75,1277,8443,1145,9766,100,16669,1087,190,7916,527,979,166,32,0,76,24,9003,763,1087,7916,236,527,1323,8443,15,14,0,55
Lee,12/8/20,19,77,77,1268,6859,1160,8137,89,9398,1242,26,6716,143,1144,16,18,1,80,9,7958,179,1242,6716,36,143,1278,6859,4,3,0,27
Lincoln,12/8/20,19,79,79,2594,13353,2441,15980,134,13695,2445,149,11993,1360,2353,88,18,1,74,60,14438,1542,2445,11993,182,1360,2627,13353,20,8,0,269
LittleRiver,12/8/20,37,81,81,680,3336,617,4031,26,12417,567,113,3058,278,516,101,35,2,16,10,3625,406,567,3058,128,278,695,3336,8,11,0,29
Logan,12/8/20,7,83,83,1092,14556,927,15673,158,21757,984,108,13074,1482,853,74,7,0,124,34,14058,1615,984,13074,133,1482,1117,14556,16,17,1,121
Lonoke,12/8/20,59,85,85,3050,38790,2640,42009,351,72206,2346,704,33467,5323,2040,600,56,3,250,101,35813,6196,2346,33467,873,5323,3219,38790,50,40,0,399
Madison,12/8/20,9,87,87,761,7544,621,8333,131,16076,651,110,7072,472,546,75,9,0,96,35,7723,610,651,7072,138,472,789,7544,6,10,1,44
Marion,12/8/20,8,89,89,490,5672,427,6184,55,16438,399,91,5164,508,349,78,7,1,43,12,5563,621,399,5164,113,508,512,5672,8,4,1,63
Miller,12/8/20,22,91,91,2277,11776,2159,14129,96,43759,1681,596,10781,995,1601,558,16,6,64,32,12462,1667,1681,10781,672,995,2353,11776,10,13,0,133
MissingCountyInfo,12/8/20,0,5,5,2722,106645,1920,109384,802,NA,2342,380,106585,60,1593,327,0,0,749,53,108927,457,2342,106585,397,60,2739,106645,-77,-24,0,920
Mississippi,12/8/20,87,93,93,3592,21657,3117,25302,387,42831,3297,295,17514,4143,2874,243,73,14,349,38,20811,4491,3297,17514,348,4143,3645,21657,51,25,1,552
Monroe,12/8/20,4,95,95,350,4134,301,4493,45,7249,312,38,3980,154,275,26,4,0,33,12,4292,201,312,3980,47,154,359,4134,13,2,0,40
Montgomery,12/8/20,11,97,97,364,4271,284,4640,69,8993,318,46,3105,1166,266,18,10,1,42,27,3423,1217,318,3105,51,1166,369,4271,11,12,0,149
Nevada,12/8/20,16,99,99,497,7232,436,7734,45,8440,438,59,6992,240,384,52,15,1,39,6,7430,304,438,6992,64,240,502,7232,3,6,1,31
Newton,12/8/20,23,101,101,488,3796,424,4295,41,7848,431,57,2711,1085,376,48,20,3,35,6,3142,1153,431,2711,68,1085,499,3796,8,5,0,24
Ouachita,12/8/20,14,103,103,966,10532,751,11544,200,24106,883,83,10071,461,685,66,14,0,183,17,10954,590,883,10071,129,461,1012,10532,20,27,0,80
Perry,12/8/20,4,105,105,298,7003,250,7314,44,10322,260,38,6677,326,224,26,3,1,33,11,6937,377,260,6677,51,326,311,7003,8,7,0,47
Phillips,12/8/20,17,107,107,1022,11399,938,12449,67,19034,972,50,11110,289,896,42,17,0,59,8,12082,367,972,11110,78,289,1050,11399,6,3,0,51
Pike,12/8/20,4,109,109,446,3891,381,4345,61,10808,401,45,3605,286,345,36,3,1,53,8,4006,339,401,3605,53,286,454,3891,14,3,0,56
Poinsett,12/8/20,48,111,111,1830,15933,1612,17814,170,24054,1657,173,15269,664,1456,156,43,5,158,12,16926,888,1657,15269,224,664,1881,15933,19,16,1,118
Polk,12/8/20,18,113,113,947,8115,791,9087,137,20163,866,81,7715,400,727,64,18,0,120,17,8581,506,866,7715,106,400,972,8115,11,15,0,48
Pope,12/8/20,46,115,115,4091,40024,3701,44151,344,63644,3531,560,38474,1550,3242,459,40,6,249,95,42005,2146,3531,38474,596,1550,4127,40024,46,44,0,237
Prairie,12/8/20,9,117,117,389,4020,349,4434,31,8244,316,73,3570,450,285,64,8,1,23,8,3886,548,316,3570,98,450,414,4020,7,5,0,16
Pulaski,12/8/20,302,119,119,18542,233353,16303,252343,1935,393463,16933,1609,220423,12930,15021,1282,284,18,1626,309,237356,14987,16933,220423,2057,12930,18990,233353,240,194,4,2314
Randolph,12/8/20,33,121,121,1121,10084,956,11258,132,17603,901,220,8879,1205,767,189,27,6,107,25,9780,1478,901,8879,273,1205,1174,10084,31,14,0,98
Saline,12/8/20,68,125,125,5673,60026,4794,65960,810,118009,4631,1042,52514,7512,3967,827,63,5,600,210,57145,8815,4631,52514,1303,7512,5934,60026,125,73,2,726
Scott,12/8/20,3,127,127,437,6360,366,6810,68,10442,353,84,6177,183,290,76,3,0,60,8,6530,280,353,6177,97,183,450,6360,6,2,0,43
Searcy,12/8/20,1,129,129,366,4207,295,4595,70,7923,264,102,3533,674,248,47,1,0,15,55,3797,798,264,3533,124,674,388,4207,14,7,0,35
Sebastian,12/8/20,127,131,131,7653,85093,6838,92836,685,127461,6881,772,83218,1875,6206,632,123,4,550,135,90099,2737,6881,83218,862,1875,7743,85093,90,76,0,454
Sevier,12/8/20,20,133,133,1820,9553,1721,11427,79,17193,1455,365,8371,1182,1403,318,19,1,33,46,9826,1601,1455,8371,419,1182,1874,9553,9,10,2,42
Sharp,12/8/20,22,135,135,800,8887,688,9739,90,17043,616,184,7924,963,531,157,18,4,67,23,8540,1199,616,7924,236,963,852,8887,6,21,1,108
St.Francis,12/8/20,16,123,123,2206,18629,2043,20855,147,26294,2133,73,18413,216,1979,64,16,0,138,9,20546,309,2133,18413,93,216,2226,18629,9,9,0,41
Stone,12/8/20,25,137,137,556,5695,452,6260,79,12446,486,70,5283,412,423,29,23,2,40,39,5769,491,486,5283,79,412,565,5695,13,5,0,45
Union,12/8/20,59,139,139,1719,15083,1547,16877,113,39732,1420,299,13161,1922,1284,263,51,8,85,28,14581,2296,1420,13161,374,1922,1794,15083,25,23,0,63
VanBuren,12/8/20,5,141,141,466,8017,406,8528,55,16684,375,91,7162,855,336,70,4,1,35,20,7537,991,375,7162,136,855,511,8017,10,2,0,126
Washington,12/8/20,186,143,143,17056,137242,15361,154925,1508,228529,14277,2779,122567,14675,12982,2379,166,20,1129,379,136844,18081,14277,122567,3406,14675,17683,137242,186,141,0,1165
White,12/8/20,60,145,145,3343,29983,2983,33520,298,78804,2527,816,25788,4195,2298,685,55,5,172,126,28315,5205,2527,25788,1010,4195,3537,29983,37,29,3,133
Woodruff,12/8/20,1,147,147,229,3184,200,3427,28,6660,194,35,3033,151,173,27,1,0,20,8,3227,200,194,3033,49,151,243,3184,5,4,0,12
Yell,12/8/20,35,149,149,1812,18334,1603,20165,174,21573,1709,103,17866,468,1529,74,32,3,148,26,19575,590,1709,17866,122,468,1831,18334,16,11,0,130
Arkansas_all_counties,12/7/20,2713,5630,5630,172042,1752818,151248,1929874,18057,2990671,149175,22867,1623898,128920,132433,18815,2485,228,14235,3822,1773073,156801,149175,1623898,27881,128920,177056,1752818,1118,1758,53,10733
Arkansas_county,12/7/20,23,1,1,1039,12696,922,13795,94,18124,814,225,9938,2758,733,189,22,1,59,35,10752,3043,814,9938,285,2758,1099,12696,3,10,0,73
Ashley,12/7/20,16,3,3,955,8895,821,9878,118,20537,849,106,8471,424,731,90,15,1,103,15,9320,558,849,8471,134,424,983,8895,7,17,0,56
Baxter,12/7/20,32,5,5,1549,11349,1355,12931,162,41219,1196,353,10085,1264,1058,297,31,1,107,55,11281,1650,1196,10085,386,1264,1582,11349,8,25,0,65
Benton,12/7/20,185,7,7,13279,115324,11898,129028,1195,258980,11036,2243,109762,5562,10081,1817,159,26,795,400,120798,8230,11036,109762,2668,5562,13704,115324,59,149,6,1172
Boone,12/7/20,49,9,9,2010,19510,1693,21640,266,37288,1715,295,18815,695,1449,244,47,2,217,49,20530,1110,1715,18815,415,695,2130,19510,9,22,2,161
Bradley,12/7/20,7,11,11,588,6157,463,6760,118,10948,504,84,4499,1658,408,55,7,0,89,29,5003,1757,504,4499,99,1658,603,6157,8,12,0,39
Calhoun,12/7/20,1,13,13,162,2394,145,2564,16,5202,143,19,2300,94,127,18,1,0,15,1,2443,121,143,2300,27,94,170,2394,1,3,0,25
Carroll,12/7/20,23,15,15,1606,11870,1380,13508,203,27887,1460,146,11685,185,1279,101,23,0,158,45,13145,363,1460,11685,178,185,1638,11870,3,17,0,121
Chicot,12/7/20,28,17,17,1262,7998,1153,9272,81,10826,1196,66,7237,761,1105,48,27,1,64,17,8433,839,1196,7237,78,761,1274,7998,2,6,0,99
Clark,12/7/20,12,19,19,938,14181,786,15155,140,22385,809,129,12274,1907,674,112,11,1,124,16,13083,2072,809,12274,165,1907,974,14181,4,12,0,247
Clay,12/7/20,24,21,21,1040,9540,841,10613,174,15061,847,193,7474,2066,696,145,19,5,131,43,8321,2292,847,7474,226,2066,1073,9540,6,19,1,191
Cleburne,12/7/20,25,23,23,821,12343,682,13186,114,25230,670,151,10686,1657,565,117,24,1,81,33,11356,1830,670,10686,173,1657,843,12343,7,13,0,100
Cleveland,12/7/20,15,25,25,417,5417,343,5845,59,8226,309,108,5165,252,273,70,14,1,22,37,5474,371,309,5165,119,252,428,5417,2,9,0,32
Columbia,12/7/20,27,27,27,1203,10702,1065,11991,111,23892,882,321,8759,1943,791,274,26,1,65,46,9641,2350,882,8759,407,1943,1289,10702,11,19,0,56
Conway,12/7/20,8,29,29,801,12150,649,12980,144,20906,700,101,10929,1221,581,68,8,0,111,33,11629,1351,700,10929,130,1221,830,12150,7,6,0,186
Craighead,12/7/20,91,31,31,7820,67179,6876,75186,852,105701,7087,733,60466,6713,6231,645,84,7,771,81,67553,7633,7087,60466,920,6713,8007,67179,45,75,6,509
Crawford,12/7/20,44,33,33,3389,38562,2979,41984,364,62472,3052,337,37517,1045,2703,276,39,5,308,56,40569,1415,3052,37517,370,1045,3422,38562,22,20,3,566
Crittenden,12/7/20,58,35,35,3506,22846,3191,26409,256,49013,3340,166,21942,904,3040,151,52,6,247,9,25282,1127,3340,21942,223,904,3563,22846,6,31,0,267
Cross,12/7/20,28,37,37,953,9024,826,10000,99,16998,808,145,8583,441,699,127,27,1,82,17,9391,609,808,8583,168,441,976,9024,6,14,0,171
Dallas,12/7/20,6,39,39,349,3847,286,4200,57,7432,326,23,3688,159,271,15,6,0,49,8,4014,186,326,3688,27,159,353,3847,4,7,0,20
Desha,12/7/20,8,41,41,663,6751,542,7448,113,11887,581,82,6232,519,489,53,7,1,85,28,6813,635,581,6232,116,519,697,6751,1,5,0,67
Drew,12/7/20,8,43,43,974,10677,701,11672,265,18502,769,205,9363,1314,546,155,7,1,216,49,10132,1540,769,9363,226,1314,995,10677,5,28,0,125
Faulkner,12/7/20,61,45,45,5378,68439,4637,73985,680,122416,4660,718,62352,6087,4126,511,54,7,480,200,67012,6973,4660,62352,886,6087,5546,68439,33,64,1,545
Franklin,12/7/20,17,47,47,880,11684,760,12595,103,17780,765,115,11270,414,661,99,17,0,87,16,12035,560,765,11270,146,414,911,11684,1,12,1,79
Fulton,12/7/20,13,49,49,591,3896,528,4508,50,12139,453,138,3193,703,407,121,11,2,35,15,3646,862,453,3193,159,703,612,3896,2,9,0,33
Garland,12/7/20,117,51,51,4176,51930,3650,56192,407,98296,3786,390,49717,2213,3354,296,111,6,319,88,53503,2689,3786,49717,476,2213,4262,51930,42,42,5,456
Grant,12/7/20,7,53,53,681,9355,587,10056,87,18086,559,122,8365,990,492,95,6,1,61,26,8924,1132,559,8365,142,990,701,9355,4,6,1,41
Greene,12/7/20,34,55,55,3449,27961,2858,31514,557,44623,2851,598,25160,2801,2352,506,32,2,467,90,28011,3503,2851,25160,702,2801,3553,27961,95,42,2,546
Hempstead,12/7/20,8,57,57,931,9446,860,10404,63,22018,771,160,9005,441,723,137,6,2,42,21,9776,628,771,9005,187,441,958,9446,4,7,0,59
HotSpring,12/7/20,45,59,59,3031,26126,2826,29202,160,33520,2900,131,23476,2650,2721,105,43,2,136,24,26376,2826,2900,23476,176,2650,3076,26126,11,21,1,135
Howard,12/7/20,15,61,61,871,6021,806,6913,50,13389,683,188,4899,1122,650,156,15,0,18,32,5582,1331,683,4899,209,1122,892,6021,5,4,0,49
Independence,12/7/20,74,63,63,2243,20973,1973,23305,196,37264,1673,570,18586,2387,1500,473,62,12,111,85,20259,3046,1673,18586,659,2387,2332,20973,8,27,2,152
Izard,12/7/20,7,65,65,1032,8564,968,9614,57,13559,919,113,7502,1062,868,100,7,0,44,13,8421,1193,919,7502,131,1062,1050,8564,2,13,0,95
Jackson,12/7/20,11,67,67,2147,15666,1620,17966,516,17225,1783,364,13850,1816,1309,311,9,2,465,51,15633,2333,1783,13850,517,1816,2300,15666,16,48,0,166
Jefferson,12/7/20,112,69,69,5486,52664,5006,58335,366,70424,4891,595,50040,2624,4587,419,105,7,197,169,54931,3404,4891,50040,780,2624,5671,52664,17,49,0,370
Johnson,12/7/20,13,71,71,1357,13904,1249,15275,95,26291,1253,104,13367,537,1162,87,12,1,79,16,14620,655,1253,13367,118,537,1371,13904,1,13,0,63
Lafayette,12/7/20,3,73,73,274,2011,262,2304,9,6915,223,51,1868,143,213,49,3,0,7,2,2091,213,223,1868,70,143,293,2011,0,3,0,4
Lawrence,12/7/20,32,75,75,1262,8403,1131,9710,99,16669,1079,183,7890,513,970,161,32,0,77,22,8969,741,1079,7890,228,513,1307,8403,3,12,0,129
Lee,12/7/20,19,77,77,1264,6836,1157,8110,88,9398,1238,26,6695,141,1141,16,18,1,79,9,7933,177,1238,6695,36,141,1274,6836,6,3,1,109
Lincoln,12/7/20,19,79,79,2574,13104,2433,15709,122,13695,2436,138,11878,1226,2351,82,18,1,67,55,14314,1395,2436,11878,169,1226,2605,13104,5,18,0,44
LittleRiver,12/7/20,37,81,81,672,3315,606,4000,29,12417,561,111,3039,276,508,98,35,2,18,11,3600,400,561,3039,124,276,685,3315,0,5,0,39
Logan,12/7/20,6,83,83,1076,14451,910,15551,160,21757,973,103,12982,1469,840,70,6,0,127,33,13955,1596,973,12982,127,1469,1100,14451,4,10,0,131
Lonoke,12/7/20,59,85,85,3000,38441,2600,41608,341,72206,2318,682,33241,5200,2017,583,56,3,245,96,35559,6049,2318,33241,849,5200,3167,38441,19,30,0,292
Madison,12/7/20,8,87,87,755,7506,611,8289,136,16076,647,108,7038,468,537,74,8,0,102,34,7685,604,647,7038,136,468,783,7506,7,14,0,38
Marion,12/7/20,7,89,89,482,5617,423,6120,52,16438,394,88,5126,491,346,77,6,1,42,10,5520,600,394,5126,109,491,503,5617,1,8,0,24
Miller,12/7/20,22,91,91,2267,11653,2146,13995,99,43759,1678,589,10767,886,1597,549,16,6,65,34,12445,1550,1678,10767,664,886,2342,11653,4,13,0,36
MissingCountyInfo,12/7/20,0,5,5,2799,105648,1944,108464,855,NA,2411,388,105588,60,1598,346,0,0,813,42,107999,465,2411,105588,405,60,2816,105648,103,20,0,-3914
Mississippi,12/7/20,86,93,93,3541,21156,3092,24748,362,42831,3249,292,17423,3733,2854,238,72,14,322,40,20672,4076,3249,17423,343,3733,3592,21156,25,30,1,139
Monroe,12/7/20,4,95,95,337,4107,299,4453,34,7249,303,34,3964,143,273,26,4,0,26,8,4267,186,303,3964,43,143,346,4107,2,5,0,38
Montgomery,12/7/20,11,97,97,353,4133,272,4490,70,8993,312,41,3102,1031,257,15,10,1,45,25,3414,1076,312,3102,45,1031,357,4133,4,5,1,11
Nevada,12/7/20,15,99,99,494,7204,430,7704,49,8440,437,57,6971,233,379,51,14,1,44,5,7408,296,437,6971,63,233,500,7204,2,1,0,41
Newton,12/7/20,23,101,101,480,3780,419,4271,38,7848,424,56,2705,1075,371,48,20,3,33,5,3129,1142,424,2705,67,1075,491,3780,1,6,0,80
Ouachita,12/7/20,14,103,103,946,10472,724,11461,207,24106,865,81,10023,449,662,62,14,0,188,19,10888,573,865,10023,124,449,989,10472,4,21,0,158
Perry,12/7/20,4,105,105,290,6964,243,7267,43,10322,254,36,6643,321,219,24,3,1,32,11,6897,370,254,6643,49,321,303,6964,3,4,0,30
Phillips,12/7/20,17,107,107,1016,11354,935,12398,64,19034,969,47,11079,275,893,42,17,0,59,5,12048,350,969,11079,75,275,1044,11354,3,14,0,68
Pike,12/7/20,4,109,109,432,3849,378,4289,50,10808,392,40,3570,279,342,36,3,1,47,3,3962,327,392,3570,48,279,440,3849,3,8,0,70
Poinsett,12/7/20,47,111,111,1811,15834,1596,17696,168,24054,1640,171,15182,652,1443,153,42,5,155,13,16822,874,1640,15182,222,652,1862,15834,13,9,1,159
Polk,12/7/20,18,113,113,936,8078,776,9038,141,20163,858,78,7684,394,712,64,18,0,127,14,8542,496,858,7684,102,394,960,8078,9,18,2,101
Pope,12/7/20,46,115,115,4045,39833,3657,43914,342,63644,3514,531,38314,1519,3209,448,40,6,265,77,41828,2086,3514,38314,567,1519,4081,39833,10,37,1,346
Prairie,12/7/20,9,117,117,382,4011,344,4418,29,8244,312,70,3562,449,282,62,8,1,22,7,3874,544,312,3562,95,449,407,4011,2,2,0,22
Pulaski,12/7/20,298,119,119,18302,231279,16109,250022,1893,393463,16760,1542,218846,12433,14859,1250,280,18,1619,274,235606,14416,16760,218846,1983,12433,18743,231279,129,183,3,1296
Randolph,12/7/20,33,121,121,1090,10017,942,11159,115,17603,875,215,8821,1196,758,184,27,6,90,25,9696,1463,875,8821,267,1196,1142,10017,5,5,2,107
Saline,12/7/20,66,125,125,5548,59425,4721,65230,760,118009,4555,993,52136,7289,3913,808,61,5,580,180,56691,8539,4555,52136,1250,7289,5805,59425,44,80,4,495
Scott,12/7/20,3,127,127,431,6323,364,6767,64,10442,349,82,6141,182,288,76,3,0,58,6,6490,277,349,6141,95,182,444,6323,1,8,0,82
Searcy,12/7/20,1,129,129,352,4186,288,4557,63,7923,260,92,3514,672,243,45,1,0,16,47,3774,783,260,3514,111,672,371,4186,-1,4,0,8
Sebastian,12/7/20,127,131,131,7563,84729,6762,92380,671,127461,6818,745,82903,1826,6145,617,123,4,548,123,89721,2659,6818,82903,833,1826,7651,84729,50,50,1,1014
Sevier,12/7/20,18,133,133,1811,9520,1711,11383,82,17193,1452,359,8350,1170,1399,312,18,0,35,47,9802,1581,1452,8350,411,1170,1863,9520,11,9,0,64
Sharp,12/7/20,21,135,135,794,8785,667,9630,106,17043,615,179,7900,885,522,145,17,4,76,30,8515,1115,615,7900,230,885,845,8785,3,9,1,94
St.Francis,12/7/20,16,123,123,2197,18597,2034,20814,147,26294,2125,72,18391,206,1971,63,16,0,138,9,20516,298,2125,18391,92,206,2217,18597,9,8,1,556
Stone,12/7/20,25,137,137,543,5663,447,6215,71,12446,482,61,5265,398,418,29,23,2,41,30,5747,468,482,5265,70,398,552,5663,2,8,0,31
Union,12/7/20,59,139,139,1694,15045,1524,16813,111,39732,1406,288,13139,1906,1269,255,51,8,86,25,14545,2268,1406,13139,362,1906,1768,15045,8,20,0,38
VanBuren,12/7/20,5,141,141,456,7901,404,8400,47,16684,367,89,7058,843,334,70,4,1,29,18,7425,975,367,7058,132,843,499,7901,3,10,0,64
Washington,12/7/20,186,143,143,16870,136263,15220,153753,1463,228529,14174,2696,121943,14320,12888,2332,166,20,1120,343,136117,17636,14174,121943,3316,14320,17490,136263,129,139,2,1132
White,12/7/20,57,145,145,3306,29887,2954,33386,293,78804,2517,789,25708,4179,2280,674,53,4,182,111,28225,5161,2517,25708,982,4179,3499,29887,22,39,1,199
Woodruff,12/7/20,1,147,147,224,3177,196,3415,27,6660,191,33,3030,147,169,27,1,0,21,6,3221,194,191,3030,47,147,238,3177,2,2,0,26
Yell,12/7/20,35,149,149,1796,18220,1592,20034,169,21573,1702,94,17767,453,1521,71,32,3,149,20,19469,565,1702,17767,112,453,1814,18220,1,12,0,195
Arkansas_all_counties,12/6/20,2660,5630,5630,170924,1743203,149490,1919084,18750,2990671,148171,22753,1614979,128224,131189,18301,2437,223,14523,4227,1763150,155934,148171,1614979,27710,128224,175881,1743203,1542,1359,40,15202
Arkansas_county,12/6/20,23,1,1,1036,12626,912,13722,101,18124,814,222,9870,2756,729,183,22,1,63,38,10684,3038,814,9870,282,2756,1096,12626,7,5,0,144
Ashley,12/6/20,16,3,3,948,8846,804,9822,128,20537,842,106,8422,424,720,84,15,1,107,21,9264,558,842,8422,134,424,976,8846,6,22,0,76
Baxter,12/6/20,32,5,5,1541,11292,1330,12866,179,41219,1192,349,10029,1263,1037,293,31,1,124,55,11221,1645,1192,10029,382,1263,1574,11292,5,25,2,56
Benton,12/6/20,179,7,7,13220,114211,11749,127859,1291,258980,10998,2222,108685,5526,9998,1751,155,24,844,447,119683,8176,10998,108685,2650,5526,13648,114211,89,120,7,369
Boone,12/6/20,47,9,9,2001,19358,1671,21479,281,37288,1707,294,18671,687,1434,237,45,2,226,55,20378,1101,1707,18671,414,687,2121,19358,16,16,2,168
Bradley,12/6/20,7,11,11,580,6126,451,6721,122,10948,496,84,4468,1658,402,49,7,0,87,35,4964,1757,496,4468,99,1658,595,6126,3,4,0,34
Calhoun,12/6/20,1,13,13,161,2370,142,2539,18,5202,142,19,2276,94,126,16,1,0,15,3,2418,121,142,2276,27,94,169,2370,0,4,0,12
Carroll,12/6/20,23,15,15,1603,11752,1363,13387,217,27887,1457,146,11568,184,1269,94,23,0,165,52,13025,362,1457,11568,178,184,1635,11752,11,13,0,43
Chicot,12/6/20,28,17,17,1260,7901,1147,9173,85,10826,1194,66,7140,761,1101,46,27,1,66,19,8334,839,1194,7140,78,761,1272,7901,4,4,0,94
Clark,12/6/20,12,19,19,934,13938,774,14907,148,22385,803,131,12033,1905,663,111,11,1,129,19,12836,2071,803,12033,166,1905,969,13938,13,9,0,171
Clay,12/6/20,23,21,21,1034,9355,822,10422,188,15061,844,190,7388,1967,681,141,18,5,144,44,8232,2190,844,7388,223,1967,1067,9355,17,19,0,35
Cleburne,12/6/20,25,23,23,814,12250,669,13086,120,25230,666,148,10597,1653,557,112,24,1,85,35,11263,1823,666,10597,170,1653,836,12250,4,11,0,47
Cleveland,12/6/20,15,25,25,415,5387,334,5813,66,8226,307,108,5138,249,270,64,14,1,23,43,5445,368,307,5138,119,249,426,5387,6,4,0,122
Columbia,12/6/20,27,27,27,1192,10657,1046,11935,119,23892,876,316,8735,1922,784,262,26,1,66,53,9611,2324,876,8735,402,1922,1278,10657,4,16,0,70
Conway,12/6/20,8,29,29,794,11971,643,12792,143,20906,693,101,10813,1158,577,66,8,0,108,35,11506,1286,693,10813,128,1158,821,11971,20,5,0,225
Craighead,12/6/20,85,31,31,7775,66715,6801,74675,888,105701,7042,733,60051,6664,6164,637,78,7,799,89,67093,7582,7042,60051,918,6664,7960,66715,77,58,2,415
Crawford,12/6/20,41,33,33,3367,38018,2959,41420,365,62472,3034,333,36975,1043,2685,274,37,4,310,55,40009,1411,3034,36975,368,1043,3402,38018,36,18,1,294
Crittenden,12/6/20,58,35,35,3500,22585,3160,26141,281,49013,3333,167,21681,904,3013,147,52,6,267,14,25014,1127,3333,21681,223,904,3556,22585,11,17,1,147
Cross,12/6/20,28,37,37,947,8859,812,9829,107,16998,802,145,8430,429,686,126,27,1,89,18,9232,597,802,8430,168,429,970,8859,4,11,1,60
Dallas,12/6/20,6,39,39,345,3831,279,4180,60,7432,323,22,3673,158,265,14,6,0,52,8,3996,184,323,3673,26,158,349,3831,3,3,0,36
Desha,12/6/20,8,41,41,662,6685,537,7380,117,11887,580,82,6167,518,485,52,7,1,88,29,6747,633,580,6167,115,518,695,6685,11,5,0,68
Drew,12/6/20,8,43,43,969,10557,673,11544,288,18502,762,207,9244,1313,537,136,7,1,218,70,10006,1538,762,9244,225,1313,987,10557,25,21,0,125
Faulkner,12/6/20,60,45,45,5345,67927,4573,73435,712,122416,4624,721,61899,6028,4081,492,53,7,490,222,66523,6912,4624,61899,884,6028,5508,67927,44,43,1,454
Franklin,12/6/20,16,47,47,879,11606,748,12516,115,17780,764,115,11191,415,654,94,16,0,94,21,11955,561,764,11191,146,415,910,11606,9,10,1,99
Fulton,12/6/20,13,49,49,589,3865,519,4475,57,12139,451,138,3162,703,399,120,11,2,41,16,3613,862,451,3162,159,703,610,3865,1,7,0,22
Garland,12/6/20,112,51,51,4134,51516,3608,55736,412,98296,3746,388,49304,2212,3315,293,106,6,323,89,53050,2686,3746,49304,474,2212,4220,51516,22,35,2,445
Grant,12/6/20,6,53,53,677,9318,581,10014,90,18086,555,122,8328,990,487,94,5,1,63,27,8883,1131,555,8328,141,990,696,9318,6,8,0,112
Greene,12/6/20,32,55,55,3354,27510,2816,30967,506,44623,2759,595,24732,2778,2326,490,30,2,403,103,27491,3476,2759,24732,698,2778,3457,27510,36,63,1,203
Hempstead,12/6/20,8,57,57,927,9391,853,10345,66,22018,767,160,8952,439,720,133,6,2,41,25,9719,626,767,8952,187,439,954,9391,2,3,0,42
HotSpring,12/6/20,44,59,59,3020,26002,2805,29066,171,33520,2888,132,23351,2651,2704,101,42,2,142,29,26239,2827,2888,23351,176,2651,3064,26002,6,17,0,264
Howard,12/6/20,15,61,61,866,5977,802,6863,49,13389,680,186,4871,1106,649,153,15,0,16,33,5551,1312,680,4871,206,1106,886,5977,7,2,0,96
Independence,12/6/20,72,63,63,2235,20829,1946,23153,217,37264,1669,566,18450,2379,1490,456,61,11,118,99,20119,3034,1669,18450,655,2379,2324,20829,8,22,1,40
Izard,12/6/20,7,65,65,1030,8471,955,9519,68,13559,917,113,7409,1062,858,97,7,0,52,16,8326,1193,917,7409,131,1062,1048,8471,3,4,1,24
Jackson,12/6/20,11,67,67,2131,15516,1572,17789,548,17225,1767,364,13700,1816,1269,303,9,2,489,59,15467,2322,1767,13700,506,1816,2273,15516,108,6,1,394
Jefferson,12/6/20,112,69,69,5469,52311,4957,57965,398,70424,4878,591,49737,2574,4560,397,105,7,211,187,54615,3350,4878,49737,776,2574,5654,52311,32,23,0,339
Johnson,12/6/20,13,71,71,1356,13842,1236,15212,107,26291,1253,103,13304,538,1154,82,12,1,87,20,14557,655,1253,13304,117,538,1370,13842,13,3,0,74
Lafayette,12/6/20,3,73,73,274,2007,259,2300,12,6915,223,51,1865,142,211,48,3,0,9,3,2088,212,223,1865,70,142,293,2007,0,2,0,5
Lawrence,12/6/20,32,75,75,1259,8277,1119,9580,108,16669,1077,182,7765,512,961,158,32,0,84,24,8842,738,1077,7765,226,512,1303,8277,9,11,0,71
Lee,12/6/20,18,77,77,1258,6733,1154,8000,86,9398,1232,26,6592,141,1140,14,17,1,75,11,7824,176,1232,6592,35,141,1267,6733,11,2,0,74
Lincoln,12/6/20,19,79,79,2569,13065,2415,15666,135,13695,2432,137,11841,1224,2345,70,18,1,69,66,14273,1393,2432,11841,169,1224,2601,13065,9,3,0,103
LittleRiver,12/6/20,37,81,81,672,3276,601,3960,34,12417,561,111,3000,276,505,96,35,2,21,13,3561,399,561,3000,123,276,684,3276,2,8,0,6
Logan,12/6/20,6,83,83,1072,14324,900,15420,166,21757,971,101,12853,1471,830,70,6,0,135,31,13824,1596,971,12853,125,1471,1096,14324,21,23,0,164
Lonoke,12/6/20,59,85,85,2981,38168,2570,41316,352,72206,2298,683,32984,5184,1993,577,56,3,249,103,35282,6034,2298,32984,850,5184,3148,38168,15,25,0,212
Madison,12/6/20,8,87,87,748,7475,597,8251,143,16076,639,109,7008,467,526,71,8,0,105,38,7647,604,639,7008,137,467,776,7475,7,11,0,70
Marion,12/6/20,7,89,89,481,5594,415,6096,59,16438,393,88,5103,491,341,74,6,1,46,13,5496,600,393,5103,109,491,502,5594,1,7,1,14
Miller,12/6/20,22,91,91,2263,11621,2133,13958,108,43759,1674,589,10735,886,1592,541,16,6,66,42,12409,1549,1674,10735,663,886,2337,11621,9,6,0,39
MissingCountyInfo,12/6/20,0,5,5,2696,109665,1924,112367,772,NA,2312,384,109605,60,1588,336,0,0,724,48,111917,450,2312,109605,390,60,2702,109665,98,-11,0,3894
Mississippi,12/6/20,85,93,93,3516,21042,3062,24607,368,42831,3226,290,17311,3731,2827,235,71,14,327,41,20537,4070,3226,17311,339,3731,3565,21042,33,26,1,141
Monroe,12/6/20,4,95,95,335,4071,294,4415,37,7249,301,34,3926,145,270,24,4,0,27,10,4227,188,301,3926,43,145,344,4071,3,4,0,44
Montgomery,12/6/20,10,97,97,349,4126,267,4480,72,8993,309,40,3095,1031,255,12,9,1,45,27,3404,1076,309,3095,45,1031,354,4126,9,5,0,60
Nevada,12/6/20,15,99,99,492,7165,429,7663,48,8440,435,57,6933,232,378,51,14,1,43,5,7368,295,435,6933,63,232,498,7165,0,1,0,94
Newton,12/6/20,23,101,101,479,3701,413,4191,43,7848,423,56,2681,1020,365,48,20,3,38,5,3104,1087,423,2681,67,1020,490,3701,7,11,0,29
Ouachita,12/6/20,14,103,103,942,10318,703,11303,224,24106,862,80,9871,447,643,60,14,0,204,20,10733,570,862,9871,123,447,985,10318,22,20,0,118
Perry,12/6/20,4,105,105,287,6937,239,7237,44,10322,251,36,6613,324,215,24,3,1,33,11,6864,373,251,6613,49,324,300,6937,8,4,0,69
Phillips,12/6/20,17,107,107,1013,11289,921,12330,75,19034,966,47,11014,275,881,40,17,0,68,7,11980,350,966,11014,75,275,1041,11289,8,9,0,55
Pike,12/6/20,4,109,109,429,3782,370,4219,55,10808,389,40,3503,279,335,35,3,1,51,4,3892,327,389,3503,48,279,437,3782,-2,1,0,41
Poinsett,12/6/20,46,111,111,1798,15688,1587,17536,165,24054,1628,170,15044,644,1434,153,41,5,153,12,16672,864,1628,15044,220,644,1848,15688,12,8,1,94
Polk,12/6/20,16,113,113,927,7986,758,8937,152,20163,850,77,7593,393,697,61,16,0,136,16,8443,494,850,7593,101,393,951,7986,6,15,3,38
Pope,12/6/20,45,115,115,4035,39497,3620,43569,370,63644,3506,529,37986,1511,3182,438,39,6,285,85,41492,2077,3506,37986,566,1511,4072,39497,43,28,0,236
Prairie,12/6/20,9,117,117,380,3991,342,4395,29,8244,310,70,3542,449,280,62,8,1,22,7,3852,543,310,3542,94,449,404,3991,2,5,0,31
Pulaski,12/6/20,295,119,119,18173,230112,15926,248722,1950,393463,16644,1529,217714,12398,14706,1220,277,18,1659,291,234358,14364,16644,217714,1966,12398,18610,230112,159,158,0,1687
Randolph,12/6/20,31,121,121,1085,9915,937,11051,117,17603,870,215,8727,1188,755,182,25,6,90,27,9597,1454,870,8727,266,1188,1136,9915,4,6,0,102
Saline,12/6/20,62,125,125,5504,58974,4641,64735,800,118009,4521,983,51700,7274,3858,783,58,4,604,196,56221,8514,4521,51700,1240,7274,5761,58974,55,64,2,371
Scott,12/6/20,3,127,127,430,6242,356,6684,71,10442,347,83,6060,182,283,73,3,0,61,10,6407,277,347,6060,95,182,442,6242,9,0,0,21
Searcy,12/6/20,1,129,129,353,4177,284,4549,68,7923,260,93,3505,672,239,45,1,0,20,48,3765,784,260,3505,112,672,372,4177,5,2,0,20
Sebastian,12/6/20,126,131,131,7513,83765,6712,91362,672,127461,6776,737,81956,1809,6106,606,122,4,546,126,88732,2630,6776,81956,821,1809,7597,83765,58,37,4,467
Sevier,12/6/20,18,133,133,1800,9467,1702,11319,80,17193,1443,357,8305,1162,1394,308,18,0,31,49,9748,1571,1443,8305,409,1162,1852,9467,6,8,0,27
Sharp,12/6/20,20,135,135,791,8694,658,9535,113,17043,611,180,7813,881,518,140,16,4,77,36,8424,1111,611,7813,230,881,841,8694,2,9,0,35
St.Francis,12/6/20,15,123,123,2188,18050,2026,20258,147,26294,2116,72,17844,206,1963,63,15,0,138,9,19960,298,2116,17844,92,206,2208,18050,10,9,0,165
Stone,12/6/20,25,137,137,541,5634,439,6184,77,12446,482,59,5238,396,414,25,23,2,45,32,5720,464,482,5238,68,396,550,5634,6,7,0,79
Union,12/6/20,59,139,139,1686,15015,1504,16775,123,39732,1402,284,13110,1905,1254,250,51,8,97,26,14512,2263,1402,13110,358,1905,1760,15015,15,18,0,54
VanBuren,12/6/20,5,141,141,453,7840,394,8336,54,16684,366,87,7020,820,328,66,4,1,34,20,7386,950,366,7020,130,820,496,7840,5,8,0,90
Washington,12/6/20,184,143,143,16741,135260,15081,152617,1475,228529,14045,2696,120961,14299,12794,2287,164,20,1087,388,135006,17611,14045,120961,3312,14299,17357,135260,125,120,2,636
White,12/6/20,56,145,145,3284,29710,2915,33186,311,78804,2505,779,25537,4173,2257,658,52,4,194,117,28042,5144,2505,25537,971,4173,3476,29710,54,24,2,137
Woodruff,12/6/20,1,147,147,222,3153,194,3389,27,6660,189,33,3007,146,167,27,1,0,21,6,3196,193,189,3007,47,146,236,3153,6,2,0,33
Yell,12/6/20,35,149,149,1795,18026,1580,19839,180,21573,1701,94,17575,451,1510,70,32,3,159,21,19276,563,1701,17575,112,451,1813,18026,21,7,0,157
Arkansas_all_counties,12/5/20,2620,5630,5630,169382,1729543,148131,1903801,18607,2990671,146711,22671,1601735,127808,130139,17992,2402,218,14148,4459,1748446,155355,146711,1601735,27547,127808,174258,1729543,2245,1635,34,16669
Arkansas_county,12/5/20,23,1,1,1029,12489,907,13578,99,18124,807,222,9770,2719,724,183,22,1,61,38,10577,3001,807,9770,282,2719,1089,12489,6,14,0,35
Ashley,12/5/20,16,3,3,942,8776,782,9745,144,20537,836,106,8352,424,700,82,15,1,121,23,9188,557,836,8352,133,424,969,8776,9,13,1,64
Baxter,12/5/20,30,5,5,1536,11241,1305,12811,201,41219,1188,348,9979,1262,1016,289,29,1,143,58,11167,1644,1188,9979,382,1262,1570,11241,26,18,0,96
Benton,12/5/20,172,7,7,13131,113931,11629,127488,1329,258980,10930,2201,108447,5484,9917,1712,150,22,862,467,119377,8111,10930,108447,2627,5484,13557,113931,123,116,3,681
Boone,12/5/20,45,9,9,1985,19206,1655,21310,283,37288,1689,296,18518,688,1423,232,43,2,221,62,20207,1103,1689,18518,415,688,2104,19206,44,24,1,119
Bradley,12/5/20,7,11,11,577,6095,447,6687,123,10948,493,84,4437,1658,399,48,7,0,87,36,4930,1757,493,4437,99,1658,592,6095,6,3,0,20
Calhoun,12/5/20,1,13,13,161,2358,138,2527,22,5202,142,19,2264,94,122,16,1,0,19,3,2406,121,142,2264,27,94,169,2358,3,2,0,9
Carroll,12/5/20,23,15,15,1592,11720,1350,13344,219,27887,1446,146,11536,184,1258,92,23,0,165,54,12982,362,1446,11536,178,184,1624,11720,34,15,0,133
Chicot,12/5/20,28,17,17,1256,7811,1143,9079,85,10826,1190,66,7050,761,1097,46,27,1,66,19,8240,839,1190,7050,78,761,1268,7811,17,17,0,38
Clark,12/5/20,12,19,19,921,13780,765,14735,144,22385,791,130,11877,1903,657,108,11,1,123,21,12668,2067,791,11877,164,1903,955,13780,19,13,0,109
Clay,12/5/20,23,21,21,1017,9337,803,10386,190,15061,828,189,7370,1967,664,139,18,5,145,45,8198,2188,828,7370,221,1967,1049,9337,17,12,1,51
Cleburne,12/5/20,25,23,23,810,12207,658,13037,127,25230,662,148,10556,1651,547,111,24,1,91,36,11218,1819,662,10556,168,1651,830,12207,16,10,0,100
Cleveland,12/5/20,15,25,25,409,5271,330,5691,64,8226,301,108,5022,249,267,63,14,1,20,44,5323,368,301,5022,119,249,420,5271,2,5,0,34
Columbia,12/5/20,27,27,27,1188,10591,1030,11865,131,23892,872,316,8683,1908,775,255,26,1,71,60,9555,2310,872,8683,402,1908,1274,10591,14,25,1,74
Conway,12/5/20,8,29,29,774,11766,638,12565,128,20906,672,102,10671,1095,573,65,8,0,91,37,11343,1222,672,10671,127,1095,799,11766,19,15,0,132
Craighead,12/5/20,83,31,31,7698,66377,6743,74254,871,105701,6967,731,59714,6663,6112,631,76,7,778,93,66681,7573,6967,59714,910,6663,7877,66377,85,68,0,619
Crawford,12/5/20,40,33,33,3331,37760,2941,41122,348,62472,2994,337,36719,1041,2672,269,37,3,283,65,39713,1409,2994,36719,368,1041,3362,37760,64,31,0,384
Crittenden,12/5/20,57,35,35,3489,22449,3143,25993,288,49013,3321,168,21546,903,2997,146,51,6,272,16,24867,1126,3321,21546,223,903,3544,22449,27,21,0,147
Cross,12/5/20,27,37,37,943,8803,801,9769,115,16998,798,145,8374,429,678,123,26,1,94,21,9172,597,798,8374,168,429,966,8803,16,14,0,130
Dallas,12/5/20,6,39,39,342,3798,276,4144,60,7432,321,21,3641,157,264,12,6,0,51,9,3962,182,321,3641,25,157,346,3798,9,7,0,44
Desha,12/5/20,8,41,41,651,6628,532,7311,111,11887,568,83,6111,517,481,51,7,1,80,31,6679,632,568,6111,115,517,683,6628,22,8,0,85
Drew,12/5/20,8,43,43,944,10457,652,11417,284,18502,736,208,9143,1314,527,125,7,1,202,82,9879,1538,736,9143,224,1314,960,10457,31,24,0,57
Faulkner,12/5/20,59,45,45,5301,67517,4530,72976,712,122416,4585,716,61487,6030,4047,483,52,7,486,226,66072,6904,4585,61487,874,6030,5459,67517,93,47,0,523
Franklin,12/5/20,15,47,47,870,11516,738,12417,117,17780,755,115,11105,411,645,93,15,0,95,22,11860,557,755,11105,146,411,901,11516,13,7,1,108
Fulton,12/5/20,13,49,49,588,3844,512,4453,63,12139,450,138,3141,703,393,119,11,2,46,17,3591,862,450,3141,159,703,609,3844,13,9,0,30
Garland,12/5/20,110,51,51,4112,51093,3573,55291,427,98296,3728,384,48884,2209,3288,285,104,6,334,93,52612,2679,3728,48884,470,2209,4198,51093,34,22,4,223
Grant,12/5/20,6,53,53,671,9212,573,9902,92,18086,550,121,8222,990,482,91,5,1,63,29,8772,1130,550,8222,140,990,690,9212,6,14,0,61
Greene,12/5/20,31,55,55,3318,27343,2753,30764,534,44623,2728,590,24578,2765,2273,480,29,2,426,108,27306,3458,2728,24578,693,2765,3421,27343,60,51,2,181
Hempstead,12/5/20,8,57,57,925,9351,850,10302,67,22018,765,160,8914,437,717,133,6,2,42,25,9679,623,765,8914,186,437,951,9351,11,2,0,144
HotSpring,12/5/20,44,59,59,3014,25744,2788,28802,182,33520,2884,130,23098,2646,2691,97,42,2,151,31,25982,2820,2884,23098,174,2646,3058,25744,10,17,2,200
Howard,12/5/20,15,61,61,859,5888,800,6766,44,13389,678,181,4827,1061,648,152,15,0,15,29,5505,1261,678,4827,200,1061,878,5888,3,5,0,73
Independence,12/5/20,71,63,63,2227,20797,1924,23114,232,37264,1662,565,18419,2378,1479,445,61,10,122,110,20081,3033,1662,18419,655,2378,2317,20797,31,14,0,311
Izard,12/5/20,6,65,65,1027,8450,951,9495,70,13559,914,113,7388,1062,856,95,6,0,52,18,8302,1193,914,7388,131,1062,1045,8450,3,2,0,29
Jackson,12/5/20,10,67,67,2023,15230,1566,17395,447,17225,1659,364,13414,1816,1263,303,8,2,388,59,15073,2322,1659,13414,506,1816,2165,15230,52,23,0,104
Jefferson,12/5/20,112,69,69,5437,52004,4934,57625,389,70424,4849,588,49430,2574,4552,382,105,7,190,199,54279,3346,4849,49430,772,2574,5621,52004,65,23,0,405
Johnson,12/5/20,13,71,71,1343,13781,1233,15138,97,26291,1241,102,13243,538,1151,82,12,1,78,19,14484,654,1241,13243,116,538,1357,13781,17,15,0,143
Lafayette,12/5/20,3,73,73,274,2002,257,2295,14,6915,223,51,1860,142,210,47,3,0,10,4,2083,212,223,1860,70,142,293,2002,2,3,0,17
Lawrence,12/5/20,32,75,75,1250,8215,1108,9508,110,16669,1068,182,7709,506,951,157,32,0,85,25,8777,731,1068,7709,225,506,1293,8215,15,14,1,71
Lee,12/5/20,18,77,77,1247,6670,1152,7926,77,9398,1221,26,6529,141,1138,14,17,1,66,11,7750,176,1221,6529,35,141,1256,6670,18,4,0,93
Lincoln,12/5/20,19,79,79,2560,12971,2412,15563,129,13695,2425,135,11747,1224,2342,70,18,1,65,64,14172,1391,2425,11747,167,1224,2592,12971,8,6,0,58
LittleRiver,12/5/20,37,81,81,670,3272,593,3954,40,12417,559,111,2996,276,498,95,35,2,26,14,3555,399,559,2996,123,276,682,3272,4,3,0,20
Logan,12/5/20,6,83,83,1051,14181,877,15256,168,21757,953,98,12712,1469,811,66,6,0,136,32,13665,1591,953,12712,122,1469,1075,14181,11,19,0,80
Lonoke,12/5/20,59,85,85,2966,37971,2545,41103,362,72206,2286,680,32798,5173,1981,564,56,3,249,113,35084,6019,2286,32798,846,5173,3132,37971,56,39,1,254
Madison,12/5/20,8,87,87,741,7412,586,8180,147,16076,631,110,6945,467,517,69,8,0,106,41,7576,604,631,6945,137,467,768,7412,11,12,0,146
Marion,12/5/20,6,89,89,480,5581,408,6083,66,16438,393,87,5090,491,335,73,5,1,53,13,5483,600,393,5090,109,491,502,5581,2,6,0,35
Miller,12/5/20,22,91,91,2254,11591,2127,13919,105,43759,1665,589,10705,886,1587,540,16,6,62,43,12370,1549,1665,10705,663,886,2328,11591,24,10,0,108
MissingCountyInfo,12/5/20,0,5,5,2598,105869,1935,108472,663,NA,2197,401,105809,60,1588,347,0,0,609,54,108006,466,2197,105809,406,60,2603,105869,23,26,0,3817
Mississippi,12/5/20,84,93,93,3483,20934,3036,24465,362,42831,3195,288,17203,3731,2806,230,70,14,318,44,20398,4067,3195,17203,336,3731,3531,20934,46,19,2,474
Monroe,12/5/20,4,95,95,332,4030,290,4371,38,7249,298,34,3888,142,266,24,4,0,28,10,4186,185,298,3888,43,142,341,4030,5,6,0,17
Montgomery,12/5/20,10,97,97,340,4075,262,4420,68,8993,300,40,3044,1031,251,11,9,1,40,28,3344,1076,300,3044,45,1031,345,4075,6,5,0,24
Nevada,12/5/20,15,99,99,492,7071,428,7569,49,8440,435,57,6841,230,378,50,14,1,43,6,7276,293,435,6841,63,230,498,7071,7,2,1,45
Newton,12/5/20,23,101,101,472,3679,402,4162,47,7848,419,53,2659,1020,356,46,20,3,43,4,3078,1084,419,2659,64,1020,483,3679,5,7,0,13
Ouachita,12/5/20,14,103,103,920,10222,683,11185,222,24106,842,78,9778,444,624,59,14,0,203,19,10620,565,842,9778,121,444,963,10222,40,27,0,163
Perry,12/5/20,4,105,105,279,6876,235,7167,40,10322,242,37,6554,322,212,23,3,1,27,13,6796,371,242,6554,49,322,291,6876,-2,4,0,72
Phillips,12/5/20,17,107,107,1005,11242,912,12275,76,19034,958,47,10971,271,874,38,17,0,67,9,11929,346,958,10971,75,271,1033,11242,10,5,0,46
Pike,12/5/20,4,109,109,431,3739,369,4178,58,10808,391,40,3460,279,334,35,3,1,54,4,3851,327,391,3460,48,279,439,3739,4,5,1,74
Poinsett,12/5/20,45,111,111,1786,15606,1579,17442,162,24054,1616,170,14962,644,1427,152,40,5,149,13,16578,864,1616,14962,220,644,1836,15606,32,14,1,118
Polk,12/5/20,13,113,113,921,7954,743,8899,164,20163,844,77,7562,392,684,59,13,0,146,18,8406,493,844,7562,101,392,945,7954,20,14,0,88
Pope,12/5/20,45,115,115,3992,39304,3592,43333,355,63644,3463,529,37808,1496,3161,431,39,6,263,92,41271,2062,3463,37808,566,1496,4029,39304,61,42,0,282
Prairie,12/5/20,9,117,117,378,3962,337,4364,32,8244,308,70,3514,448,276,61,8,1,24,8,3822,542,308,3514,94,448,402,3962,2,3,1,19
Pulaski,12/5/20,295,119,119,18014,228584,15768,247031,1949,393463,16491,1523,216275,12309,14568,1200,277,18,1644,305,232766,14265,16491,216275,1956,12309,18447,228584,222,159,3,1618
Randolph,12/5/20,31,121,121,1081,9817,931,10949,119,17603,867,214,8630,1187,751,180,25,6,91,28,9497,1452,867,8630,265,1187,1132,9817,12,8,0,50
Saline,12/5/20,60,125,125,5449,58658,4577,64361,811,118009,4471,978,51390,7268,3815,762,57,3,598,213,55861,8500,4471,51390,1232,7268,5703,58658,119,77,0,656
Scott,12/5/20,3,127,127,421,6230,356,6662,62,10442,337,84,6049,181,283,73,3,0,51,11,6386,276,337,6049,95,181,432,6230,10,0,0,36
Searcy,12/5/20,1,129,129,348,4162,282,4528,65,7923,257,91,3491,671,238,44,1,0,18,47,3748,780,257,3491,109,671,366,4162,7,3,0,16
Sebastian,12/5/20,122,131,131,7455,83356,6675,90888,655,127461,6716,739,81561,1795,6075,600,118,4,521,134,88277,2611,6716,81561,816,1795,7532,83356,94,61,1,547
Sevier,12/5/20,18,133,133,1794,9446,1694,11290,82,17193,1437,357,8286,1160,1387,307,18,0,32,50,9723,1567,1437,8286,407,1160,1844,9446,12,10,0,42
Sharp,12/5/20,20,135,135,789,8661,649,9500,120,17043,610,179,7782,879,511,138,16,4,83,37,8392,1108,610,7782,229,879,839,8661,13,20,0,44
St.Francis,12/5/20,15,123,123,2178,17895,2017,20093,146,26294,2106,72,17690,205,1954,63,15,0,137,9,19796,297,2106,17690,92,205,2198,17895,28,8,0,133
Stone,12/5/20,25,137,137,535,5561,432,6104,78,12446,475,60,5167,394,408,24,23,2,44,34,5642,462,475,5167,68,394,543,5561,7,5,0,42
Union,12/5/20,59,139,139,1671,14976,1486,16721,126,39732,1397,274,13074,1902,1244,242,51,8,102,24,14471,2250,1397,13074,348,1902,1745,14976,17,13,0,139
VanBuren,12/5/20,5,141,141,448,7755,386,8246,57,16684,361,87,6937,818,322,64,4,1,35,22,7298,948,361,6937,130,818,491,7755,5,12,0,50
Washington,12/5/20,182,143,143,16616,134749,14961,151962,1472,228529,13926,2690,120452,14297,12714,2247,162,20,1050,422,134378,17584,13926,120452,3287,14297,17213,134749,220,180,3,1213
White,12/5/20,54,145,145,3230,29627,2891,33041,283,78804,2463,767,25456,4171,2238,653,50,4,173,110,27919,5122,2463,25456,951,4171,3414,29627,31,45,2,148
Woodruff,12/5/20,1,147,147,216,3126,192,3356,23,6660,185,31,2980,146,165,27,1,0,19,4,3165,191,185,2980,45,146,230,3126,0,1,0,22
Yell,12/5/20,35,149,149,1774,17890,1573,19682,166,21573,1680,94,17441,449,1504,69,32,3,144,22,19121,561,1680,17441,112,449,1792,17890,18,12,1,83
Arkansas_all_counties,12/4/20,2586,5630,5630,167137,1715119,146496,1887018,18032,2990671,144910,22227,1589776,125343,128911,17585,2370,216,13608,4424,1734686,152332,144910,1589776,26989,125343,171899,1715119,2827,1872,31,18369
Arkansas_county,12/4/20,23,1,1,1023,12460,893,13542,107,18124,804,219,9756,2704,714,179,22,1,68,39,10560,2982,804,9756,278,2704,1082,12460,25,8,0,113
Ashley,12/4/20,15,3,3,933,8721,769,9680,149,20537,828,105,8297,424,690,79,14,1,124,25,9125,555,828,8297,131,424,959,8721,17,9,0,119
Baxter,12/4/20,30,5,5,1510,11171,1287,12711,193,41219,1167,343,9913,1258,1007,280,29,1,131,62,11080,1631,1167,9913,373,1258,1540,11171,38,17,0,304
Benton,12/4/20,169,7,7,13008,113373,11513,126797,1325,258980,10848,2160,108029,5344,9833,1680,147,22,867,458,118877,7920,10848,108029,2576,5344,13424,113373,248,160,5,1047
Boone,12/4/20,44,9,9,1941,19131,1631,21191,265,37288,1646,295,18456,675,1405,226,42,2,198,67,20102,1089,1646,18456,414,675,2060,19131,36,45,0,279
Bradley,12/4/20,7,11,11,571,6081,444,6665,120,10948,485,86,4427,1654,396,48,7,0,82,38,4912,1753,485,4427,99,1654,584,6081,24,6,0,77
Calhoun,12/4/20,1,13,13,158,2352,136,2518,21,5202,139,19,2260,92,121,15,1,0,17,4,2399,119,139,2260,27,92,166,2352,3,4,0,25
Carroll,12/4/20,23,15,15,1558,11621,1335,13211,200,27887,1415,143,11439,182,1243,92,23,0,149,51,12854,357,1415,11439,175,182,1590,11621,18,21,0,63
Chicot,12/4/20,28,17,17,1239,7790,1126,9040,85,10826,1177,62,7042,748,1086,40,27,1,64,21,8219,821,1177,7042,73,748,1250,7790,17,7,0,106
Clark,12/4/20,12,19,19,902,13690,752,14625,138,22385,776,126,11806,1884,645,107,11,1,120,18,12582,2043,776,11806,159,1884,935,13690,41,12,0,205
Clay,12/4/20,22,21,21,1000,9303,791,10335,186,15061,811,189,7341,1962,655,136,18,4,137,49,8152,2183,811,7341,221,1962,1032,9303,34,18,0,102
Cleburne,12/4/20,25,23,23,794,12123,648,12936,121,25230,648,146,10483,1640,540,108,24,1,84,37,11131,1805,648,10483,165,1640,813,12123,6,7,1,167
Cleveland,12/4/20,15,25,25,407,5239,325,5657,67,8226,301,106,5001,238,265,60,14,1,22,45,5302,355,301,5001,117,238,418,5239,7,3,0,47
Columbia,12/4/20,26,27,27,1174,10531,1005,11788,143,23892,860,314,8633,1898,762,243,25,1,73,70,9493,2295,860,8633,397,1898,1257,10531,15,9,1,143
Conway,12/4/20,8,29,29,755,11653,623,12429,124,20906,655,100,10563,1090,561,62,8,0,86,38,11218,1211,655,10563,121,1090,776,11653,30,20,0,184
Craighead,12/4/20,83,31,31,7613,65843,6675,73634,854,105701,6893,720,59334,6509,6057,618,76,7,759,95,66227,7407,6893,59334,898,6509,7791,65843,143,73,1,647
Crawford,12/4/20,40,33,33,3267,37440,2910,40735,315,62472,2942,325,36487,953,2649,261,37,3,254,61,39429,1306,2942,36487,353,953,3295,37440,30,35,1,403
Crittenden,12/4/20,57,35,35,3462,22329,3122,25844,282,49013,3294,168,21427,902,2975,147,51,6,267,15,24721,1123,3294,21427,221,902,3515,22329,58,41,0,239
Cross,12/4/20,27,37,37,927,8689,787,9638,113,16998,787,140,8262,427,669,118,26,1,92,21,9049,589,787,8262,162,427,949,8689,25,14,0,85
Dallas,12/4/20,6,39,39,333,3763,269,4100,58,7432,312,21,3612,151,257,12,6,0,49,9,3924,176,312,3612,25,151,337,3763,9,5,0,114
Desha,12/4/20,8,41,41,629,6565,524,7225,97,11887,547,82,6060,505,475,49,7,1,65,32,6607,618,547,6060,113,505,660,6565,19,10,0,122
Drew,12/4/20,8,43,43,913,10431,628,11360,277,18502,709,204,9120,1311,513,115,7,1,189,88,9829,1531,709,9120,220,1311,929,10431,38,27,0,152
Faulkner,12/4/20,59,45,45,5208,67087,4483,72449,666,122416,4517,691,61106,5981,4010,473,52,7,455,211,65623,6826,4517,61106,845,5981,5362,67087,101,54,0,716
Franklin,12/4/20,14,47,47,857,11421,731,12308,112,17780,741,116,11016,405,638,93,14,0,89,23,11757,551,741,11016,146,405,887,11421,25,9,0,146
Fulton,12/4/20,13,49,49,575,3827,503,4423,59,12139,440,135,3127,700,388,115,11,2,41,18,3567,856,440,3127,156,700,596,3827,7,8,1,54
Garland,12/4/20,106,51,51,4078,50904,3551,55066,419,98296,3703,375,48731,2173,3275,276,100,6,326,93,52434,2632,3703,48731,459,2173,4162,50904,73,63,1,301
Grant,12/4/20,6,53,53,665,9157,559,9841,100,18086,545,120,8195,962,473,86,5,1,67,33,8740,1101,545,8195,139,962,684,9157,16,17,0,90
Greene,12/4/20,29,55,55,3258,27222,2702,30579,527,44623,2676,582,24474,2748,2230,472,27,2,419,108,27150,3429,2676,24474,681,2748,3357,27222,70,73,0,312
Hempstead,12/4/20,8,57,57,914,9218,848,10158,58,22018,759,155,8793,425,716,132,6,2,37,21,9552,606,759,8793,181,425,940,9218,15,9,0,61
HotSpring,12/4/20,42,59,59,3004,25554,2771,28601,191,33520,2877,127,23000,2554,2678,93,40,2,159,32,25877,2724,2877,23000,170,2554,3047,25554,19,14,0,205
Howard,12/4/20,15,61,61,856,5818,795,6693,46,13389,677,179,4784,1034,648,147,15,0,14,32,5461,1232,677,4784,198,1034,875,5818,12,8,0,134
Independence,12/4/20,71,63,63,2196,20517,1910,22802,215,37264,1641,555,18377,2140,1473,437,61,10,107,108,20018,2784,1641,18377,644,2140,2285,20517,16,14,0,137
Izard,12/4/20,6,65,65,1024,8424,949,9466,69,13559,911,113,7366,1058,854,95,6,0,51,18,8277,1189,911,7366,131,1058,1042,8424,7,2,0,67
Jackson,12/4/20,10,67,67,1971,15178,1543,17288,418,17225,1610,361,13366,1812,1243,300,8,2,359,59,14976,2312,1610,13366,500,1812,2110,15178,22,25,0,51
Jefferson,12/4/20,112,69,69,5372,51664,4911,57214,347,70424,4834,538,49217,2447,4545,366,105,7,182,165,54051,3163,4834,49217,716,2447,5550,51664,34,38,1,258
Johnson,12/4/20,13,71,71,1326,13655,1218,14995,95,26291,1231,95,13135,520,1142,76,12,1,77,18,14366,629,1231,13135,109,520,1340,13655,29,8,0,137
Lafayette,12/4/20,3,73,73,272,1987,254,2278,15,6915,222,50,1847,140,209,45,3,0,10,5,2069,209,222,1847,69,140,291,1987,1,2,0,18
Lawrence,12/4/20,31,75,75,1235,8159,1094,9434,110,16669,1055,180,7666,493,938,156,31,0,86,24,8721,713,1055,7666,220,493,1275,8159,25,19,0,91
Lee,12/4/20,18,77,77,1229,6595,1148,7833,63,9398,1203,26,6455,140,1135,13,17,1,51,12,7658,175,1203,6455,35,140,1238,6595,14,5,0,130
Lincoln,12/4/20,19,79,79,2552,12921,2406,15504,127,13695,2417,135,11702,1219,2339,67,18,1,60,67,14119,1385,2417,11702,166,1219,2583,12921,12,8,0,92
LittleRiver,12/4/20,37,81,81,666,3256,590,3934,39,12417,556,110,2982,274,495,95,35,2,26,13,3538,396,556,2982,122,274,678,3256,6,6,0,20
Logan,12/4/20,6,83,83,1040,14112,858,15176,176,21757,944,96,12649,1463,793,65,6,0,145,31,13593,1583,944,12649,120,1463,1064,14112,28,16,0,151
Lonoke,12/4/20,58,85,85,2910,37773,2506,40848,346,72206,2248,662,32624,5149,1957,549,55,3,236,110,34872,5976,2248,32624,827,5149,3075,37773,58,30,2,591
Madison,12/4/20,8,87,87,730,7277,574,8034,148,16076,622,108,6826,451,510,64,8,0,104,44,7448,586,622,6826,135,451,757,7277,40,5,0,201
Marion,12/4/20,6,89,89,478,5548,402,6048,70,16438,392,86,5058,490,330,72,5,1,57,13,5450,598,392,5058,108,490,500,5548,5,3,0,95
Miller,12/4/20,22,91,91,2230,11507,2117,13811,91,43759,1655,575,10664,843,1582,535,16,6,57,34,12319,1492,1655,10664,649,843,2304,11507,21,10,0,74
MissingCountyInfo,12/4/20,0,5,5,2575,102075,1909,104655,666,NA,2156,419,102015,60,1562,347,0,0,594,72,104171,484,2156,102015,424,60,2580,102075,-9,66,0,1272
Mississippi,12/4/20,82,93,93,3437,20506,3017,23990,337,42831,3157,280,17144,3362,2788,229,68,14,300,37,20301,3689,3157,17144,327,3362,3484,20506,79,36,0,332
Monroe,12/4/20,4,95,95,327,4018,284,4354,39,7249,295,32,3879,139,261,23,4,0,30,9,4174,180,295,3879,41,139,336,4018,2,2,0,38
Montgomery,12/4/20,10,97,97,334,4057,257,4396,67,8993,297,37,3027,1030,246,11,9,1,42,25,3324,1072,297,3027,42,1030,339,4057,10,6,0,28
Nevada,12/4/20,14,99,99,485,7033,426,7524,45,8440,428,57,6807,226,376,50,13,1,39,6,7235,289,428,6807,63,226,491,7033,6,6,0,91
Newton,12/4/20,23,101,101,467,3671,395,4149,49,7848,415,52,2652,1019,352,43,20,3,43,6,3067,1082,415,2652,63,1019,478,3671,5,7,0,35
Ouachita,12/4/20,14,103,103,880,10099,656,11019,209,24106,803,77,9656,443,598,58,14,0,190,19,10459,560,803,9656,117,443,920,10099,44,14,0,197
Perry,12/4/20,4,105,105,281,6802,231,7095,46,10322,243,38,6486,316,209,22,3,1,31,15,6729,366,243,6486,50,316,293,6802,10,3,0,118
Phillips,12/4/20,17,107,107,995,11206,907,12229,71,19034,950,45,10936,270,870,37,17,0,63,8,11886,343,950,10936,73,270,1023,11206,15,12,0,190
Pike,12/4/20,3,109,109,427,3669,364,4103,60,10808,388,39,3392,277,331,33,2,1,55,5,3780,323,388,3392,46,277,434,3669,24,-1,0,46
Poinsett,12/4/20,44,111,111,1754,15520,1565,17323,145,24054,1587,167,14891,629,1414,151,39,5,134,11,16478,845,1587,14891,216,629,1803,15520,30,8,0,162
Polk,12/4/20,13,113,113,901,7886,729,8811,158,20163,829,72,7500,386,672,57,13,0,143,15,8329,482,829,7500,96,386,925,7886,33,20,1,89
Pope,12/4/20,45,115,115,3931,39083,3550,43052,336,63644,3419,512,37600,1483,3138,412,39,6,242,94,41019,2033,3419,37600,550,1483,3969,39083,63,42,2,397
Prairie,12/4/20,8,117,117,376,3945,334,4342,34,8244,305,71,3499,446,272,62,8,0,25,9,3804,538,305,3499,92,446,397,3945,3,2,0,37
Pulaski,12/4/20,292,119,119,17792,227188,15609,245403,1889,393463,16274,1518,214989,12199,14432,1177,274,18,1566,323,231263,14140,16274,214989,1941,12199,18215,227188,214,149,8,1668
Randolph,12/4/20,31,121,121,1069,9779,923,10899,115,17603,855,214,8594,1185,743,180,25,6,87,28,9449,1450,855,8594,265,1185,1120,9779,19,14,0,128
Saline,12/4/20,60,125,125,5330,58121,4500,63703,769,118009,4387,943,51074,7047,3763,737,57,3,566,203,55461,8242,4387,51074,1195,7047,5582,58121,130,83,1,654
Scott,12/4/20,3,127,127,411,6204,356,6626,52,10442,328,83,6023,181,283,73,3,0,42,10,6351,275,328,6023,94,181,422,6204,4,12,0,61
Searcy,12/4/20,1,129,129,341,4153,279,4511,61,7923,255,86,3484,669,236,43,1,0,18,43,3739,772,255,3484,103,669,358,4153,7,6,0,63
Sebastian,12/4/20,121,131,131,7361,82903,6614,90339,623,127461,6636,725,81151,1752,6021,593,117,4,496,127,87787,2552,6636,81151,800,1752,7436,82903,61,75,2,768
Sevier,12/4/20,18,133,133,1782,9416,1684,11247,80,17193,1434,348,8270,1146,1384,300,18,0,32,48,9704,1543,1434,8270,397,1146,1831,9416,21,16,0,170
Sharp,12/4/20,20,135,135,776,8630,629,9453,127,17043,598,178,7767,863,498,131,16,4,84,43,8365,1088,598,7767,225,863,823,8630,11,14,2,139
St.Francis,12/4/20,15,123,123,2150,17790,2009,19959,126,26294,2081,69,17589,201,1947,62,15,0,119,7,19670,289,2081,17589,88,201,2169,17790,60,15,0,321
Stone,12/4/20,25,137,137,528,5526,427,6063,76,12446,471,57,5145,381,404,23,23,2,44,32,5616,447,471,5145,66,381,537,5526,23,2,0,133
Union,12/4/20,59,139,139,1654,14854,1473,16579,122,39732,1384,270,13006,1848,1235,238,51,8,98,24,14390,2189,1384,13006,341,1848,1725,14854,27,9,0,126
VanBuren,12/4/20,5,141,141,443,7710,374,8195,64,16684,358,85,6894,816,310,64,4,1,44,20,7252,943,358,6894,127,816,485,7710,21,18,1,123
Washington,12/4/20,179,143,143,16396,133756,14781,150729,1435,228529,13776,2620,119704,14052,12585,2196,159,20,1032,403,133480,17249,13776,119704,3197,14052,16973,133756,284,178,0,1575
White,12/4/20,52,145,145,3199,29510,2846,32894,299,78804,2431,768,25348,4162,2203,643,48,4,178,121,27779,5115,2431,25348,953,4162,3384,29510,28,47,0,293
Woodruff,12/4/20,1,147,147,216,3104,191,3334,24,6660,185,31,2959,145,164,27,1,0,20,4,3144,190,185,2959,45,145,230,3104,5,2,0,34
Yell,12/4/20,34,149,149,1756,17825,1561,19598,161,21573,1665,91,17387,438,1495,66,31,3,139,22,19052,546,1665,17387,108,438,1773,17825,60,12,0,206
Arkansas_all_counties,12/3/20,2555,5630,5630,164310,1699577,144624,1868470,17109,2990671,142722,21588,1576679,122898,127537,17087,2343,212,12822,4287,1719401,149069,142722,1576679,26171,122898,168893,1699577,2789,2024,33,20180
Arkansas_county,12/3/20,23,1,1,998,12372,885,13428,90,18124,788,210,9686,2686,710,175,22,1,56,34,10474,2954,788,9686,268,2686,1056,12372,11,5,1,133
Ashley,12/3/20,15,3,3,916,8619,760,9561,141,20537,812,104,8200,419,685,75,14,1,113,28,9012,549,812,8200,130,419,942,8619,30,18,0,124
Baxter,12/3/20,30,5,5,1472,10905,1270,12407,172,41219,1133,339,9693,1212,992,278,29,1,112,60,10826,1581,1133,9693,369,1212,1502,10905,26,16,1,155
Benton,12/3/20,164,7,7,12760,112574,11353,125737,1242,258980,10688,2072,107292,5282,9726,1627,142,22,819,423,117980,7757,10688,107292,2475,5282,13163,112574,264,146,1,1216
Boone,12/3/20,44,9,9,1905,18888,1586,20910,275,37288,1618,287,18222,666,1372,214,42,2,204,71,19840,1070,1618,18222,404,666,2022,18888,43,33,0,228
Bradley,12/3/20,7,11,11,547,6028,438,6587,102,10948,466,81,4384,1644,392,46,7,0,67,35,4850,1737,466,4384,93,1644,559,6028,20,9,0,88
Calhoun,12/3/20,1,13,13,155,2330,132,2492,22,5202,136,19,2239,91,117,15,1,0,18,4,2375,117,136,2239,26,91,162,2330,0,3,0,14
Carroll,12/3/20,23,15,15,1540,11576,1314,13148,203,27887,1406,134,11396,180,1222,92,23,0,161,42,12802,346,1406,11396,166,180,1572,11576,37,28,0,129
Chicot,12/3/20,28,17,17,1222,7701,1119,8934,75,10826,1166,56,6991,710,1080,39,27,1,59,16,8157,777,1166,6991,67,710,1233,7701,17,13,0,98
Clark,12/3/20,12,19,19,861,13526,740,14419,109,22385,741,120,11712,1814,637,103,11,1,93,16,12453,1966,741,11712,152,1814,893,13526,10,5,1,197
Clay,12/3/20,22,21,21,966,9235,773,10230,170,15061,779,187,7283,1952,641,132,18,4,119,51,8062,2168,779,7283,216,1952,995,9235,23,16,1,88
Cleburne,12/3/20,24,23,23,788,11962,641,12769,123,25230,646,142,10409,1553,536,105,23,1,87,36,11055,1714,646,10409,161,1553,807,11962,18,8,0,118
Cleveland,12/3/20,15,25,25,400,5199,322,5611,63,8226,301,99,4965,234,265,57,14,1,22,41,5266,345,301,4965,111,234,412,5199,12,4,0,78
Columbia,12/3/20,25,27,27,1159,10403,996,11644,138,23892,851,308,8518,1885,759,237,24,1,68,70,9369,2275,851,8518,390,1885,1241,10403,18,22,1,237
Conway,12/3/20,8,29,29,725,11499,603,12245,114,20906,641,84,10442,1057,543,60,8,0,90,24,11083,1162,641,10442,105,1057,746,11499,14,17,0,208
Craighead,12/3/20,82,31,31,7470,65339,6602,72973,785,105701,6763,707,58889,6450,5997,605,75,7,690,95,65652,7321,6763,58889,871,6450,7634,65339,107,101,0,766
Crawford,12/3/20,39,33,33,3237,37067,2875,40328,321,62472,2916,321,36131,936,2621,254,36,3,257,64,39047,1281,2916,36131,345,936,3261,37067,74,44,1,385
Crittenden,12/3/20,57,35,35,3404,22148,3081,25599,265,49013,3235,169,21251,897,2943,138,51,6,240,25,24486,1113,3235,21251,216,897,3451,22148,52,32,0,311
Cross,12/3/20,27,37,37,902,8629,773,9553,102,16998,770,132,8214,415,662,111,26,1,82,20,8984,569,770,8214,154,415,924,8629,15,8,1,72
Dallas,12/3/20,6,39,39,324,3658,264,3986,54,7432,304,20,3510,148,253,11,6,0,45,9,3814,172,304,3510,24,148,328,3658,7,7,0,36
Desha,12/3/20,8,41,41,610,6462,514,7102,88,11887,530,80,5972,490,468,46,7,1,55,33,6502,600,530,5972,110,490,640,6462,25,4,0,96
Drew,12/3/20,8,43,43,875,10317,601,11208,266,18502,675,200,9015,1302,500,101,7,1,168,98,9690,1518,675,9015,216,1302,891,10317,77,24,0,328
Faulkner,12/3/20,59,45,45,5107,66472,4429,71728,619,122416,4448,659,60617,5855,3966,463,52,7,430,189,65065,6663,4448,60617,808,5855,5256,66472,109,66,3,905
Franklin,12/3/20,14,47,47,832,11300,722,12162,96,17780,719,113,10898,402,634,88,14,0,71,25,11617,545,719,10898,143,402,862,11300,20,13,1,144
Fulton,12/3/20,12,49,49,568,3780,495,4369,61,12139,433,135,3089,691,382,113,10,2,41,20,3522,847,433,3089,156,691,589,3780,5,10,0,59
Garland,12/3/20,105,51,51,4005,50676,3488,54763,410,98296,3644,361,48510,2166,3224,264,99,6,319,91,52154,2609,3644,48510,443,2166,4087,50676,56,51,0,574
Grant,12/3/20,6,53,53,649,9083,542,9749,101,18086,534,115,8130,953,459,83,5,1,70,31,8664,1085,534,8130,132,953,666,9083,8,10,0,93
Greene,12/3/20,29,55,55,3188,26980,2629,30261,530,44623,2624,564,24282,2698,2168,461,27,2,429,101,26906,3355,2624,24282,657,2698,3281,26980,92,65,1,451
Hempstead,12/3/20,8,57,57,899,9172,839,10096,52,22018,745,154,8756,416,707,132,6,2,32,20,9501,595,745,8756,179,416,924,9172,9,9,0,45
HotSpring,12/3/20,42,59,59,2985,25368,2757,28393,186,33520,2863,122,22828,2540,2672,85,40,2,151,35,25691,2702,2863,22828,162,2540,3025,25368,14,29,0,202
Howard,12/3/20,15,61,61,844,5696,787,6559,42,13389,674,170,4763,933,643,144,15,0,16,26,5437,1122,674,4763,189,933,863,5696,3,9,0,16
Independence,12/3/20,71,63,63,2180,20396,1896,22665,213,37264,1631,549,18281,2115,1466,430,61,10,104,109,19912,2753,1631,18281,638,2115,2269,20396,33,14,0,230
Izard,12/3/20,6,65,65,1017,8364,947,9399,64,13559,905,112,7316,1048,852,95,6,0,47,17,8221,1178,905,7316,130,1048,1035,8364,4,6,0,124
Jackson,12/3/20,10,67,67,1949,15149,1518,17231,421,17225,1599,350,13340,1809,1221,297,8,2,370,51,14939,2292,1599,13340,483,1809,2082,15149,81,50,1,250
Jefferson,12/3/20,111,69,69,5338,51440,4873,56952,352,70424,4818,520,49041,2399,4523,350,104,7,189,163,53859,3093,4818,49041,694,2399,5512,51440,75,23,0,384
Johnson,12/3/20,13,71,71,1297,13547,1210,14856,74,26291,1206,91,13037,510,1135,75,12,1,59,15,14243,613,1206,13037,103,510,1309,13547,12,7,0,78
Lafayette,12/3/20,3,73,73,271,1970,252,2260,16,6915,222,49,1831,139,207,45,3,0,12,4,2053,207,222,1831,68,139,290,1970,0,5,0,18
Lawrence,12/3/20,31,75,75,1210,8093,1075,9342,104,16669,1038,172,7601,492,925,150,31,0,82,22,8639,703,1038,7601,211,492,1249,8093,3,10,1,60
Lee,12/3/20,18,77,77,1215,6479,1143,7701,54,9398,1191,24,6351,128,1131,12,17,1,43,11,7542,159,1191,6351,31,128,1222,6479,6,4,0,30
Lincoln,12/3/20,19,79,79,2540,12841,2398,15411,123,13695,2409,131,11626,1215,2335,63,18,1,56,67,14035,1376,2409,11626,161,1215,2570,12841,21,5,1,227
LittleRiver,12/3/20,37,81,81,660,3242,584,3914,39,12417,555,105,2971,271,492,92,35,2,28,11,3526,388,555,2971,117,271,672,3242,4,0,0,15
Logan,12/3/20,6,83,83,1012,13989,842,15025,164,21757,919,93,12537,1452,778,64,6,0,135,29,13456,1569,919,12537,117,1452,1036,13989,29,11,0,202
Lonoke,12/3/20,56,85,85,2852,37240,2476,40251,320,72206,2207,645,32327,4913,1936,540,53,3,218,102,34534,5717,2207,32327,804,4913,3011,37240,52,32,0,340
Madison,12/3/20,8,87,87,690,7116,569,7832,113,16076,590,100,6676,440,508,61,8,0,74,39,7266,566,590,6676,126,440,716,7116,25,11,0,87
Marion,12/3/20,6,89,89,473,5458,399,5952,68,16438,386,87,4982,476,326,73,5,1,55,13,5368,584,386,4982,108,476,494,5458,9,15,0,76
Miller,12/3/20,22,91,91,2209,11454,2107,13736,80,43759,1644,565,10630,824,1577,530,16,6,51,29,12274,1462,1644,10630,638,824,2282,11454,19,20,0,44
MissingCountyInfo,12/3/20,0,5,5,2584,100794,1843,103385,741,NA,2159,425,100734,60,1517,326,0,0,642,99,102893,492,2159,100734,432,60,2591,100794,85,64,0,1771
Mississippi,12/3/20,82,93,93,3358,20253,2981,23654,294,42831,3084,274,17003,3250,2758,223,68,14,257,37,20087,3567,3084,17003,317,3250,3401,20253,42,30,0,293
Monroe,12/3/20,4,95,95,325,3982,282,4315,39,7249,292,33,3844,138,259,23,4,0,29,10,4136,179,292,3844,41,138,333,3982,10,2,0,45
Montgomery,12/3/20,10,97,97,324,4039,251,4367,63,8993,291,33,3011,1028,241,10,9,1,41,22,3302,1065,291,3011,37,1028,328,4039,3,6,0,120
Nevada,12/3/20,14,99,99,479,6948,420,7432,45,8440,421,58,6723,225,370,50,13,1,38,7,7144,288,421,6723,63,225,484,6948,8,3,0,75
Newton,12/3/20,23,101,101,462,3641,388,4114,51,7848,412,50,2623,1018,346,42,20,3,46,5,3035,1079,412,2623,61,1018,473,3641,8,5,1,26
Ouachita,12/3/20,14,103,103,836,9946,642,10820,179,24106,762,74,9519,427,587,55,14,0,160,19,10281,539,762,9519,112,427,874,9946,21,29,0,108
Perry,12/3/20,4,105,105,271,6694,228,6977,39,10322,238,33,6387,307,206,22,3,1,29,10,6625,352,238,6387,45,307,283,6694,6,2,0,65
Phillips,12/3/20,17,107,107,980,11031,895,12039,68,19034,935,45,10763,268,859,36,17,0,59,9,11698,341,935,10763,73,268,1008,11031,12,7,0,84
Pike,12/3/20,3,109,109,403,3647,365,4056,35,10808,363,40,3371,276,331,34,2,1,30,5,3734,322,363,3371,46,276,409,3647,6,5,0,31
Poinsett,12/3/20,44,111,111,1724,15388,1557,17161,123,24054,1561,163,14765,623,1406,151,39,5,116,7,16326,835,1561,14765,212,623,1773,15388,18,13,1,162
Polk,12/3/20,12,113,113,868,7830,709,8722,146,20163,800,68,7445,385,654,55,12,0,133,13,8245,477,800,7445,92,385,892,7830,19,20,1,86
Pope,12/3/20,43,115,115,3868,38749,3508,42654,317,63644,3378,490,37280,1469,3108,400,38,5,232,85,40658,1996,3378,37280,527,1469,3905,38749,89,46,0,377
Prairie,12/3/20,8,117,117,373,3911,332,4305,33,8244,304,69,3477,434,271,61,8,0,25,8,3781,524,304,3477,90,434,394,3911,7,4,0,25
Pulaski,12/3/20,284,119,119,17578,225734,15460,243717,1832,393463,16096,1482,213717,12017,14310,1150,267,17,1517,315,229813,13904,16096,213717,1887,12017,17983,225734,224,206,7,2028
Randolph,12/3/20,31,121,121,1050,9670,909,10771,110,17603,839,211,8493,1177,732,177,25,6,82,28,9332,1439,839,8493,262,1177,1101,9670,18,16,0,133
Saline,12/3/20,59,125,125,5200,57597,4417,63039,723,118009,4300,900,50652,6945,3707,710,56,3,536,187,54952,8087,4300,50652,1142,6945,5442,57597,83,85,2,640
Scott,12/3/20,3,127,127,407,6147,344,6565,60,10442,324,83,5970,177,275,69,3,0,46,14,6294,271,324,5970,94,177,418,6147,11,5,0,84
Searcy,12/3/20,1,129,129,334,4097,273,4448,60,7923,251,83,3462,635,232,41,1,0,18,42,3713,735,251,3462,100,635,351,4097,25,4,0,67
Sebastian,12/3/20,119,131,131,7300,82196,6539,89562,639,127461,6585,715,80483,1713,5964,575,115,4,504,135,87068,2494,6585,80483,781,1713,7366,82196,111,84,0,792
Sevier,12/3/20,18,133,133,1761,9267,1668,11077,75,17193,1425,336,8211,1056,1376,292,18,0,31,44,9636,1441,1425,8211,385,1056,1810,9267,10,9,0,114
Sharp,12/3/20,18,135,135,765,8502,615,9314,132,17043,588,177,7685,817,488,127,15,3,85,47,8273,1041,588,7685,224,817,812,8502,26,28,3,157
St.Francis,12/3/20,15,123,123,2090,17529,1994,19638,81,26294,2027,63,17333,196,1936,58,15,0,76,5,19360,278,2027,17333,82,196,2109,17529,8,11,0,119
Stone,12/3/20,25,137,137,505,5416,425,5928,55,12446,457,48,5061,355,403,22,23,2,31,24,5518,410,457,5061,55,355,512,5416,10,2,0,66
Union,12/3/20,59,139,139,1627,14755,1464,16452,104,39732,1360,267,12919,1836,1230,234,51,8,79,25,14279,2173,1360,12919,337,1836,1697,14755,21,20,0,181
VanBuren,12/3/20,4,141,141,422,7608,356,8072,62,16684,350,72,6808,800,300,56,4,0,46,16,7158,914,350,6808,114,800,464,7608,15,20,0,70
Washington,12/3/20,179,143,143,16112,132465,14603,149119,1329,228529,13552,2560,118711,13754,12462,2141,159,20,931,398,132263,16856,13552,118711,3102,13754,16654,132465,246,161,1,2113
White,12/3/20,52,145,145,3171,29245,2799,32598,318,78804,2409,762,25224,4021,2172,627,48,4,187,131,27633,4965,2409,25224,944,4021,3353,29245,38,82,1,281
Woodruff,12/3/20,1,147,147,211,3075,189,3299,21,6660,180,31,2933,142,162,27,1,0,17,4,3113,186,180,2933,44,142,224,3075,5,4,0,43
Yell,12/3/20,34,149,149,1696,17679,1549,19392,113,21573,1610,86,17238,441,1487,62,31,3,92,21,18848,544,1610,17238,103,441,1713,17679,15,13,0,265
Arkansas_all_counties,12/2/20,2522,5630,5630,161521,1682186,142600,1848132,16378,2990671,140705,20816,1562561,119625,125975,16625,2312,210,12399,3979,1703266,144866,140705,1562561,25241,119625,165946,1682186,2212,1918,10,14959
Arkansas_county,12/2/20,22,1,1,987,12250,880,13293,85,18124,780,207,9594,2656,706,174,21,1,53,32,10374,2919,780,9594,263,2656,1043,12250,14,9,1,88
Ashley,12/2/20,15,3,3,886,8525,742,9435,129,20537,788,98,8126,399,668,74,14,1,106,23,8914,521,788,8126,122,399,910,8525,15,8,0,89
Baxter,12/2/20,29,5,5,1446,10776,1254,12250,163,41219,1119,327,9570,1206,980,274,28,1,111,52,10689,1561,1119,9570,355,1206,1474,10776,11,29,0,108
Benton,12/2/20,163,7,7,12496,111622,11207,124498,1125,258980,10491,2005,106511,5111,9620,1587,141,22,729,396,117002,7496,10491,106511,2385,5111,12876,111622,208,163,3,902
Boone,12/2/20,44,9,9,1862,18703,1553,20679,265,37288,1581,281,18057,646,1349,204,42,2,190,75,19638,1041,1581,18057,395,646,1976,18703,31,40,0,119
Bradley,12/2/20,7,11,11,527,5960,429,6497,91,10948,452,75,4347,1613,389,40,7,0,56,35,4799,1698,452,4347,85,1613,537,5960,11,12,0,-189
Calhoun,12/2/20,1,13,13,155,2316,129,2478,25,5202,136,19,2227,89,114,15,1,0,21,4,2363,115,136,2227,26,89,162,2316,2,2,0,1
Carroll,12/2/20,23,15,15,1503,11484,1286,13019,194,27887,1380,123,11309,175,1195,91,23,0,162,32,12689,330,1380,11309,155,175,1535,11484,40,22,0,112
Chicot,12/2/20,28,17,17,1205,7620,1106,8835,71,10826,1153,52,6943,677,1068,38,27,1,58,13,8096,739,1153,6943,62,677,1215,7620,10,6,0,89
Clark,12/2/20,11,19,19,851,13339,735,14223,105,22385,734,117,11612,1727,632,103,10,1,92,13,12346,1877,734,11612,150,1727,884,13339,10,6,0,239
Clay,12/2/20,21,21,21,943,9170,757,10141,164,15061,758,185,7239,1931,630,127,17,4,110,54,7997,2144,758,7239,213,1931,971,9170,29,22,0,147
Cleburne,12/2/20,24,23,23,770,11862,633,12650,113,25230,636,134,10346,1516,530,103,23,1,83,30,10982,1668,636,10346,152,1516,788,11862,18,2,0,192
Cleveland,12/2/20,15,25,25,388,5133,318,5533,55,8226,298,90,4924,209,264,54,14,1,20,35,5222,311,298,4924,102,209,400,5133,9,9,0,88
Columbia,12/2/20,24,27,27,1141,10184,974,11406,143,23892,840,301,8388,1796,747,227,24,0,69,74,9228,2178,840,8388,382,1796,1222,10184,14,16,0,55
Conway,12/2/20,8,29,29,711,11305,586,12037,117,20906,630,81,10306,999,527,59,8,0,95,22,10936,1101,630,10306,102,999,732,11305,16,13,0,75
Craighead,12/2/20,82,31,31,7363,64680,6501,72205,779,105701,6673,690,58382,6298,5909,592,75,7,688,91,65055,7150,6673,58382,852,6298,7525,64680,128,75,0,495
Crawford,12/2/20,38,33,33,3163,36756,2831,39942,292,62472,2856,307,35831,925,2581,250,35,3,238,54,38687,1255,2856,35831,330,925,3186,36756,37,39,0,319
Crittenden,12/2/20,57,35,35,3352,21889,3049,25286,245,49013,3186,166,21066,823,2913,136,51,6,221,24,24252,1034,3186,21066,211,823,3397,21889,64,42,0,335
Cross,12/2/20,26,37,37,887,8572,765,9481,96,16998,758,129,8165,407,656,109,25,1,77,19,8923,558,758,8165,151,407,909,8572,6,16,0,135
Dallas,12/2/20,6,39,39,317,3629,257,3950,54,7432,299,18,3487,142,246,11,6,0,47,7,3786,164,299,3487,22,142,321,3629,14,5,0,24
Desha,12/2/20,8,41,41,585,6391,510,7004,67,11887,510,75,5920,471,465,45,7,1,38,29,6430,574,510,5920,103,471,613,6391,11,6,0,74
Drew,12/2/20,8,43,43,798,10066,577,10880,213,18502,620,178,8862,1204,486,91,7,1,127,86,9482,1398,620,8862,194,1204,814,10066,35,16,0,122
Faulkner,12/2/20,56,45,45,4998,65676,4363,70821,579,122416,4372,626,60085,5591,3914,449,49,7,409,170,64457,6364,4372,60085,773,5591,5145,65676,91,49,0,554
Franklin,12/2/20,13,47,47,812,11176,709,12016,90,17780,705,107,10794,382,624,85,13,0,68,22,11499,517,705,10794,135,382,840,11176,9,9,0,85
Fulton,12/2/20,12,49,49,563,3726,485,4311,66,12139,429,134,3048,678,374,111,10,2,45,21,3477,834,429,3048,156,678,585,3726,2,9,0,20
Garland,12/2/20,105,51,51,3949,50158,3437,54189,406,98296,3614,335,48032,2126,3181,256,99,6,333,73,51646,2543,3614,48032,417,2126,4031,50158,39,55,0,335
Grant,12/2/20,6,53,53,641,8998,532,9655,103,18086,529,112,8067,931,451,81,5,1,73,30,8596,1059,529,8067,128,931,657,8998,17,15,0,88
Greene,12/2/20,28,55,55,3096,26621,2564,29808,504,44623,2549,547,23987,2634,2117,447,26,2,406,98,26536,3272,2549,23987,638,2634,3187,26621,52,55,1,203
Hempstead,12/2/20,8,57,57,890,9136,830,10051,52,22018,737,153,8730,406,697,133,6,2,34,18,9467,584,737,8730,178,406,915,9136,8,9,0,120
HotSpring,12/2/20,42,59,59,2971,25180,2728,28191,201,33520,2851,120,22674,2506,2644,84,40,2,167,34,25525,2666,2851,22674,160,2506,3011,25180,17,25,0,348
Howard,12/2/20,15,61,61,841,5683,778,6542,48,13389,670,171,4751,932,638,140,15,0,17,31,5421,1121,670,4751,189,932,859,5683,5,8,0,139
Independence,12/2/20,71,63,63,2147,20199,1882,22432,194,37264,1610,537,18118,2081,1457,425,61,10,92,102,19728,2704,1610,18118,623,2081,2233,20199,22,17,0,75
Izard,12/2/20,6,65,65,1013,8244,941,9275,66,13559,901,112,7207,1037,848,93,6,0,47,19,8108,1167,901,7207,130,1037,1031,8244,6,11,0,31
Jackson,12/2/20,9,67,67,1868,14980,1468,16978,391,17225,1519,349,13176,1804,1171,297,7,2,341,50,14695,2283,1519,13176,479,1804,1998,14980,48,74,1,204
Jefferson,12/2/20,111,69,69,5263,51131,4850,56565,300,70424,4764,499,48767,2364,4509,341,104,7,149,151,53531,3034,4764,48767,670,2364,5434,51131,25,37,0,575
Johnson,12/2/20,13,71,71,1285,13481,1203,14777,69,26291,1194,91,12983,498,1129,74,12,1,53,16,14177,600,1194,12983,102,498,1296,13481,7,9,1,198
Lafayette,12/2/20,3,73,73,271,1952,247,2242,21,6915,222,49,1817,135,202,45,3,0,17,4,2039,203,222,1817,68,135,290,1952,4,1,0,21
Lawrence,12/2/20,30,75,75,1207,8036,1065,9281,112,16669,1034,173,7556,480,918,147,30,0,86,26,8590,691,1034,7556,211,480,1245,8036,26,10,1,80
Lee,12/2/20,18,77,77,1209,6455,1139,7670,52,9398,1190,19,6328,127,1127,12,17,1,46,6,7518,152,1190,6328,25,127,1215,6455,12,4,0,120
Lincoln,12/2/20,18,79,79,2519,12635,2393,15184,108,13695,2400,119,11496,1139,2335,58,17,1,48,60,13896,1288,2400,11496,149,1139,2549,12635,42,4,0,226
LittleRiver,12/2/20,37,81,81,656,3231,584,3899,35,12417,554,102,2962,269,492,92,35,2,27,8,3516,383,554,2962,114,269,668,3231,5,6,0,60
Logan,12/2/20,6,83,83,983,13816,831,14821,146,21757,894,89,12368,1448,771,60,6,0,117,29,13262,1559,894,12368,111,1448,1005,13816,8,7,0,68
Lonoke,12/2/20,56,85,85,2800,36952,2444,39906,300,72206,2179,621,32089,4863,1911,533,53,3,215,85,34268,5638,2179,32089,775,4863,2954,36952,22,33,0,384
Madison,12/2/20,8,87,87,665,7054,558,7738,99,16076,568,97,6634,420,498,60,8,0,62,37,7202,536,568,6634,116,420,684,7054,25,12,0,66
Marion,12/2/20,6,89,89,464,5391,384,5876,74,16438,380,84,4921,470,315,69,5,1,60,14,5301,575,380,4921,105,470,485,5391,16,9,0,82
Miller,12/2/20,22,91,91,2190,11429,2087,13691,81,43759,1637,553,10607,822,1564,523,16,6,57,24,12244,1447,1637,10607,625,822,2262,11429,12,22,0,220
MissingCountyInfo,12/2/20,0,5,5,2499,99108,1779,101616,720,NA,2108,391,99047,61,1490,289,0,0,618,102,101155,461,2108,99047,400,61,2508,99108,-3,51,0,1281
Mississippi,12/2/20,82,93,93,3316,20002,2951,23356,282,42831,3047,269,16904,3098,2731,220,68,14,247,35,19951,3405,3047,16904,307,3098,3354,20002,51,29,1,130
Monroe,12/2/20,4,95,95,315,3947,280,4269,31,7249,284,31,3810,137,259,21,4,0,21,10,4094,175,284,3810,38,137,322,3947,5,3,0,35
Montgomery,12/2/20,10,97,97,321,3922,245,4245,66,8993,289,32,2995,927,236,9,9,1,44,22,3284,961,289,2995,34,927,323,3922,7,10,0,11
Nevada,12/2/20,14,99,99,471,6881,417,7357,40,8440,414,57,6659,222,368,49,13,1,33,7,7073,284,414,6659,62,222,476,6881,3,5,0,54
Newton,12/2/20,22,101,101,454,3623,383,4088,49,7848,405,49,2606,1017,342,41,19,3,44,5,3011,1077,405,2606,60,1017,465,3623,4,6,0,13
Ouachita,12/2/20,14,103,103,815,9859,613,10712,187,24106,749,66,9443,416,560,53,14,0,174,13,10192,520,749,9443,104,416,853,9859,21,23,0,67
Perry,12/2/20,4,105,105,265,6635,226,6912,35,10322,234,31,6336,299,204,22,3,1,27,8,6570,342,234,6336,43,299,277,6635,2,6,0,31
Phillips,12/2/20,17,107,107,968,10959,888,11955,63,19034,924,44,10693,266,853,35,17,0,54,9,11617,338,924,10693,72,266,996,10959,8,9,0,133
Pike,12/2/20,3,109,109,397,3622,360,4025,34,10808,358,39,3352,270,328,32,2,1,28,6,3710,315,358,3352,45,270,403,3622,7,9,0,79
Poinsett,12/2/20,43,111,111,1706,15244,1544,16998,119,24054,1543,163,14629,615,1395,149,38,5,110,9,16172,826,1543,14629,211,615,1754,15244,17,19,0,116
Polk,12/2/20,11,113,113,849,7763,689,8635,148,20163,786,63,7378,385,635,54,11,0,139,9,8164,471,786,7378,86,385,872,7763,19,20,0,62
Pope,12/2/20,43,115,115,3779,38461,3462,42276,274,63644,3308,471,37006,1455,3074,388,38,5,196,78,40314,1962,3308,37006,507,1455,3815,38461,18,33,0,155
Prairie,12/2/20,8,117,117,366,3893,328,4278,30,8244,298,68,3459,434,267,61,8,0,23,7,3757,521,298,3459,87,434,385,3893,5,2,0,23
Pulaski,12/2/20,277,119,119,17354,223930,15254,241678,1821,393463,15936,1418,212076,11854,14139,1115,260,17,1535,286,228012,13666,15936,212076,1812,11854,17748,223930,254,172,1,1572
Randolph,12/2/20,31,121,121,1032,9555,893,10638,108,17603,827,205,8390,1165,719,174,25,6,83,25,9217,1421,827,8390,256,1165,1083,9555,25,14,0,216
Saline,12/2/20,57,125,125,5117,57040,4332,62397,727,118009,4247,870,50222,6818,3651,681,54,3,541,186,54469,7928,4247,50222,1110,6818,5357,57040,121,63,0,704
Scott,12/2/20,3,127,127,396,6074,339,6480,54,10442,313,83,5903,171,269,70,3,0,41,13,6216,264,313,5903,93,171,406,6074,8,7,0,112
Searcy,12/2/20,1,129,129,309,4055,269,4372,39,7923,248,61,3441,614,228,41,1,0,19,20,3689,683,248,3441,69,614,317,4055,0,4,0,32
Sebastian,12/2/20,119,131,131,7189,81515,6455,88767,612,127461,6492,697,79847,1668,5891,564,115,4,484,128,86339,2428,6492,79847,760,1668,7252,81515,67,71,0,568
Sevier,12/2/20,18,133,133,1751,9163,1659,10962,74,17193,1422,329,8147,1016,1369,290,18,0,35,39,9569,1393,1422,8147,377,1016,1799,9163,15,13,0,77
Sharp,12/2/20,15,135,135,739,8371,587,9156,137,17043,568,171,7583,788,468,119,13,2,87,50,8151,1005,568,7583,217,788,785,8371,11,6,0,111
St.Francis,12/2/20,15,123,123,2082,17418,1983,19518,84,26294,2019,63,17227,191,1926,57,15,0,78,6,19246,272,2019,17227,81,191,2100,17418,15,13,0,81
Stone,12/2/20,25,137,137,495,5360,423,5861,47,12446,454,41,5030,330,401,22,23,2,30,17,5484,377,454,5030,47,330,501,5360,9,4,0,42
Union,12/2/20,59,139,139,1606,14595,1444,16269,103,39732,1344,262,12779,1816,1215,229,51,8,78,25,14123,2146,1344,12779,330,1816,1674,14595,21,23,0,132
VanBuren,12/2/20,4,141,141,407,7553,336,8001,67,16684,346,61,6763,790,294,42,4,0,48,19,7109,892,346,6763,102,790,448,7553,11,9,0,45
Washington,12/2/20,178,143,143,15866,130598,14442,146970,1245,228529,13397,2469,117441,13157,12350,2092,158,20,889,356,130838,16132,13397,117441,2975,13157,16372,130598,174,167,0,936
White,12/2/20,51,145,145,3133,29002,2717,32318,363,78804,2392,741,25096,3906,2116,601,47,4,227,136,27488,4830,2392,25096,924,3906,3316,29002,49,63,0,143
Woodruff,12/2/20,1,147,147,206,3037,185,3255,20,6660,175,31,2899,138,158,27,1,0,16,4,3074,181,175,2899,43,138,218,3037,1,3,0,3
Yell,12/2/20,34,149,149,1681,17429,1536,19127,111,21573,1598,83,16991,438,1477,59,31,3,90,21,18589,538,1598,16991,100,438,1698,17429,14,13,0,74
Arkansas_all_counties,12/1/20,2512,5630,5630,159309,1669439,140682,1833060,16094,2990671,139198,20111,1552255,117184,124466,16216,2304,208,12409,3685,1691453,141607,139198,1552255,24423,117184,163621,1669439,1950,1986,10,12688
Arkansas_county,12/1/20,21,1,1,973,12176,871,13205,81,18124,772,201,9540,2636,697,174,21,0,54,27,10312,2893,772,9540,257,2636,1029,12176,13,18,0,78
Ashley,12/1/20,15,3,3,871,8451,734,9347,122,20537,777,94,8054,397,662,72,14,1,101,21,8831,516,777,8054,119,397,896,8451,11,10,0,140
Baxter,12/1/20,29,5,5,1435,10679,1225,12143,181,41219,1111,324,9475,1204,955,270,28,1,128,53,10586,1557,1111,9475,353,1204,1464,10679,19,38,0,73
Benton,12/1/20,160,7,7,12288,110928,11044,123581,1083,258980,10384,1904,105970,4958,9507,1537,138,22,738,345,116354,7227,10384,105970,2269,4958,12653,110928,197,131,0,633
Boone,12/1/20,44,9,9,1831,18615,1513,20548,274,37288,1560,271,17980,635,1306,207,42,2,212,62,19540,1008,1560,17980,373,635,1933,18615,38,15,0,146
Bradley,12/1/20,7,11,11,516,6160,417,6684,92,10948,441,75,4563,1597,382,35,7,0,52,40,5004,1680,441,4563,83,1597,524,6160,12,6,0,232
Calhoun,12/1/20,1,13,13,153,2317,127,2477,25,5202,134,19,2228,89,112,15,1,0,21,4,2362,115,134,2228,26,89,160,2317,3,6,0,10
Carroll,12/1/20,23,15,15,1463,11412,1264,12906,176,27887,1354,109,11238,174,1176,88,23,0,155,21,12592,314,1354,11238,140,174,1494,11412,30,21,0,142
Chicot,12/1/20,28,17,17,1195,7541,1100,8746,67,10826,1143,52,6866,675,1062,38,27,1,54,13,8009,737,1143,6866,62,675,1205,7541,4,3,1,67
Clark,12/1/20,11,19,19,841,13110,729,13984,101,22385,727,114,11453,1657,627,102,10,1,90,11,12180,1804,727,11453,147,1657,874,13110,3,3,0,28
Clay,12/1/20,21,21,21,914,9052,735,9993,157,15061,742,172,7213,1839,613,122,17,4,111,46,7955,2038,742,7213,199,1839,941,9052,24,17,0,193
Cleburne,12/1/20,24,23,23,752,11688,631,12457,97,25230,620,132,10225,1463,529,102,23,1,68,29,10845,1612,620,10225,149,1463,769,11688,18,12,1,103
Cleveland,12/1/20,15,25,25,379,5054,309,5445,55,8226,294,85,4849,205,258,51,14,1,22,33,5143,302,294,4849,97,205,391,5054,17,7,0,49
Columbia,12/1/20,24,27,27,1127,10143,958,11350,145,23892,835,292,8360,1783,738,220,24,0,73,72,9195,2155,835,8360,372,1783,1207,10143,27,24,0,65
Conway,12/1/20,8,29,29,695,11246,573,11962,114,20906,614,81,10262,984,519,54,8,0,87,27,10876,1086,614,10262,102,984,716,11246,13,14,0,111
Craighead,12/1/20,82,31,31,7235,64313,6426,71708,726,105701,6569,666,58056,6257,5844,582,75,7,649,77,64625,7083,6569,58056,826,6257,7395,64313,63,106,1,509
Crawford,12/1/20,38,33,33,3126,36474,2792,39623,294,62472,2831,295,35626,848,2544,248,35,3,250,44,38457,1166,2831,35626,318,848,3149,36474,45,41,0,232
Crittenden,12/1/20,57,35,35,3288,21618,3007,24946,223,49013,3125,163,20834,784,2873,134,51,6,200,23,23959,987,3125,20834,203,784,3328,21618,17,22,0,107
Cross,12/1/20,26,37,37,881,8443,749,9346,106,16998,756,125,8043,400,642,107,25,1,89,17,8799,547,756,8043,147,400,903,8443,17,14,0,44
Dallas,12/1/20,6,39,39,303,3619,252,3926,45,7432,286,17,3482,137,242,10,6,0,38,7,3768,158,286,3482,21,137,307,3619,1,7,0,14
Desha,12/1/20,8,41,41,574,6328,504,6927,62,11887,501,73,5897,431,461,43,7,1,33,29,6398,529,501,5897,98,431,599,6328,10,10,0,93
Drew,12/1/20,8,43,43,763,9979,561,10757,194,18502,587,176,8802,1177,481,80,7,1,99,95,9389,1368,587,8802,191,1177,778,9979,20,9,1,172
Faulkner,12/1/20,56,45,45,4907,65213,4314,70264,537,122416,4311,596,59699,5514,3872,442,49,7,390,147,64010,6254,4311,59699,740,5514,5051,65213,75,72,0,744
Franklin,12/1/20,13,47,47,803,11100,700,11928,90,17780,697,106,10733,367,618,82,13,0,66,24,11430,498,697,10733,131,367,828,11100,4,18,0,65
Fulton,12/1/20,12,49,49,561,3708,476,4290,73,12139,428,133,3039,669,368,108,10,2,50,23,3467,823,428,3039,154,669,582,3708,12,5,0,40
Garland,12/1/20,105,51,51,3910,49862,3382,53850,422,98296,3585,325,47775,2087,3140,242,99,6,345,77,51360,2490,3585,47775,403,2087,3988,49862,38,51,0,133
Grant,12/1/20,6,53,53,624,8927,517,9567,101,18086,518,106,8022,905,443,74,5,1,70,31,8540,1027,518,8022,122,905,640,8927,15,7,0,76
Greene,12/1/20,27,55,55,3044,26470,2509,29606,508,44623,2512,532,23874,2596,2072,437,25,2,415,93,26386,3220,2512,23874,624,2596,3136,26470,91,69,0,327
Hempstead,12/1/20,8,57,57,882,9024,821,9931,53,22018,735,147,8623,401,692,129,6,2,37,16,9358,573,735,8623,172,401,907,9024,16,10,0,46
HotSpring,12/1/20,42,59,59,2954,24849,2703,27841,209,33520,2832,122,22405,2444,2620,83,40,2,172,37,25237,2604,2832,22405,160,2444,2992,24849,6,25,0,131
Howard,12/1/20,15,61,61,836,5549,770,6403,51,13389,668,168,4693,856,630,140,15,0,23,28,5361,1042,668,4693,186,856,854,5549,22,10,0,107
Independence,12/1/20,71,63,63,2125,20146,1865,22355,189,37264,1602,523,18100,2046,1447,418,61,10,94,95,19702,2653,1602,18100,607,2046,2209,20146,37,15,0,364
Izard,12/1/20,6,65,65,1007,8219,930,9244,71,13559,899,108,7188,1031,839,91,6,0,54,17,8087,1157,899,7188,126,1031,1025,8219,9,2,0,34
Jackson,12/1/20,8,67,67,1820,14824,1394,16774,418,17225,1499,321,13020,1804,1103,291,7,1,389,29,14519,2255,1499,13020,451,1804,1950,14824,13,81,0,41
Jefferson,12/1/20,111,69,69,5238,50581,4813,55984,312,70424,4756,482,48370,2211,4489,324,104,7,161,151,53126,2858,4756,48370,647,2211,5403,50581,31,33,0,390
Johnson,12/1/20,12,71,71,1278,13290,1194,14579,72,26291,1190,88,12807,483,1122,72,11,1,57,15,13997,582,1190,12807,99,483,1289,13290,4,12,1,169
Lafayette,12/1/20,3,73,73,267,1935,246,2221,18,6915,219,48,1802,133,201,45,3,0,15,3,2021,200,219,1802,67,133,286,1935,1,3,0,8
Lawrence,12/1/20,29,75,75,1181,7982,1055,9201,97,16669,1024,157,7524,458,913,142,29,0,82,15,8548,653,1024,7524,195,458,1219,7982,10,14,0,40
Lee,12/1/20,18,77,77,1197,6347,1135,7550,44,9398,1178,19,6220,127,1123,12,17,1,38,6,7398,152,1178,6220,25,127,1203,6347,3,3,0,24
Lincoln,12/1/20,18,79,79,2477,12451,2389,14950,70,13695,2390,87,11326,1125,2334,55,17,1,39,31,13716,1234,2390,11326,109,1125,2499,12451,13,17,0,155
LittleRiver,12/1/20,37,81,81,651,3176,578,3838,36,12417,552,99,2907,269,486,92,35,2,31,5,3459,379,552,2907,110,269,662,3176,6,9,0,13
Logan,12/1/20,6,83,83,975,13756,824,14752,145,21757,889,86,12316,1440,766,58,6,0,117,28,13205,1547,889,12316,107,1440,996,13756,15,26,0,128
Lonoke,12/1/20,56,85,85,2778,36590,2411,39522,311,72206,2161,617,31790,4800,1887,524,53,3,221,90,33951,5571,2161,31790,771,4800,2932,36590,43,35,1,385
Madison,12/1/20,8,87,87,640,7013,546,7671,86,16076,555,85,6599,414,490,56,8,0,57,29,7154,517,555,6599,103,414,658,7013,11,3,0,48
Marion,12/1/20,6,89,89,448,5325,375,5794,67,16438,367,81,4866,459,307,68,5,1,55,12,5233,561,367,4866,102,459,469,5325,6,10,0,80
Miller,12/1/20,22,91,91,2178,11221,2065,13471,91,43759,1633,545,10479,742,1548,517,16,6,69,22,12112,1359,1633,10479,617,742,2250,11221,20,16,0,48
MissingCountyInfo,12/1/20,0,5,5,2502,97824,1728,100337,774,NA,2139,363,97764,60,1454,274,0,0,685,89,99903,434,2139,97764,374,60,2513,97824,8,18,0,730
Mississippi,12/1/20,81,93,93,3265,19923,2922,23225,261,42831,3014,251,16827,3096,2708,214,67,14,238,23,19841,3384,3014,16827,288,3096,3302,19923,40,35,0,209
Monroe,12/1/20,4,95,95,310,3917,277,4234,29,7249,282,28,3781,136,257,20,4,0,21,8,4063,171,282,3781,35,136,317,3917,1,4,0,31
Montgomery,12/1/20,10,97,97,314,3918,235,4233,69,8993,285,29,2991,927,228,7,9,1,48,21,3276,957,285,2991,30,927,315,3918,4,8,0,99
Nevada,12/1/20,14,99,99,468,6830,412,7303,42,8440,411,57,6615,215,364,48,13,1,34,8,7026,277,411,6615,62,215,473,6830,4,12,0,80
Newton,12/1/20,22,101,101,450,3614,377,4075,51,7848,401,49,2597,1017,337,40,19,3,45,6,2998,1077,401,2597,60,1017,461,3614,6,5,0,54
Ouachita,12/1/20,14,103,103,794,9813,590,10644,189,24106,729,65,9402,411,538,52,14,0,176,13,10131,513,729,9402,102,411,831,9813,18,22,2,91
Perry,12/1/20,4,105,105,263,6606,220,6880,39,10322,234,29,6305,301,198,22,3,1,33,6,6539,341,234,6305,40,301,274,6606,3,6,0,37
Phillips,12/1/20,17,107,107,960,10834,879,11822,64,19034,919,41,10571,263,846,33,17,0,56,8,11490,332,919,10571,69,263,988,10834,3,16,0,30
Pike,12/1/20,3,109,109,390,3550,351,3946,36,10808,353,37,3303,247,321,30,2,1,30,6,3656,290,353,3303,43,247,396,3550,3,10,0,35
Poinsett,12/1/20,43,111,111,1689,15145,1525,16882,121,24054,1529,160,14540,605,1377,148,38,5,114,7,16069,813,1529,14540,208,605,1737,15145,16,18,0,82
Polk,12/1/20,11,113,113,830,7720,669,8573,149,20163,767,63,7337,383,617,52,11,0,138,11,8104,469,767,7337,86,383,853,7720,14,11,1,61
Pope,12/1/20,43,115,115,3761,38324,3429,42122,289,63644,3295,466,36908,1416,3050,379,38,5,207,82,40203,1919,3295,36908,503,1416,3798,38324,31,64,0,207
Prairie,12/1/20,8,117,117,361,3875,326,4255,27,8244,295,66,3446,429,266,60,8,0,21,6,3741,514,295,3446,85,429,380,3875,1,4,0,9
Pulaski,12/1/20,276,119,119,17100,222612,15082,240083,1740,393463,15710,1390,210923,11689,13976,1106,259,17,1473,267,226633,13450,15710,210923,1761,11689,17471,222612,195,224,0,1215
Randolph,12/1/20,31,121,121,1007,9364,879,10421,97,17603,807,200,8370,994,704,175,25,6,78,19,9177,1244,807,8370,250,994,1057,9364,18,15,0,47
Saline,12/1/20,57,125,125,4996,56457,4269,61690,669,118009,4136,860,49815,6642,3608,661,54,3,473,196,53951,7739,4136,49815,1097,6642,5233,56457,107,85,0,733
Scott,12/1/20,3,127,127,388,5970,332,6367,53,10442,307,81,5803,167,265,67,3,0,39,14,6110,257,307,5803,90,167,397,5970,6,6,0,46
Searcy,12/1/20,1,129,129,309,4023,265,4340,43,7923,248,61,3411,612,225,40,1,0,22,21,3659,681,248,3411,69,612,317,4023,12,3,0,74
Sebastian,12/1/20,119,131,131,7122,81014,6384,88199,616,127461,6444,678,79396,1618,5837,547,115,4,490,126,85840,2359,6444,79396,741,1618,7185,81014,77,74,0,435
Sevier,12/1/20,18,133,133,1736,9101,1646,10885,72,17193,1417,319,8121,980,1364,282,18,0,35,37,9538,1347,1417,8121,367,980,1784,9101,21,15,0,47
Sharp,12/1/20,15,135,135,728,8271,581,9045,132,17043,563,165,7544,727,464,117,13,2,86,46,8107,938,563,7544,211,727,774,8271,27,15,0,99
St.Francis,12/1/20,15,123,123,2067,17352,1970,19437,82,26294,2008,59,17162,190,1914,56,15,0,79,3,19170,267,2008,17162,77,190,2085,17352,9,10,0,31
Stone,12/1/20,25,137,137,486,5327,419,5819,42,12446,449,37,5011,316,398,21,23,2,28,14,5460,359,449,5011,43,316,492,5327,6,4,0,23
Union,12/1/20,59,139,139,1585,14484,1421,16137,105,39732,1331,254,12677,1807,1198,223,51,8,82,23,14008,2129,1331,12677,322,1807,1653,14484,17,21,0,38
VanBuren,12/1/20,4,141,141,396,7519,327,7956,65,16684,339,57,6740,779,285,42,4,0,50,15,7079,877,339,6740,98,779,437,7519,10,18,0,102
Washington,12/1/20,178,143,143,15692,129836,14275,146023,1238,228529,13305,2387,116835,13001,12227,2048,158,20,920,318,130140,15883,13305,116835,2882,13001,16187,129836,144,121,1,910
White,12/1/20,51,145,145,3084,28908,2654,32175,377,78804,2358,726,25028,3880,2080,574,47,4,229,148,27386,4789,2358,25028,909,3880,3267,28908,34,49,0,230
Woodruff,12/1/20,1,147,147,205,3035,182,3253,22,6660,175,30,2897,138,155,27,1,0,19,3,3072,181,175,2897,43,138,218,3035,2,5,0,11
Yell,12/1/20,34,149,149,1667,17369,1523,19052,110,21573,1585,82,16942,427,1465,58,31,3,89,21,18527,525,1585,16942,98,427,1683,17369,10,8,0,55
Arkansas_all_counties,11/30/20,2502,5630,5630,157359,1658701,138696,1820231,16140,2990671,138056,19303,1545401,113300,122926,15770,2295,207,12816,3324,1683457,136774,138056,1545401,23474,113300,161530,1658701,1112,1824,32,8574
Arkansas_county,11/30/20,21,1,1,960,12111,853,13127,86,18124,762,198,9523,2588,684,169,21,0,57,29,10285,2842,762,9523,254,2588,1016,12111,1,11,1,24
Ashley,11/30/20,15,3,3,860,8322,724,9206,121,20537,768,92,7953,369,654,70,14,1,100,21,8721,485,768,7953,116,369,884,8322,5,13,0,50
Baxter,11/30/20,29,5,5,1416,10625,1187,12064,200,41219,1105,311,9425,1200,925,262,28,1,152,48,10530,1534,1105,9425,334,1200,1439,10625,10,33,0,101
Benton,11/30/20,160,7,7,12091,110492,10913,122935,1017,258980,10277,1814,105640,4852,9413,1500,138,22,725,292,115917,7018,10277,105640,2166,4852,12443,110492,90,120,2,1223
Boone,11/30/20,44,9,9,1793,18507,1498,20395,251,37288,1527,266,17899,608,1290,208,42,2,195,56,19426,969,1527,17899,361,608,1888,18507,25,32,1,164
Bradley,11/30/20,7,11,11,504,5940,411,6451,86,10948,435,69,4559,1381,380,31,7,0,48,38,4994,1457,435,4559,76,1381,511,5940,9,6,0,32
Calhoun,11/30/20,1,13,13,150,2310,121,2467,28,5202,133,17,2227,83,108,13,1,0,24,4,2360,107,133,2227,24,83,157,2310,3,4,0,10
Carroll,11/30/20,23,15,15,1433,11300,1243,12760,167,27887,1329,104,11135,165,1159,84,23,0,147,20,12464,296,1329,11135,131,165,1460,11300,16,23,0,135
Chicot,11/30/20,27,17,17,1191,7478,1097,8679,67,10826,1142,49,6863,615,1060,37,26,1,56,11,8005,674,1142,6863,59,615,1201,7478,5,8,0,15
Clark,11/30/20,11,19,19,838,13085,726,13956,101,22385,726,112,11445,1640,624,102,10,1,92,9,12171,1785,726,11445,145,1640,871,13085,30,18,0,262
Clay,11/30/20,21,21,21,890,8883,718,9801,150,15061,733,157,7114,1769,602,116,17,4,113,37,7847,1954,733,7114,185,1769,918,8883,16,9,0,113
Cleburne,11/30/20,23,23,23,734,11603,619,12354,92,25230,612,122,10193,1410,522,97,22,1,68,24,10805,1549,612,10193,139,1410,751,11603,6,11,1,48
Cleveland,11/30/20,15,25,25,362,5022,302,5395,45,8226,291,71,4833,189,253,49,14,1,24,21,5124,271,291,4833,82,189,373,5022,0,3,0,12
Columbia,11/30/20,24,27,27,1100,10105,934,11280,142,23892,818,282,8347,1758,721,213,24,0,73,69,9165,2115,818,8347,357,1758,1175,10105,7,8,0,140
Conway,11/30/20,8,29,29,682,11148,559,11850,115,20906,609,73,10220,928,510,49,8,0,91,24,10829,1021,609,10220,93,928,702,11148,8,15,0,57
Craighead,11/30/20,81,31,31,7172,63867,6320,71191,770,105701,6509,663,57781,6086,5750,570,74,7,684,86,64290,6901,6509,57781,815,6086,7324,63867,106,94,3,643
Crawford,11/30/20,38,33,33,3081,36287,2751,39391,290,62472,2796,285,35455,832,2506,245,35,3,253,37,38251,1140,2796,35455,308,832,3104,36287,15,18,1,409
Crittenden,11/30/20,57,35,35,3271,21528,2985,24840,228,49013,3116,155,20767,761,2855,130,51,6,209,19,23883,957,3116,20767,196,761,3312,21528,17,38,1,434
Cross,11/30/20,26,37,37,864,8416,735,9302,103,16998,752,112,8022,394,633,102,25,1,94,9,8774,528,752,8022,134,394,886,8416,12,26,0,83
Dallas,11/30/20,6,39,39,302,3606,245,3911,51,7432,286,16,3475,131,236,9,6,0,44,7,3761,150,286,3475,19,131,305,3606,2,6,0,27
Desha,11/30/20,8,41,41,564,6245,494,6833,62,11887,495,69,5855,390,455,39,7,1,33,29,6350,483,495,5855,93,390,588,6245,5,8,0,54
Drew,11/30/20,7,43,43,743,9827,552,10582,184,18502,576,167,8775,1052,475,77,6,1,95,89,9351,1231,576,8775,179,1052,755,9827,11,11,0,132
Faulkner,11/30/20,56,45,45,4832,64544,4242,69516,534,122416,4279,553,59407,5137,3811,431,49,7,419,115,63686,5830,4279,59407,693,5137,4972,64544,57,55,0,457
Franklin,11/30/20,13,47,47,799,11039,682,11863,104,17780,697,102,10682,357,602,80,13,0,82,22,11379,484,697,10682,127,357,824,11039,4,3,1,62
Fulton,11/30/20,12,49,49,549,3680,471,4249,66,12139,422,127,3022,658,364,107,10,2,48,18,3444,805,422,3022,147,658,569,3680,1,8,0,44
Garland,11/30/20,105,51,51,3872,49767,3331,53717,435,98296,3571,301,47713,2054,3102,229,99,6,369,66,51284,2433,3571,47713,379,2054,3950,49767,63,41,1,509
Grant,11/30/20,6,53,53,609,8866,510,9491,93,18086,511,98,8006,860,436,74,5,1,70,23,8517,974,511,8006,114,860,625,8866,7,21,1,43
Greene,11/30/20,27,55,55,2953,26234,2440,29272,486,44623,2443,510,23715,2519,2022,418,25,2,396,90,26158,3114,2443,23715,595,2519,3038,26234,45,51,1,428
Hempstead,11/30/20,8,57,57,866,8994,811,9885,47,22018,726,140,8600,394,683,128,6,2,37,10,9326,559,726,8600,165,394,891,8994,18,11,0,74
HotSpring,11/30/20,42,59,59,2948,24724,2678,27710,228,33520,2831,117,22349,2375,2602,76,40,2,189,39,25180,2530,2831,22349,155,2375,2986,24724,23,33,0,241
Howard,11/30/20,15,61,61,814,5464,760,6295,39,13389,665,149,4688,776,625,135,15,0,25,14,5353,942,665,4688,166,776,831,5464,13,15,0,68
Independence,11/30/20,71,63,63,2088,19819,1850,21991,167,37264,1595,493,18081,1738,1440,410,61,10,94,73,19676,2315,1595,18081,577,1738,2172,19819,12,23,0,170
Izard,11/30/20,6,65,65,998,8194,928,9210,64,13559,897,101,7177,1017,839,89,6,0,52,12,8074,1136,897,7177,119,1017,1016,8194,2,5,0,158
Jackson,11/30/20,8,67,67,1807,14796,1313,16729,486,17225,1491,316,13003,1793,1025,288,7,1,459,27,14494,2235,1491,13003,442,1793,1933,14796,19,13,1,244
Jefferson,11/30/20,111,69,69,5207,50222,4780,55592,314,70424,4746,461,48032,2190,4468,312,104,7,172,142,52778,2814,4746,48032,624,2190,5370,50222,10,43,0,188
Johnson,11/30/20,11,71,71,1274,13125,1182,14409,81,26291,1187,87,12650,475,1110,72,10,1,67,14,13837,572,1187,12650,97,475,1284,13125,5,8,0,63
Lafayette,11/30/20,3,73,73,266,1928,243,2213,20,6915,219,47,1796,132,200,43,3,0,16,4,2015,198,219,1796,66,132,285,1928,1,4,0,10
Lawrence,11/30/20,29,75,75,1171,7952,1041,9159,101,16669,1018,153,7501,451,905,136,29,0,84,17,8519,640,1018,7501,189,451,1207,7952,7,11,1,72
Lee,11/30/20,18,77,77,1194,6326,1132,7526,44,9398,1177,17,6201,125,1121,11,17,1,39,5,7378,148,1177,6201,23,125,1200,6326,5,4,0,46
Lincoln,11/30/20,18,79,79,2464,12309,2372,14795,74,13695,2380,84,11189,1120,2324,48,17,1,39,35,13569,1226,2380,11189,106,1120,2486,12309,6,8,0,77
LittleRiver,11/30/20,37,81,81,645,3169,569,3824,39,12417,548,97,2900,269,479,90,35,2,34,5,3448,376,548,2900,107,269,655,3169,4,8,0,34
Logan,11/30/20,6,83,83,960,13643,798,14625,156,21757,882,78,12213,1430,743,55,6,0,133,23,13095,1530,882,12213,100,1430,982,13643,4,9,0,131
Lonoke,11/30/20,55,85,85,2735,36248,2376,39133,304,72206,2134,601,31512,4736,1862,514,52,3,220,84,33646,5487,2134,31512,751,4736,2885,36248,36,34,1,203
Madison,11/30/20,8,87,87,629,6976,543,7623,78,16076,550,79,6568,408,488,55,8,0,54,24,7118,505,550,6568,97,408,647,6976,11,9,0,64
Marion,11/30/20,6,89,89,442,5251,365,5714,71,16438,365,77,4793,458,298,67,5,1,62,9,5158,556,365,4793,98,458,463,5251,4,13,0,51
Miller,11/30/20,22,91,91,2158,11193,2049,13422,87,43759,1619,539,10453,740,1538,511,16,6,65,22,12072,1350,1619,10453,610,740,2229,11193,11,16,0,38
MissingCountyInfo,11/30/20,0,5,5,2494,97102,1710,99615,784,NA,2146,348,97041,61,1443,267,0,0,703,81,99187,428,2146,97041,367,61,2513,97102,-340,-40,0,-6286
Mississippi,11/30/20,81,93,93,3225,19754,2887,23013,256,42831,2980,245,16781,2973,2680,207,67,14,232,24,19761,3252,2980,16781,279,2973,3259,19754,38,30,0,156
Monroe,11/30/20,4,95,95,309,3887,273,4202,32,7249,281,28,3771,116,255,18,4,0,22,10,4052,150,281,3771,34,116,315,3887,2,4,0,19
Montgomery,11/30/20,10,97,97,310,3823,227,4134,73,8993,283,27,2989,834,220,7,9,1,54,19,3272,862,283,2989,28,834,311,3823,14,4,0,36
Nevada,11/30/20,14,99,99,464,6754,400,7223,50,8440,409,55,6543,211,353,47,13,1,43,7,6952,271,409,6543,60,211,469,6754,10,6,0,44
Newton,11/30/20,22,101,101,444,3566,372,4021,50,7848,396,48,2591,975,333,39,19,3,44,6,2987,1034,396,2591,59,975,455,3566,2,3,0,19
Ouachita,11/30/20,12,103,103,776,9740,568,10546,195,24106,716,60,9336,404,520,48,12,0,183,12,10052,494,716,9336,90,404,806,9740,28,14,0,168
Perry,11/30/20,4,105,105,260,6572,214,6843,42,10322,233,27,6296,276,192,22,3,1,38,4,6529,314,233,6296,38,276,271,6572,6,2,0,149
Phillips,11/30/20,17,107,107,957,10807,863,11792,77,19034,917,40,10547,260,832,31,17,0,68,9,11464,328,917,10547,68,260,985,10807,11,14,0,69
Pike,11/30/20,3,109,109,387,3518,341,3910,43,10808,350,37,3273,245,313,28,2,1,35,8,3623,287,350,3273,42,245,392,3518,17,11,1,63
Poinsett,11/30/20,43,111,111,1673,15079,1507,16800,123,24054,1514,159,14484,595,1362,145,38,5,114,9,15998,802,1514,14484,207,595,1721,15079,14,21,0,170
Polk,11/30/20,10,113,113,816,7673,658,8509,147,20163,755,61,7294,379,608,50,10,0,136,11,8049,460,755,7294,81,379,836,7673,27,20,0,78
Pope,11/30/20,43,115,115,3730,38148,3365,41916,322,63644,3284,446,36764,1384,3000,365,38,5,246,76,40048,1868,3284,36764,484,1384,3768,38148,17,43,0,407
Prairie,11/30/20,8,117,117,360,3867,322,4246,30,8244,294,66,3440,427,263,59,8,0,23,7,3734,512,294,3440,85,427,379,3867,1,2,0,14
Pulaski,11/30/20,276,119,119,16905,221592,14858,238854,1769,393463,15570,1335,210218,11374,13782,1076,259,17,1527,242,225788,13066,15570,210218,1692,11374,17262,221592,172,189,7,1882
Randolph,11/30/20,31,121,121,989,9335,864,10374,94,17603,794,195,8345,990,693,171,25,6,76,18,9139,1235,794,8345,245,990,1039,9335,13,3,3,80
Saline,11/30/20,57,125,125,4889,55831,4184,60950,647,118009,4074,815,49494,6337,3540,644,54,3,479,168,53568,7382,4074,49494,1045,6337,5119,55831,64,88,0,511
Scott,11/30/20,3,127,127,382,5930,326,6319,53,10442,304,78,5765,165,264,62,3,0,37,16,6069,250,304,5765,85,165,389,5930,8,5,1,72
Searcy,11/30/20,1,129,129,297,3961,262,4264,34,7923,248,49,3398,563,223,39,1,0,24,10,3646,618,248,3398,55,563,303,3961,2,2,0,67
Sebastian,11/30/20,119,131,131,7045,80656,6310,87764,613,127461,6391,654,79080,1576,5777,533,115,4,497,116,85471,2293,6391,79080,717,1576,7108,80656,30,83,1,889
Sevier,11/30/20,18,133,133,1715,9075,1631,10833,66,17193,1408,307,8112,963,1353,278,18,0,37,29,9520,1313,1408,8112,350,963,1758,9075,8,10,0,37
Sharp,11/30/20,15,135,135,701,8199,566,8945,120,17043,542,159,7502,697,453,113,13,2,76,44,8044,901,542,7502,204,697,746,8199,8,11,0,117
St.Francis,11/30/20,15,123,123,2058,17330,1960,19405,83,26294,2000,58,17144,186,1905,55,15,0,80,3,19144,261,2000,17144,75,186,2075,17330,8,14,0,311
Stone,11/30/20,25,137,137,480,5310,415,5796,40,12446,449,31,5005,305,394,21,23,2,32,8,5454,342,449,5005,37,305,486,5310,4,1,0,48
Union,11/30/20,59,139,139,1568,14463,1400,16094,109,39732,1319,249,12661,1802,1183,217,51,8,85,24,13980,2114,1319,12661,312,1802,1631,14463,28,34,0,117
VanBuren,11/30/20,4,141,141,386,7427,309,7847,73,16684,335,51,6691,736,274,35,4,0,57,16,7026,821,335,6691,85,736,420,7427,8,14,1,72
Washington,11/30/20,177,143,143,15548,129070,14154,145106,1216,228529,13218,2330,116371,12699,12150,2004,158,19,910,306,129589,15517,13218,116371,2818,12699,16036,129070,108,206,0,1055
White,11/30/20,51,145,145,3050,28712,2605,31939,392,78804,2342,708,24912,3800,2048,557,47,4,245,147,27254,4685,2342,24912,885,3800,3227,28712,32,60,0,207
Woodruff,11/30/20,1,147,147,203,3026,177,3242,25,6660,174,29,2891,135,152,25,1,0,21,4,3065,177,174,2891,42,135,216,3026,2,0,0,26
Yell,11/30/20,34,149,149,1657,17324,1515,18996,108,21573,1580,77,16905,419,1459,56,31,3,90,18,18485,511,1580,16905,92,419,1672,17324,3,9,1,334
Arkansas_all_counties,11/29/20,2470,5630,5630,156247,1651239,136872,1811537,16884,2990671,137090,19157,1538738,112501,121597,15275,2265,205,13209,3675,1675828,135709,137090,1538738,23208,112501,160298,1651239,1221,1258,21,10914
Arkansas_county,11/29/20,20,1,1,959,12088,842,13103,97,18124,761,198,9501,2587,677,165,20,0,64,33,10262,2841,761,9501,254,2587,1015,12088,2,5,0,148
Ashley,11/29/20,15,3,3,855,8277,711,9155,129,20537,763,92,7909,368,642,69,14,1,107,22,8672,483,763,7909,115,368,878,8277,6,7,2,47
Baxter,11/29/20,29,5,5,1406,10534,1154,11962,223,41219,1097,309,9334,1200,901,253,28,1,168,55,10431,1531,1097,9334,331,1200,1428,10534,25,14,2,77
Benton,11/29/20,158,7,7,12001,109359,10793,121697,1049,258980,10198,1803,104545,4814,9329,1464,136,22,732,317,114743,6954,10198,104545,2140,4814,12338,109359,102,82,5,607
Boone,11/29/20,43,9,9,1768,18368,1466,20231,259,37288,1504,264,17761,607,1267,199,41,2,196,63,19265,966,1504,17761,359,607,1863,18368,20,22,0,204
Bradley,11/29/20,7,11,11,495,5917,405,6419,83,10948,426,69,4539,1378,377,28,7,0,42,41,4965,1454,426,4539,76,1378,502,5917,7,3,-1,35
Calhoun,11/29/20,1,13,13,147,2303,117,2456,29,5202,131,16,2220,83,106,11,1,0,24,5,2351,105,131,2220,22,83,153,2303,0,3,0,14
Carroll,11/29/20,23,15,15,1417,11181,1220,12625,174,27887,1315,102,11018,163,1143,77,23,0,149,25,12333,292,1315,11018,129,163,1444,11181,7,14,0,41
Chicot,11/29/20,27,17,17,1186,7468,1089,8664,70,10826,1138,48,6853,615,1056,33,26,1,56,14,7991,673,1138,6853,58,615,1196,7468,3,6,0,29
Clark,11/29/20,11,19,19,808,12853,708,13693,89,22385,698,110,11220,1633,609,99,10,1,79,10,11918,1775,698,11220,142,1633,840,12853,3,8,0,50
Clay,11/29/20,21,21,21,874,8786,709,9688,143,15061,718,156,7021,1765,598,111,17,4,102,41,7739,1949,718,7021,184,1765,902,8786,15,5,2,42
Cleburne,11/29/20,22,23,23,728,11561,608,12306,98,25230,607,121,10157,1404,516,92,21,1,70,28,10764,1542,607,10157,138,1404,745,11561,7,3,1,51
Cleveland,11/29/20,15,25,25,362,5010,299,5382,48,8226,290,72,4821,189,251,48,14,1,25,23,5111,271,290,4821,82,189,372,5010,1,4,0,82
Columbia,11/29/20,24,27,27,1093,9972,926,11139,143,23892,814,279,8277,1695,716,210,24,0,74,69,9091,2048,814,8277,353,1695,1167,9972,10,13,0,39
Conway,11/29/20,8,29,29,674,11099,544,11789,122,20906,600,74,10183,916,497,47,8,0,95,27,10783,1006,600,10183,90,916,690,11099,10,7,0,114
Craighead,11/29/20,78,31,31,7066,63330,6226,70547,761,105701,6414,652,57304,6026,5677,549,71,7,665,96,63718,6829,6414,57304,803,6026,7217,63330,67,55,1,387
Crawford,11/29/20,37,33,33,3066,35893,2733,38982,294,62472,2784,282,35115,778,2491,242,34,3,257,37,37899,1083,2784,35115,305,778,3089,35893,14,21,1,121
Crittenden,11/29/20,56,35,35,3254,21111,2947,24403,250,49013,3097,157,20351,760,2821,126,50,6,225,25,23448,955,3097,20351,195,760,3292,21111,18,14,0,112
Cross,11/29/20,26,37,37,852,8345,709,9219,117,16998,740,112,7958,387,613,96,25,1,102,15,8698,521,740,7958,134,387,874,8345,10,13,-1,79
Dallas,11/29/20,6,39,39,300,3581,239,3883,55,7432,284,16,3450,131,229,10,6,0,49,6,3734,149,284,3450,18,131,302,3581,4,3,0,16
Desha,11/29/20,8,41,41,559,6196,486,6778,65,11887,492,67,5806,390,452,34,7,1,33,32,6298,480,492,5806,90,390,582,6196,5,3,0,18
Drew,11/29/20,7,43,43,732,9706,541,10448,184,18502,563,169,8654,1052,469,72,6,1,88,96,9217,1231,563,8654,179,1052,742,9706,5,4,0,74
Faulkner,11/29/20,56,45,45,4775,64144,4187,69052,532,122416,4238,537,59025,5119,3769,418,49,7,420,112,63263,5789,4238,59025,670,5119,4908,64144,52,37,1,340
Franklin,11/29/20,12,47,47,795,10981,679,11801,104,17780,693,102,10623,358,599,80,12,0,82,22,11316,485,693,10623,127,358,820,10981,5,5,0,33
Fulton,11/29/20,12,49,49,548,3637,463,4205,73,12139,421,127,2982,655,359,104,10,2,52,21,3403,802,421,2982,147,655,568,3637,1,11,0,5
Garland,11/29/20,104,51,51,3809,49321,3290,53205,414,98296,3511,298,47269,2052,3071,219,98,6,341,73,50780,2425,3511,47269,373,2052,3884,49321,33,45,1,290
Grant,11/29/20,5,53,53,602,8830,489,9448,108,18086,508,94,7971,859,424,65,4,1,80,28,8479,969,508,7971,110,859,618,8830,4,8,0,44
Greene,11/29/20,26,55,55,2908,25851,2389,28833,493,44623,2399,509,23340,2511,1990,399,24,2,385,108,25739,3094,2399,23340,583,2511,2982,25851,21,44,0,62
Hempstead,11/29/20,8,57,57,848,8938,800,9811,40,22018,711,137,8544,394,676,124,6,2,29,11,9255,556,711,8544,162,394,873,8938,1,6,0,108
HotSpring,11/29/20,42,59,59,2925,24506,2645,27469,238,33520,2809,116,22136,2370,2574,71,40,2,195,43,24945,2524,2809,22136,154,2370,2963,24506,13,31,0,78
Howard,11/29/20,15,61,61,801,5409,745,6225,41,13389,659,142,4678,731,621,124,15,0,23,18,5337,888,659,4678,157,731,816,5409,1,6,0,57
Independence,11/29/20,71,63,63,2076,19661,1827,21816,178,37264,1585,491,17944,1717,1428,399,61,10,96,82,19529,2287,1585,17944,570,1717,2155,19661,6,13,0,42
Izard,11/29/20,6,65,65,996,8038,923,9052,67,13559,895,101,7024,1014,837,86,6,0,52,15,7919,1133,895,7024,119,1014,1014,8038,12,13,0,23
Jackson,11/29/20,7,67,67,1788,14571,1300,16486,481,17225,1472,316,12780,1791,1015,285,6,1,451,30,14252,2234,1472,12780,443,1791,1915,14571,9,7,0,61
Jefferson,11/29/20,111,69,69,5197,50044,4737,55403,347,70424,4740,457,47855,2189,4449,288,104,7,185,162,52595,2808,4740,47855,619,2189,5359,50044,35,28,2,159
Johnson,11/29/20,11,71,71,1269,13067,1174,14345,84,26291,1182,87,12595,472,1103,71,10,1,69,15,13777,568,1182,12595,96,472,1278,13067,4,6,0,42
Lafayette,11/29/20,3,73,73,265,1919,239,2203,23,6915,219,46,1791,128,196,43,3,0,20,3,2010,193,219,1791,65,128,284,1919,3,2,0,20
Lawrence,11/29/20,28,75,75,1164,7887,1030,9085,106,16669,1012,152,7443,444,896,134,28,0,88,18,8455,630,1012,7443,186,444,1198,7887,3,7,0,28
Lee,11/29/20,18,77,77,1189,6285,1128,7480,43,9398,1172,17,6161,124,1117,11,17,1,38,5,7333,147,1172,6161,23,124,1195,6285,14,0,0,87
Lincoln,11/29/20,18,79,79,2458,12238,2364,14716,76,13695,2374,84,11120,1118,2323,41,17,1,34,42,13494,1222,2374,11120,104,1118,2478,12238,4,7,0,17
LittleRiver,11/29/20,37,81,81,641,3139,561,3789,43,12417,545,96,2871,268,472,89,35,2,38,5,3416,373,545,2871,105,268,650,3139,1,7,-3,6
Logan,11/29/20,6,83,83,956,13516,789,14494,161,21757,880,76,12086,1430,735,54,6,0,139,22,12966,1528,880,12086,98,1430,978,13516,6,14,0,101
Lonoke,11/29/20,54,85,85,2699,36081,2342,38924,303,72206,2109,590,31366,4715,1842,500,51,3,216,87,33475,5449,2109,31366,734,4715,2843,36081,28,21,1,236
Madison,11/29/20,8,87,87,618,6923,534,7558,76,16076,545,73,6520,403,482,52,8,0,55,21,7065,493,545,6520,90,403,635,6923,1,2,0,109
Marion,11/29/20,6,89,89,438,5204,352,5663,80,16438,362,76,4752,452,287,65,5,1,70,10,5114,549,362,4752,97,452,459,5204,5,10,0,17
Miller,11/29/20,22,91,91,2147,11166,2033,13383,92,43759,1613,534,10426,740,1532,501,16,6,65,27,12039,1344,1613,10426,604,740,2217,11166,7,13,0,30
MissingCountyInfo,11/29/20,0,5,5,2834,103048,1750,105910,1084,NA,2424,410,102992,56,1469,281,0,0,955,129,105416,494,2424,102992,438,56,2862,103048,35,33,0,2283
Mississippi,11/29/20,81,93,93,3187,19636,2857,22855,248,42831,2944,243,16677,2959,2656,201,67,14,220,28,19621,3234,2944,16677,275,2959,3219,19636,27,10,0,66
Monroe,11/29/20,4,95,95,307,3870,269,4183,34,7249,279,28,3754,116,252,17,4,0,23,11,4033,150,279,3754,34,116,313,3870,1,4,0,5
Montgomery,11/29/20,10,97,97,296,3801,223,4098,63,8993,268,28,2969,832,217,6,9,1,42,21,3237,861,268,2969,29,832,297,3801,3,3,0,12
Nevada,11/29/20,14,99,99,454,6720,394,7179,46,8440,399,55,6512,208,347,47,13,1,39,7,6911,268,399,6512,60,208,459,6720,0,3,0,103
Newton,11/29/20,22,101,101,442,3549,369,4002,51,7848,394,48,2574,975,331,38,19,3,44,7,2968,1034,394,2574,59,975,453,3549,2,4,0,19
Ouachita,11/29/20,12,103,103,748,9600,554,10376,181,24106,686,62,9205,395,508,46,12,0,165,16,9891,485,686,9205,90,395,776,9600,18,11,0,110
Perry,11/29/20,4,105,105,254,6429,212,6694,38,10322,227,27,6154,275,191,21,3,1,33,5,6381,313,227,6154,38,275,265,6429,3,2,1,89
Phillips,11/29/20,17,107,107,946,10749,849,11723,80,19034,906,40,10489,260,820,29,17,0,69,11,11395,328,906,10489,68,260,974,10749,8,2,0,20
Pike,11/29/20,2,109,109,370,3472,330,3846,38,10808,338,32,3227,245,305,25,1,1,32,6,3565,281,338,3227,36,245,374,3472,2,4,0,9
Poinsett,11/29/20,43,111,111,1659,14923,1486,16630,130,24054,1500,159,14332,591,1342,144,38,5,120,10,15832,798,1500,14332,207,591,1707,14923,6,7,2,86
Polk,11/29/20,10,113,113,789,7622,638,8430,140,20163,728,61,7247,375,588,50,10,0,129,11,7975,455,728,7247,80,375,808,7622,13,13,0,80
Pope,11/29/20,43,115,115,3713,37758,3322,41506,348,63644,3268,445,36378,1380,2970,352,38,5,260,88,39646,1860,3268,36378,480,1380,3748,37758,18,36,1,189
Prairie,11/29/20,8,117,117,359,3854,320,4232,31,8244,294,65,3429,425,262,58,8,0,24,7,3723,509,294,3429,84,425,378,3854,2,2,0,14
Pulaski,11/29/20,269,119,119,16733,219882,14669,236964,1793,393463,15417,1316,208557,11325,13615,1054,252,17,1548,245,223974,12990,15417,208557,1665,11325,17082,219882,209,148,3,1527
Randolph,11/29/20,28,121,121,976,9268,861,10294,87,17603,784,192,8286,982,689,172,24,4,71,16,9070,1224,784,8286,242,982,1026,9268,8,6,-2,25
Saline,11/29/20,57,125,125,4825,55384,4096,60435,671,118009,4026,799,49052,6332,3473,623,54,3,498,173,53078,7357,4026,49052,1025,6332,5051,55384,78,61,1,367
Scott,11/29/20,2,127,127,374,5866,321,6247,51,10442,296,78,5699,167,263,58,2,0,31,20,5995,252,296,5699,85,167,381,5866,0,6,0,16
Searcy,11/29/20,1,129,129,295,3896,260,4195,34,7923,244,51,3381,515,222,38,1,0,21,13,3625,570,244,3381,55,515,299,3896,3,2,0,14
Sebastian,11/29/20,118,131,131,7015,79797,6227,86875,667,127461,6364,651,78287,1510,5714,513,114,4,534,133,84651,2224,6364,78287,714,1510,7078,79797,34,42,-5,345
Sevier,11/29/20,18,133,133,1707,9046,1621,10793,68,17193,1402,305,8099,947,1349,272,18,0,35,33,9501,1292,1402,8099,345,947,1747,9046,3,9,0,27
Sharp,11/29/20,15,135,135,693,8090,555,8828,123,17043,537,156,7395,695,444,111,13,2,80,43,7932,896,537,7395,201,695,738,8090,1,11,1,11
St.Francis,11/29/20,15,123,123,2050,17027,1946,19095,89,26294,1994,56,16844,183,1892,54,15,0,87,2,18838,257,1994,16844,74,183,2068,17027,6,15,0,61
Stone,11/29/20,25,137,137,476,5266,414,5748,37,12446,447,29,4972,294,393,21,23,2,31,6,5419,329,447,4972,35,294,482,5266,2,1,2,35
Union,11/29/20,59,139,139,1540,14374,1366,15971,115,39732,1308,232,12580,1794,1171,195,51,8,86,29,13888,2083,1308,12580,289,1794,1597,14374,6,18,3,89
VanBuren,11/29/20,3,141,141,378,7363,295,7771,80,16684,331,47,6629,734,265,30,3,0,63,17,6960,811,331,6629,77,734,408,7363,4,7,0,23
Washington,11/29/20,177,143,143,15440,128123,13948,144043,1314,228529,13125,2315,115513,12610,11998,1950,158,19,969,345,128638,15405,13125,115513,2795,12610,15920,128123,93,114,1,734
White,11/29/20,51,145,145,3018,28537,2545,31724,420,78804,2323,695,24762,3775,2014,531,47,4,260,160,27085,4639,2323,24762,864,3775,3187,28537,17,25,-1,79
Woodruff,11/29/20,1,147,147,201,3002,177,3216,23,6660,172,29,2867,135,152,25,1,0,19,4,3039,177,172,2867,42,135,214,3002,1,0,0,16
Yell,11/29/20,33,149,149,1654,16993,1506,18659,115,21573,1577,77,16577,416,1451,55,30,3,96,19,18154,505,1577,16577,89,416,1666,16993,8,7,0,78
Arkansas_all_counties,11/28/20,2449,5630,5630,155026,1641546,135614,1800495,16942,2990671,136071,18955,1529514,112032,120582,15032,2249,200,13221,3721,1665585,134910,136071,1529514,22878,112032,158949,1641546,1349,1302,13,10816
Arkansas_county,11/28/20,20,1,1,957,11942,837,12953,100,18124,759,198,9401,2541,675,162,20,0,64,36,10160,2793,759,9401,252,2541,1011,11942,4,1,0,47
Ashley,11/28/20,13,3,3,849,8236,704,9109,132,20537,758,91,7867,369,635,69,13,0,110,22,8625,484,758,7867,115,369,873,8236,11,14,0,41
Baxter,11/28/20,27,5,5,1381,10482,1140,11886,214,41219,1087,294,9284,1198,891,249,27,0,169,45,10371,1515,1087,9284,317,1198,1404,10482,11,14,0,53
Benton,11/28/20,153,7,7,11899,108854,10711,121087,1034,258980,10139,1760,104049,4805,9256,1455,135,18,747,287,114188,6899,10139,104049,2094,4805,12233,108854,68,77,0,404
Boone,11/28/20,43,9,9,1748,18184,1444,20015,261,37288,1475,273,17584,600,1255,189,41,2,179,82,19059,956,1475,17584,356,600,1831,18184,12,22,0,75
Bradley,11/28/20,8,11,11,488,5889,402,6383,78,10948,418,70,4515,1374,374,28,7,1,37,41,4933,1450,418,4515,76,1374,494,5889,10,8,0,30
Calhoun,11/28/20,1,13,13,147,2289,114,2441,32,5202,130,17,2209,80,104,10,1,0,25,7,2339,102,130,2209,22,80,152,2289,3,3,0,9
Carroll,11/28/20,23,15,15,1410,11147,1206,12582,181,27887,1307,103,10986,161,1131,75,23,0,153,28,12293,289,1307,10986,128,161,1435,11147,14,11,0,48
Chicot,11/28/20,27,17,17,1183,7442,1083,8635,73,10826,1135,48,6827,615,1053,30,26,1,56,17,7962,673,1135,6827,58,615,1193,7442,2,5,0,90
Clark,11/28/20,11,19,19,805,12806,700,13643,94,22385,695,110,11174,1632,601,99,10,1,84,10,11869,1774,695,11174,142,1632,837,12806,6,7,0,59
Clay,11/28/20,19,21,21,859,8759,704,9647,135,15061,707,152,6999,1760,594,110,16,3,96,39,7706,1941,707,6999,181,1760,888,8759,8,21,0,42
Cleburne,11/28/20,21,23,23,721,11517,605,12255,95,25230,601,120,10115,1402,513,92,20,1,68,27,10716,1539,601,10115,137,1402,738,11517,17,6,0,87
Cleveland,11/28/20,15,25,25,361,4929,295,5300,51,8226,289,72,4739,190,247,48,14,1,28,23,5028,272,289,4739,82,190,371,4929,5,1,0,121
Columbia,11/28/20,24,27,27,1083,9943,913,11090,146,23892,802,281,8261,1682,704,209,24,0,74,72,9063,2027,802,8261,345,1682,1147,9943,17,8,0,107
Conway,11/28/20,8,29,29,664,10995,537,11674,119,20906,595,69,10075,920,491,46,8,0,96,23,10670,1004,595,10075,84,920,679,10995,5,6,1,42
Craighead,11/28/20,77,31,31,6999,63010,6171,70159,750,105701,6355,644,56986,6024,5635,536,70,7,649,101,63341,6818,6355,56986,794,6024,7149,63010,49,48,0,236
Crawford,11/28/20,36,33,33,3052,35786,2712,38862,302,62472,2774,278,35015,771,2471,241,34,2,267,35,37789,1073,2774,35015,302,771,3076,35786,42,24,0,234
Crittenden,11/28/20,56,35,35,3236,21017,2933,24290,246,49013,3083,153,20257,760,2809,124,49,7,224,22,23340,950,3083,20257,190,760,3273,21017,19,30,1,114
Cross,11/28/20,27,37,37,842,8276,696,9136,119,16998,729,113,7889,387,602,94,25,2,102,17,8618,518,729,7889,131,387,860,8276,11,6,1,63
Dallas,11/28/20,6,39,39,296,3569,236,3867,54,7432,281,15,3438,131,227,9,6,0,48,6,3719,148,281,3438,17,131,298,3569,2,7,0,22
Desha,11/28/20,8,41,41,554,6183,483,6760,63,11887,491,63,5795,388,451,32,7,1,33,30,6286,474,491,5795,86,388,577,6183,5,2,0,36
Drew,11/28/20,7,43,43,727,9637,537,10374,183,18502,560,167,8586,1051,465,72,6,1,89,94,9146,1228,560,8586,177,1051,737,9637,15,8,0,40
Faulkner,11/28/20,55,45,45,4723,63856,4150,68709,518,122416,4197,526,58789,5067,3739,411,49,6,409,109,62986,5723,4197,58789,656,5067,4853,63856,44,35,2,331
Franklin,11/28/20,12,47,47,790,10953,674,11768,104,17780,691,99,10599,354,595,79,12,0,84,20,11290,478,691,10599,124,354,815,10953,10,12,0,81
Fulton,11/28/20,12,49,49,547,3633,452,4200,83,12139,421,126,2978,655,350,102,10,2,61,22,3399,801,421,2978,146,655,567,3633,6,6,0,25
Garland,11/28/20,103,51,51,3776,49064,3245,52916,427,98296,3488,288,47018,2046,3033,212,98,5,356,71,50506,2410,3488,47018,364,2046,3852,49064,17,45,0,265
Grant,11/28/20,5,53,53,598,8790,481,9402,112,18086,503,95,7931,859,419,62,4,1,80,32,8434,968,503,7931,109,859,612,8790,9,7,0,71
Greene,11/28/20,26,55,55,2887,25810,2345,28770,516,44623,2378,509,23299,2511,1956,389,24,2,398,118,25677,3093,2378,23299,582,2511,2960,25810,22,51,0,86
Hempstead,11/28/20,8,57,57,847,8831,794,9703,45,22018,711,136,8437,394,671,123,6,2,34,11,9148,555,711,8437,161,394,872,8831,3,5,0,24
HotSpring,11/28/20,42,59,59,2912,24441,2614,27391,256,33520,2801,111,22072,2369,2543,71,40,2,218,38,24873,2518,2801,22072,149,2369,2950,24441,12,19,0,184
Howard,11/28/20,15,61,61,800,5353,739,6167,46,13389,658,142,4661,692,617,122,15,0,26,20,5319,848,658,4661,156,692,814,5353,5,10,0,11
Independence,11/28/20,71,63,63,2070,19625,1814,21772,185,37264,1579,491,17926,1699,1419,395,61,10,99,86,19505,2267,1579,17926,568,1699,2147,19625,30,6,0,87
Izard,11/28/20,6,65,65,984,8027,910,9028,68,13559,883,101,7016,1011,824,86,6,0,53,15,7899,1129,883,7016,118,1011,1001,8027,1,4,0,33
Jackson,11/28/20,7,67,67,1779,14519,1293,16425,479,17225,1463,316,12728,1791,1013,280,6,1,444,35,14191,2234,1463,12728,443,1791,1906,14519,57,19,0,265
Jefferson,11/28/20,109,69,69,5162,49920,4709,55244,342,70424,4722,440,47746,2174,4429,280,104,5,187,155,52468,2776,4722,47746,602,2174,5324,49920,15,20,0,286
Johnson,11/28/20,11,71,71,1265,13029,1168,14303,86,26291,1180,85,12557,472,1099,69,10,1,71,15,13737,566,1180,12557,94,472,1274,13029,18,5,0,75
Lafayette,11/28/20,3,73,73,262,1902,237,2181,22,6915,216,46,1775,127,195,42,3,0,18,4,1991,190,216,1775,63,127,279,1902,2,1,0,15
Lawrence,11/28/20,28,75,75,1161,7862,1023,9057,110,16669,1009,152,7420,442,892,131,28,0,89,21,8429,628,1009,7420,186,442,1195,7862,13,11,0,38
Lee,11/28/20,18,77,77,1175,6212,1128,7393,29,9398,1158,17,6088,124,1117,11,17,1,24,5,7246,147,1158,6088,23,124,1181,6212,0,3,0,10
Lincoln,11/28/20,18,79,79,2454,12225,2357,14698,79,13695,2371,83,11108,1117,2319,38,17,1,35,44,13479,1219,2371,11108,102,1117,2473,12225,6,8,0,67
LittleRiver,11/28/20,40,81,81,640,3134,554,3780,46,12417,541,99,2866,268,466,88,35,5,40,6,3407,373,541,2866,105,268,646,3134,0,4,0,3
Logan,11/28/20,6,83,83,950,13421,775,14390,169,21757,876,74,11994,1427,722,53,6,0,148,21,12870,1520,876,11994,93,1427,969,13421,25,15,0,76
Lonoke,11/28/20,53,85,85,2671,35873,2321,38687,297,72206,2089,582,31169,4704,1830,491,50,3,209,88,33258,5429,2089,31169,725,4704,2814,35873,23,27,0,290
Madison,11/28/20,8,87,87,617,6815,532,7449,77,16076,544,73,6417,398,480,52,8,0,56,21,6961,488,544,6417,90,398,634,6815,6,6,0,54
Marion,11/28/20,6,89,89,433,5192,342,5646,85,16438,359,74,4743,449,278,64,5,1,76,9,5102,544,359,4743,95,449,454,5192,6,11,0,36
Miller,11/28/20,22,91,91,2140,11143,2020,13352,98,43759,1609,531,10403,740,1525,495,16,6,68,30,12012,1340,1609,10403,600,740,2209,11143,4,13,0,19
MissingCountyInfo,11/28/20,0,5,5,2799,100800,1717,103613,1082,NA,2381,418,100744,56,1443,274,0,0,938,144,103125,488,2381,100744,432,56,2813,100800,105,38,0,2237
Mississippi,11/28/20,81,93,93,3160,19597,2847,22785,231,42831,2921,239,16642,2955,2648,199,67,14,205,26,19563,3222,2921,16642,267,2955,3188,19597,17,21,1,66
Monroe,11/28/20,4,95,95,306,3866,265,4178,37,7249,279,27,3751,115,248,17,4,0,27,10,4030,148,279,3751,33,115,312,3866,5,1,0,23
Montgomery,11/28/20,10,97,97,293,3792,220,4086,63,8993,266,27,2960,832,214,6,9,1,43,20,3226,860,266,2960,28,832,294,3792,15,3,0,30
Nevada,11/28/20,14,99,99,454,6617,391,7076,49,8440,399,55,6411,206,345,46,13,1,41,8,6810,266,399,6411,60,206,459,6617,10,4,0,117
Newton,11/28/20,22,101,101,440,3532,365,3981,53,7848,390,50,2558,974,329,36,19,3,42,11,2948,1033,390,2558,59,974,449,3532,6,6,0,52
Ouachita,11/28/20,12,103,103,730,9508,543,10264,174,24106,668,62,9126,382,498,45,12,0,157,17,9794,470,668,9126,88,382,756,9508,14,7,0,44
Perry,11/28/20,3,105,105,251,6343,210,6605,38,10322,225,26,6075,268,189,21,3,0,33,5,6300,305,225,6075,37,268,262,6343,1,5,0,66
Phillips,11/28/20,17,107,107,938,10737,847,11703,74,19034,898,40,10479,258,818,29,17,0,63,11,11377,326,898,10479,68,258,966,10737,6,2,0,18
Pike,11/28/20,2,109,109,368,3465,326,3837,40,10808,336,32,3221,244,301,25,1,1,34,6,3557,280,336,3221,36,244,372,3465,2,3,0,15
Poinsett,11/28/20,41,111,111,1653,14843,1479,16544,133,24054,1496,157,14252,591,1337,142,36,5,123,10,15748,796,1496,14252,205,591,1701,14843,9,12,0,47
Polk,11/28/20,10,113,113,776,7555,625,8349,140,20163,714,62,7180,375,576,49,10,0,127,13,7894,455,714,7180,80,375,794,7555,4,16,0,23
Pope,11/28/20,42,115,115,3695,37587,3286,41316,367,63644,3262,433,36223,1364,2943,343,38,4,281,86,39485,1831,3262,36223,467,1364,3729,37587,45,25,0,173
Prairie,11/28/20,8,117,117,357,3842,318,4218,31,8244,293,64,3419,423,261,57,8,0,24,7,3712,506,293,3419,83,423,376,3842,5,1,1,31
Pulaski,11/28/20,266,119,119,16524,218564,14521,235424,1735,393463,15226,1298,207285,11279,13485,1036,251,15,1488,247,222511,12913,15226,207285,1634,11279,16860,218564,129,143,3,1271
Randolph,11/28/20,30,121,121,968,9251,855,10267,83,17603,774,194,8273,978,683,172,24,6,67,16,9047,1220,774,8273,242,978,1016,9251,9,14,0,43
Saline,11/28/20,56,125,125,4747,55095,4035,60059,655,118009,3959,788,48770,6325,3430,605,53,3,475,180,52729,7330,3959,48770,1005,6325,4964,55095,45,62,1,341
Scott,11/28/20,2,127,127,374,5850,315,6231,57,10442,296,78,5685,165,258,57,2,0,36,21,5981,250,296,5685,85,165,381,5850,3,6,0,17
Searcy,11/28/20,1,129,129,292,3885,258,4181,33,7923,243,49,3372,513,220,38,1,0,22,11,3615,566,243,3372,53,513,296,3885,1,5,0,5
Sebastian,11/28/20,123,131,131,6981,79486,6185,86521,670,127461,6337,644,77989,1497,5678,507,114,9,543,127,84326,2195,6337,77989,698,1497,7035,79486,68,64,0,440
Sevier,11/28/20,18,133,133,1704,9022,1612,10766,74,17193,1401,303,8084,938,1344,268,18,0,39,35,9485,1281,1401,8084,343,938,1744,9022,4,7,0,21
Sharp,11/28/20,14,135,135,692,8080,544,8817,134,17043,536,156,7384,696,436,108,13,1,87,47,7920,897,536,7384,201,696,737,8080,7,11,0,44
St.Francis,11/28/20,15,123,123,2044,16972,1931,19034,98,26294,1988,56,16788,184,1880,51,15,0,93,5,18776,258,1988,16788,74,184,2062,16972,10,2,0,63
Stone,11/28/20,23,137,137,474,5233,413,5715,38,12446,447,27,4941,292,393,20,23,0,31,7,5388,327,447,4941,35,292,482,5233,8,2,0,34
Union,11/28/20,56,139,139,1534,14291,1348,15874,130,39732,1299,235,12541,1750,1152,196,49,7,98,32,13840,2034,1299,12541,284,1750,1583,14291,24,16,0,54
VanBuren,11/28/20,3,141,141,374,7344,288,7747,83,16684,327,47,6609,735,259,29,3,0,65,18,6936,811,327,6609,76,735,403,7344,12,0,0,45
Washington,11/28/20,176,143,143,15347,127482,13834,143302,1336,228529,13039,2308,114882,12600,11903,1931,157,19,979,357,127921,15381,13039,114882,2781,12600,15820,127482,65,98,0,766
White,11/28/20,52,145,145,3001,28475,2520,31642,427,78804,2312,689,24708,3767,1999,521,46,6,265,162,27020,4622,2312,24708,855,3767,3167,28475,29,46,2,206
Woodruff,11/28/20,1,147,147,200,2987,177,3200,22,6660,171,29,2852,135,152,25,1,0,18,4,3023,177,171,2852,42,135,213,2987,4,1,0,28
Yell,11/28/20,33,149,149,1646,16923,1499,18581,114,21573,1571,75,16519,404,1445,54,30,3,96,18,18090,491,1571,16519,87,404,1658,16923,17,9,0,64
Arkansas_all_counties,11/27/20,2436,5630,5630,153677,1632079,134312,1789553,16908,2990671,134904,18773,1521090,110989,119558,14754,2237,199,13090,3818,1655994,133559,134904,1521090,22570,110989,157474,1632079,1052,1732,0,9486
Arkansas_county,11/27/20,20,1,1,953,11899,836,12905,97,18124,755,198,9363,2536,674,162,20,0,61,36,10118,2787,755,9363,251,2536,1006,11899,3,9,0,49
Ashley,11/27/20,13,3,3,838,8206,690,9069,135,20537,749,89,7838,368,626,64,13,0,110,25,8587,482,749,7838,114,368,863,8206,7,8,0,38
Baxter,11/27/20,27,5,5,1370,10440,1126,11834,217,41219,1077,293,9247,1193,882,244,27,0,168,49,10324,1510,1077,9247,317,1193,1394,10440,6,20,0,56
Benton,11/27/20,153,7,7,11831,108518,10634,120678,1043,258980,10078,1753,103743,4775,9198,1436,135,18,744,299,113821,6857,10078,103743,2082,4775,12160,108518,131,178,0,442
Boone,11/27/20,43,9,9,1736,18121,1422,19938,271,37288,1463,273,17543,578,1240,182,41,2,182,89,19006,932,1463,17543,354,578,1817,18121,20,28,0,43
Bradley,11/27/20,8,11,11,478,5869,394,6353,76,10948,409,69,4494,1375,370,24,7,1,32,44,4903,1450,409,4494,75,1375,484,5869,4,2,0,27
Calhoun,11/27/20,1,13,13,144,2283,111,2432,32,5202,128,16,2204,79,101,10,1,0,26,6,2332,100,128,2204,21,79,149,2283,2,2,0,7
Carroll,11/27/20,23,15,15,1396,11113,1195,12531,178,27887,1293,103,10952,161,1121,74,23,0,149,29,12245,286,1293,10952,125,161,1418,11113,5,13,0,21
Chicot,11/27/20,27,17,17,1181,7354,1078,8544,76,10826,1132,49,6775,579,1050,28,26,1,56,20,7907,637,1132,6775,58,579,1190,7354,6,2,0,23
Clark,11/27/20,11,19,19,799,12753,693,13583,95,22385,689,110,11129,1624,595,98,10,1,84,11,11818,1765,689,11129,141,1624,830,12753,3,11,0,35
Clay,11/27/20,19,21,21,851,8725,683,9605,148,15061,699,152,6966,1759,584,99,16,3,98,50,7665,1940,699,6966,181,1759,880,8725,12,17,0,48
Cleburne,11/27/20,21,23,23,704,11447,599,12168,84,25230,590,114,10081,1366,508,91,20,1,62,22,10671,1497,590,10081,131,1366,721,11447,5,9,0,39
Cleveland,11/27/20,15,25,25,356,4813,294,5179,47,8226,286,70,4624,189,246,48,14,1,26,21,4910,269,286,4624,80,189,366,4813,0,1,0,10
Columbia,11/27/20,24,27,27,1066,9853,905,10981,137,23892,794,272,8219,1634,699,206,24,0,71,66,9013,1968,794,8219,334,1634,1128,9853,3,18,0,64
Conway,11/27/20,7,29,29,659,10958,531,11632,121,20906,591,68,10052,906,485,46,7,0,99,22,10643,989,591,10052,83,906,674,10958,4,18,0,28
Craighead,11/27/20,77,31,31,6950,62823,6123,69921,749,105701,6313,637,56868,5955,5594,529,70,7,648,101,63181,6740,6313,56868,785,5955,7098,62823,61,71,0,421
Crawford,11/27/20,36,33,33,3010,35594,2688,38626,284,62472,2735,275,34829,765,2448,240,34,2,251,33,37564,1062,2735,34829,297,765,3032,35594,9,43,0,166
Crittenden,11/27/20,55,35,35,3217,20922,2903,24174,258,49013,3066,151,20233,689,2780,123,48,7,237,21,23299,875,3066,20233,186,689,3252,20922,18,23,0,76
Cross,11/27/20,26,37,37,831,8224,690,9071,115,16998,717,114,7837,387,598,92,24,2,95,20,8554,517,717,7837,130,387,847,8224,3,8,0,49
Dallas,11/27/20,6,39,39,294,3549,229,3845,59,7432,279,15,3419,130,220,9,6,0,53,6,3698,147,279,3419,17,130,296,3549,3,4,0,13
Desha,11/27/20,8,41,41,549,6152,481,6724,60,11887,489,60,5769,383,447,34,7,1,35,25,6258,466,489,5769,83,383,572,6152,2,2,0,20
Drew,11/27/20,7,43,43,712,9612,529,10334,176,18502,549,163,8562,1050,460,69,6,1,83,93,9111,1223,549,8562,173,1050,722,9612,22,12,0,104
Faulkner,11/27/20,53,45,45,4679,63569,4115,68377,511,122416,4168,511,58491,5078,3713,402,47,6,408,103,62659,5718,4168,58491,640,5078,4808,63569,21,46,0,288
Franklin,11/27/20,12,47,47,780,10882,662,11687,106,17780,682,98,10530,352,587,75,12,0,83,23,11212,475,682,10530,123,352,805,10882,6,3,0,57
Fulton,11/27/20,12,49,49,541,3614,446,4174,83,12139,415,126,2959,655,345,101,10,2,60,23,3374,800,415,2959,145,655,560,3614,1,10,0,9
Garland,11/27/20,103,51,51,3759,48816,3200,52644,455,98296,3473,286,46778,2038,2996,204,98,5,378,77,50251,2393,3473,46778,355,2038,3828,48816,26,43,0,185
Grant,11/27/20,5,53,53,589,8728,474,9331,110,18086,493,96,7872,856,413,61,4,1,76,34,8365,966,493,7872,110,856,603,8728,4,7,0,40
Greene,11/27/20,26,55,55,2865,25746,2294,28683,545,44623,2358,507,23244,2502,1921,373,24,2,413,132,25602,3081,2358,23244,579,2502,2937,25746,31,48,0,98
Hempstead,11/27/20,8,57,57,844,8810,789,9678,47,22018,708,136,8420,390,666,123,6,2,36,11,9128,550,708,8420,160,390,868,8810,5,11,0,33
HotSpring,11/27/20,42,59,59,2900,24269,2595,27206,263,33520,2794,106,21909,2360,2526,69,40,2,228,35,24703,2503,2794,21909,143,2360,2937,24269,17,28,0,129
Howard,11/27/20,15,61,61,795,5347,729,6156,51,13389,656,139,4655,692,612,117,15,0,29,22,5311,845,656,4655,153,692,809,5347,0,6,0,12
Independence,11/27/20,71,63,63,2040,19568,1808,21670,161,37264,1557,483,17880,1688,1414,394,61,10,82,79,19437,2233,1557,17880,545,1688,2102,19568,10,9,0,36
Izard,11/27/20,6,65,65,983,7995,906,8995,71,13559,882,101,6985,1010,822,84,6,0,54,17,7867,1128,882,6985,118,1010,1000,7995,4,3,0,9
Jackson,11/27/20,7,67,67,1722,14311,1274,16142,441,17225,1408,314,12522,1789,996,278,6,1,406,35,13930,2212,1408,12522,423,1789,1831,14311,20,49,0,115
Jefferson,11/27/20,109,69,69,5147,49649,4689,54958,347,70424,4717,430,47495,2154,4413,276,104,5,198,149,52212,2746,4717,47495,592,2154,5309,49649,10,35,0,88
Johnson,11/27/20,11,71,71,1247,12972,1163,14229,73,26291,1164,83,12505,467,1095,68,10,1,59,14,13669,560,1164,12505,93,467,1257,12972,-1,5,0,82
Lafayette,11/27/20,3,73,73,260,1889,236,2166,21,6915,214,46,1769,120,194,42,3,0,17,4,1983,183,214,1769,63,120,277,1889,1,1,0,7
Lawrence,11/27/20,28,75,75,1148,7837,1012,9019,108,16669,997,151,7404,433,882,130,28,0,87,21,8401,618,997,7404,185,433,1182,7837,8,11,0,47
Lee,11/27/20,18,77,77,1175,6202,1125,7383,32,9398,1158,17,6077,125,1114,11,17,1,27,5,7235,148,1158,6077,23,125,1181,6202,2,2,0,19
Lincoln,11/27/20,18,79,79,2448,12164,2349,14631,81,13695,2365,83,11048,1116,2317,32,17,1,31,50,13413,1218,2365,11048,102,1116,2467,12164,5,3,0,75
LittleRiver,11/27/20,40,81,81,640,3131,550,3777,50,12417,541,99,2863,268,463,87,35,5,43,7,3404,373,541,2863,105,268,646,3131,14,22,0,17
Logan,11/27/20,6,83,83,925,13370,760,14314,159,21757,852,73,11948,1422,708,52,6,0,138,21,12800,1514,852,11948,92,1422,944,13370,11,10,0,66
Lonoke,11/27/20,53,85,85,2648,35606,2294,38393,301,72206,2068,580,30917,4689,1808,486,50,3,210,91,32985,5408,2068,30917,719,4689,2787,35606,13,41,0,168
Madison,11/27/20,8,87,87,611,6767,526,7395,77,16076,539,72,6377,390,474,52,8,0,57,20,6916,479,539,6377,89,390,628,6767,4,10,0,24
Marion,11/27/20,6,89,89,427,5162,331,5610,90,16438,353,74,4713,449,269,62,5,1,79,11,5066,544,353,4713,95,449,448,5162,5,15,0,15
Miller,11/27/20,22,91,91,2136,11128,2007,13332,107,43759,1607,529,10398,730,1519,488,16,6,72,35,12005,1327,1607,10398,597,730,2204,11128,17,27,0,44
MissingCountyInfo,11/27/20,0,5,5,2694,98668,1679,101376,1015,NA,2258,436,98612,56,1406,273,0,0,852,163,100870,506,2258,98612,450,56,2708,98668,128,49,0,3090
Mississippi,11/27/20,80,93,93,3143,19548,2826,22717,236,42831,2905,238,16596,2952,2628,198,66,14,210,26,19501,3216,2905,16596,264,2952,3169,19548,24,28,0,107
Monroe,11/27/20,4,95,95,301,3848,264,4155,33,7249,274,27,3732,116,247,17,4,0,23,10,4006,149,274,3732,33,116,307,3848,3,3,0,10
Montgomery,11/27/20,10,97,97,278,3777,217,4055,51,8993,260,18,2945,832,211,6,9,1,40,11,3205,850,260,2945,18,832,278,3777,1,1,0,11
Nevada,11/27/20,14,99,99,444,6510,387,6959,43,8440,391,53,6306,204,342,45,13,1,36,7,6697,262,391,6306,58,204,449,6510,1,4,0,18
Newton,11/27/20,22,101,101,434,3486,359,3926,53,7848,384,50,2549,937,323,36,19,3,42,11,2933,993,384,2549,56,937,440,3486,2,4,0,4
Ouachita,11/27/20,12,103,103,716,9478,536,10220,167,24106,659,57,9105,373,493,43,12,0,153,14,9764,456,659,9105,83,373,742,9478,13,14,0,84
Perry,11/27/20,3,105,105,250,6278,205,6539,42,10322,224,26,6006,272,185,20,3,0,36,6,6230,309,224,6006,37,272,261,6278,1,5,0,29
Phillips,11/27/20,17,107,107,932,10725,845,11683,70,19034,893,39,10466,259,816,29,17,0,60,10,11359,324,893,10466,65,259,958,10725,6,6,0,104
Pike,11/27/20,2,109,109,366,3452,323,3822,41,10808,335,31,3208,244,298,25,1,1,36,5,3543,279,335,3208,35,244,370,3452,1,0,0,4
Poinsett,11/27/20,41,111,111,1644,14805,1467,16497,136,24054,1488,156,14218,587,1329,138,36,5,123,13,15706,791,1488,14218,204,587,1692,14805,10,20,0,69
Polk,11/27/20,10,113,113,772,7536,609,8327,152,20163,711,61,7164,372,562,47,10,0,138,14,7875,452,711,7164,80,372,791,7536,2,14,0,12
Pope,11/27/20,42,115,115,3650,37459,3261,41143,347,63644,3218,432,36117,1342,2924,337,38,4,256,91,39335,1808,3218,36117,466,1342,3684,37459,8,41,0,218
Prairie,11/27/20,7,117,117,352,3816,317,4187,28,8244,288,64,3395,421,260,57,7,0,21,7,3683,504,288,3395,83,421,371,3816,2,3,0,10
Pulaski,11/27/20,263,119,119,16395,217422,14378,234149,1752,393463,15126,1269,206288,11134,13351,1027,248,15,1525,227,221414,12735,15126,206288,1601,11134,16727,217422,63,154,0,610
Randolph,11/27/20,30,121,121,959,9217,841,10223,88,17603,766,193,8246,971,671,170,24,6,71,17,9012,1211,766,8246,240,971,1006,9217,7,17,0,55
Saline,11/27/20,55,125,125,4702,54799,3973,59690,673,118009,3897,805,48484,6315,3380,593,52,3,464,209,52381,7309,3897,48484,994,6315,4891,54799,40,69,0,227
Scott,11/27/20,2,127,127,371,5836,309,6214,60,10442,294,77,5674,162,254,55,2,0,38,22,5968,246,294,5674,84,162,378,5836,1,6,0,24
Searcy,11/27/20,1,129,129,291,3881,253,4176,37,7923,242,49,3369,512,219,34,1,0,22,15,3611,565,242,3369,53,512,295,3881,1,1,0,5
Sebastian,11/27/20,123,131,131,6913,79114,6121,86082,666,127461,6284,629,77640,1474,5626,495,114,9,542,124,83924,2158,6284,77640,684,1474,6968,79114,37,78,0,401
Sevier,11/27/20,18,133,133,1700,9005,1605,10745,77,17193,1397,303,8083,922,1340,265,18,0,39,38,9480,1265,1397,8083,343,922,1740,9005,3,9,0,45
Sharp,11/27/20,14,135,135,685,8043,533,8773,138,17043,531,154,7356,687,427,106,13,1,91,47,7887,886,531,7356,199,687,730,8043,5,10,0,27
St.Francis,11/27/20,15,123,123,2034,16919,1929,18971,90,26294,1978,56,16735,184,1879,50,15,0,84,6,18713,258,1978,16735,74,184,2052,16919,6,6,0,38
Stone,11/27/20,23,137,137,466,5207,411,5681,32,12446,440,26,4918,289,391,20,23,0,26,6,5358,323,440,4918,34,289,474,5207,7,1,0,35
Union,11/27/20,56,139,139,1510,14261,1332,15820,122,39732,1283,227,12512,1749,1144,188,49,7,90,32,13795,2025,1283,12512,276,1749,1559,14261,13,13,0,110
VanBuren,11/27/20,3,141,141,362,7311,288,7698,71,16684,316,46,6577,734,259,29,3,0,54,17,6893,805,316,6577,71,734,387,7311,2,5,0,34
Washington,11/27/20,176,143,143,15282,126781,13736,142529,1369,228529,12988,2294,114412,12369,11840,1896,157,19,991,378,127400,15129,12988,114412,2760,12369,15748,126781,70,141,0,482
White,11/27/20,50,145,145,2972,28298,2474,31431,446,78804,2301,671,24572,3726,1973,501,45,5,281,165,26873,4558,2301,24572,832,3726,3133,28298,21,74,0,110
Woodruff,11/27/20,1,147,147,196,2963,176,3171,19,6660,169,27,2828,135,151,25,1,0,17,2,2997,174,169,2828,39,135,208,2963,3,0,0,3
Yell,11/27/20,33,149,149,1629,16876,1490,18517,106,21573,1554,75,16471,405,1436,54,30,3,88,18,18025,492,1554,16471,87,405,1641,16876,8,12,0,68
Arkansas_all_counties,11/26/20,2436,5630,5630,152625,1623645,132580,1779993,17588,2990671,133942,18683,1513202,110443,118157,14423,2237,199,13529,4059,1647144,132849,133942,1513202,22406,110443,156348,1623645,2348,1762,11,19718
Arkansas_county,11/26/20,20,1,1,950,11853,827,12856,103,18124,752,198,9321,2532,670,157,20,0,62,41,10073,2783,752,9321,251,2532,1003,11853,6,11,0,149
Ashley,11/26/20,13,3,3,831,8175,682,9031,136,20537,742,89,7808,367,619,63,13,0,110,26,8550,481,742,7808,114,367,856,8175,27,8,0,101
Baxter,11/26/20,27,5,5,1364,10390,1106,11778,231,41219,1071,293,9197,1193,868,238,27,0,176,55,10268,1510,1071,9197,317,1193,1388,10390,19,27,0,350
Benton,11/26/20,153,7,7,11700,108207,10456,120221,1090,258980,9952,1748,103444,4763,9046,1410,135,18,770,320,113396,6825,9952,103444,2062,4763,12014,108207,162,127,0,696
Boone,11/26/20,43,9,9,1716,18098,1394,19896,279,37288,1447,269,17522,576,1219,175,41,2,187,92,18969,927,1447,17522,351,576,1798,18098,45,29,0,254
Bradley,11/26/20,8,11,11,474,5846,392,6326,74,10948,405,69,4472,1374,369,23,7,1,29,45,4877,1449,405,4472,75,1374,480,5846,14,5,0,60
Calhoun,11/26/20,1,13,13,142,2278,109,2425,32,5202,126,16,2199,79,100,9,1,0,25,7,2325,100,126,2199,21,79,147,2278,4,3,0,13
Carroll,11/26/20,23,15,15,1391,11097,1182,12510,186,27887,1289,102,10936,161,1110,72,23,0,156,30,12225,285,1289,10936,124,161,1413,11097,23,17,0,75
Chicot,11/26/20,27,17,17,1175,7337,1076,8521,72,10826,1127,48,6759,578,1049,27,26,1,52,20,7886,635,1127,6759,57,578,1184,7337,18,1,0,91
Clark,11/26/20,11,19,19,796,12721,682,13547,103,22385,685,111,11097,1624,585,97,10,1,90,13,11782,1765,685,11097,141,1624,826,12721,18,10,0,187
Clay,11/26/20,19,21,21,839,8689,666,9557,153,15061,690,149,6935,1754,573,93,16,3,100,53,7625,1932,690,6935,178,1754,868,8689,19,8,0,212
Cleburne,11/26/20,21,23,23,699,11413,590,12129,88,25230,586,113,10049,1364,503,87,20,1,63,25,10635,1494,586,10049,130,1364,716,11413,10,9,0,72
Cleveland,11/26/20,15,25,25,356,4803,293,5169,48,8226,286,70,4615,188,245,48,14,1,27,21,4901,268,286,4615,80,188,366,4803,5,8,0,38
Columbia,11/26/20,24,27,27,1063,9792,887,10917,152,23892,792,271,8187,1605,692,195,24,0,76,76,8979,1938,792,8187,333,1605,1125,9792,9,12,0,59
Conway,11/26/20,7,29,29,655,10934,513,11604,135,20906,588,67,10026,908,469,44,7,0,112,23,10614,990,588,10026,82,908,670,10934,9,21,0,119
Craighead,11/26/20,77,31,31,6889,62463,6052,69497,759,105701,6255,634,56608,5855,5535,517,70,7,649,110,62863,6634,6255,56608,779,5855,7034,62463,126,65,2,599
Crawford,11/26/20,36,33,33,3001,35437,2645,38460,318,62472,2730,271,34676,761,2408,237,34,2,286,32,37406,1054,2730,34676,293,761,3023,35437,27,35,0,216
Crittenden,11/26/20,55,35,35,3199,20864,2880,24098,263,49013,3048,151,20176,688,2757,123,48,7,242,21,23224,874,3048,20176,186,688,3234,20864,43,31,0,240
Cross,11/26/20,26,37,37,828,8178,682,9022,120,16998,714,114,7795,383,591,91,24,2,99,21,8509,513,714,7795,130,383,844,8178,8,7,0,96
Dallas,11/26/20,6,39,39,291,3539,225,3832,60,7432,277,14,3411,128,216,9,6,0,55,5,3688,144,277,3411,16,128,293,3539,1,10,0,17
Desha,11/26/20,8,41,41,547,6134,479,6704,60,11887,487,60,5754,380,445,34,7,1,35,25,6241,463,487,5754,83,380,570,6134,4,5,0,33
Drew,11/26/20,7,43,43,690,9530,517,10229,166,18502,530,160,8481,1049,453,64,6,1,71,95,9011,1218,530,8481,169,1049,699,9530,74,6,0,143
Faulkner,11/26/20,53,45,45,4658,63302,4069,68085,536,122416,4145,513,58248,5054,3671,398,47,6,427,109,62393,5692,4145,58248,638,5054,4783,63302,83,49,0,808
Franklin,11/26/20,12,47,47,774,10831,659,11629,103,17780,676,98,10491,340,584,75,12,0,80,23,11167,462,676,10491,122,340,798,10831,19,8,0,66
Fulton,11/26/20,12,49,49,540,3606,436,4165,92,12139,414,126,2952,654,339,97,10,2,65,27,3366,799,414,2952,145,654,559,3606,6,3,0,32
Garland,11/26/20,103,51,51,3733,48657,3157,52458,472,98296,3451,282,46653,2004,2956,201,98,5,396,76,50104,2354,3451,46653,350,2004,3801,48657,100,58,0,461
Grant,11/26/20,5,53,53,585,8692,467,9291,113,18086,490,95,7836,856,407,60,4,1,79,34,8326,965,490,7836,109,856,599,8692,14,9,0,103
Greene,11/26/20,26,55,55,2834,25679,2246,28585,562,44623,2327,507,23184,2495,1886,360,24,2,417,145,25511,3074,2327,23184,579,2495,2906,25679,99,51,0,254
Hempstead,11/26/20,8,57,57,839,8782,778,9644,53,22018,705,134,8394,388,658,120,6,2,41,12,9099,545,705,8394,157,388,862,8782,7,11,1,43
HotSpring,11/26/20,42,59,59,2883,24157,2567,27076,274,33520,2778,105,21797,2360,2503,64,40,2,235,39,24575,2501,2778,21797,141,2360,2919,24157,27,32,0,367
Howard,11/26/20,15,61,61,795,5335,723,6144,57,13389,656,139,4653,682,609,114,15,0,32,25,5309,835,656,4653,153,682,809,5335,3,3,0,21
Independence,11/26/20,71,63,63,2030,19542,1799,21634,160,37264,1549,481,17862,1680,1408,391,61,10,80,80,19411,2223,1549,17862,543,1680,2092,19542,23,16,0,454
Izard,11/26/20,6,65,65,979,7990,903,8986,70,13559,879,100,6981,1009,820,83,6,0,53,17,7860,1126,879,6981,117,1009,996,7990,5,8,0,41
Jackson,11/26/20,7,67,67,1702,14216,1225,16027,470,17225,1389,313,12429,1787,952,273,6,1,431,39,13818,2209,1389,12429,422,1787,1811,14216,35,79,1,327
Jefferson,11/26/20,109,69,69,5137,49571,4654,54868,372,70424,4709,428,47419,2152,4388,266,104,5,215,157,52128,2740,4709,47419,588,2152,5297,49571,48,34,0,702
Johnson,11/26/20,11,71,71,1248,12889,1158,14147,79,26291,1164,84,12424,465,1090,68,10,1,64,15,13588,559,1164,12424,94,465,1258,12889,13,8,0,60
Lafayette,11/26/20,3,73,73,259,1883,235,2159,21,6915,213,46,1763,120,193,42,3,0,17,4,1976,183,213,1763,63,120,276,1883,1,3,0,11
Lawrence,11/26/20,28,75,75,1140,7798,1001,8973,111,16669,991,149,7369,429,874,127,28,0,89,22,8360,613,991,7369,184,429,1175,7798,20,11,0,65
Lee,11/26/20,18,77,77,1173,6185,1123,7364,32,9398,1156,17,6061,124,1112,11,17,1,27,5,7217,147,1156,6061,23,124,1179,6185,4,3,0,100
Lincoln,11/26/20,18,79,79,2443,12094,2346,14556,79,13695,2362,81,10978,1116,2316,30,17,1,29,50,13340,1216,2362,10978,100,1116,2462,12094,35,3,0,149
LittleRiver,11/26/20,40,81,81,626,3128,528,3758,58,12417,525,101,2860,268,447,81,35,5,43,15,3385,373,525,2860,105,268,630,3128,6,7,0,25
Logan,11/26/20,6,83,83,914,13315,750,14246,158,21757,841,73,11892,1423,697,53,6,0,138,20,12733,1513,841,11892,90,1423,931,13315,16,8,0,287
Lonoke,11/26/20,53,85,85,2635,35451,2253,38224,329,72206,2056,579,30802,4649,1778,475,50,3,228,101,32858,5366,2056,30802,717,4649,2773,35451,52,26,1,527
Madison,11/26/20,8,87,87,607,6747,516,7371,83,16076,537,70,6358,389,466,50,8,0,63,20,6895,476,537,6358,87,389,624,6747,7,8,0,24
Marion,11/26/20,6,89,89,422,5152,316,5594,100,16438,347,75,4703,449,256,60,5,1,86,14,5050,544,347,4703,95,449,442,5152,5,12,0,97
Miller,11/26/20,22,91,91,2119,11101,1980,13286,117,43759,1590,529,10381,720,1504,476,16,6,70,47,11971,1315,1590,10381,595,720,2185,11101,19,30,0,114
MissingCountyInfo,11/26/20,0,5,5,2566,95706,1630,98284,936,NA,2127,439,95650,56,1362,268,0,0,765,171,97777,507,2127,95650,451,56,2578,95706,165,39,0,3841
Mississippi,11/26/20,80,93,93,3119,19465,2798,22610,240,42831,2884,235,16550,2915,2601,197,66,14,216,24,19434,3176,2884,16550,261,2915,3145,19465,43,30,0,272
Monroe,11/26/20,4,95,95,298,3841,261,4145,33,7249,271,27,3727,114,245,16,4,0,22,11,3998,147,271,3727,33,114,304,3841,3,3,0,35
Montgomery,11/26/20,10,97,97,277,3767,216,4044,51,8993,260,17,2941,826,210,6,9,1,41,10,3201,843,260,2941,17,826,277,3767,8,5,0,118
Nevada,11/26/20,14,99,99,443,6493,383,6941,46,8440,390,53,6289,204,338,45,13,1,39,7,6679,262,390,6289,58,204,448,6493,3,4,0,33
Newton,11/26/20,22,101,101,432,3484,355,3921,55,7848,381,51,2547,937,320,35,19,3,42,13,2928,993,381,2547,56,937,437,3484,10,4,0,78
Ouachita,11/26/20,12,103,103,703,9407,522,10136,168,24106,646,57,9036,371,482,40,12,0,151,17,9682,454,646,9036,83,371,729,9407,14,15,1,104
Perry,11/26/20,3,105,105,249,6250,200,6510,46,10322,223,26,5986,264,181,19,3,0,39,7,6209,301,223,5986,37,264,260,6250,4,4,0,58
Phillips,11/26/20,17,107,107,926,10627,839,11579,70,19034,887,39,10368,259,810,29,17,0,60,10,11255,324,887,10368,65,259,952,10627,5,5,0,124
Pike,11/26/20,2,109,109,365,3449,323,3818,40,10808,334,31,3205,244,298,25,1,1,35,5,3539,279,334,3205,35,244,369,3449,5,3,0,24
Poinsett,11/26/20,41,111,111,1634,14746,1447,16428,146,24054,1482,152,14170,576,1310,137,36,5,136,10,15652,776,1482,14170,200,576,1682,14746,22,12,1,122
Polk,11/26/20,10,113,113,770,7526,595,8315,164,20163,709,61,7156,370,549,46,10,0,149,15,7865,450,709,7156,80,370,789,7526,23,17,0,69
Pope,11/26/20,42,115,115,3642,37249,3220,40925,380,63644,3212,430,35919,1330,2890,330,38,4,284,96,39131,1794,3212,35919,464,1330,3676,37249,45,43,0,245
Prairie,11/26/20,7,117,117,350,3808,314,4177,29,8244,286,64,3388,420,259,55,7,0,20,9,3674,503,286,3388,83,420,369,3808,2,2,0,25
Pulaski,11/26/20,263,119,119,16332,216875,14224,233536,1843,393463,15072,1260,205753,11122,13221,1003,248,15,1601,242,220825,12711,15072,205753,1589,11122,16661,216875,180,201,2,1875
Randolph,11/26/20,30,121,121,952,9169,824,10168,98,17603,763,189,8211,958,657,167,24,6,82,16,8974,1194,763,8211,236,958,999,9169,8,15,0,42
Saline,11/26/20,55,125,125,4662,54612,3904,59453,702,118009,3858,804,48323,6289,3325,579,52,3,480,222,52181,7272,3858,48323,983,6289,4841,54612,97,71,1,653
Scott,11/26/20,2,127,127,370,5813,303,6186,65,10442,289,81,5651,162,250,53,2,0,37,28,5940,246,289,5651,84,162,373,5813,11,7,0,86
Searcy,11/26/20,1,129,129,290,3877,252,4170,37,7923,241,49,3365,512,218,34,1,0,22,15,3606,564,241,3365,52,512,293,3877,6,2,0,26
Sebastian,11/26/20,123,131,131,6876,78750,6043,85681,707,127461,6251,625,77285,1465,5570,473,114,9,565,142,83536,2145,6251,77285,680,1465,6931,78750,67,61,0,398
Sevier,11/26/20,18,133,133,1697,8963,1596,10697,83,17193,1392,305,8048,915,1337,259,18,0,37,46,9440,1257,1392,8048,342,915,1734,8963,13,5,0,111
Sharp,11/26/20,14,135,135,680,8021,523,8746,143,17043,526,154,7338,683,418,105,13,1,95,48,7864,882,526,7338,199,683,725,8021,24,6,0,126
St.Francis,11/26/20,15,123,123,2028,16887,1923,18932,90,26294,1971,57,16703,184,1872,51,15,0,84,6,18674,258,1971,16703,74,184,2045,16887,9,9,1,155
Stone,11/26/20,23,137,137,459,5179,410,5646,26,12446,433,26,4894,285,390,20,23,0,20,6,5327,319,433,4894,34,285,467,5179,7,0,0,32
Union,11/26/20,56,139,139,1497,14164,1319,15710,122,39732,1273,224,12417,1747,1134,185,49,7,90,32,13690,2020,1273,12417,273,1747,1546,14164,10,17,0,221
VanBuren,11/26/20,3,141,141,360,7279,283,7664,74,16684,315,45,6551,728,255,28,3,0,57,17,6866,798,315,6551,70,728,385,7279,9,4,0,177
Washington,11/26/20,176,143,143,15212,126369,13595,142040,1440,228529,12946,2266,114042,12327,11723,1872,157,19,1066,374,126988,15052,12946,114042,2725,12327,15671,126369,188,169,0,1253
White,11/26/20,50,145,145,2951,28209,2400,31317,499,78804,2280,671,24491,3718,1921,479,45,5,312,187,26771,4546,2280,24491,828,3718,3108,28209,44,57,0,272
Woodruff,11/26/20,1,147,147,193,2963,176,3168,16,6660,166,27,2828,135,151,25,1,0,14,2,2994,174,166,2828,39,135,205,2963,1,3,0,16
Yell,11/26/20,33,149,149,1621,16816,1478,18447,110,21573,1545,76,16412,404,1424,54,30,3,91,19,17957,490,1545,16412,86,404,1631,16816,4,14,0,169
Arkansas_all_counties,11/25/20,2425,5630,5630,150277,1606275,130818,1760136,17014,2990671,132249,18028,1500257,106018,116777,14041,2227,198,13227,3787,1632506,127630,132249,1500257,21612,106018,153861,1606275,1965,1987,20,19710
Arkansas_county,11/25/20,20,1,1,944,11710,816,12707,108,18124,751,193,9226,2484,662,154,20,0,69,39,9977,2730,751,9226,246,2484,997,11710,9,15,0,76
Ashley,11/25/20,13,3,3,804,8101,674,8930,117,20537,728,76,7737,364,612,62,13,0,103,14,8465,465,728,7737,101,364,829,8101,15,15,0,61
Baxter,11/25/20,27,5,5,1345,10059,1079,11426,239,41219,1057,288,9161,898,848,231,27,0,182,57,10218,1208,1057,9161,310,898,1367,10059,16,32,0,216
Benton,11/25/20,153,7,7,11538,107673,10329,119511,1055,258980,9862,1676,102983,4690,8949,1380,135,18,777,278,112845,6666,9862,102983,1976,4690,11838,107673,151,143,2,1095
Boone,11/25/20,43,9,9,1671,17889,1365,19641,263,37288,1413,258,17325,564,1198,167,41,2,174,89,18738,903,1413,17325,339,564,1752,17889,29,41,0,123
Bradley,11/25/20,8,11,11,460,5800,387,6264,65,10948,402,58,4450,1350,367,20,7,1,28,37,4852,1412,402,4450,62,1350,464,5800,13,1,0,78
Calhoun,11/25/20,1,13,13,138,2269,106,2412,31,5202,122,16,2192,77,97,9,1,0,24,7,2314,98,122,2192,21,77,143,2269,6,4,1,28
Carroll,11/25/20,23,15,15,1368,11045,1165,12435,180,27887,1269,99,10887,158,1096,69,23,0,150,30,12156,279,1269,10887,121,158,1390,11045,18,21,0,133
Chicot,11/25/20,27,17,17,1157,7264,1075,8429,55,10826,1123,34,6687,577,1049,26,26,1,48,7,7810,619,1123,6687,42,577,1165,7264,6,8,1,46
Clark,11/25/20,11,19,19,778,12552,672,13360,95,22385,673,105,11030,1522,580,92,10,1,83,12,11703,1657,673,11030,135,1522,808,12552,18,13,1,203
Clay,11/25/20,19,21,21,820,8496,658,9345,142,15061,676,144,6899,1597,567,91,16,3,92,50,7575,1770,676,6899,173,1597,849,8496,21,24,0,130
Cleburne,11/25/20,21,23,23,689,11351,581,12057,87,25230,578,111,9999,1352,495,86,20,1,63,24,10577,1480,578,9999,128,1352,706,11351,22,6,1,118
Cleveland,11/25/20,15,25,25,351,4770,285,5131,51,8226,285,66,4583,187,239,46,14,1,32,19,4868,263,285,4583,76,187,361,4770,8,2,1,25
Columbia,11/25/20,24,27,27,1054,9742,875,10862,155,23892,788,266,8158,1584,684,191,24,0,80,75,8946,1916,788,8158,332,1584,1120,9742,37,21,0,226
Conway,11/25/20,7,29,29,646,10824,492,11485,147,20906,580,66,9960,864,453,39,7,0,120,27,10540,945,580,9960,81,864,661,10824,22,24,0,199
Craighead,11/25/20,75,31,31,6763,61990,5987,68898,700,105701,6150,613,56207,5783,5477,510,68,7,604,96,62357,6541,6150,56207,758,5783,6908,61990,106,81,0,570
Crawford,11/25/20,36,33,33,2974,35248,2610,38243,326,62472,2706,268,34494,754,2386,224,34,2,284,42,37200,1043,2706,34494,289,754,2995,35248,29,37,1,281
Crittenden,11/25/20,55,35,35,3156,20667,2849,23856,251,49013,3012,144,20023,644,2729,120,48,7,234,17,23035,821,3012,20023,177,644,3189,20667,33,34,0,306
Cross,11/25/20,26,37,37,820,8090,675,8923,119,16998,705,115,7714,376,587,88,24,2,94,25,8419,504,705,7714,128,376,833,8090,16,15,0,165
Dallas,11/25/20,6,39,39,290,3523,215,3815,69,7432,276,14,3398,125,207,8,6,0,63,6,3674,141,276,3398,16,125,292,3523,12,4,0,91
Desha,11/25/20,8,41,41,543,6105,474,6671,61,11887,483,60,5728,377,440,34,7,1,36,25,6211,460,483,5728,83,377,566,6105,13,9,0,70
Drew,11/25/20,7,43,43,616,9461,511,10085,98,18502,508,108,8431,1030,451,60,6,1,51,47,8939,1146,508,8431,116,1030,624,9461,14,8,0,86
Faulkner,11/25/20,53,45,45,4575,62577,4020,67269,502,122416,4086,489,57670,4907,3633,387,47,6,406,96,61756,5513,4086,57670,606,4907,4692,62577,58,45,0,667
Franklin,11/25/20,12,47,47,755,10784,651,11563,92,17780,658,97,10456,328,578,73,12,0,68,24,11114,449,658,10456,121,328,779,10784,15,8,1,141
Fulton,11/25/20,12,49,49,534,3580,433,4133,89,12139,409,125,2930,650,336,97,10,2,63,26,3339,794,409,2930,144,650,553,3580,17,6,0,45
Garland,11/25/20,103,51,51,3633,48296,3099,51995,430,98296,3368,265,46326,1970,2903,196,98,5,366,64,49694,2301,3368,46326,331,1970,3699,48296,54,57,-1,464
Grant,11/25/20,5,53,53,571,8603,458,9186,108,18086,477,94,7766,837,399,59,4,1,74,34,8243,943,477,7766,106,837,583,8603,10,15,0,167
Greene,11/25/20,26,55,55,2735,25524,2195,28329,514,44623,2247,488,23087,2437,1841,354,24,2,382,132,25334,2995,2247,23087,558,2437,2805,25524,61,54,0,357
Hempstead,11/25/20,7,57,57,832,8746,767,9599,58,22018,699,133,8363,383,647,120,6,1,46,12,9062,537,699,8363,154,383,853,8746,7,22,0,153
HotSpring,11/25/20,42,59,59,2856,23817,2535,26710,279,33520,2755,101,21625,2192,2474,61,40,2,241,38,24380,2330,2755,21625,138,2192,2893,23817,31,32,0,535
Howard,11/25/20,15,61,61,792,5317,720,6123,57,13389,655,137,4644,673,606,114,15,0,34,23,5299,824,655,4644,151,673,806,5317,9,4,0,60
Independence,11/25/20,71,63,63,2007,19111,1783,21179,153,37264,1540,467,17829,1282,1397,386,61,10,82,71,19369,1810,1540,17829,528,1282,2068,19111,11,22,0,205
Izard,11/25/20,6,65,65,974,7954,895,8944,73,13559,875,99,6966,988,815,80,6,0,54,19,7841,1103,875,6966,115,988,990,7954,15,4,0,54
Jackson,11/25/20,6,67,67,1667,13924,1146,15698,515,17225,1357,310,12182,1742,881,265,5,1,471,44,13539,2159,1357,12182,417,1742,1774,13924,69,32,0,718
Jefferson,11/25/20,109,69,69,5089,48917,4620,54163,358,70424,4682,407,46929,1988,4363,257,104,5,213,145,51611,2552,4682,46929,564,1988,5246,48917,28,33,0,703
Johnson,11/25/20,11,71,71,1235,12842,1150,14087,74,26291,1154,81,12384,458,1083,67,10,1,61,13,13538,549,1154,12384,91,458,1245,12842,12,18,0,223
Lafayette,11/25/20,3,73,73,258,1873,232,2147,23,6915,212,46,1755,118,190,42,3,0,19,4,1967,180,212,1755,62,118,274,1873,3,3,0,26
Lawrence,11/25/20,28,75,75,1120,7753,990,8907,102,16669,978,142,7334,419,865,125,28,0,85,17,8312,595,978,7334,176,419,1154,7753,12,11,0,62
Lee,11/25/20,18,77,77,1169,6089,1120,7263,31,9398,1155,14,6005,84,1109,11,17,1,29,2,7160,103,1155,6005,19,84,1174,6089,4,3,0,61
Lincoln,11/25/20,18,79,79,2408,11980,2343,14403,47,13695,2357,51,10868,1112,2315,28,17,1,25,22,13225,1178,2357,10868,66,1112,2423,11980,10,4,0,841
LittleRiver,11/25/20,40,81,81,620,3109,521,3733,59,12417,519,101,2846,263,442,79,35,5,42,17,3365,368,519,2846,105,263,624,3109,5,4,0,85
Logan,11/25/20,6,83,83,898,13044,742,13958,150,21757,829,69,11807,1237,692,50,6,0,131,19,12636,1322,829,11807,85,1237,914,13044,18,17,0,135
Lonoke,11/25/20,52,85,85,2583,34976,2227,37696,304,72206,2028,555,30521,4455,1765,462,49,3,214,90,32549,5147,2028,30521,692,4455,2720,34976,33,49,1,284
Madison,11/25/20,8,87,87,600,6730,508,7346,84,16076,534,66,6349,381,462,46,8,0,64,20,6883,463,534,6349,82,381,616,6730,14,8,0,80
Marion,11/25/20,6,89,89,417,5060,304,5496,107,16438,342,75,4683,377,250,54,5,1,87,20,5025,471,342,4683,94,377,436,5060,8,16,0,52
Miller,11/25/20,22,91,91,2100,11006,1950,13170,128,43759,1584,516,10291,715,1493,457,16,6,75,53,11875,1295,1584,10291,580,715,2164,11006,24,27,0,131
MissingCountyInfo,11/25/20,0,5,5,2401,92030,1591,94435,810,NA,1962,439,91975,55,1325,266,0,0,637,173,93937,498,1962,91975,443,55,2405,92030,-32,33,0,1546
Mississippi,11/25/20,80,93,93,3076,19236,2768,22338,227,42831,2850,226,16480,2756,2579,189,66,14,204,23,19330,3008,2850,16480,252,2756,3102,19236,28,30,1,259
Monroe,11/25/20,4,95,95,295,3809,258,4109,33,7249,269,26,3697,112,242,16,4,0,23,10,3966,143,269,3697,31,112,300,3809,2,1,0,32
Montgomery,11/25/20,10,97,97,269,3657,211,3927,48,8993,255,14,2935,722,205,6,9,1,41,7,3190,737,255,2935,15,722,270,3657,7,5,0,21
Nevada,11/25/20,14,99,99,440,6463,379,6908,47,8440,387,53,6265,198,336,43,13,1,38,9,6652,256,387,6265,58,198,445,6463,5,3,0,108
Newton,11/25/20,22,101,101,422,3416,351,3842,49,7848,372,50,2527,889,317,34,19,3,36,13,2899,943,372,2527,54,889,426,3416,6,4,0,21
Ouachita,11/25/20,11,103,103,689,9317,507,10032,170,24106,633,56,8954,363,467,40,11,0,154,16,9587,445,633,8954,82,363,715,9317,37,24,0,144
Perry,11/25/20,3,105,105,245,6196,196,6452,46,10322,222,23,5935,261,178,18,3,0,41,5,6157,295,222,5935,34,261,256,6196,6,2,0,134
Phillips,11/25/20,17,107,107,921,10508,834,11453,70,19034,880,41,10252,256,804,30,17,0,59,11,11132,321,880,10252,65,256,945,10508,11,21,0,135
Pike,11/25/20,2,109,109,360,3430,320,3794,38,10808,328,32,3192,238,295,25,1,1,32,6,3520,274,328,3192,36,238,364,3430,6,5,0,46
Poinsett,11/25/20,40,111,111,1612,14646,1435,16306,137,24054,1460,152,14082,564,1298,137,35,5,127,10,15542,764,1460,14082,200,564,1660,14646,10,30,1,124
Polk,11/25/20,10,113,113,747,7480,578,8245,159,20163,687,60,7112,368,534,44,10,0,143,16,7799,446,687,7112,78,368,765,7480,14,27,1,80
Pope,11/25/20,42,115,115,3597,37049,3177,40680,378,63644,3175,422,35741,1308,2858,319,38,4,279,99,38916,1764,3175,35741,456,1308,3631,37049,52,58,0,301
Prairie,11/25/20,7,117,117,348,3785,312,4152,29,8244,284,64,3367,418,257,55,7,0,20,9,3651,501,284,3367,83,418,367,3785,3,2,0,23
Pulaski,11/25/20,261,119,119,16152,215180,14023,231653,1866,393463,14916,1236,204464,10716,13051,972,246,15,1617,249,219380,12273,14916,204464,1557,10716,16473,215180,197,191,2,2214
Randolph,11/25/20,30,121,121,944,9135,809,10125,105,17603,755,189,8188,947,643,166,24,6,88,17,8943,1182,755,8188,235,947,990,9135,7,11,0,65
Saline,11/25/20,54,125,125,4565,54056,3833,58793,677,118009,3804,761,48000,6056,3278,555,51,3,474,203,51804,6989,3804,48000,933,6056,4737,54056,92,79,0,851
Scott,11/25/20,2,127,127,359,5738,296,6100,61,10442,280,79,5585,153,246,50,2,0,32,29,5865,235,280,5585,82,153,362,5738,14,4,0,131
Searcy,11/25/20,1,129,129,284,3857,250,4142,33,7923,238,46,3349,508,217,33,1,0,20,13,3587,555,238,3349,47,508,285,3857,2,0,0,76
Sebastian,11/25/20,123,131,131,6809,78419,5982,85283,701,127461,6192,617,76986,1433,5520,462,114,9,556,145,83178,2105,6192,76986,672,1433,6864,78419,94,93,1,784
Sevier,11/25/20,18,133,133,1684,8865,1591,10583,75,17193,1386,298,7958,907,1334,257,18,0,34,41,9344,1239,1386,7958,332,907,1718,8865,11,14,0,46
Sharp,11/25/20,14,135,135,656,7919,517,8616,125,17043,518,138,7286,633,412,105,13,1,93,32,7804,812,518,7286,179,633,697,7919,11,16,0,72
St.Francis,11/25/20,14,123,123,2019,16741,1914,18776,91,26294,1964,55,16564,177,1865,49,14,0,85,6,18528,248,1964,16564,71,177,2035,16741,10,18,0,187
Stone,11/25/20,23,137,137,452,5154,410,5614,19,12446,427,25,4871,283,390,20,23,0,14,5,5298,316,427,4871,33,283,460,5154,2,3,0,40
Union,11/25/20,56,139,139,1487,13953,1302,15483,129,39732,1262,225,12295,1658,1119,183,49,7,94,35,13557,1926,1262,12295,268,1658,1530,13953,12,18,0,45
VanBuren,11/25/20,3,141,141,351,7111,279,7487,69,16684,309,42,6412,699,253,26,3,0,53,16,6721,766,309,6412,67,699,376,7111,7,7,0,57
Washington,11/25/20,176,143,143,15024,125304,13426,140758,1421,228529,12835,2189,113437,11867,11589,1837,157,19,1089,332,126272,14486,12835,113437,2619,11867,15454,125304,160,155,2,1321
White,11/25/20,50,145,145,2907,27981,2343,31038,512,78804,2244,663,24384,3597,1892,451,45,5,305,207,26628,4410,2244,24384,813,3597,3057,27981,31,69,2,137
Woodruff,11/25/20,1,147,147,192,2948,173,3151,18,6660,165,27,2818,130,149,24,1,0,15,3,2983,168,165,2818,38,130,203,2948,1,1,1,28
Yell,11/25/20,33,149,149,1617,16651,1464,18278,120,21573,1543,74,16258,393,1412,52,30,3,101,19,17801,477,1543,16258,84,393,1627,16651,17,11,0,107
Arkansas_all_counties,11/24/20,2405,5630,5630,148312,1588530,128831,1740349,17057,2990671,130826,17486,1487077,101453,115248,13583,2208,197,13352,3705,1617903,122446,130826,1487077,20993,101453,151819,1588530,2122,1772,18,16432
Arkansas_county,11/24/20,20,1,1,935,11643,801,12632,114,18124,747,188,9177,2466,654,147,20,0,73,41,9924,2708,747,9177,242,2466,989,11643,17,10,0,117
Ashley,11/24/20,13,3,3,789,8055,659,8868,117,20537,715,74,7693,362,601,58,13,0,101,16,8408,460,715,7693,98,362,813,8055,17,9,0,168
Baxter,11/24/20,27,5,5,1329,9859,1047,11207,255,41219,1042,287,8968,891,821,226,27,0,194,61,10010,1197,1042,8968,306,891,1348,9859,48,22,0,266
Benton,11/24/20,151,7,7,11387,106729,10186,118409,1049,258980,9750,1637,102177,4552,8843,1343,133,18,773,276,111927,6482,9750,102177,1930,4552,11680,106729,180,128,1,1024
Boone,11/24/20,43,9,9,1642,17795,1324,19517,275,37288,1398,244,17238,557,1161,163,41,2,196,79,18636,881,1398,17238,324,557,1722,17795,36,36,1,138
Bradley,11/24/20,8,11,11,447,5735,386,6186,53,10948,401,46,4438,1297,366,20,7,1,28,25,4839,1347,401,4438,50,1297,451,5735,11,6,0,214
Calhoun,11/24/20,0,13,13,132,2247,102,2384,30,5202,117,15,2171,76,93,9,0,0,24,6,2288,96,117,2171,20,76,137,2247,2,3,0,11
Carroll,11/24/20,23,15,15,1350,10930,1144,12302,183,27887,1257,93,10780,150,1079,65,23,0,155,28,12037,265,1257,10780,115,150,1372,10930,36,18,0,145
Chicot,11/24/20,26,17,17,1151,7224,1067,8382,58,10826,1117,34,6649,575,1044,23,25,1,48,10,7766,616,1117,6649,41,575,1158,7224,6,3,0,36
Clark,11/24/20,10,19,19,760,12367,659,13157,91,22385,656,104,10853,1514,569,90,9,1,78,13,11509,1648,656,10853,134,1514,790,12367,11,13,0,96
Clay,11/24/20,19,21,21,799,8387,634,9214,145,15061,662,137,6795,1592,544,90,16,3,101,44,7457,1757,662,6795,165,1592,827,8387,13,15,0,76
Cleburne,11/24/20,20,23,23,667,11255,575,11938,72,25230,562,105,9933,1322,489,86,20,0,53,19,10495,1443,562,9933,121,1322,683,11255,13,5,0,158
Cleveland,11/24/20,14,25,25,343,4753,283,5106,46,8226,278,65,4570,183,239,44,13,1,26,20,4848,258,278,4570,75,183,353,4753,9,8,0,46
Columbia,11/24/20,24,27,27,1017,9553,854,10637,139,23892,775,242,8097,1456,675,179,24,0,76,63,8872,1765,775,8097,309,1456,1084,9553,17,8,0,171
Conway,11/24/20,7,29,29,624,10647,468,11285,149,20906,559,65,9857,790,433,35,7,0,119,30,10416,869,559,9857,79,790,638,10647,14,14,0,147
Craighead,11/24/20,75,31,31,6657,61526,5906,68326,675,105701,6060,597,55789,5737,5406,500,68,7,585,90,61849,6477,6060,55789,740,5737,6800,61526,72,98,3,1055
Crawford,11/24/20,35,33,33,2945,34996,2573,37961,335,62472,2679,266,34273,723,2356,217,33,2,288,47,36952,1009,2679,34273,286,723,2965,34996,31,38,0,265
Crittenden,11/24/20,55,35,35,3123,20394,2815,23550,252,49013,2981,142,19833,561,2697,118,48,7,235,17,22814,736,2981,19833,175,561,3156,20394,17,24,0,104
Cross,11/24/20,26,37,37,804,7941,660,8756,118,16998,692,112,7574,367,574,86,24,2,94,24,8266,490,692,7574,123,367,815,7941,21,6,0,67
Dallas,11/24/20,6,39,39,278,3444,211,3724,61,7432,268,10,3324,120,204,7,6,0,58,3,3592,132,268,3324,12,120,280,3444,9,4,0,43
Desha,11/24/20,8,41,41,530,6048,465,6601,57,11887,479,51,5683,365,434,31,7,1,38,19,6162,439,479,5683,74,365,553,6048,8,3,0,98
Drew,11/24/20,7,43,43,602,9389,503,9999,92,18502,502,100,8371,1018,446,57,6,1,50,42,8873,1126,502,8371,108,1018,610,9389,19,8,0,79
Faulkner,11/24/20,53,45,45,4517,61968,3975,66601,489,122416,4042,475,57329,4639,3595,380,47,6,400,89,61371,5230,4042,57329,591,4639,4633,61968,73,66,0,898
Franklin,11/24/20,11,47,47,740,10658,643,11421,86,17780,653,87,10357,301,572,71,11,0,70,16,11010,411,653,10357,110,301,763,10658,12,4,0,69
Fulton,11/24/20,12,49,49,517,3552,427,4086,78,12139,398,119,2917,635,331,96,10,2,57,21,3315,771,398,2917,136,635,534,3552,15,7,0,65
Garland,11/24/20,104,51,51,3579,47886,3042,51531,432,98296,3318,261,46022,1864,2855,187,99,5,363,69,49340,2191,3318,46022,327,1864,3645,47886,72,57,0,430
Grant,11/24/20,5,53,53,561,8446,443,9019,113,18086,470,91,7716,730,392,51,4,1,74,39,8186,833,470,7716,103,730,573,8446,20,11,0,105
Greene,11/24/20,26,55,55,2674,25228,2141,27966,507,44623,2198,476,22843,2385,1800,341,24,2,374,133,25041,2925,2198,22843,540,2385,2738,25228,56,47,0,193
Hempstead,11/24/20,7,57,57,825,8600,745,9446,73,22018,696,129,8221,379,632,113,6,1,58,15,8917,529,696,8221,150,379,846,8600,8,25,1,33
HotSpring,11/24/20,42,59,59,2825,23313,2503,26172,280,33520,2728,97,21448,1865,2443,60,40,2,245,35,24176,1996,2728,21448,131,1865,2859,23313,31,27,0,279
Howard,11/24/20,15,61,61,783,5266,716,6063,52,13389,650,133,4593,673,605,111,15,0,30,22,5243,820,650,4593,147,673,797,5266,6,9,0,28
Independence,11/24/20,71,63,63,1996,18917,1761,20975,164,37264,1537,459,17793,1124,1384,377,61,10,92,72,19330,1645,1537,17793,521,1124,2058,18917,28,11,0,133
Izard,11/24/20,6,65,65,959,7915,891,8890,62,13559,866,93,6933,982,813,78,6,0,47,15,7799,1091,866,6933,109,982,975,7915,8,13,0,44
Jackson,11/24/20,6,67,67,1598,13275,1114,14980,478,17225,1299,299,11930,1345,852,262,5,1,442,36,13229,1751,1299,11930,406,1345,1705,13275,69,10,0,251
Jefferson,11/24/20,109,69,69,5061,48242,4587,53457,363,70424,4670,391,46589,1653,4338,249,104,5,226,137,51259,2198,4670,46589,545,1653,5215,48242,51,26,0,324
Johnson,11/24/20,11,71,71,1223,12631,1132,13863,80,26291,1143,80,12184,447,1069,63,10,1,64,16,13327,536,1143,12184,89,447,1232,12631,7,8,0,52
Lafayette,11/24/20,3,73,73,255,1850,229,2119,23,6915,209,46,1738,112,189,40,3,0,17,6,1947,172,209,1738,60,112,269,1850,3,0,0,18
Lawrence,11/24/20,28,75,75,1108,7703,979,8845,101,16669,966,142,7295,408,857,122,28,0,81,20,8261,584,966,7295,176,408,1142,7703,12,8,0,125
Lee,11/24/20,18,77,77,1165,6032,1117,7202,30,9398,1152,13,5950,82,1106,11,17,1,29,1,7102,100,1152,5950,18,82,1170,6032,4,5,0,45
Lincoln,11/24/20,18,79,79,2398,11149,2339,13564,41,13695,2355,43,10772,377,2312,27,17,1,26,15,13127,437,2355,10772,60,377,2415,11149,5,2,0,105
LittleRiver,11/24/20,40,81,81,615,3029,517,3648,58,12417,516,99,2769,260,439,78,35,5,42,16,3285,363,516,2769,103,260,619,3029,4,12,0,14
Logan,11/24/20,6,83,83,880,12927,725,13823,149,21757,813,67,11698,1229,678,47,6,0,129,20,12511,1312,813,11698,83,1229,896,12927,2,29,0,92
Lonoke,11/24/20,51,85,85,2550,34725,2178,37414,321,72206,2006,544,30330,4395,1728,450,48,3,230,91,32336,5078,2006,30330,683,4395,2689,34725,38,32,2,349
Madison,11/24/20,8,87,87,586,6664,500,7266,78,16076,526,60,6298,366,455,45,8,0,63,15,6824,442,526,6298,76,366,602,6664,8,5,1,58
Marion,11/24/20,6,89,89,409,5016,288,5443,115,16438,335,74,4647,369,234,54,5,1,96,19,4982,461,335,4647,92,369,427,5016,16,12,0,115
Miller,11/24/20,22,91,91,2076,10899,1923,13039,131,43759,1578,498,10203,696,1483,440,16,6,79,52,11781,1258,1578,10203,562,696,2140,10899,12,14,0,98
MissingCountyInfo,11/24/20,0,5,5,2433,90452,1558,92890,875,NA,1982,451,90398,54,1291,267,0,0,691,184,92380,510,1982,90398,456,54,2438,90452,75,47,0,1037
Mississippi,11/24/20,79,93,93,3048,19005,2738,22078,230,42831,2827,221,16394,2611,2550,188,65,14,211,19,19221,2857,2827,16394,246,2611,3073,19005,24,30,0,279
Monroe,11/24/20,4,95,95,293,3779,257,4077,32,7249,267,26,3670,109,241,16,4,0,22,10,3937,140,267,3670,31,109,298,3779,1,3,0,15
Montgomery,11/24/20,10,97,97,262,3643,206,3906,46,8993,250,12,2923,720,201,5,9,1,40,6,3173,733,250,2923,13,720,263,3643,8,1,0,89
Nevada,11/24/20,14,99,99,435,6360,376,6800,45,8440,383,52,6171,189,333,43,13,1,37,8,6554,246,383,6171,57,189,440,6360,7,6,0,115
Newton,11/24/20,22,101,101,416,3401,347,3821,47,7848,371,45,2513,888,315,32,19,3,37,10,2884,937,371,2513,49,888,420,3401,4,2,0,47
Ouachita,11/24/20,11,103,103,652,9210,483,9888,157,24106,597,55,8849,361,449,34,11,0,136,21,9446,442,597,8849,81,361,678,9210,23,18,0,212
Perry,11/24/20,3,105,105,239,6068,194,6318,42,10322,216,23,5819,249,176,18,3,0,37,5,6035,283,216,5819,34,249,250,6068,6,3,0,80
Phillips,11/24/20,17,107,107,910,10384,813,11318,80,19034,871,39,10135,249,788,25,17,0,66,14,11006,312,871,10135,63,249,934,10384,18,5,1,86
Pike,11/24/20,2,109,109,354,3390,315,3748,37,10808,325,29,3156,234,291,24,1,1,33,4,3481,267,325,3156,33,234,358,3390,3,7,1,43
Poinsett,11/24/20,39,111,111,1602,14532,1405,16180,158,24054,1450,152,13987,545,1271,134,34,5,145,13,15437,743,1450,13987,198,545,1648,14532,12,19,0,110
Polk,11/24/20,9,113,113,733,7414,551,8165,173,20163,678,55,7047,367,510,41,9,0,159,14,7725,440,678,7047,73,367,751,7414,23,17,1,86
Pope,11/24/20,42,115,115,3545,36800,3119,40378,384,63644,3138,407,35519,1281,2828,291,38,4,272,112,38657,1721,3138,35519,440,1281,3578,36800,51,52,0,216
Prairie,11/24/20,7,117,117,345,3765,310,4127,28,8244,283,62,3351,414,255,55,7,0,21,7,3634,493,283,3351,79,414,362,3765,3,3,1,20
Pulaski,11/24/20,259,119,119,15955,213163,13832,229427,1862,393463,14762,1193,202703,10460,12891,941,244,15,1625,237,217465,11962,14762,202703,1502,10460,16264,213163,212,158,1,1748
Randolph,11/24/20,30,121,121,937,9077,798,10061,109,17603,751,186,8150,927,636,162,24,6,91,18,8901,1160,751,8150,233,927,984,9077,7,17,0,63
Saline,11/24/20,54,125,125,4473,53297,3754,57936,664,118009,3738,735,47531,5766,3231,523,51,3,455,209,51269,6667,3738,47531,901,5766,4639,53297,106,59,0,779
Scott,11/24/20,2,127,127,345,5621,292,5971,51,10442,272,73,5469,152,243,49,2,0,27,24,5741,230,272,5469,78,152,350,5621,14,4,0,35
Searcy,11/24/20,1,129,129,282,3783,250,4066,31,7923,236,46,3339,444,219,31,1,0,16,15,3575,491,236,3339,47,444,283,3783,7,4,0,40
Sebastian,11/24/20,122,131,131,6715,77729,5889,84495,702,127461,6115,600,76335,1394,5443,446,113,9,557,145,82450,2045,6115,76335,651,1394,6766,77729,58,77,0,716
Sevier,11/24/20,18,133,133,1673,8830,1577,10537,78,17193,1382,291,7935,895,1329,248,18,0,35,43,9317,1220,1382,7935,325,895,1707,8830,8,14,1,48
Sharp,11/24/20,14,135,135,645,7858,501,8543,130,17043,511,134,7238,620,398,103,13,1,100,30,7749,794,511,7238,174,620,685,7858,17,16,0,79
St.Francis,11/24/20,14,123,123,2009,16564,1896,18589,99,26294,1956,53,16394,170,1847,49,14,0,95,4,18350,239,1956,16394,69,170,2025,16564,10,11,0,119
Stone,11/24/20,23,137,137,450,5116,407,5574,20,12446,425,25,4845,271,387,20,23,0,15,5,5270,304,425,4845,33,271,458,5116,6,1,0,56
Union,11/24/20,56,139,139,1475,13920,1284,15437,135,39732,1257,218,12267,1653,1110,174,49,7,98,37,13524,1913,1257,12267,260,1653,1517,13920,14,12,0,78
VanBuren,11/24/20,3,141,141,344,7061,272,7430,69,16684,305,39,6372,689,250,22,3,0,52,17,6677,753,305,6372,64,689,369,7061,9,8,0,55
Washington,11/24/20,174,143,143,14864,124143,13271,139426,1418,228529,12735,2129,112493,11650,11482,1789,155,19,1098,320,125228,14198,12735,112493,2548,11650,15283,124143,189,152,2,1472
White,11/24/20,48,145,145,2876,27875,2274,30897,552,78804,2228,648,24291,3584,1841,433,43,5,342,210,26519,4378,2228,24291,794,3584,3022,27875,27,93,1,180
Woodruff,11/24/20,0,147,147,191,2921,172,3123,19,6660,164,27,2792,129,148,24,0,0,16,3,2956,167,164,2792,38,129,202,2921,3,5,0,14
Yell,11/24/20,33,149,149,1600,16561,1453,18169,114,21573,1530,70,16173,388,1404,49,30,3,96,18,17703,466,1530,16173,78,388,1608,16561,10,9,0,68
Arkansas_all_counties,11/23/20,2387,5630,5630,146190,1574220,127059,1723786,16727,2990671,129405,16785,1475768,98452,113946,13113,2191,196,13252,3475,1605173,118613,129405,1475768,20161,98452,149566,1574220,1017,1906,30,11838
Arkansas_county,11/23/20,20,1,1,918,11543,791,12513,107,18124,738,180,9117,2426,651,140,20,0,67,40,9855,2658,738,9117,232,2426,970,11543,2,8,0,108
Ashley,11/23/20,13,3,3,772,7904,650,8699,109,20537,702,70,7546,358,593,57,13,0,96,13,8248,451,702,7546,93,358,795,7904,18,8,0,157
Baxter,11/23/20,27,5,5,1281,9641,1025,10940,229,41219,1013,268,8819,822,806,219,27,0,180,49,9832,1108,1013,8819,286,822,1299,9641,14,31,0,74
Benton,11/23/20,150,7,7,11207,105885,10058,117372,998,258980,9630,1577,101349,4536,8766,1292,132,18,731,267,110979,6393,9630,101349,1857,4536,11487,105885,82,141,2,1295
Boone,11/23/20,42,9,9,1606,17693,1288,19377,276,37288,1373,233,17142,551,1131,157,40,2,202,74,18515,862,1373,17142,311,551,1684,17693,30,33,1,337
Bradley,11/23/20,8,11,11,436,5532,380,5971,48,10948,397,39,4416,1116,364,16,7,1,26,22,4813,1158,397,4416,42,1116,439,5532,7,1,0,28
Calhoun,11/23/20,0,13,13,130,2238,99,2373,31,5202,115,15,2163,75,89,10,0,0,26,5,2278,95,115,2163,20,75,135,2238,3,3,0,24
Carroll,11/23/20,23,15,15,1314,10821,1126,12158,165,27887,1225,89,10673,148,1064,62,23,0,138,27,11898,260,1225,10673,112,148,1337,10821,13,14,2,177
Chicot,11/23/20,26,17,17,1145,7194,1064,8345,55,10826,1112,33,6624,570,1042,22,25,1,45,10,7736,609,1112,6624,39,570,1151,7194,11,2,1,106
Clark,11/23/20,10,19,19,749,12282,646,13061,93,22385,650,99,10821,1461,560,86,9,1,81,12,11471,1590,650,10821,129,1461,779,12282,1,14,0,223
Clay,11/23/20,19,21,21,786,8324,619,9136,147,15061,654,132,6745,1579,530,89,16,3,107,40,7399,1737,654,6745,158,1579,812,8324,11,15,0,92
Cleburne,11/23/20,20,23,23,654,11110,570,11779,64,25230,553,101,9831,1279,485,85,20,0,48,16,10384,1395,553,9831,116,1279,669,11110,4,16,0,91
Cleveland,11/23/20,14,25,25,334,4716,275,5060,45,8226,276,58,4543,173,233,42,13,1,30,15,4819,241,276,4543,68,173,344,4716,0,4,0,17
Columbia,11/23/20,24,27,27,1000,9399,846,10464,130,23892,769,231,8058,1341,670,176,24,0,75,55,8827,1637,769,8058,296,1341,1065,9399,12,11,0,64
Conway,11/23/20,7,29,29,610,10514,454,11137,149,20906,547,63,9746,768,422,32,7,0,118,31,10293,844,547,9746,76,768,623,10514,4,16,1,87
Craighead,11/23/20,72,31,31,6585,60543,5808,67270,704,105701,5999,586,55333,5210,5321,487,65,7,612,92,61332,5938,5999,55333,728,5210,6727,60543,33,97,0,436
Crawford,11/23/20,35,33,33,2914,34762,2535,37696,343,62472,2656,258,34051,711,2327,208,33,2,295,48,36707,989,2656,34051,278,711,2934,34762,26,51,0,403
Crittenden,11/23/20,55,35,35,3106,20307,2791,23446,259,49013,2967,139,19749,558,2678,113,48,7,240,19,22716,730,2967,19749,172,558,3139,20307,15,26,0,171
Cross,11/23/20,26,37,37,783,7895,654,8689,103,16998,678,105,7531,364,570,84,24,2,84,19,8209,480,678,7531,116,364,794,7895,10,8,0,91
Dallas,11/23/20,6,39,39,269,3410,207,3681,56,7432,259,10,3296,114,200,7,6,0,53,3,3555,126,259,3296,12,114,271,3410,4,3,0,24
Desha,11/23/20,8,41,41,522,5958,462,6502,52,11887,476,46,5604,354,431,31,7,1,38,14,6080,422,476,5604,68,354,544,5958,4,4,0,56
Drew,11/23/20,7,43,43,583,9329,495,9920,81,18502,496,87,8354,975,443,52,6,1,47,34,8850,1070,496,8354,95,975,591,9329,4,5,0,87
Faulkner,11/23/20,53,45,45,4444,61143,3909,65696,482,122416,3984,460,56685,4458,3550,359,47,6,387,95,60669,5027,3984,56685,569,4458,4553,61143,27,30,1,501
Franklin,11/23/20,11,47,47,728,10601,639,11351,78,17780,645,83,10301,300,568,71,11,0,66,12,10946,405,645,10301,105,300,750,10601,10,4,1,97
Fulton,11/23/20,12,49,49,502,3502,420,4021,70,12139,389,113,2885,617,326,94,10,2,53,17,3274,747,389,2885,130,617,519,3502,2,13,0,23
Garland,11/23/20,104,51,51,3507,47528,2985,51100,418,98296,3265,242,45741,1787,2804,181,99,5,362,56,49006,2094,3265,45741,307,1787,3572,47528,15,42,3,271
Grant,11/23/20,5,53,53,541,8361,432,8914,104,18086,462,79,7653,708,385,47,4,1,73,31,8115,799,462,7653,91,708,553,8361,3,10,0,77
Greene,11/23/20,26,55,55,2618,25091,2094,27771,498,44623,2159,459,22750,2341,1770,324,24,2,365,133,24909,2862,2159,22750,521,2341,2680,25091,40,57,0,487
Hempstead,11/23/20,6,57,57,817,8575,720,9412,91,22018,691,126,8207,368,608,112,6,0,77,14,8898,514,691,8207,146,368,837,8575,11,19,0,84
HotSpring,11/23/20,42,59,59,2794,23065,2476,25892,276,33520,2708,86,21253,1812,2419,57,40,2,249,27,23961,1931,2708,21253,119,1812,2827,23065,25,41,1,347
Howard,11/23/20,15,61,61,777,5244,707,6035,55,13389,645,132,4580,664,600,107,15,0,30,25,5225,810,645,4580,146,664,791,5244,4,6,0,22
Independence,11/23/20,71,63,63,1968,18812,1750,20839,147,37264,1530,438,17742,1070,1378,372,61,10,91,56,19272,1567,1530,17742,497,1070,2027,18812,15,63,0,414
Izard,11/23/20,6,65,65,951,7879,878,8846,67,13559,863,88,6907,972,805,73,6,0,52,15,7770,1076,863,6907,104,972,967,7879,6,10,1,180
Jackson,11/23/20,6,67,67,1529,13093,1104,14717,419,17225,1240,289,11757,1336,846,258,5,1,389,30,12997,1720,1240,11757,384,1336,1624,13093,11,19,0,127
Jefferson,11/23/20,109,69,69,5010,47969,4561,53132,338,70424,4642,368,46323,1646,4323,238,104,5,213,125,50965,2167,4642,46323,521,1646,5163,47969,20,36,2,213
Johnson,11/23/20,11,71,71,1216,12586,1124,13811,81,26291,1139,77,12145,441,1065,59,10,1,64,17,13284,527,1139,12145,86,441,1225,12586,7,12,0,79
Lafayette,11/23/20,3,73,73,252,1835,229,2101,20,6915,207,45,1734,101,189,40,3,0,15,5,1941,160,207,1734,59,101,266,1835,0,1,0,6
Lawrence,11/23/20,28,75,75,1096,7590,971,8720,97,16669,956,140,7193,397,850,121,28,0,78,19,8149,571,956,7193,174,397,1130,7590,6,13,0,69
Lee,11/23/20,18,77,77,1161,5991,1112,7157,31,9398,1149,12,5915,76,1101,11,17,1,31,0,7064,93,1149,5915,17,76,1166,5991,2,4,0,35
Lincoln,11/23/20,18,79,79,2393,11049,2337,13459,38,13695,2352,41,10677,372,2311,26,17,1,24,14,13029,430,2352,10677,58,372,2410,11049,4,1,0,84
LittleRiver,11/23/20,40,81,81,611,3019,505,3634,66,12417,513,98,2761,258,436,69,35,5,42,24,3274,360,513,2761,102,258,615,3019,3,7,0,41
Logan,11/23/20,6,83,83,878,12837,696,13731,176,21757,812,66,11608,1229,653,43,6,0,153,23,12420,1311,812,11608,82,1229,894,12837,33,10,0,149
Lonoke,11/23/20,49,85,85,2512,34414,2146,37061,317,72206,1988,524,30108,4306,1709,437,46,3,233,84,32096,4965,1988,30108,659,4306,2647,34414,25,31,4,195
Madison,11/23/20,7,87,87,578,6614,495,7207,76,16076,519,59,6252,362,449,46,7,0,63,13,6771,436,519,6252,74,362,593,6614,12,6,0,100
Marion,11/23/20,6,89,89,393,4917,276,5327,111,16438,326,67,4562,355,226,50,5,1,95,16,4888,439,326,4562,84,355,410,4917,4,17,0,107
Miller,11/23/20,22,91,91,2064,10813,1909,12942,133,43759,1571,493,10121,692,1476,433,16,6,79,54,11692,1250,1571,10121,558,692,2129,10813,13,27,0,99
MissingCountyInfo,11/23/20,0,5,5,2358,89490,1511,91853,847,NA,1984,374,89442,48,1261,250,0,0,723,124,91426,427,1984,89442,379,48,2363,89490,-220,17,0,-4010
Mississippi,11/23/20,79,93,93,3024,18750,2708,21798,236,42831,2807,217,16306,2444,2526,182,65,14,215,21,19113,2685,2807,16306,241,2444,3048,18750,27,27,0,286
Monroe,11/23/20,4,95,95,292,3765,254,4062,34,7249,267,25,3660,105,238,16,4,0,25,9,3927,135,267,3660,30,105,297,3765,2,1,0,31
Montgomery,11/23/20,10,97,97,254,3562,205,3817,39,8993,246,8,2904,658,200,5,9,1,37,2,3150,667,246,2904,9,658,255,3562,9,2,0,31
Nevada,11/23/20,14,99,99,428,6252,370,6685,44,8440,378,50,6068,184,330,40,13,1,35,9,6446,239,378,6068,55,184,433,6252,3,7,0,118
Newton,11/23/20,22,101,101,412,3358,345,3773,45,7848,366,46,2508,850,313,32,19,3,34,11,2874,899,366,2508,49,850,415,3358,2,3,0,81
Ouachita,11/23/20,11,103,103,629,9021,465,9676,152,24106,575,54,8676,345,434,31,11,0,129,23,9251,425,575,8676,80,345,655,9021,21,15,0,197
Perry,11/23/20,3,105,105,233,5994,191,6238,39,10322,211,22,5750,244,174,17,3,0,34,5,5961,277,211,5750,33,244,244,5994,4,4,0,35
Phillips,11/23/20,16,107,107,892,10316,808,11232,68,19034,856,36,10068,248,784,24,16,0,56,12,10924,308,856,10068,60,248,916,10316,7,4,0,89
Pike,11/23/20,1,109,109,351,3350,308,3705,42,10808,322,29,3117,233,288,20,0,1,34,8,3439,266,322,3117,33,233,355,3350,1,4,0,32
Poinsett,11/23/20,39,111,111,1590,14434,1386,16068,165,24054,1436,154,13918,516,1256,130,34,5,146,19,15354,714,1436,13918,198,516,1634,14434,6,23,0,142
Polk,11/23/20,8,113,113,710,7351,534,8079,168,20163,657,53,6990,361,493,41,8,0,156,12,7647,432,657,6990,71,361,728,7351,11,16,0,175
Pope,11/23/20,42,115,115,3494,36635,3067,40162,385,63644,3119,375,35376,1259,2794,273,38,4,287,98,38495,1667,3119,35376,408,1259,3527,36635,13,26,0,369
Prairie,11/23/20,6,117,117,342,3748,307,4107,29,8244,283,59,3338,410,253,54,6,0,24,5,3621,486,283,3338,76,410,359,3748,4,8,0,24
Pulaski,11/23/20,258,119,119,15743,211627,13674,227667,1809,393463,14596,1147,201444,10183,12760,914,243,15,1591,218,216040,11627,14596,201444,1444,10183,16040,211627,158,196,2,1829
Randolph,11/23/20,30,121,121,930,9021,781,9998,119,17603,747,183,8106,915,620,161,24,6,103,16,8853,1145,747,8106,230,915,977,9021,5,13,1,71
Saline,11/23/20,54,125,125,4367,52624,3695,57153,617,118009,3682,685,47086,5538,3184,511,51,3,446,171,50768,6385,3682,47086,847,5538,4529,52624,58,95,2,703
Scott,11/23/20,2,127,127,331,5600,288,5935,41,10442,264,67,5447,153,241,47,2,0,21,20,5711,224,264,5447,71,153,335,5600,0,8,0,45
Searcy,11/23/20,1,129,129,275,3750,246,4026,28,7923,232,43,3308,442,215,31,1,0,16,12,3540,486,232,3308,44,442,276,3750,3,5,0,18
Sebastian,11/23/20,122,131,131,6657,77071,5812,83778,721,127461,6081,576,75712,1359,5391,421,113,9,575,146,81793,1985,6081,75712,626,1359,6707,77071,61,98,1,923
Sevier,11/23/20,17,133,133,1665,8790,1563,10488,85,17193,1378,287,7911,879,1326,237,17,0,35,50,9289,1199,1378,7911,320,879,1698,8790,17,18,0,117
Sharp,11/23/20,14,135,135,628,7796,485,8463,129,17043,501,127,7191,605,386,99,13,1,102,27,7692,771,501,7191,166,605,667,7796,6,10,0,139
St.Francis,11/23/20,14,123,123,1999,16455,1885,18471,100,26294,1947,52,16285,170,1840,45,14,0,93,7,18232,239,1947,16285,69,170,2016,16455,11,15,0,126
Stone,11/23/20,23,137,137,444,5066,406,5517,15,12446,422,22,4806,260,387,19,23,0,12,3,5228,289,422,4806,29,260,451,5066,2,5,1,37
Union,11/23/20,56,139,139,1461,13856,1272,15358,133,39732,1249,212,12247,1609,1103,169,49,7,97,36,13496,1862,1249,12247,253,1609,1502,13856,11,9,0,78
VanBuren,11/23/20,3,141,141,335,7015,264,7373,68,16684,300,35,6335,680,248,16,3,0,49,19,6635,738,300,6335,58,680,358,7015,6,7,0,139
Washington,11/23/20,172,143,143,14675,122860,13119,137914,1383,228529,12554,2121,111303,11557,11372,1747,153,19,1029,354,123857,14057,12554,111303,2500,11557,15054,122860,107,170,2,1698
White,11/23/20,47,145,145,2849,27722,2181,30717,619,78804,2219,630,24196,3526,1768,413,42,5,407,212,26415,4302,2219,24196,776,3526,2995,27722,72,93,1,279
Woodruff,11/23/20,0,147,147,188,2910,167,3107,21,6660,162,26,2780,130,143,24,0,0,19,2,2942,165,162,2780,35,130,197,2910,2,2,0,32
Yell,11/23/20,33,149,149,1590,16503,1444,18101,113,21573,1524,66,16119,384,1395,49,30,3,99,14,17643,458,1524,16119,74,384,1598,16503,2,15,0,49
Arkansas_all_counties,11/22/20,2357,5630,5630,145173,1563399,125153,1711844,17646,2990671,128493,16680,1466454,96945,112602,12551,2161,196,13714,3932,1594947,116897,128493,1466454,19952,96945,148445,1563399,1352,1431,20,14696
Arkansas_county,11/22/20,20,1,1,916,11437,783,12405,113,18124,737,179,9014,2423,646,137,20,0,71,42,9751,2654,737,9014,231,2423,968,11437,16,5,0,116
Ashley,11/22/20,13,3,3,754,7765,642,8541,99,20537,685,69,7417,348,588,54,13,0,84,15,8102,439,685,7417,91,348,776,7765,25,6,0,97
Baxter,11/22/20,27,5,5,1267,9581,994,10865,246,41219,999,268,8760,821,784,210,27,0,188,58,9759,1106,999,8760,285,821,1284,9581,26,21,0,184
Benton,11/22/20,148,7,7,11125,104672,9917,116063,1059,258980,9558,1567,100188,4484,8695,1222,130,18,732,327,109746,6317,9558,100188,1833,4484,11391,104672,107,95,6,437
Boone,11/22/20,41,9,9,1576,17386,1255,19036,280,37288,1343,233,16844,542,1100,155,39,2,204,76,18187,849,1343,16844,307,542,1650,17386,20,23,0,103
Bradley,11/22/20,8,11,11,429,5511,379,5943,42,10948,390,39,4400,1111,363,16,7,1,20,22,4790,1153,390,4400,42,1111,432,5511,3,0,0,22
Calhoun,11/22/20,0,13,13,127,2217,96,2347,31,5202,112,15,2143,74,86,10,0,0,26,5,2255,92,112,2143,18,74,130,2217,0,3,0,14
Carroll,11/22/20,21,15,15,1301,10657,1112,11982,168,27887,1215,86,10513,144,1051,61,21,0,143,25,11728,254,1215,10513,110,144,1325,10657,18,5,0,51
Chicot,11/22/20,25,17,17,1134,7099,1062,8239,47,10826,1103,31,6532,567,1040,22,24,1,39,8,7635,604,1103,6532,37,567,1140,7099,7,5,0,58
Clark,11/22/20,10,19,19,748,12060,632,12838,106,22385,649,99,10601,1459,549,83,9,1,91,15,11250,1588,649,10601,129,1459,778,12060,6,10,0,63
Clay,11/22/20,19,21,21,775,8243,604,9044,151,15061,643,132,6666,1577,519,85,16,3,107,44,7309,1735,643,6666,158,1577,801,8243,14,8,1,45
Cleburne,11/22/20,20,23,23,650,11023,554,11687,76,25230,549,101,9755,1268,472,82,20,0,57,19,10304,1383,549,9755,115,1268,664,11023,6,9,0,116
Cleveland,11/22/20,14,25,25,334,4699,271,5043,49,8226,276,58,4528,171,233,38,13,1,30,19,4804,239,276,4528,68,171,344,4699,6,1,0,53
Columbia,11/22/20,24,27,27,988,9347,835,10400,129,23892,759,229,8009,1338,666,169,24,0,69,60,8768,1632,759,8009,294,1338,1053,9347,9,11,0,60
Conway,11/22/20,6,29,29,606,10431,438,11048,162,20906,542,64,9679,752,408,30,6,0,128,34,10221,827,542,9679,75,752,617,10431,7,10,0,186
Craighead,11/22/20,72,31,31,6552,60140,5711,66834,768,105701,5967,585,54986,5154,5242,469,65,7,659,109,60953,5881,5967,54986,727,5154,6694,60140,54,66,0,390
Crawford,11/22/20,35,33,33,2888,34385,2484,37291,368,62472,2633,255,33745,640,2282,202,33,2,317,51,36378,913,2633,33745,273,640,2906,34385,28,28,0,217
Crittenden,11/22/20,55,35,35,3091,20151,2765,23275,270,49013,2952,139,19594,557,2657,108,48,7,246,24,22546,729,2952,19594,172,557,3124,20151,15,16,0,128
Cross,11/22/20,26,37,37,773,7814,646,8597,101,16998,669,104,7467,347,565,81,24,2,80,21,8136,461,669,7467,114,347,783,7814,21,8,0,78
Dallas,11/22/20,6,39,39,265,3390,204,3657,55,7432,255,10,3277,113,197,7,6,0,52,3,3532,125,255,3277,12,113,267,3390,2,2,0,22
Desha,11/22/20,8,41,41,518,5906,458,6445,52,11887,473,45,5554,352,428,30,7,1,38,14,6027,418,473,5554,66,352,539,5906,5,-1,0,70
Drew,11/22/20,7,43,43,579,9246,490,9833,82,18502,494,85,8273,973,440,50,6,1,48,34,8767,1066,494,8273,93,973,587,9246,7,5,0,41
Faulkner,11/22/20,52,45,45,4417,60669,3879,65191,486,122416,3954,463,56322,4347,3529,350,46,6,379,107,60276,4915,3954,56322,568,4347,4522,60669,30,40,2,303
Franklin,11/22/20,10,47,47,718,10514,635,11254,73,17780,636,82,10214,300,565,70,10,0,61,12,10850,404,636,10214,104,300,740,10514,9,6,2,71
Fulton,11/22/20,12,49,49,500,3481,407,3998,81,12139,388,112,2865,616,322,85,10,2,56,25,3253,745,388,2865,129,616,517,3481,4,4,0,32
Garland,11/22/20,101,51,51,3492,47272,2943,50825,448,98296,3250,242,45497,1775,2769,174,96,5,385,63,48747,2078,3250,45497,303,1775,3553,47272,36,25,1,226
Grant,11/22/20,5,53,53,538,8287,422,8837,111,18086,459,79,7579,708,376,46,4,1,79,32,8038,799,459,7579,91,708,550,8287,4,5,0,48
Greene,11/22/20,26,55,55,2578,24644,2037,27284,515,44623,2122,456,22314,2330,1734,303,24,2,364,151,24436,2848,2122,22314,518,2330,2640,24644,50,36,0,154
Hempstead,11/22/20,6,57,57,806,8502,701,9328,99,22018,688,118,8145,357,598,103,6,0,84,15,8833,495,688,8145,138,357,826,8502,8,7,0,47
HotSpring,11/22/20,41,59,59,2769,22743,2435,25540,293,33520,2683,86,20937,1806,2382,53,39,2,262,31,23620,1920,2683,20937,114,1806,2797,22743,14,21,0,162
Howard,11/22/20,15,61,61,773,5226,701,6012,57,13389,641,132,4567,659,596,105,15,0,30,27,5208,804,641,4567,145,659,786,5226,5,2,0,39
Independence,11/22/20,71,63,63,1953,18413,1687,20419,195,37264,1516,437,17370,1043,1328,359,61,10,127,68,18886,1533,1516,17370,490,1043,2006,18413,11,88,0,82
Izard,11/22/20,5,65,65,945,7705,868,8667,72,13559,858,87,6736,969,800,68,5,0,53,19,7594,1073,858,6736,104,969,962,7705,3,3,0,94
Jackson,11/22/20,6,67,67,1518,12977,1085,14585,427,17225,1230,288,11642,1335,838,247,5,1,387,40,12872,1713,1230,11642,378,1335,1608,12977,21,28,0,45
Jefferson,11/22/20,107,69,69,4990,47776,4525,52917,356,70424,4627,363,46145,1631,4305,220,102,5,218,138,50772,2145,4627,46145,514,1631,5141,47776,18,24,0,159
Johnson,11/22/20,11,71,71,1209,12514,1112,13732,86,26291,1135,74,12077,437,1057,55,10,1,68,18,13212,520,1135,12077,83,437,1218,12514,11,7,0,70
Lafayette,11/22/20,3,73,73,252,1829,228,2095,21,6915,207,45,1729,100,188,40,3,0,16,5,1936,159,207,1729,59,100,266,1829,1,4,0,11
Lawrence,11/22/20,28,75,75,1090,7527,958,8649,104,16669,950,140,7140,387,840,118,28,0,82,22,8090,559,950,7140,172,387,1122,7527,10,7,0,49
Lee,11/22/20,18,77,77,1159,5958,1108,7122,33,9398,1147,12,5883,75,1097,11,17,1,33,0,7030,92,1147,5883,17,75,1164,5958,4,3,0,70
Lincoln,11/22/20,18,79,79,2389,10969,2336,13374,35,13695,2348,41,10599,370,2310,26,17,1,21,14,12947,427,2348,10599,57,370,2405,10969,2,0,0,13
LittleRiver,11/22/20,40,81,81,608,2981,498,3594,70,12417,513,95,2725,256,433,65,35,5,45,25,3238,356,513,2725,100,256,613,2981,3,5,0,11
Logan,11/22/20,6,83,83,845,12721,686,13581,153,21757,780,65,11498,1223,645,41,6,0,129,24,12278,1303,780,11498,80,1223,860,12721,15,11,0,92
Lonoke,11/22/20,45,85,85,2487,34244,2115,36865,327,72206,1970,517,29970,4274,1698,417,42,3,230,97,31940,4925,1970,29970,651,4274,2621,34244,25,35,1,273
Madison,11/22/20,7,87,87,566,6526,489,7107,70,16076,511,55,6171,355,446,43,7,0,58,12,6682,425,511,6171,70,355,581,6526,8,3,0,62
Marion,11/22/20,6,89,89,389,4814,259,5220,124,16438,321,68,4461,353,215,44,5,1,101,23,4782,438,321,4461,85,353,406,4814,12,6,0,72
Miller,11/22/20,22,91,91,2051,10727,1882,12841,147,43759,1562,489,10049,678,1459,423,16,6,87,60,11611,1230,1562,10049,552,678,2114,10727,17,7,0,96
MissingCountyInfo,11/22/20,0,5,5,2578,93280,1494,95870,1084,NA,2154,424,93235,45,1253,241,0,0,901,183,95389,481,2154,93235,436,45,2590,93280,-25,16,0,4355
Mississippi,11/22/20,79,93,93,2997,18491,2681,21511,236,42831,2782,215,16230,2261,2504,177,65,14,212,24,19012,2499,2782,16230,238,2261,3020,18491,19,29,0,103
Monroe,11/22/20,4,95,95,290,3736,253,4031,33,7249,266,24,3632,104,238,15,4,0,24,9,3898,133,266,3632,29,104,295,3736,4,3,0,36
Montgomery,11/22/20,10,97,97,245,3540,203,3786,32,8993,237,8,2893,647,198,5,9,1,30,2,3130,656,237,2893,9,647,246,3540,5,5,0,18
Nevada,11/22/20,14,99,99,425,6137,363,6567,48,8440,376,49,5956,181,327,36,13,1,36,12,6332,235,376,5956,54,181,430,6137,1,7,0,36
Newton,11/22/20,22,101,101,410,3279,342,3692,46,7848,364,46,2474,805,310,32,19,3,35,11,2838,854,364,2474,49,805,413,3279,9,5,0,21
Ouachita,11/22/20,11,103,103,608,8845,450,9479,146,24106,556,52,8501,344,421,29,11,0,123,23,9057,422,556,8501,78,344,634,8845,16,9,0,107
Perry,11/22/20,3,105,105,229,5963,187,6203,39,10322,207,22,5727,236,172,15,3,0,32,7,5934,269,207,5727,33,236,240,5963,5,2,0,93
Phillips,11/22/20,16,107,107,885,10234,804,11143,65,19034,849,36,9986,248,781,23,16,0,52,13,10835,308,849,9986,60,248,909,10234,4,1,0,52
Pike,11/22/20,1,109,109,350,3319,304,3673,45,10808,321,29,3088,231,285,19,0,1,36,9,3409,264,321,3088,33,231,354,3319,1,3,0,16
Poinsett,11/22/20,39,111,111,1584,14298,1363,15923,182,24054,1430,154,13799,499,1237,126,34,5,159,23,15229,694,1430,13799,195,499,1625,14298,10,12,0,100
Polk,11/22/20,8,113,113,699,7187,518,7904,173,20163,647,52,6910,277,478,40,8,0,161,12,7557,347,647,6910,70,277,717,7187,11,19,1,51
Pope,11/22/20,42,115,115,3481,36279,3041,39793,398,63644,3106,375,35018,1261,2776,265,38,4,292,106,38124,1669,3106,35018,408,1261,3514,36279,32,31,0,226
Prairie,11/22/20,6,117,117,338,3728,299,4083,33,8244,279,59,3325,403,247,52,6,0,26,7,3604,479,279,3325,76,403,355,3728,1,10,0,31
Pulaski,11/22/20,256,119,119,15585,209956,13478,225829,1849,393463,14444,1141,199855,10101,12602,876,241,15,1599,250,214299,11530,14444,199855,1429,10101,15873,209956,165,146,4,2082
Randolph,11/22/20,29,121,121,925,8955,768,9927,128,17603,742,183,8053,902,608,160,23,6,111,17,8795,1132,742,8053,230,902,972,8955,9,14,0,35
Saline,11/22/20,52,125,125,4309,51979,3600,56442,656,118009,3626,683,46488,5491,3117,483,49,3,459,197,50114,6328,3626,46488,837,5491,4463,51979,53,52,1,374
Scott,11/22/20,2,127,127,331,5555,280,5890,49,10442,264,67,5400,155,236,44,2,0,26,23,5664,226,264,5400,71,155,335,5555,4,1,0,11
Searcy,11/22/20,1,129,129,272,3735,241,4008,30,7923,229,43,3294,441,213,28,1,0,15,15,3523,485,229,3294,44,441,273,3735,2,4,0,20
Sebastian,11/22/20,121,131,131,6596,76209,5714,82851,759,127461,6028,568,74917,1292,5314,400,112,9,600,159,80945,1906,6028,74917,614,1292,6642,76209,41,101,0,356
Sevier,11/22/20,17,133,133,1648,8690,1545,10362,86,17193,1365,283,7859,831,1314,231,17,0,34,52,9224,1138,1365,7859,307,831,1672,8690,7,10,0,45
Sharp,11/22/20,14,135,135,622,7663,475,8324,133,17043,495,127,7061,602,381,94,13,1,101,32,7556,768,495,7061,166,602,661,7663,5,14,0,44
St.Francis,11/22/20,14,123,123,1988,16340,1870,18345,104,26294,1937,51,16177,163,1829,41,14,0,94,10,18114,231,1937,16177,68,163,2005,16340,20,12,1,114
Stone,11/22/20,22,137,137,442,5031,401,5479,19,12446,420,22,4774,257,383,18,22,0,15,4,5194,285,420,4774,28,257,448,5031,2,0,0,46
Union,11/22/20,56,139,139,1450,13789,1263,15278,131,39732,1241,209,12199,1590,1098,165,49,7,94,37,13440,1838,1241,12199,248,1590,1489,13789,14,7,0,56
VanBuren,11/22/20,3,141,141,329,6882,257,7233,69,16684,293,36,6210,672,242,15,3,0,48,21,6503,730,293,6210,58,672,351,6882,9,6,0,85
Washington,11/22/20,170,143,143,14568,121269,12949,136211,1448,228529,12484,2084,109918,11351,11273,1676,151,19,1060,388,122402,13809,12484,109918,2458,11351,14942,121269,162,130,0,1109
White,11/22/20,46,145,145,2777,27515,2088,30430,641,78804,2169,608,24067,3448,1698,390,41,5,428,213,26236,4194,2169,24067,746,3448,2915,27515,25,51,0,92
Woodruff,11/22/20,0,147,147,186,2880,165,3075,21,6660,160,26,2752,128,141,24,0,0,19,2,2912,163,160,2752,35,128,195,2880,4,2,0,38
Yell,11/22/20,33,149,149,1588,16456,1429,18052,126,21573,1523,65,16076,380,1385,44,30,3,108,18,17599,453,1523,16076,73,380,1596,16456,14,16,0,112
Arkansas_all_counties,11/21/20,2337,5630,5630,143821,1550055,123722,1697010,17745,2990671,127216,16605,1453725,96330,111525,12197,2141,196,13534,4211,1580941,116069,127216,1453725,19739,96330,146955,1550055,1905,1503,16,18184
Arkansas_county,11/21/20,20,1,1,900,11337,778,12288,102,18124,723,177,8945,2392,642,136,20,0,61,41,9668,2620,723,8945,228,2392,951,11337,6,4,0,42
Ashley,11/21/20,13,3,3,729,7693,636,8442,80,20537,660,69,7345,348,583,53,13,0,64,16,8005,437,660,7345,89,348,749,7693,5,7,0,97
Baxter,11/21/20,27,5,5,1241,9423,973,10680,241,41219,976,265,8607,816,770,203,27,0,179,62,9583,1097,976,8607,281,816,1257,9423,25,19,1,162
Benton,11/21/20,142,7,7,11018,104342,9822,115612,1053,258980,9455,1563,99896,4446,8638,1184,124,18,692,361,109351,6261,9455,99896,1815,4446,11270,104342,112,136,1,743
Boone,11/21/20,41,9,9,1556,17303,1232,18932,283,37288,1327,229,16762,541,1084,148,39,2,204,79,18089,843,1327,16762,302,541,1629,17303,34,26,0,233
Bradley,11/21/20,8,11,11,426,5492,379,5920,39,10948,387,39,4381,1111,363,16,7,1,17,22,4768,1152,387,4381,41,1111,428,5492,6,2,0,61
Calhoun,11/21/20,0,13,13,127,2203,93,2333,34,5202,112,15,2130,73,83,10,0,0,29,5,2242,91,112,2130,18,73,130,2203,2,0,0,12
Carroll,11/21/20,21,15,15,1283,10624,1107,11930,155,27887,1198,85,10480,144,1048,59,21,0,129,26,11678,252,1198,10480,108,144,1306,10624,24,11,0,63
Chicot,11/21/20,25,17,17,1127,7048,1057,8181,45,10826,1096,31,6482,566,1036,21,24,1,36,9,7578,603,1096,6482,37,566,1133,7048,8,5,0,91
Clark,11/21/20,10,19,19,742,12003,622,12774,110,22385,642,100,10549,1454,541,81,9,1,92,18,11191,1583,642,10549,129,1454,771,12003,8,9,1,90
Clay,11/21/20,18,21,21,761,8212,596,8999,146,15061,631,130,6637,1575,512,84,15,3,103,43,7268,1731,631,6637,156,1575,787,8212,6,8,0,86
Cleburne,11/21/20,20,23,23,644,10913,545,11570,79,25230,542,102,9672,1241,465,80,20,0,57,22,10214,1356,542,9672,115,1241,657,10913,9,4,0,138
Cleveland,11/21/20,14,25,25,328,4652,270,4990,44,8226,272,56,4481,171,232,38,13,1,27,17,4753,237,272,4481,66,171,338,4652,4,0,0,89
Columbia,11/21/20,24,27,27,979,9296,824,10337,131,23892,749,230,7964,1332,662,162,24,0,63,68,8713,1624,749,7964,292,1332,1041,9296,27,12,0,97
Conway,11/21/20,6,29,29,599,10252,428,10862,165,20906,535,64,9507,745,398,30,6,0,131,34,10042,820,535,9507,75,745,610,10252,17,11,0,133
Craighead,11/21/20,72,31,31,6498,59804,5645,66440,780,105701,5916,582,54660,5144,5184,461,65,7,666,114,60576,5864,5916,54660,720,5144,6636,59804,75,64,1,674
Crawford,11/21/20,35,33,33,2860,34196,2456,37073,368,62472,2607,253,33564,632,2258,198,33,2,315,53,36171,902,2607,33564,270,632,2877,34196,42,36,0,248
Crittenden,11/21/20,55,35,35,3076,20038,2749,23147,271,49013,2937,139,19484,554,2641,108,48,7,247,24,22421,726,2937,19484,172,554,3109,20038,33,17,0,132
Cross,11/21/20,26,37,37,752,7757,638,8515,88,16998,648,104,7416,341,562,76,24,2,62,26,8064,451,648,7416,110,341,758,7757,12,8,1,52
Dallas,11/21/20,6,39,39,263,3370,202,3635,55,7432,253,10,3258,112,195,7,6,0,52,3,3511,124,253,3258,12,112,265,3370,8,2,0,26
Desha,11/21/20,8,41,41,513,5841,459,6376,46,11887,468,45,5492,349,429,30,7,1,32,14,5960,416,468,5492,67,349,535,5841,8,0,0,38
Drew,11/21/20,7,43,43,572,9212,485,9792,80,18502,488,84,8239,973,436,49,6,1,46,34,8727,1065,488,8239,92,973,580,9212,14,6,0,92
Faulkner,11/21/20,50,45,45,4387,60396,3839,64885,498,122416,3925,462,56049,4347,3497,342,44,6,384,114,59974,4911,3925,56049,564,4347,4489,60396,45,45,0,685
Franklin,11/21/20,8,47,47,709,10452,629,11182,72,17780,627,82,10155,297,562,67,8,0,57,15,10782,400,627,10155,103,297,730,10452,11,6,0,69
Fulton,11/21/20,12,49,49,496,3453,403,3965,81,12139,385,111,2837,616,319,84,10,2,56,25,3222,743,385,2837,127,616,512,3453,8,4,0,31
Garland,11/21/20,100,51,51,3456,47082,2918,50598,438,98296,3215,241,45331,1751,2747,171,95,5,373,65,48546,2052,3215,45331,301,1751,3516,47082,40,41,1,251
Grant,11/21/20,5,53,53,534,8243,417,8789,112,18086,456,78,7536,707,374,43,4,1,78,34,7992,797,456,7536,90,707,546,8243,15,4,0,86
Greene,11/21/20,26,55,55,2528,24540,2001,27125,501,44623,2080,448,22220,2320,1714,287,24,2,342,159,24300,2825,2080,22220,505,2320,2585,24540,46,33,0,223
Hempstead,11/21/20,6,57,57,798,8463,694,9281,98,22018,680,118,8115,348,592,102,6,0,82,16,8795,486,680,8115,138,348,818,8463,8,10,0,141
HotSpring,11/21/20,41,59,59,2755,22595,2414,25376,300,33520,2669,86,20795,1800,2363,51,39,2,267,33,23464,1912,2669,20795,112,1800,2781,22595,26,35,0,407
Howard,11/21/20,15,61,61,768,5192,699,5972,54,13389,638,130,4548,644,596,103,15,0,27,27,5186,786,638,4548,142,644,780,5192,9,6,0,30
Independence,11/21/20,71,63,63,1942,18342,1599,20334,272,37264,1506,436,17313,1029,1255,344,61,10,190,82,18819,1515,1506,17313,486,1029,1992,18342,19,17,0,67
Izard,11/21/20,5,65,65,942,7614,865,8573,72,13559,855,87,6646,968,798,67,5,0,52,20,7501,1072,855,6646,104,968,959,7614,2,43,0,29
Jackson,11/21/20,6,67,67,1497,12953,1057,14539,434,17225,1213,284,11618,1335,814,243,5,1,394,40,12831,1708,1213,11618,373,1335,1586,12953,18,36,0,319
Jefferson,11/21/20,107,69,69,4972,47635,4501,52758,362,70424,4615,357,46021,1614,4291,210,102,5,220,142,50636,2122,4615,46021,508,1614,5123,47635,43,37,0,551
Johnson,11/21/20,11,71,71,1198,12455,1105,13662,82,26291,1125,73,12017,438,1051,54,10,1,64,18,13142,520,1125,12017,82,438,1207,12455,7,2,0,149
Lafayette,11/21/20,3,73,73,251,1819,224,2084,24,6915,206,45,1719,100,185,39,3,0,18,6,1925,159,206,1719,59,100,265,1819,3,0,0,25
Lawrence,11/21/20,28,75,75,1080,7488,951,8596,101,16669,938,142,7101,387,834,117,28,0,76,25,8039,557,938,7101,170,387,1108,7488,10,11,0,55
Lee,11/21/20,18,77,77,1155,5892,1105,7052,32,9398,1144,11,5825,67,1095,10,17,1,32,0,6969,83,1144,5825,16,67,1160,5892,7,3,0,36
Lincoln,11/21/20,18,79,79,2387,10958,2336,13361,33,13695,2347,40,10588,370,2310,26,17,1,20,13,12935,426,2347,10588,56,370,2403,10958,5,1,0,20
LittleRiver,11/21/20,40,81,81,605,2973,493,3583,72,12417,510,95,2718,255,429,64,35,5,46,26,3228,355,510,2718,100,255,610,2973,4,2,1,31
Logan,11/21/20,6,83,83,830,12644,675,13488,149,21757,764,66,11422,1222,636,39,6,0,122,27,12186,1302,764,11422,80,1222,844,12644,8,10,0,114
Lonoke,11/21/20,44,85,85,2462,33996,2080,36589,338,72206,1947,515,29741,4255,1677,403,41,3,229,109,31688,4901,1947,29741,646,4255,2593,33996,39,30,0,403
Madison,11/21/20,7,87,87,558,6472,486,7045,65,16076,503,55,6117,355,443,43,7,0,53,12,6620,425,503,6117,70,355,573,6472,12,10,1,86
Marion,11/21/20,6,89,89,377,4754,253,5146,118,16438,308,69,4401,353,209,44,5,1,94,24,4709,437,308,4401,84,353,392,4754,12,8,1,104
Miller,11/21/20,22,91,91,2034,10648,1875,12743,137,43759,1550,484,9970,678,1453,422,16,6,81,56,11520,1223,1550,9970,545,678,2095,10648,17,21,0,177
MissingCountyInfo,11/21/20,0,5,5,2603,88900,1478,91519,1125,NA,2165,438,88855,45,1244,234,0,0,921,204,91020,499,2165,88855,454,45,2619,88900,199,1,0,3836
Mississippi,11/21/20,79,93,93,2978,18407,2652,21405,246,42831,2764,214,16147,2260,2480,172,65,14,218,28,18911,2494,2764,16147,234,2260,2998,18407,18,29,0,171
Monroe,11/21/20,4,95,95,286,3704,250,3995,32,7249,263,23,3601,103,235,15,4,0,24,8,3864,131,263,3601,28,103,291,3704,3,2,0,35
Montgomery,11/21/20,10,97,97,240,3527,198,3768,32,8993,232,8,2881,646,193,5,9,1,30,2,3113,655,232,2881,9,646,241,3527,5,3,0,21
Nevada,11/21/20,14,99,99,424,6102,356,6530,54,8440,374,50,5924,178,322,34,13,1,39,15,6298,232,374,5924,54,178,428,6102,8,5,0,46
Newton,11/21/20,22,101,101,401,3267,337,3670,42,7848,355,46,2462,805,306,31,19,3,30,12,2817,853,355,2462,48,805,403,3267,4,4,0,22
Ouachita,11/21/20,11,103,103,592,8754,441,9372,139,24106,543,49,8411,343,413,28,11,0,118,21,8954,418,543,8411,75,343,618,8754,13,6,0,79
Perry,11/21/20,3,105,105,224,5875,185,6110,36,10322,204,20,5636,239,171,14,3,0,30,6,5840,270,204,5636,31,239,235,5875,2,7,0,61
Phillips,11/21/20,16,107,107,881,10186,803,11091,62,19034,845,36,9942,244,780,23,16,0,49,13,10787,304,845,9942,60,244,905,10186,7,5,0,49
Pike,11/21/20,1,109,109,349,3304,301,3657,47,10808,320,29,3073,231,283,18,0,1,37,10,3393,264,320,3073,33,231,353,3304,5,8,0,23
Poinsett,11/21/20,39,111,111,1574,14208,1351,15823,184,24054,1420,154,13709,499,1227,124,34,5,159,25,15129,694,1420,13709,195,499,1615,14208,17,25,1,104
Polk,11/21/20,7,113,113,688,7147,499,7853,182,20163,636,52,6873,274,459,40,7,0,170,12,7509,344,636,6873,70,274,706,7147,15,18,0,77
Pope,11/21/20,42,115,115,3449,36085,3010,39567,397,63644,3077,372,34830,1255,2752,258,38,4,287,110,37907,1660,3077,34830,405,1255,3482,36085,36,22,1,400
Prairie,11/21/20,6,117,117,337,3698,289,4052,42,8244,278,59,3295,403,241,48,6,0,31,11,3573,479,278,3295,76,403,354,3698,2,8,0,25
Pulaski,11/21/20,252,119,119,15420,208039,13332,223735,1834,393463,14282,1138,198006,10033,12482,850,237,15,1561,273,212288,11447,14282,198006,1414,10033,15696,208039,165,153,1,1736
Randolph,11/21/20,29,121,121,916,8929,754,9891,133,17603,734,182,8027,902,595,159,23,6,116,17,8761,1130,734,8027,228,902,962,8929,9,3,1,55
Saline,11/21/20,51,125,125,4256,51658,3548,56060,656,118009,3579,677,46175,5483,3090,458,48,3,440,216,49754,6306,3579,46175,823,5483,4402,51658,86,76,0,698
Scott,11/21/20,2,127,127,327,5548,279,5879,46,10442,262,65,5394,154,236,43,2,0,24,22,5656,223,262,5394,69,154,331,5548,4,0,0,33
Searcy,11/21/20,1,129,129,270,3717,237,3988,32,7923,227,43,3278,439,212,25,1,0,14,18,3505,483,227,3278,44,439,271,3717,2,6,0,43
Sebastian,11/21/20,121,131,131,6555,75894,5613,82495,819,127461,5992,563,74616,1278,5228,385,112,9,650,169,80608,1887,5992,74616,609,1278,6601,75894,88,86,2,641
Sevier,11/21/20,17,133,133,1641,8652,1535,10314,89,17193,1359,282,7834,818,1308,227,17,0,34,55,9193,1121,1359,7834,303,818,1662,8652,11,12,1,77
Sharp,11/21/20,14,135,135,617,7624,461,8280,142,17043,490,127,7027,597,370,91,13,1,107,35,7517,763,490,7027,166,597,656,7624,13,11,0,81
St.Francis,11/21/20,13,123,123,1968,16246,1858,18229,97,26294,1921,47,16085,161,1820,38,13,0,88,9,18006,223,1921,16085,62,161,1983,16246,9,5,0,60
Stone,11/21/20,22,137,137,440,4987,401,5433,17,12446,418,22,4734,253,383,18,22,0,13,4,5152,281,418,4734,28,253,446,4987,1,2,0,20
Union,11/21/20,56,139,139,1436,13747,1256,15220,124,39732,1228,208,12163,1584,1093,163,49,7,86,38,13391,1829,1228,12163,245,1584,1473,13747,16,7,0,75
VanBuren,11/21/20,3,141,141,320,6806,251,7146,66,16684,284,36,6137,669,235,16,3,0,46,20,6421,725,284,6137,56,669,340,6806,13,2,0,142
Washington,11/21/20,170,143,143,14406,120322,12819,135073,1416,228529,12327,2079,109145,11177,11190,1629,151,19,986,430,121472,13601,12327,109145,2424,11177,14751,120322,154,136,0,1716
White,11/21/20,46,145,145,2752,27448,2037,30325,667,78804,2143,609,24013,3435,1659,378,41,5,441,226,26156,4169,2143,24013,734,3435,2877,27448,89,42,0,247
Woodruff,11/21/20,0,147,147,182,2846,163,3036,19,6660,156,26,2718,128,139,24,0,0,17,2,2874,162,156,2718,34,128,190,2846,1,3,0,15
Yell,11/21/20,33,149,149,1574,16358,1413,17940,128,21573,1510,64,15980,378,1373,40,30,3,107,21,17490,450,1510,15980,72,378,1582,16358,11,14,0,108
Arkansas_all_counties,11/20/20,2321,5630,5630,141916,1533776,122219,1678657,17360,2990671,125783,16133,1440090,93686,110379,11840,2125,196,13264,4096,1565873,112784,125783,1440090,19098,93686,144881,1533776,2061,1674,24,18758
Arkansas_county,11/20/20,20,1,1,894,11301,774,12246,100,18124,718,176,8919,2382,642,132,20,0,56,44,9637,2609,718,8919,227,2382,945,11301,13,8,0,126
Ashley,11/20/20,13,3,3,724,7601,629,8345,82,20537,657,67,7261,340,579,50,13,0,65,17,7918,427,657,7261,87,340,744,7601,11,12,0,51
Baxter,11/20/20,26,5,5,1216,9286,954,10517,236,41219,957,259,8489,797,756,198,26,0,175,61,9446,1071,957,8489,274,797,1231,9286,34,29,1,359
Benton,11/20/20,141,7,7,10906,103711,9686,114857,1078,258980,9375,1531,99348,4363,8553,1133,123,18,698,380,108723,6134,9375,99348,1771,4363,11146,103711,159,223,1,871
Boone,11/20/20,41,9,9,1522,17104,1206,18699,275,37288,1303,219,16574,530,1061,145,39,2,203,72,17877,822,1303,16574,292,530,1595,17104,33,23,0,147
Bradley,11/20/20,8,11,11,420,5437,377,5859,35,10948,386,34,4351,1086,362,15,7,1,17,18,4737,1122,386,4351,36,1086,422,5437,5,2,0,45
Calhoun,11/20/20,0,13,13,125,2193,93,2320,32,5202,111,14,2121,72,83,10,0,0,28,4,2232,88,111,2121,16,72,127,2193,8,4,0,24
Carroll,11/20/20,21,15,15,1259,10585,1096,11861,142,27887,1176,83,10444,141,1038,58,21,0,117,25,11620,241,1176,10444,100,141,1276,10585,36,6,0,101
Chicot,11/20/20,25,17,17,1119,6965,1052,8089,42,10826,1088,31,6404,561,1031,21,24,1,33,9,7492,597,1088,6404,36,561,1124,6965,8,4,1,195
Clark,11/20/20,9,19,19,734,11921,613,12683,112,22385,634,100,10480,1441,533,80,8,1,93,19,11114,1569,634,10480,128,1441,762,11921,18,8,1,187
Clay,11/20/20,18,21,21,755,8132,588,8912,148,15061,625,130,6597,1535,506,82,15,3,103,45,7222,1690,625,6597,155,1535,780,8132,13,21,0,51
Cleburne,11/20/20,20,23,23,635,10784,541,11430,74,25230,534,101,9565,1219,462,79,20,0,52,22,10099,1331,534,9565,112,1219,646,10784,11,7,0,130
Cleveland,11/20/20,14,25,25,324,4567,270,4901,40,8226,271,53,4398,169,232,38,13,1,26,14,4669,232,271,4398,63,169,334,4567,2,1,0,23
Columbia,11/20/20,24,27,27,952,9226,812,10238,116,23892,746,206,7937,1289,656,156,24,0,66,50,8683,1555,746,7937,266,1289,1012,9226,23,7,1,359
Conway,11/20/20,6,29,29,582,10136,417,10727,159,20906,518,64,9393,743,388,29,6,0,124,35,9911,816,518,9393,73,743,591,10136,28,13,0,147
Craighead,11/20/20,71,31,31,6423,59205,5581,65765,770,105701,5844,579,54196,5009,5132,449,64,7,647,123,60040,5725,5844,54196,716,5009,6560,59205,104,90,1,533
Crawford,11/20/20,35,33,33,2818,33990,2420,36824,362,62472,2568,250,33366,624,2230,190,33,2,304,58,35934,890,2568,33366,266,624,2834,33990,33,39,0,247
Crittenden,11/20/20,55,35,35,3043,19939,2732,23012,255,49013,2911,132,19410,529,2626,106,48,7,236,19,22321,691,2911,19410,162,529,3073,19939,32,23,0,241
Cross,11/20/20,25,37,37,740,7717,630,8463,85,16998,639,101,7377,340,558,72,23,2,58,27,8016,447,639,7377,107,340,746,7717,16,8,0,80
Dallas,11/20/20,6,39,39,255,3352,200,3609,49,7432,245,10,3239,113,193,7,6,0,46,3,3484,125,245,3239,12,113,257,3352,1,4,0,57
Desha,11/20/20,8,41,41,505,5811,459,6336,38,11887,464,41,5467,344,429,30,7,1,28,10,5931,405,464,5467,61,344,525,5811,2,2,0,59
Drew,11/20/20,7,43,43,558,9134,479,9700,72,18502,483,75,8172,962,435,44,6,1,42,30,8655,1045,483,8172,83,962,566,9134,13,5,0,173
Faulkner,11/20/20,50,45,45,4342,59756,3794,64195,498,122416,3886,456,55454,4302,3460,334,44,6,382,116,59340,4855,3886,55454,553,4302,4439,59756,50,28,1,545
Franklin,11/20/20,8,47,47,698,10394,623,11113,67,17780,617,81,10100,294,556,67,8,0,53,14,10717,396,617,10100,102,294,719,10394,8,8,1,118
Fulton,11/20/20,12,49,49,488,3430,399,3934,77,12139,381,107,2814,616,316,83,10,2,55,22,3195,739,381,2814,123,616,504,3430,15,9,0,53
Garland,11/20/20,99,51,51,3416,46871,2877,50339,440,98296,3188,228,45157,1714,2710,167,94,5,384,56,48345,1994,3188,45157,280,1714,3468,46871,66,43,0,317
Grant,11/20/20,5,53,53,519,8172,413,8703,101,18086,445,74,7493,679,372,41,4,1,69,32,7938,765,445,7493,86,679,531,8172,17,4,0,86
Greene,11/20/20,26,55,55,2482,24363,1968,26901,488,44623,2050,432,22079,2284,1686,282,24,2,340,148,24129,2772,2050,22079,488,2284,2538,24363,81,41,0,216
Hempstead,11/20/20,6,57,57,790,8330,684,9140,100,22018,677,113,7986,344,582,102,6,0,89,11,8663,477,677,7986,133,344,810,8330,31,8,0,95
HotSpring,11/20/20,41,59,59,2729,22214,2379,24966,309,33520,2650,79,20621,1593,2330,49,39,2,281,28,23271,1695,2650,20621,102,1593,2752,22214,40,15,0,397
Howard,11/20/20,15,61,61,759,5171,693,5942,51,13389,632,127,4531,640,594,99,15,0,23,28,5163,779,632,4531,139,640,771,5171,12,11,0,55
Independence,11/20/20,71,63,63,1923,18294,1582,20266,270,37264,1497,426,17287,1007,1247,335,61,10,189,81,18784,1482,1497,17287,475,1007,1972,18294,9,17,2,123
Izard,11/20/20,5,65,65,940,7587,822,8543,113,13559,853,87,6622,965,759,63,5,0,89,24,7475,1068,853,6622,103,965,956,7587,7,10,1,82
Jackson,11/20/20,6,67,67,1479,12652,1021,14217,452,17225,1199,280,11547,1105,782,239,5,1,412,40,12746,1471,1199,11547,366,1105,1565,12652,15,11,0,168
Jefferson,11/20/20,107,69,69,4929,47127,4464,52204,356,70424,4587,342,45612,1515,4268,196,102,5,215,141,50199,2005,4587,45612,490,1515,5077,47127,35,74,1,689
Johnson,11/20/20,11,71,71,1191,12313,1103,13513,77,26291,1120,71,11884,429,1049,54,10,1,61,16,13004,509,1120,11884,80,429,1200,12313,11,13,0,134
Lafayette,11/20/20,3,73,73,248,1797,224,2058,21,6915,204,44,1700,97,185,39,3,0,16,5,1904,154,204,1700,57,97,261,1797,2,2,0,26
Lawrence,11/20/20,28,75,75,1070,7443,940,8541,102,16669,934,136,7063,380,823,117,28,0,83,19,7997,544,934,7063,164,380,1098,7443,16,13,1,87
Lee,11/20/20,18,77,77,1148,5863,1102,7016,28,9398,1137,11,5796,67,1094,8,17,1,26,2,6933,83,1137,5796,16,67,1153,5863,1,3,0,77
Lincoln,11/20/20,18,79,79,2382,10943,2335,13341,29,13695,2344,38,10573,370,2309,26,17,1,18,11,12917,424,2344,10573,54,370,2398,10943,3,-1,0,83
LittleRiver,11/20/20,39,81,81,601,2946,491,3551,71,12417,508,93,2701,245,428,63,34,5,46,25,3209,342,508,2701,97,245,605,2946,13,5,0,34
Logan,11/20/20,6,83,83,822,12538,665,13374,151,21757,758,64,11324,1214,629,36,6,0,123,28,12082,1292,758,11324,78,1214,836,12538,6,12,0,369
Lonoke,11/20/20,44,85,85,2423,33632,2050,36181,329,72206,1916,507,29396,4236,1653,397,41,3,222,107,31312,4869,1916,29396,633,4236,2549,33632,34,30,1,240
Madison,11/20/20,6,87,87,546,6398,476,6959,64,16076,495,51,6070,328,439,37,6,0,50,14,6565,394,495,6070,66,328,561,6398,3,8,0,45
Marion,11/20/20,5,89,89,365,4662,245,5040,115,16438,298,67,4314,348,205,40,4,1,89,26,4612,428,298,4314,80,348,378,4662,14,13,0,74
Miller,11/20/20,22,91,91,2017,10488,1854,12563,141,43759,1542,475,9815,673,1438,416,16,6,88,53,11357,1206,1542,9815,533,673,2075,10488,30,24,0,123
MissingCountyInfo,11/20/20,0,5,5,2404,85263,1477,87678,927,NA,2002,402,85223,40,1244,233,0,0,758,169,87225,453,2002,85223,413,40,2415,85263,21,0,0,1429
Mississippi,11/20/20,79,93,93,2960,18254,2623,21236,257,42831,2749,211,16072,2182,2455,168,65,14,228,29,18821,2415,2749,16072,233,2182,2982,18254,26,36,0,937
Monroe,11/20/20,4,95,95,283,3672,248,3960,31,7249,261,22,3571,101,233,15,4,0,24,7,3832,128,261,3571,27,101,288,3672,6,3,0,34
Montgomery,11/20/20,10,97,97,235,3511,195,3747,30,8993,227,8,2867,644,190,5,9,1,28,2,3094,653,227,2867,9,644,236,3511,4,2,0,118
Nevada,11/20/20,14,99,99,416,6064,351,6484,51,8440,370,46,5890,174,317,34,13,1,40,11,6260,224,370,5890,50,174,420,6064,8,1,0,48
Newton,11/20/20,22,101,101,397,3249,333,3648,42,7848,352,45,2445,804,302,31,19,3,31,11,2797,851,352,2445,47,804,399,3249,3,1,0,23
Ouachita,11/20/20,11,103,103,579,8688,435,9292,132,24106,533,46,8353,335,410,25,11,0,111,21,8886,406,533,8353,71,335,604,8688,17,5,0,100
Perry,11/20/20,3,105,105,222,5816,178,6049,41,10322,201,21,5582,234,165,13,3,0,33,8,5783,266,201,5582,32,234,233,5816,5,2,0,54
Phillips,11/20/20,16,107,107,874,10144,798,11041,60,19034,838,36,9902,242,775,23,16,0,47,13,10740,301,838,9902,59,242,897,10144,11,2,0,210
Pike,11/20/20,1,109,109,344,3286,293,3634,50,10808,316,28,3061,225,278,15,0,1,38,12,3377,257,316,3061,32,225,348,3286,8,0,0,20
Poinsett,11/20/20,38,111,111,1557,14121,1326,15719,193,24054,1407,150,13630,491,1207,119,33,5,167,26,15037,682,1407,13630,191,491,1598,14121,5,17,0,77
Polk,11/20/20,7,113,113,673,7085,481,7776,185,20163,624,49,6813,272,445,36,7,0,172,13,7437,339,624,6813,67,272,691,7085,31,22,0,153
Pope,11/20/20,41,115,115,3413,35721,2988,39164,384,63644,3043,370,34477,1244,2738,250,37,4,268,116,37520,1644,3043,34477,400,1244,3443,35721,39,26,1,379
Prairie,11/20/20,6,117,117,335,3675,281,4026,48,8244,276,59,3274,401,236,45,6,0,34,14,3550,476,276,3274,75,401,351,3675,5,6,0,27
Pulaski,11/20/20,251,119,119,15255,206468,13179,221993,1823,393463,14140,1115,196691,9777,12362,817,236,15,1540,283,210831,11162,14140,196691,1385,9777,15525,206468,206,132,4,1893
Randolph,11/20/20,28,121,121,907,8883,751,9834,128,17603,725,182,7995,888,593,158,22,6,110,18,8720,1114,725,7995,226,888,951,8883,15,7,0,215
Saline,11/20/20,51,125,125,4170,51046,3472,55348,646,118009,3517,653,45850,5196,3026,446,48,3,442,204,49367,5981,3517,45850,785,5196,4302,51046,76,67,2,930
Scott,11/20/20,2,127,127,323,5519,279,5846,42,10442,261,62,5374,145,236,43,2,0,23,19,5635,211,261,5374,66,145,327,5519,7,5,0,46
Searcy,11/20/20,1,129,129,268,3676,231,3944,36,7923,227,41,3265,411,208,23,1,0,18,18,3492,452,227,3265,41,411,268,3676,3,3,0,31
Sebastian,11/20/20,119,131,131,6467,75341,5527,81850,819,127461,5923,544,74081,1260,5154,373,110,9,657,162,80004,1846,5923,74081,586,1260,6509,75341,81,90,0,648
Sevier,11/20/20,16,133,133,1630,8586,1523,10237,91,17193,1354,276,7783,803,1304,219,16,0,34,57,9137,1100,1354,7783,297,803,1651,8586,10,12,0,54
Sharp,11/20/20,14,135,135,604,7556,450,8187,140,17043,484,120,6991,565,360,90,13,1,111,29,7475,712,484,6991,147,565,631,7556,26,18,0,139
St.Francis,11/20/20,13,123,123,1959,16195,1853,18167,93,26294,1913,46,16039,156,1815,38,13,0,85,8,17952,215,1913,16039,59,156,1972,16195,10,15,0,88
Stone,11/20/20,22,137,137,439,4968,399,5413,18,12446,418,21,4720,248,383,16,22,0,13,5,5138,275,418,4720,27,248,445,4968,4,2,0,32
Union,11/20/20,56,139,139,1420,13688,1249,15141,115,39732,1219,201,12117,1571,1088,161,49,7,82,33,13336,1805,1219,12117,234,1571,1453,13688,27,10,0,297
VanBuren,11/20/20,3,141,141,307,6677,249,7001,55,16684,273,34,6046,631,234,15,3,0,36,19,6319,682,273,6046,51,631,324,6677,11,3,0,95
Washington,11/20/20,170,143,143,14252,118760,12683,133333,1398,228529,12225,2027,108064,10696,11096,1587,151,19,978,420,120289,13044,12225,108064,2348,10696,14573,118760,169,163,2,1425
White,11/20/20,46,145,145,2663,27290,1995,30065,621,78804,2080,583,23867,3423,1624,371,41,5,414,207,25947,4118,2080,23867,695,3423,2775,27290,85,67,1,603
Woodruff,11/20/20,0,147,147,181,2832,160,3020,21,6660,155,26,2705,127,137,23,0,0,18,3,2860,160,155,2705,33,127,188,2832,2,1,0,52
Yell,11/20/20,33,149,149,1563,16261,1399,17831,131,21573,1499,64,15895,366,1365,34,30,3,104,27,17394,437,1499,15895,71,366,1570,16261,18,16,0,159
Arkansas_all_counties,11/19/20,2297,5630,5630,139855,1517079,120545,1659681,16998,2990671,124165,15690,1428285,88794,109135,11410,2105,192,12911,4087,1552450,107231,124165,1428285,18437,88794,142602,1517079,2238,1794,22,18021
Arkansas_county,11/19/20,20,1,1,881,11188,766,12120,95,18124,711,170,8823,2365,636,130,20,0,55,40,9534,2586,711,8823,221,2365,932,11188,15,10,0,124
Ashley,11/19/20,13,3,3,713,7561,617,8293,83,20537,647,66,7228,333,571,46,13,0,63,20,7875,418,647,7228,85,333,732,7561,11,12,0,86
Baxter,11/19/20,25,5,5,1182,8961,925,10156,232,41219,928,254,8170,791,737,188,25,0,166,66,9098,1058,928,8170,267,791,1195,8961,39,28,1,318
Benton,11/19/20,140,7,7,10747,102999,9463,113966,1143,258980,9246,1501,98789,4210,8383,1080,122,18,740,403,108035,5931,9246,98789,1721,4210,10967,102999,129,190,2,884
Boone,11/19/20,41,9,9,1489,16990,1183,18548,265,37288,1282,207,16466,524,1041,142,39,2,202,63,17748,800,1282,16466,276,524,1558,16990,47,35,0,206
Bradley,11/19/20,8,11,11,415,5397,375,5814,32,10948,385,30,4324,1073,361,14,7,1,17,15,4709,1105,385,4324,32,1073,417,5397,6,2,0,45
Calhoun,11/19/20,0,13,13,117,2177,89,2296,28,5202,105,12,2110,67,80,9,0,0,25,3,2215,81,105,2110,14,67,119,2177,4,7,0,21
Carroll,11/19/20,21,15,15,1223,10520,1090,11758,112,27887,1137,86,10381,139,1034,56,21,0,82,30,11518,240,1137,10381,101,139,1238,10520,18,16,0,62
Chicot,11/19/20,24,17,17,1111,6778,1048,7894,39,10826,1081,30,6372,406,1026,22,23,1,32,7,7453,441,1081,6372,35,406,1116,6778,3,4,0,99
Clark,11/19/20,8,19,19,716,11752,605,12495,103,22385,615,101,10354,1398,527,78,8,0,80,23,10969,1526,615,10354,128,1398,743,11752,11,13,0,225
Clay,11/19/20,18,21,21,742,8094,567,8859,156,15061,618,124,6572,1522,496,71,15,3,106,50,7190,1669,618,6572,147,1522,765,8094,14,12,0,83
Cleburne,11/19/20,20,23,23,624,10665,534,11300,70,25230,525,99,9500,1165,457,77,20,0,48,22,10025,1275,525,9500,110,1165,635,10665,15,8,0,86
Cleveland,11/19/20,14,25,25,322,4546,269,4878,39,8226,271,51,4379,167,231,38,13,1,27,12,4650,228,271,4379,61,167,332,4546,8,4,0,26
Columbia,11/19/20,23,27,27,929,8890,805,9871,101,23892,723,206,7667,1223,652,153,23,0,48,53,8390,1481,723,7667,258,1223,981,8890,16,12,0,209
Conway,11/19/20,6,29,29,554,10017,404,10579,144,20906,496,58,9297,720,375,29,6,0,115,29,9793,786,496,9297,66,720,562,10017,22,7,0,116
Craighead,11/19/20,70,31,31,6319,58776,5491,65229,757,105701,5766,553,53807,4969,5054,437,64,6,647,110,59573,5656,5766,53807,687,4969,6453,58776,112,115,0,579
Crawford,11/19/20,35,33,33,2785,33776,2381,36571,369,62472,2535,250,33164,612,2197,184,33,2,305,64,35699,872,2535,33164,260,612,2795,33776,54,47,1,319
Crittenden,11/19/20,55,35,35,3011,19730,2709,22766,246,49013,2876,135,19316,414,2601,108,48,7,226,20,22192,574,2876,19316,160,414,3036,19730,47,30,0,317
Cross,11/19/20,25,37,37,724,7653,622,8381,77,16998,630,94,7318,335,553,69,23,2,54,23,7948,433,630,7318,98,335,728,7653,9,6,1,161
Dallas,11/19/20,6,39,39,254,3296,196,3551,52,7432,244,10,3185,111,190,6,6,0,48,4,3429,122,244,3185,11,111,255,3296,2,3,0,25
Desha,11/19/20,8,41,41,503,5754,457,6277,38,11887,461,42,5434,320,429,28,7,1,25,13,5895,382,461,5434,62,320,523,5754,11,10,0,27
Drew,11/19/20,7,43,43,545,8974,474,9527,64,18502,477,68,8021,953,433,41,6,1,38,26,8498,1029,477,8021,76,953,553,8974,10,3,0,83
Faulkner,11/19/20,49,45,45,4292,59261,3766,63644,477,122416,3844,448,55138,4123,3439,327,43,6,362,115,58982,4662,3844,55138,539,4123,4383,59261,58,49,2,622
Franklin,11/19/20,7,47,47,690,10284,615,10995,68,17780,614,76,10006,278,549,66,7,0,58,10,10620,375,614,10006,97,278,711,10284,8,5,0,51
Fulton,11/19/20,12,49,49,473,3392,390,3880,71,12139,368,105,2782,610,314,76,10,2,44,27,3150,730,368,2782,120,610,488,3392,8,12,0,51
Garland,11/19/20,99,51,51,3350,46620,2834,50016,417,98296,3127,223,44958,1662,2672,162,94,5,361,56,48085,1931,3127,44958,269,1662,3396,46620,79,48,3,825
Grant,11/19/20,5,53,53,502,8103,409,8617,88,18086,433,69,7441,662,369,40,4,1,60,28,7874,743,433,7441,81,662,514,8103,17,10,0,207
Greene,11/19/20,26,55,55,2401,24228,1927,26683,448,44623,1992,409,21968,2260,1654,273,24,2,314,134,23960,2723,1992,21968,463,2260,2455,24228,71,48,0,373
Hempstead,11/19/20,6,57,57,759,8266,676,9044,77,22018,651,108,7951,315,578,98,6,0,67,10,8602,442,651,7951,127,315,778,8266,17,13,0,67
HotSpring,11/19/20,41,59,59,2689,21857,2364,24568,284,33520,2615,74,20358,1499,2320,44,39,2,256,28,22973,1595,2615,20358,96,1499,2711,21857,29,13,0,384
Howard,11/19/20,15,61,61,747,5128,682,5887,50,13389,631,116,4515,613,588,94,15,0,28,22,5146,741,631,4515,128,613,759,5128,11,13,0,32
Independence,11/19/20,69,63,63,1914,18180,1565,20141,280,37264,1491,423,17208,972,1242,323,59,10,190,90,18699,1442,1491,17208,470,972,1961,18180,17,12,0,317
Izard,11/19/20,4,65,65,933,7512,812,8460,117,13559,847,86,6571,941,754,58,4,0,89,28,7418,1042,847,6571,101,941,948,7512,7,101,0,180
Jackson,11/19/20,6,67,67,1464,12499,1010,14048,448,17225,1188,276,11519,980,775,235,5,1,408,40,12707,1341,1188,11519,361,980,1549,12499,106,7,0,257
Jefferson,11/19/20,106,69,69,4894,46473,4390,51512,396,70424,4568,326,45371,1102,4207,183,101,5,258,138,49939,1573,4568,45371,471,1102,5039,46473,41,53,0,312
Johnson,11/19/20,11,71,71,1180,12190,1090,13378,79,26291,1110,70,11773,417,1037,53,10,1,63,16,12883,495,1110,11773,78,417,1188,12190,11,8,0,115
Lafayette,11/19/20,3,73,73,246,1773,222,2032,21,6915,203,43,1679,94,183,39,3,0,17,4,1882,150,203,1679,56,94,259,1773,10,4,0,38
Lawrence,11/19/20,27,75,75,1054,7372,927,8451,100,16669,921,133,7004,368,809,118,27,0,85,15,7925,526,921,7004,158,368,1079,7372,13,9,0,60
Lee,11/19/20,18,77,77,1147,5787,1099,6938,30,9398,1136,11,5721,66,1092,7,17,1,27,3,6857,81,1136,5721,15,66,1151,5787,2,-1,0,19
Lincoln,11/19/20,18,79,79,2379,10863,2336,13256,25,13695,2343,36,10496,367,2310,26,17,1,16,9,12839,417,2343,10496,50,367,2393,10863,2,1,0,50
LittleRiver,11/19/20,39,81,81,588,2925,486,3515,63,12417,501,87,2683,242,425,61,34,5,42,21,3184,331,501,2683,89,242,590,2925,9,2,0,35
Logan,11/19/20,6,83,83,816,12175,653,13003,157,21757,752,64,11182,993,618,35,6,0,128,29,11934,1069,752,11182,76,993,828,12175,35,9,0,146
Lonoke,11/19/20,43,85,85,2389,33426,2020,35935,326,72206,1886,503,29240,4186,1631,389,40,3,215,111,31126,4809,1886,29240,623,4186,2509,33426,29,38,1,284
Madison,11/19/20,6,87,87,543,6356,468,6912,69,16076,492,51,6039,317,433,35,6,0,53,16,6531,381,492,6039,64,317,556,6356,6,8,0,41
Marion,11/19/20,5,89,89,351,4602,232,4962,114,16438,289,62,4257,345,198,34,4,1,87,27,4546,416,289,4257,71,345,360,4602,18,8,0,192
Miller,11/19/20,22,91,91,1987,10395,1830,12437,135,43759,1532,455,9771,624,1427,403,16,6,89,46,11303,1134,1532,9771,510,624,2042,10395,40,33,0,90
MissingCountyInfo,11/19/20,0,5,5,2383,83855,1477,86254,906,NA,2019,364,83819,36,1247,230,0,0,772,134,85838,416,2019,83819,380,36,2399,83855,4,-9,0,1884
Mississippi,11/19/20,79,93,93,2934,17343,2587,20295,267,42831,2727,207,16015,1328,2424,163,65,14,237,30,18742,1553,2727,16015,225,1328,2952,17343,42,43,0,275
Monroe,11/19/20,4,95,95,277,3644,245,3926,28,7249,257,20,3545,99,231,14,4,0,22,6,3802,124,257,3545,25,99,282,3644,4,1,0,64
Montgomery,11/19/20,10,97,97,231,3397,193,3628,28,8993,223,8,2859,538,188,5,9,1,26,2,3082,546,223,2859,8,538,231,3397,8,2,0,20
Nevada,11/19/20,14,99,99,408,6024,350,6436,44,8440,365,43,5855,169,316,34,13,1,36,8,6220,216,365,5855,47,169,412,6024,8,7,0,83
Newton,11/19/20,22,101,101,394,3229,332,3624,40,7848,350,44,2428,801,301,31,19,3,30,10,2778,846,350,2428,45,801,395,3229,6,5,0,83
Ouachita,11/19/20,11,103,103,562,8605,430,9191,120,24106,518,44,8278,327,405,25,11,0,101,19,8796,395,518,8278,68,327,586,8605,15,6,0,54
Perry,11/19/20,3,105,105,217,5767,176,5994,38,10322,194,23,5537,230,163,13,3,0,28,10,5731,263,194,5537,33,230,227,5767,7,0,0,47
Phillips,11/19/20,16,107,107,863,9945,796,10831,51,19034,828,35,9714,231,772,24,16,0,40,11,10542,289,828,9714,58,231,886,9945,12,5,0,70
Pike,11/19/20,1,109,109,336,3274,293,3611,42,10808,307,29,3052,222,278,15,0,1,29,13,3359,252,307,3052,30,222,337,3274,6,3,0,31
Poinsett,11/19/20,38,111,111,1552,14049,1309,15642,205,24054,1403,149,13562,487,1192,117,33,5,178,27,14965,677,1403,13562,190,487,1593,14049,38,10,1,157
Polk,11/19/20,7,113,113,642,6963,459,7621,176,20163,593,49,6694,269,427,32,7,0,159,17,7287,334,593,6694,65,269,658,6963,24,20,1,96
Pope,11/19/20,40,115,115,3374,35381,2962,38783,372,63644,3018,356,34166,1215,2720,242,36,4,262,110,37184,1599,3018,34166,384,1215,3402,35381,55,27,0,462
Prairie,11/19/20,6,117,117,330,3653,275,3998,49,8244,271,59,3257,396,232,43,6,0,33,16,3528,470,271,3257,74,396,345,3653,1,3,1,31
Pulaski,11/19/20,247,119,119,15049,204781,13047,220091,1753,393463,13961,1088,195364,9417,12252,795,232,15,1475,278,209325,10766,13961,195364,1349,9417,15310,204781,217,162,3,1914
Randolph,11/19/20,28,121,121,892,8683,744,9616,120,17603,716,176,7805,878,586,158,22,6,108,12,8521,1095,716,7805,217,878,933,8683,18,23,0,120
Saline,11/19/20,49,125,125,4094,50192,3405,54405,639,118009,3454,640,45482,4710,2977,428,47,2,429,210,48936,5469,3454,45482,759,4710,4213,50192,90,64,1,729
Scott,11/19/20,2,127,127,316,5480,274,5800,40,10442,257,59,5342,138,233,41,2,0,22,18,5599,201,257,5342,63,138,320,5480,9,9,0,152
Searcy,11/19/20,1,129,129,265,3648,228,3913,36,7923,225,40,3246,402,208,20,1,0,16,20,3471,442,225,3246,40,402,265,3648,3,4,0,23
Sebastian,11/19/20,119,131,131,6386,74774,5437,81194,828,127461,5855,531,73552,1222,5093,344,110,9,650,178,79407,1787,5855,73552,565,1222,6420,74774,119,71,1,643
Sevier,11/19/20,16,133,133,1620,8542,1511,10183,93,17193,1352,268,7752,790,1299,212,16,0,37,56,9104,1079,1352,7752,289,790,1641,8542,13,13,0,47
Sharp,11/19/20,14,135,135,578,7443,432,8046,132,17043,460,118,6893,550,347,85,13,1,100,32,7353,693,460,6893,143,550,603,7443,18,13,1,133
St.Francis,11/19/20,13,123,123,1949,16117,1838,18079,98,26294,1906,43,15961,156,1804,34,13,0,89,9,17867,212,1906,15961,56,156,1962,16117,16,4,1,158
Stone,11/19/20,22,137,137,435,4940,397,5381,16,12446,416,19,4701,239,381,16,22,0,13,3,5117,264,416,4701,25,239,441,4940,1,3,0,65
Union,11/19/20,56,139,139,1393,13418,1239,14841,98,39732,1196,197,11852,1566,1081,158,49,7,66,32,13048,1793,1196,11852,227,1566,1423,13418,13,8,0,66
VanBuren,11/19/20,3,141,141,296,6593,246,6906,47,16684,265,31,5994,599,231,15,3,0,31,16,6259,647,265,5994,48,599,313,6593,8,5,0,149
Washington,11/19/20,168,143,143,14083,117504,12520,131862,1394,228529,12085,1998,107308,10196,10997,1523,150,18,938,456,119393,12469,12085,107308,2273,10196,14358,117504,149,128,0,1017
White,11/19/20,45,145,145,2578,26772,1928,29451,604,78804,2015,563,23514,3258,1571,357,40,5,403,201,25529,3922,2015,23514,664,3258,2679,26772,60,69,1,274
Woodruff,11/19/20,0,147,147,179,2782,159,2967,20,6660,154,25,2662,120,136,23,0,0,18,2,2816,151,154,2662,31,120,185,2782,3,4,0,25
Yell,11/19/20,33,149,149,1545,16120,1383,17669,129,21573,1482,63,15768,352,1355,28,30,3,97,32,17250,419,1482,15768,67,352,1549,16120,24,14,0,300
Arkansas_all_counties,11/18/20,2275,5630,5630,137617,1501296,118751,1641540,16577,2990671,122481,15136,1415302,85994,107772,10979,2085,190,12611,3966,1537783,103757,122481,1415302,17763,85994,140244,1501296,1715,1683,30,14992
Arkansas_county,11/18/20,20,1,1,866,11079,756,11995,90,18124,699,167,8765,2314,629,127,20,0,50,40,9464,2531,699,8765,217,2314,916,11079,8,16,0,89
Ashley,11/18/20,13,3,3,702,7486,605,8207,84,20537,639,63,7159,327,564,41,13,0,62,22,7798,409,639,7159,82,327,721,7486,6,11,0,42
Baxter,11/18/20,24,5,5,1143,8682,897,9837,222,41219,909,234,7938,744,717,180,24,0,168,54,8847,990,909,7938,246,744,1155,8682,18,26,2,103
Benton,11/18/20,138,7,7,10618,102244,9273,113071,1206,258980,9167,1451,98187,4057,8244,1029,120,18,802,404,107354,5717,9167,98187,1660,4057,10827,102244,75,203,3,658
Boone,11/18/20,41,9,9,1442,16831,1148,18335,253,37288,1242,200,16338,493,1009,139,39,2,194,59,17580,755,1242,16338,262,493,1504,16831,25,16,1,115
Bradley,11/18/20,8,11,11,409,5358,373,5769,28,10948,381,28,4305,1053,360,13,7,1,14,14,4686,1083,381,4305,30,1053,411,5358,8,3,0,28
Calhoun,11/18/20,0,13,13,113,2160,82,2275,31,5202,102,11,2093,67,74,8,0,0,28,3,2195,80,102,2093,13,67,115,2160,2,5,0,10
Carroll,11/18/20,21,15,15,1205,10476,1074,11696,110,27887,1125,80,10338,138,1021,53,21,0,83,27,11463,233,1125,10338,95,138,1220,10476,10,10,0,132
Chicot,11/18/20,24,17,17,1108,6682,1044,7795,40,10826,1080,28,6318,364,1024,20,23,1,33,7,7398,397,1080,6318,33,364,1113,6682,4,4,0,22
Clark,11/18/20,8,19,19,705,11538,592,12269,105,22385,606,99,10268,1270,517,75,8,0,81,24,10874,1395,606,10268,125,1270,731,11538,10,12,0,149
Clay,11/18/20,18,21,21,728,8025,555,8775,154,15061,608,120,6519,1506,488,67,15,3,104,50,7127,1648,608,6519,142,1506,750,8025,15,13,0,161
Cleburne,11/18/20,20,23,23,609,10594,526,11212,63,25230,514,95,9458,1136,453,73,20,0,41,22,9972,1240,514,9458,104,1136,618,10594,4,6,0,101
Cleveland,11/18/20,14,25,25,314,4528,265,4852,35,8226,267,47,4366,162,229,36,13,1,25,10,4633,219,267,4366,57,162,324,4528,7,3,0,54
Columbia,11/18/20,23,27,27,913,8697,793,9659,97,23892,717,196,7554,1143,645,148,23,0,49,48,8271,1388,717,7554,245,1143,962,8697,23,6,1,177
Conway,11/18/20,6,29,29,532,9923,397,10463,129,20906,481,51,9214,709,370,27,6,0,105,24,9695,768,481,9214,59,709,540,9923,11,10,0,173
Craighead,11/18/20,70,31,31,6207,58309,5376,64644,760,105701,5665,542,53387,4922,4972,404,64,6,628,132,59052,5592,5665,53387,670,4922,6335,58309,83,93,1,717
Crawford,11/18/20,34,33,33,2731,33511,2334,36252,363,62472,2490,241,32910,601,2165,169,32,2,293,70,35400,852,2490,32910,251,601,2741,33511,20,28,0,320
Crittenden,11/18/20,55,35,35,2964,19460,2679,22448,229,49013,2831,133,19054,406,2574,105,48,7,208,21,21885,563,2831,19054,157,406,2988,19460,32,49,0,147
Cross,11/18/20,24,37,37,715,7501,616,8219,75,16998,623,92,7171,330,547,69,22,2,54,21,7794,425,623,7171,95,330,718,7501,9,6,0,26
Dallas,11/18/20,6,39,39,252,3273,193,3526,53,7432,243,9,3164,109,188,5,6,0,49,4,3407,119,243,3164,10,109,253,3273,10,4,0,77
Desha,11/18/20,8,41,41,492,5738,447,6250,37,11887,453,39,5422,316,420,27,7,1,26,11,5875,375,453,5422,59,316,512,5738,4,7,0,63
Drew,11/18/20,7,43,43,535,8901,471,9444,57,18502,472,63,7958,943,431,40,6,1,35,22,8430,1014,472,7958,71,943,543,8901,3,12,0,40
Faulkner,11/18/20,47,45,45,4234,58697,3717,63019,470,122416,3806,428,54717,3980,3402,315,41,6,363,107,58523,4496,3806,54717,516,3980,4322,58697,53,50,3,312
Franklin,11/18/20,7,47,47,682,10241,610,10944,65,17780,606,76,9965,276,546,64,7,0,53,12,10571,373,606,9965,97,276,703,10241,6,7,1,51
Fulton,11/18/20,12,49,49,465,3349,378,3829,75,12139,361,104,2749,600,311,67,10,2,40,35,3110,719,361,2749,119,600,480,3349,6,10,0,31
Garland,11/18/20,96,51,51,3271,45874,2786,49188,389,98296,3063,208,44251,1623,2629,157,91,5,343,46,47314,1874,3063,44251,251,1623,3314,45874,23,46,3,384
Grant,11/18/20,5,53,53,485,7913,399,8409,81,18086,424,61,7267,646,360,39,4,1,60,21,7691,718,424,7267,72,646,496,7913,12,2,0,59
Greene,11/18/20,26,55,55,2330,23926,1879,26308,425,44623,1934,396,21758,2168,1623,256,24,2,287,138,23692,2616,1934,21758,448,2168,2382,23926,53,46,0,353
Hempstead,11/18/20,6,57,57,742,8216,663,8977,73,22018,634,108,7904,312,572,91,6,0,56,17,8538,439,634,7904,127,312,761,8216,9,14,0,160
HotSpring,11/18/20,41,59,59,2660,21502,2351,24183,268,33520,2590,70,20098,1404,2310,41,39,2,241,27,22688,1495,2590,20098,91,1404,2681,21502,25,16,0,400
Howard,11/18/20,15,61,61,736,5107,669,5854,52,13389,623,113,4495,612,577,92,15,0,31,21,5118,736,623,4495,124,612,747,5107,8,23,0,72
Independence,11/18/20,69,63,63,1897,17880,1553,19825,275,37264,1483,414,16961,919,1238,315,59,10,186,89,18444,1381,1483,16961,462,919,1945,17880,17,26,1,254
Izard,11/18/20,4,65,65,926,7339,711,8280,211,13559,840,86,6426,913,654,57,4,0,182,29,7266,1014,840,6426,101,913,941,7339,3,3,0,40
Jackson,11/18/20,6,67,67,1358,12348,1003,13791,349,17225,1085,273,11377,971,772,231,5,1,308,41,12462,1329,1085,11377,358,971,1443,12348,71,23,0,223
Jefferson,11/18/20,106,69,69,4853,46202,4337,51197,408,70424,4547,306,45150,1052,4165,172,101,5,279,129,49697,1500,4547,45150,448,1052,4995,46202,22,19,1,469
Johnson,11/18/20,11,71,71,1169,12086,1082,13263,76,26291,1102,67,11690,396,1030,52,10,1,62,14,12792,471,1102,11690,75,396,1177,12086,9,6,0,227
Lafayette,11/18/20,3,73,73,236,1745,218,1993,15,6915,197,39,1657,88,180,38,3,0,14,1,1854,139,197,1657,51,88,248,1745,2,2,0,23
Lawrence,11/18/20,27,75,75,1041,7325,918,8391,96,16669,908,133,6959,366,801,117,27,0,80,16,7867,524,908,6959,158,366,1066,7325,7,8,0,75
Lee,11/18/20,18,77,77,1145,5770,1100,6919,27,9398,1134,11,5702,68,1093,7,17,1,24,3,6836,83,1134,5702,15,68,1149,5770,3,3,0,25
Lincoln,11/18/20,18,79,79,2377,10815,2335,13206,24,13695,2343,34,10451,364,2309,26,17,1,17,7,12794,412,2343,10451,48,364,2391,10815,12,3,0,111
LittleRiver,11/18/20,39,81,81,579,2899,484,3479,56,12417,494,85,2659,240,424,60,34,5,36,20,3153,326,494,2659,86,240,580,2899,7,7,0,61
Logan,11/18/20,6,83,83,781,12064,644,12857,131,21757,721,60,11080,984,609,35,6,0,106,25,11801,1056,721,11080,72,984,793,12064,5,9,0,68
Lonoke,11/18/20,42,85,85,2360,33171,1982,35647,336,72206,1861,499,29053,4118,1597,385,40,2,224,112,30914,4733,1861,29053,615,4118,2476,33171,40,32,0,419
Madison,11/18/20,6,87,87,537,6321,460,6871,71,16076,487,50,6010,311,426,34,6,0,55,16,6497,374,487,6010,63,311,550,6321,1,0,0,29
Marion,11/18/20,5,89,89,333,4428,224,4771,104,16438,277,56,4095,333,190,34,4,1,83,21,4372,399,277,4095,66,333,343,4428,7,10,2,49
Miller,11/18/20,22,91,91,1947,10345,1797,12337,128,43759,1514,433,9733,612,1414,383,16,6,84,44,11247,1090,1514,9733,478,612,1992,10345,16,21,0,133
MissingCountyInfo,11/18/20,0,5,5,2379,81975,1486,84384,893,NA,2016,363,81943,32,1239,247,0,0,777,116,83959,425,2016,81943,393,32,2409,81975,171,35,0,1898
Mississippi,11/18/20,79,93,93,2892,17110,2544,20018,268,42831,2689,203,15906,1204,2386,158,65,14,237,31,18595,1423,2689,15906,219,1204,2908,17110,23,50,2,117
Monroe,11/18/20,4,95,95,273,3584,244,3862,25,7249,256,17,3485,99,230,14,4,0,22,3,3741,121,256,3485,22,99,278,3584,2,0,0,39
Montgomery,11/18/20,10,97,97,223,3385,191,3608,22,8993,216,7,2848,537,186,5,9,1,21,1,3064,544,216,2848,7,537,223,3385,2,1,0,11
Nevada,11/18/20,14,99,99,400,5949,343,6352,43,8440,359,41,5784,165,310,33,13,1,36,7,6143,209,359,5784,44,165,403,5949,9,3,0,109
Newton,11/18/20,22,101,101,388,3152,327,3541,39,7848,345,43,2408,744,296,31,19,3,30,9,2753,788,345,2408,44,744,389,3152,4,3,0,23
Ouachita,11/18/20,11,103,103,547,8566,424,9135,111,24106,505,42,8242,324,399,25,11,0,94,17,8747,388,505,8242,64,324,569,8566,21,5,0,144
Perry,11/18/20,3,105,105,210,5727,176,5946,31,10322,190,20,5504,223,163,13,3,0,24,7,5694,252,190,5504,29,223,219,5727,5,5,0,85
Phillips,11/18/20,16,107,107,851,9887,791,10761,44,19034,820,31,9653,234,769,22,16,0,35,9,10473,288,820,9653,54,234,874,9887,5,1,0,114
Pike,11/18/20,1,109,109,330,3249,290,3580,39,10808,303,27,3030,219,275,15,0,1,28,11,3333,247,303,3030,28,219,331,3249,4,2,0,38
Poinsett,11/18/20,37,111,111,1514,13930,1299,15484,178,24054,1367,147,13454,476,1184,115,32,5,151,27,14821,663,1367,13454,187,476,1554,13930,19,52,0,164
Polk,11/18/20,6,113,113,618,6891,439,7524,173,20163,574,44,6623,268,408,31,6,0,160,13,7197,327,574,6623,59,268,633,6891,9,10,0,66
Pope,11/18/20,40,115,115,3319,34974,2935,38313,344,63644,2983,336,33888,1086,2700,235,36,4,247,97,36871,1442,2983,33888,356,1086,3339,34974,49,25,1,250
Prairie,11/18/20,5,117,117,329,3623,272,3966,52,8244,270,59,3236,387,230,42,5,0,35,17,3506,460,270,3236,73,387,343,3623,5,2,0,39
Pulaski,11/18/20,244,119,119,14832,203084,12885,218156,1701,393463,13780,1052,193928,9156,12118,767,229,15,1431,270,207708,10448,13780,193928,1292,9156,15072,203084,148,133,3,1486
Randolph,11/18/20,28,121,121,874,8581,721,9494,125,17603,700,174,7715,866,564,157,22,6,114,11,8415,1079,700,7715,213,866,913,8581,13,14,0,46
Saline,11/18/20,48,125,125,4004,49553,3341,53672,614,118009,3405,599,45028,4525,2930,411,46,2,428,186,48433,5239,3405,45028,714,4525,4119,49553,47,73,0,553
Scott,11/18/20,2,127,127,307,5337,265,5648,40,10442,252,55,5207,130,230,35,2,0,20,20,5459,189,252,5207,59,130,311,5337,5,6,0,109
Searcy,11/18/20,1,129,129,262,3628,224,3889,37,7923,223,39,3234,394,205,19,1,0,17,20,3457,432,223,3234,38,394,261,3628,4,2,0,28
Sebastian,11/18/20,118,131,131,6267,74250,5366,80548,782,127461,5761,506,73061,1189,5034,332,109,9,617,165,78822,1726,5761,73061,537,1189,6298,74250,49,84,3,519
Sevier,11/18/20,16,133,133,1607,8508,1498,10136,93,17193,1348,259,7728,780,1293,205,16,0,39,54,9076,1060,1348,7728,280,780,1628,8508,6,10,0,22
Sharp,11/18/20,13,135,135,560,7328,419,7912,128,17043,445,115,6787,541,340,79,13,0,92,36,7232,680,445,6787,139,541,584,7328,5,11,0,67
St.Francis,11/18/20,12,123,123,1933,15975,1834,17921,87,26294,1891,42,15820,155,1801,33,12,0,78,9,17711,210,1891,15820,55,155,1946,15975,4,14,0,43
Stone,11/18/20,22,137,137,434,4876,394,5316,18,12446,416,18,4645,231,378,16,22,0,16,2,5061,255,416,4645,24,231,440,4876,3,2,0,22
Union,11/18/20,56,139,139,1380,13365,1231,14775,93,39732,1191,189,11804,1561,1074,157,49,7,68,25,12995,1780,1191,11804,219,1561,1410,13365,22,9,1,53
VanBuren,11/18/20,3,141,141,288,6452,241,6756,44,16684,259,29,5956,496,226,15,3,0,30,14,6215,541,259,5956,45,496,304,6452,10,3,0,93
Washington,11/18/20,168,143,143,13934,116636,12392,130835,1373,228529,11984,1950,106749,9887,10926,1466,150,18,908,465,118733,12102,11984,106749,2215,9887,14199,116636,152,127,1,997
White,11/18/20,44,145,145,2518,26558,1859,29167,614,78804,1966,552,23394,3164,1528,331,39,5,398,216,25360,3807,1966,23394,643,3164,2609,26558,99,56,0,211
Woodruff,11/18/20,0,147,147,176,2760,155,2941,21,6660,152,24,2640,120,132,23,0,0,20,1,2792,149,152,2640,29,120,181,2760,4,3,0,9
Yell,11/18/20,33,149,149,1521,15844,1369,17369,119,21573,1467,54,15509,335,1345,24,30,3,92,27,16976,393,1467,15509,58,335,1525,15844,12,13,0,205
Arkansas_all_counties,11/17/20,2245,5630,5630,135902,1488019,117068,1626424,16576,2990671,121153,14749,1404126,83893,106515,10553,2057,188,12569,4007,1525279,101145,121153,1404126,17252,83893,138405,1488019,1554,1443,20,12329
Arkansas_county,11/17/20,20,1,1,858,10998,740,11906,98,18124,697,161,8692,2306,620,120,20,0,57,41,9389,2517,697,8692,211,2306,908,10998,13,5,0,83
Ashley,11/17/20,13,3,3,696,7450,594,8165,89,20537,637,59,7133,317,556,38,13,0,68,21,7770,395,637,7133,78,317,715,7450,5,4,0,29
Baxter,11/17/20,22,5,5,1125,8597,871,9733,232,41219,891,234,7858,739,698,173,22,0,171,61,8749,984,891,7858,245,739,1136,8597,18,24,1,84
Benton,11/17/20,135,7,7,10543,101661,9070,112389,1337,258980,9095,1448,97672,3989,8084,986,117,18,893,444,106767,5622,9095,97672,1633,3989,10728,101661,101,107,0,609
Boone,11/17/20,40,9,9,1417,16741,1132,18201,245,37288,1204,213,16252,489,993,139,38,2,173,72,17456,745,1204,16252,256,489,1460,16741,28,16,0,99
Bradley,11/17/20,8,11,11,401,5338,370,5741,23,10948,379,22,4295,1043,359,11,7,1,13,10,4674,1067,379,4295,24,1043,403,5338,3,1,0,181
Calhoun,11/17/20,0,13,13,111,2152,77,2265,34,5202,101,10,2085,67,70,7,0,0,31,3,2186,79,101,2085,12,67,113,2152,1,4,0,18
Carroll,11/17/20,21,15,15,1195,10354,1064,11562,110,27887,1120,75,10217,137,1013,51,21,0,86,24,11337,225,1120,10217,88,137,1208,10354,16,13,0,34
Chicot,11/17/20,24,17,17,1104,6664,1040,7773,40,10826,1079,25,6313,351,1023,17,23,1,33,7,7392,381,1079,6313,30,351,1109,6664,3,2,0,25
Clark,11/17/20,8,19,19,695,11399,580,12119,107,22385,596,99,10158,1241,506,74,8,0,82,25,10754,1365,596,10158,124,1241,720,11399,8,14,1,61
Clay,11/17/20,18,21,21,713,7879,542,8614,152,15061,602,111,6481,1398,480,62,15,3,106,46,7083,1531,602,6481,133,1398,735,7879,22,18,0,60
Cleburne,11/17/20,20,23,23,605,10497,520,11111,65,25230,511,94,9402,1095,449,71,20,0,42,23,9913,1198,511,9402,103,1095,614,10497,6,6,2,38
Cleveland,11/17/20,14,25,25,307,4481,262,4797,31,8226,260,47,4319,162,229,33,13,1,18,13,4579,218,260,4319,56,162,316,4481,1,5,0,96
Columbia,11/17/20,22,27,27,890,8543,787,9478,81,23892,708,182,7529,1014,642,145,22,0,44,37,8237,1241,708,7529,227,1014,935,8543,12,12,0,107
Conway,11/17/20,6,29,29,521,9761,387,10289,128,20906,475,46,9175,586,360,27,6,0,109,19,9650,639,475,9175,53,586,528,9761,9,8,0,125
Craighead,11/17/20,69,31,31,6124,57675,5283,63930,771,105701,5596,528,52965,4710,4894,389,63,6,638,133,58561,5369,5596,52965,659,4710,6255,57675,64,89,0,463
Crawford,11/17/20,34,33,33,2711,33211,2306,35931,371,62472,2470,241,32613,598,2145,161,32,2,293,78,35083,848,2470,32613,250,598,2720,33211,34,36,0,201
Crittenden,11/17/20,55,35,35,2932,19345,2630,22299,246,49013,2801,131,18940,405,2526,104,48,7,226,20,21741,558,2801,18940,153,405,2954,19345,25,29,0,104
Cross,11/17/20,24,37,37,706,7484,610,8193,72,16998,617,89,7155,329,543,67,22,2,52,20,7772,421,617,7155,92,329,709,7484,21,4,0,65
Dallas,11/17/20,6,39,39,242,3206,189,3449,47,7432,233,9,3099,107,184,5,6,0,43,4,3332,117,233,3099,10,107,243,3206,6,2,0,43
Desha,11/17/20,8,41,41,488,5679,440,6186,40,11887,452,36,5399,280,412,28,7,1,33,7,5851,335,452,5399,55,280,507,5679,5,5,0,46
Drew,11/17/20,7,43,43,532,8864,459,9404,66,18502,472,60,7936,928,423,36,6,1,43,23,8408,996,472,7936,68,928,540,8864,9,6,0,77
Faulkner,11/17/20,44,45,45,4181,58438,3667,62703,470,122416,3764,417,54498,3940,3361,306,39,5,364,106,58262,4441,3764,54498,501,3940,4265,58438,59,37,0,593
Franklin,11/17/20,6,47,47,676,10196,603,10893,67,17780,601,75,9926,270,542,61,6,0,53,14,10527,366,601,9926,96,270,697,10196,8,7,0,89
Fulton,11/17/20,12,49,49,459,3324,368,3798,79,12139,358,101,2732,592,306,62,10,2,42,37,3090,708,358,2732,116,592,474,3324,15,6,0,54
Garland,11/17/20,93,51,51,3248,45513,2740,48804,415,98296,3042,206,43929,1584,2591,149,88,5,363,52,46971,1833,3042,43929,249,1584,3291,45513,28,41,2,288
Grant,11/17/20,5,53,53,473,7866,397,8349,71,18086,415,58,7236,630,358,39,4,1,53,18,7651,698,415,7236,68,630,483,7866,5,7,0,63
Greene,11/17/20,26,55,55,2277,23626,1833,25950,418,44623,1890,387,21556,2070,1591,242,24,2,275,143,23446,2504,1890,21556,434,2070,2324,23626,49,40,0,206
Hempstead,11/17/20,6,57,57,733,8065,649,8817,78,22018,629,104,7757,308,565,84,6,0,58,20,8386,431,629,7757,123,308,752,8065,7,15,0,67
HotSpring,11/17/20,41,59,59,2635,21127,2335,23783,259,33520,2568,67,19764,1363,2298,37,39,2,231,28,22332,1451,2568,19764,88,1363,2656,21127,24,50,0,438
Howard,11/17/20,15,61,61,728,5043,646,5782,67,13389,617,111,4436,607,564,82,15,0,38,29,5053,729,617,4436,122,607,739,5043,7,7,0,17
Independence,11/17/20,68,63,63,1880,17643,1527,19568,285,37264,1477,403,16752,891,1223,304,58,10,196,89,18229,1339,1477,16752,448,891,1925,17643,20,9,0,85
Izard,11/17/20,4,65,65,923,7302,708,8240,211,13559,840,83,6395,907,651,57,4,0,185,26,7235,1005,840,6395,98,907,938,7302,10,5,0,37
Jackson,11/17/20,6,67,67,1287,12196,980,13566,301,17225,1016,271,11233,963,754,226,5,1,257,44,12249,1317,1016,11233,354,963,1370,12196,19,18,0,236
Jefferson,11/17/20,105,69,69,4831,45755,4318,50724,406,70424,4535,296,44723,1032,4150,168,100,5,283,123,49258,1466,4535,44723,434,1032,4969,45755,40,66,1,396
Johnson,11/17/20,11,71,71,1160,11868,1076,13036,73,26291,1093,67,11484,384,1025,51,10,1,58,15,12577,459,1093,11484,75,384,1168,11868,9,8,0,46
Lafayette,11/17/20,3,73,73,234,1724,216,1969,15,6915,195,39,1638,86,178,38,3,0,14,1,1833,136,195,1638,50,86,245,1724,3,3,0,14
Lawrence,11/17/20,27,75,75,1034,7257,910,8314,97,16669,900,134,6901,356,798,112,27,0,75,22,7801,513,900,6901,157,356,1057,7257,9,14,0,48
Lee,11/17/20,18,77,77,1142,5748,1097,6894,27,9398,1131,11,5682,66,1091,6,17,1,23,4,6813,81,1131,5682,15,66,1146,5748,6,2,0,43
Lincoln,11/17/20,18,79,79,2365,10716,2332,13095,15,13695,2335,30,10353,363,2307,25,17,1,11,4,12688,407,2335,10353,44,363,2379,10716,-2,11,0,282
LittleRiver,11/17/20,39,81,81,572,2845,477,3417,56,12417,488,84,2614,231,420,57,34,5,34,22,3102,315,488,2614,84,231,572,2845,9,5,0,33
Logan,11/17/20,6,83,83,776,12001,635,12789,135,21757,718,58,11026,975,601,34,6,0,111,24,11744,1045,718,11026,70,975,788,12001,19,9,0,99
Lonoke,11/17/20,42,85,85,2320,32792,1950,35225,328,72206,1834,486,28727,4065,1570,380,40,2,224,104,30561,4664,1834,28727,599,4065,2433,32792,29,22,4,346
Madison,11/17/20,6,87,87,536,6293,460,6841,70,16076,486,50,5984,309,426,34,6,0,54,16,6470,371,486,5984,62,309,548,6293,7,3,0,43
Marion,11/17/20,3,89,89,326,4386,214,4721,109,16438,271,55,4065,321,180,34,2,1,89,20,4336,385,271,4065,64,321,335,4386,12,11,0,51
Miller,11/17/20,22,91,91,1931,10228,1776,12203,133,43759,1502,429,9619,609,1403,373,16,6,83,50,11121,1082,1502,9619,473,609,1975,10228,24,29,0,139
MissingCountyInfo,11/17/20,0,5,5,2208,80248,1451,82487,757,NA,1866,342,80218,30,1216,235,0,0,650,107,82084,403,1866,80218,373,30,2239,80248,29,26,0,785
Mississippi,11/17/20,77,93,93,2869,17016,2494,19894,297,42831,2665,204,15833,1183,2342,152,64,13,258,39,18498,1396,2665,15833,213,1183,2878,17016,28,30,1,169
Monroe,11/17/20,4,95,95,271,3547,244,3823,23,7249,255,16,3449,98,230,14,4,0,21,2,3704,119,255,3449,21,98,276,3547,2,4,0,7
Montgomery,11/17/20,10,97,97,221,3376,190,3597,21,8993,214,7,2845,531,185,5,9,1,20,1,3059,538,214,2845,7,531,221,3376,2,2,0,11
Nevada,11/17/20,14,99,99,391,5849,340,6243,37,8440,352,39,5687,162,309,31,13,1,30,7,6039,204,352,5687,42,162,394,5849,1,1,0,73
Newton,11/17/20,22,101,101,384,3133,324,3513,38,7848,337,47,2394,739,294,30,19,3,24,14,2731,782,337,2394,43,739,380,3133,8,3,0,107
Ouachita,11/17/20,11,103,103,526,8443,419,8990,95,24106,488,38,8121,322,394,25,11,0,82,13,8609,381,488,8121,59,322,547,8443,19,6,0,98
Perry,11/17/20,3,105,105,205,5647,171,5859,31,10322,187,18,5424,223,160,11,3,0,24,7,5611,248,187,5424,25,223,212,5647,4,2,0,105
Phillips,11/17/20,16,107,107,846,9778,790,10647,40,19034,815,31,9546,232,768,22,16,0,31,9,10361,286,815,9546,54,232,869,9778,6,5,0,43
Pike,11/17/20,1,109,109,326,3215,288,3542,37,10808,300,26,2996,219,273,15,0,1,27,10,3296,246,300,2996,27,219,327,3215,6,2,0,23
Poinsett,11/17/20,37,111,111,1495,13785,1247,15320,211,24054,1351,144,13318,467,1140,107,32,5,179,32,14669,651,1351,13318,184,467,1535,13785,20,20,0,69
Polk,11/17/20,6,113,113,609,6834,429,7457,174,20163,564,45,6568,266,398,31,6,0,160,14,7132,325,564,6568,59,266,623,6834,25,8,0,78
Pope,11/17/20,39,115,115,3270,34773,2910,38063,321,63644,2943,327,33705,1068,2687,223,35,4,221,100,36648,1415,2943,33705,347,1068,3290,34773,23,17,0,146
Prairie,11/17/20,5,117,117,324,3589,270,3927,49,8244,266,58,3202,387,228,42,5,0,33,16,3468,459,266,3202,72,387,338,3589,5,5,0,20
Pulaski,11/17/20,241,119,119,14684,201746,12752,216659,1689,393463,13672,1012,192770,8976,12006,746,226,15,1438,251,206442,10217,13672,192770,1241,8976,14913,201746,157,138,4,1380
Randolph,11/17/20,28,121,121,861,8548,707,9447,126,17603,686,175,7693,855,552,155,22,6,112,14,8379,1068,686,7693,213,855,899,8548,16,5,0,77
Saline,11/17/20,48,125,125,3957,49047,3268,53120,640,118009,3372,585,44687,4360,2889,379,46,2,436,204,48059,5061,3372,44687,701,4360,4073,49047,67,42,1,514
Scott,11/17/20,2,127,127,302,5233,259,5538,41,10442,251,51,5103,130,226,33,2,0,23,18,5354,184,251,5103,54,130,305,5233,1,10,0,23
Searcy,11/17/20,1,129,129,258,3604,222,3861,35,7923,222,36,3221,383,204,18,1,0,17,18,3443,418,222,3221,35,383,257,3604,1,0,0,21
Sebastian,11/17/20,115,131,131,6218,73780,5282,80031,820,127461,5733,485,72613,1167,4974,308,106,9,652,168,78346,1685,5733,72613,518,1167,6251,73780,39,53,2,350
Sevier,11/17/20,16,133,133,1601,8492,1488,10113,97,17193,1344,257,7714,778,1286,202,16,0,42,55,9058,1055,1344,7714,277,778,1621,8492,15,16,0,35
Sharp,11/17/20,13,135,135,555,7266,408,7844,134,17043,442,113,6738,528,334,74,13,0,95,39,7180,664,442,6738,136,528,578,7266,11,10,0,79
St.Francis,11/17/20,12,123,123,1929,15936,1820,17878,97,26294,1887,42,15784,152,1788,32,12,0,87,10,17671,207,1887,15784,55,152,1942,15936,9,6,0,116
Stone,11/17/20,22,137,137,431,4857,392,5293,17,12446,412,19,4632,225,375,17,22,0,15,2,5044,249,412,4632,24,225,436,4857,1,0,0,8
Union,11/17/20,55,139,139,1358,13334,1222,14722,81,39732,1176,182,11779,1555,1069,153,48,7,59,22,12955,1767,1176,11779,212,1555,1388,13334,11,12,0,25
VanBuren,11/17/20,3,141,141,278,6369,238,6662,37,16684,255,23,5941,428,223,15,3,0,29,8,6196,466,255,5941,38,428,293,6369,5,5,0,26
Washington,11/17/20,167,143,143,13782,115791,12265,129833,1349,228529,11908,1874,106151,9640,10849,1416,149,18,910,439,118059,11774,11908,106151,2134,9640,14042,115791,143,127,1,1259
White,11/17/20,44,145,145,2419,26446,1803,28949,572,78804,1885,534,23309,3137,1488,315,39,5,358,214,25194,3755,1885,23309,618,3137,2503,26446,70,44,0,260
Woodruff,11/17/20,0,147,147,172,2755,152,2932,20,6660,148,24,2638,117,130,22,0,0,18,2,2786,146,148,2638,29,117,177,2755,2,3,0,25
Yell,11/17/20,33,149,149,1509,15651,1356,17164,120,21573,1456,53,15329,322,1336,20,30,3,90,30,16785,379,1456,15329,57,322,1513,15651,2,6,0,36
Arkansas_all_counties,11/16/20,2225,5630,5630,134348,1477244,115625,1613970,16485,2990671,120008,14340,1396858,80386,105468,10157,2038,187,12490,3995,1516866,97104,120008,1396858,16718,80386,136726,1477244,1308,1313,42,12472
Arkansas_county,11/16/20,20,1,1,845,10928,735,11822,90,18124,691,154,8644,2284,618,117,20,0,53,37,9335,2487,691,8644,203,2284,894,10928,7,8,0,133
Ashley,11/16/20,13,3,3,691,7426,590,8136,88,20537,634,57,7115,311,552,38,13,0,69,19,7749,387,634,7115,76,311,710,7426,12,5,0,95
Baxter,11/16/20,21,5,5,1107,8531,847,9649,239,41219,874,233,7799,732,681,166,21,0,172,67,8673,976,874,7799,244,732,1118,8531,18,23,2,172
Benton,11/16/20,135,7,7,10442,101153,8963,111770,1343,258980,9036,1406,97333,3820,8019,944,117,18,899,444,106369,5401,9036,97333,1581,3820,10617,101153,88,118,0,1169
Boone,11/16/20,40,9,9,1389,16670,1116,18102,233,37288,1197,192,16201,469,980,136,38,2,179,54,17398,704,1197,16201,235,469,1432,16670,26,13,0,292
Bradley,11/16/20,8,11,11,398,5160,369,5560,21,10948,379,19,4288,872,358,11,7,1,14,7,4667,893,379,4288,21,872,400,5160,6,0,0,26
Calhoun,11/16/20,0,13,13,110,2135,73,2247,37,5202,100,10,2070,65,66,7,0,0,34,3,2170,77,100,2070,12,65,112,2135,6,6,0,19
Carroll,11/16/20,21,15,15,1179,10336,1051,11527,107,27887,1117,62,10203,133,1002,49,21,0,94,13,11320,207,1117,10203,74,133,1191,10336,8,8,0,188
Chicot,11/16/20,24,17,17,1101,6642,1038,7748,39,10826,1078,23,6299,343,1021,17,23,1,34,5,7377,371,1078,6299,28,343,1106,6642,11,2,0,80
Clark,11/16/20,7,19,19,687,11346,566,12058,114,22385,591,96,10123,1223,495,71,7,0,89,25,10714,1344,591,10123,121,1223,712,11346,4,10,1,226
Clay,11/16/20,18,21,21,691,7841,524,8553,148,15061,590,101,6447,1394,470,54,15,3,104,44,7037,1516,590,6447,122,1394,712,7841,11,5,0,109
Cleburne,11/16/20,18,23,23,599,10465,514,11073,67,25230,506,93,9376,1089,446,68,18,0,42,25,9882,1191,506,9376,102,1089,608,10465,1,8,0,40
Cleveland,11/16/20,14,25,25,306,4386,257,4699,35,8226,259,47,4230,156,226,31,13,1,20,15,4489,210,259,4230,54,156,313,4386,5,2,1,23
Columbia,11/16/20,22,27,27,878,8448,775,9369,81,23892,704,174,7517,931,638,137,22,0,44,37,8221,1148,704,7517,217,931,921,8448,8,13,0,81
Conway,11/16/20,6,29,29,512,9645,379,10164,127,20906,468,44,9139,506,353,26,6,0,109,18,9607,557,468,9139,51,506,519,9645,12,7,0,76
Craighead,11/16/20,69,31,31,6060,57276,5194,63456,796,105701,5533,527,52670,4606,4813,381,63,6,656,140,58203,5253,5533,52670,647,4606,6180,57276,67,84,7,490
Crawford,11/16/20,34,33,33,2677,33044,2270,35731,373,62472,2442,235,32456,588,2117,153,32,2,293,80,34898,833,2442,32456,245,588,2687,33044,31,30,1,554
Crittenden,11/16/20,55,35,35,2907,19266,2601,22191,250,49013,2777,130,18872,394,2502,99,48,7,226,24,21649,542,2777,18872,148,394,2925,19266,28,21,1,148
Cross,11/16/20,24,37,37,685,7440,606,8128,55,16998,601,84,7111,329,541,65,22,2,38,17,7712,416,601,7111,87,329,688,7440,10,3,0,67
Dallas,11/16/20,6,39,39,236,3169,187,3406,43,7432,228,8,3069,100,182,5,6,0,40,3,3297,109,228,3069,9,100,237,3169,4,3,0,21
Desha,11/16/20,8,41,41,483,5638,435,6138,40,11887,448,35,5370,268,409,26,7,1,32,8,5818,320,448,5370,52,268,500,5638,4,2,0,15
Drew,11/16/20,7,43,43,523,8796,453,9327,63,18502,469,54,7920,876,420,33,6,1,43,20,8389,938,469,7920,62,876,531,8796,8,0,0,93
Faulkner,11/16/20,44,45,45,4122,57904,3630,62103,448,122416,3722,400,54256,3648,3329,301,39,5,354,94,57978,4125,3722,54256,477,3648,4199,57904,22,43,1,457
Franklin,11/16/20,6,47,47,668,10115,596,10804,66,17780,595,73,9852,263,539,57,6,0,50,16,10447,357,595,9852,94,263,689,10115,8,7,1,111
Fulton,11/16/20,12,49,49,444,3285,362,3743,70,12139,353,91,2720,565,299,63,10,2,44,26,3073,670,353,2720,105,565,458,3285,10,10,0,43
Garland,11/16/20,91,51,51,3220,45253,2699,48513,430,98296,3014,206,43780,1473,2555,144,86,5,373,57,46794,1719,3014,43780,246,1473,3260,45253,10,20,5,326
Grant,11/16/20,5,53,53,468,7808,390,8286,73,18086,411,57,7193,615,353,37,4,1,54,19,7604,682,411,7193,67,615,478,7808,4,2,0,48
Greene,11/16/20,26,55,55,2228,23469,1793,25745,409,44623,1863,365,21444,2025,1563,230,24,2,276,133,23307,2438,1863,21444,413,2025,2276,23469,36,40,1,281
Hempstead,11/16/20,6,57,57,726,8005,634,8750,86,22018,623,103,7711,294,553,81,6,0,64,22,8334,416,623,7711,122,294,745,8005,4,5,0,81
HotSpring,11/16/20,41,59,59,2611,20713,2285,23344,285,33520,2546,65,19685,1028,2250,35,39,2,257,28,22231,1113,2546,19685,85,1028,2631,20713,20,8,1,114
Howard,11/16/20,15,61,61,721,5033,639,5765,67,13389,613,108,4433,600,558,81,15,0,40,27,5046,719,613,4433,119,600,732,5033,0,7,0,52
Independence,11/16/20,68,63,63,1860,17578,1518,19481,274,37264,1466,394,16703,875,1219,299,58,10,189,85,18169,1312,1466,16703,437,875,1903,17578,8,12,0,395
Izard,11/16/20,4,65,65,913,7275,703,8203,206,13559,834,79,6373,902,647,56,4,0,183,23,7207,996,834,6373,94,902,928,7275,27,17,0,204
Jackson,11/16/20,6,67,67,1268,11979,962,13328,300,17225,1003,265,11164,815,740,222,5,1,258,42,12167,1161,1003,11164,346,815,1349,11979,0,27,0,21
Jefferson,11/16/20,104,69,69,4791,45399,4252,50310,433,70424,4513,278,44445,954,4097,155,99,5,315,118,48958,1352,4513,44445,398,954,4911,45399,33,11,0,228
Johnson,11/16/20,11,71,71,1151,11831,1068,12991,72,26291,1087,64,11455,376,1020,48,10,1,57,15,12542,449,1087,11455,73,376,1160,11831,9,0,0,105
Lafayette,11/16/20,3,73,73,231,1713,213,1955,15,6915,192,39,1632,81,177,36,3,0,12,3,1824,131,192,1632,50,81,242,1713,1,5,0,4
Lawrence,11/16/20,27,75,75,1025,7218,896,8265,102,16669,893,132,6867,351,790,106,27,0,76,26,7760,505,893,6867,154,351,1047,7218,7,3,1,84
Lee,11/16/20,18,77,77,1136,5711,1095,6851,23,9398,1125,11,5651,60,1089,6,17,1,19,4,6776,75,1125,5651,15,60,1140,5711,0,0,0,35
Lincoln,11/16/20,18,79,79,2367,10432,2321,12811,28,13695,2336,31,10284,148,2297,24,17,1,22,6,12620,191,2336,10284,43,148,2379,10432,3,2,0,16
LittleRiver,11/16/20,39,81,81,563,2821,472,3384,52,12417,482,81,2594,227,418,54,34,5,30,22,3076,308,482,2594,81,227,563,2821,5,3,0,49
Logan,11/16/20,6,83,83,757,11921,626,12690,125,21757,704,53,10955,966,598,28,6,0,100,25,11659,1031,704,10955,65,966,769,11921,16,4,1,148
Lonoke,11/16/20,38,85,85,2291,32475,1928,34877,325,72206,1819,472,28496,3979,1557,371,36,2,226,99,30315,4562,1819,28496,583,3979,2402,32475,25,23,2,274
Madison,11/16/20,6,87,87,529,6257,457,6798,66,16076,479,50,5953,304,423,34,6,0,50,16,6432,366,479,5953,62,304,541,6257,3,4,0,65
Marion,11/16/20,3,89,89,314,4347,203,4666,108,16438,258,56,4035,312,169,34,2,1,87,21,4293,373,258,4035,61,312,319,4347,21,7,1,135
Miller,11/16/20,22,91,91,1907,10113,1747,12060,138,43759,1488,419,9544,569,1384,363,16,6,88,50,11032,1028,1488,9544,459,569,1947,10113,13,32,0,115
MissingCountyInfo,11/16/20,0,5,5,2179,79492,1425,81695,754,NA,1839,340,79468,24,1194,231,0,0,645,109,81307,388,1839,79468,364,24,2203,79492,13,66,0,-2392
Mississippi,11/16/20,76,93,93,2841,16875,2464,19723,300,42831,2639,202,15776,1099,2322,142,63,13,253,47,18415,1308,2639,15776,209,1099,2848,16875,23,33,1,108
Monroe,11/16/20,4,95,95,269,3542,240,3816,25,7249,253,16,3443,99,226,14,4,0,23,2,3696,120,253,3443,21,99,274,3542,2,2,0,35
Montgomery,11/16/20,10,97,97,219,3367,188,3586,21,8993,212,7,2838,529,184,4,9,1,19,2,3050,536,212,2838,7,529,219,3367,2,1,0,24
Nevada,11/16/20,14,99,99,390,5777,339,6168,37,8440,350,40,5621,156,308,31,13,1,29,8,5971,197,350,5621,41,156,391,5777,1,3,0,102
Newton,11/16/20,22,101,101,376,3034,321,3405,33,7848,335,41,2387,647,292,29,19,3,24,9,2722,683,335,2387,36,647,371,3034,2,6,0,27
Ouachita,11/16/20,11,103,103,507,8364,413,8891,82,24106,472,35,8058,306,390,23,11,0,70,12,8530,361,472,8058,55,306,527,8364,13,9,0,85
Perry,11/16/20,3,105,105,201,5546,169,5754,29,10322,184,17,5336,210,158,11,3,0,23,6,5520,234,184,5336,24,210,208,5546,4,4,0,36
Phillips,11/16/20,16,107,107,840,9741,785,10603,39,19034,810,30,9517,224,763,22,16,0,31,8,10327,276,810,9517,52,224,862,9741,5,9,0,68
Pike,11/16/20,1,109,109,320,3198,286,3518,33,10808,294,26,2992,206,271,15,0,1,23,10,3286,232,294,2992,26,206,320,3198,3,2,0,30
Poinsett,11/16/20,37,111,111,1475,13736,1227,15250,211,24054,1336,139,13282,454,1125,102,32,5,179,32,14618,632,1336,13282,178,454,1514,13736,9,15,4,101
Polk,11/16/20,6,113,113,584,6781,421,7378,157,20163,542,42,6518,263,390,31,6,0,146,11,7060,318,542,6518,55,263,597,6781,17,15,0,143
Pope,11/16/20,39,115,115,3247,34650,2893,37915,315,63644,2928,319,33617,1033,2678,215,35,4,215,100,36545,1370,2928,33617,337,1033,3265,34650,34,25,0,594
Prairie,11/16/20,5,117,117,319,3574,265,3907,49,8244,263,56,3194,380,225,40,5,0,33,16,3457,450,263,3194,70,380,333,3574,2,5,0,24
Pulaski,11/16/20,237,119,119,14527,200523,12614,215276,1674,393463,13531,996,191802,8721,11898,716,222,15,1409,265,205333,9943,13531,191802,1222,8721,14753,200523,136,108,1,1749
Randolph,11/16/20,28,121,121,845,8487,702,9368,115,17603,670,175,7650,837,546,156,22,6,102,13,8320,1048,670,7650,211,837,881,8487,17,14,0,89
Saline,11/16/20,47,125,125,3890,48600,3226,52599,616,118009,3320,570,44333,4267,2863,363,45,2,411,205,47653,4946,3320,44333,679,4267,3999,48600,45,72,1,715
Scott,11/16/20,2,127,127,301,5211,249,5515,50,10442,250,51,5082,129,222,27,2,0,26,24,5332,183,250,5082,54,129,304,5211,3,2,0,56
Searcy,11/16/20,1,129,129,257,3584,222,3840,34,7923,221,36,3206,378,204,18,1,0,16,18,3427,413,221,3206,35,378,256,3584,-1,1,0,13
Sebastian,11/16/20,113,131,131,6179,73469,5229,79678,836,127461,5699,480,72356,1113,4930,299,105,8,663,173,78055,1623,5699,72356,510,1113,6209,73469,62,47,2,1179
Sevier,11/16/20,16,133,133,1586,8472,1472,10078,98,17193,1341,245,7706,766,1279,193,16,0,46,52,9047,1031,1341,7706,265,766,1606,8472,9,14,0,74
Sharp,11/16/20,13,135,135,544,7198,398,7761,133,17043,432,112,6685,513,327,71,13,0,92,41,7117,644,432,6685,131,513,563,7198,18,7,0,150
St.Francis,11/16/20,12,123,123,1920,15829,1814,17762,94,26294,1878,42,15678,151,1781,33,12,0,85,9,17556,206,1878,15678,55,151,1933,15829,10,8,1,105
Stone,11/16/20,22,137,137,430,4850,392,5285,16,12446,412,18,4628,222,375,17,22,0,15,1,5040,245,412,4628,23,222,435,4850,0,1,0,31
Union,11/16/20,55,139,139,1347,13320,1210,14697,82,39732,1170,177,11775,1545,1061,149,48,7,61,21,12945,1752,1170,11775,207,1545,1377,13320,11,10,1,87
VanBuren,11/16/20,3,141,141,273,6348,233,6636,37,16684,255,18,5924,424,221,12,3,0,31,6,6179,457,255,5924,33,424,288,6348,3,2,0,30
Washington,11/16/20,166,143,143,13639,114675,12138,128568,1334,228529,11785,1854,105370,9305,10784,1354,148,18,853,481,117155,11413,11785,105370,2108,9305,13893,114675,165,119,2,1370
White,11/16/20,44,145,145,2349,26256,1759,28688,546,78804,1846,503,23216,3040,1460,299,39,5,347,199,25062,3626,1846,23216,586,3040,2432,26256,35,43,2,167
Woodruff,11/16/20,0,147,147,170,2732,149,2906,21,6660,145,25,2617,115,128,21,0,0,17,4,2762,144,145,2617,29,115,174,2732,2,2,0,30
Yell,11/16/20,33,149,149,1507,15617,1350,17127,124,21573,1455,52,15306,311,1330,20,30,3,95,29,16761,366,1455,15306,55,311,1510,15617,3,5,0,134
Arkansas_all_counties,11/15/20,2183,5630,5630,133040,1466080,114312,1601368,16531,2990671,118843,14197,1386711,79369,104627,9685,2000,183,12203,4328,1505554,95814,118843,1386711,16445,79369,135288,1466080,874,872,24,9697
Arkansas_county,11/15/20,20,1,1,838,10802,727,11688,91,18124,686,152,8595,2207,617,110,20,0,49,42,9281,2407,686,8595,200,2207,886,10802,5,11,0,55
Ashley,11/15/20,13,3,3,679,7343,585,8041,81,20537,621,58,7047,296,550,35,13,0,58,23,7668,373,621,7047,77,296,698,7343,4,7,0,26
Baxter,11/15/20,19,5,5,1089,8377,824,9477,246,41219,856,233,7645,732,666,158,19,0,171,75,8501,976,856,7645,244,732,1100,8377,10,9,2,68
Benton,11/15/20,135,7,7,10354,100072,8845,110590,1373,258980,8951,1403,96258,3814,7938,907,117,18,895,478,105209,5381,8951,96258,1567,3814,10518,100072,69,98,1,384
Boone,11/15/20,40,9,9,1363,16404,1103,17807,220,37288,1175,188,15953,451,969,134,38,2,168,52,17128,679,1175,15953,228,451,1403,16404,13,10,0,98
Bradley,11/15/20,8,11,11,392,5140,369,5534,15,10948,372,20,4272,868,358,11,7,1,7,8,4644,890,372,4272,22,868,394,5140,-1,2,0,22
Calhoun,11/15/20,0,13,13,104,2122,67,2228,37,5202,94,10,2059,63,61,6,0,0,33,4,2153,75,94,2059,12,63,106,2122,-1,2,0,3
Carroll,11/15/20,21,15,15,1171,10156,1043,11339,107,27887,1109,62,10023,133,997,46,21,0,91,16,11132,207,1109,10023,74,133,1183,10156,1,1,0,30
Chicot,11/15/20,24,17,17,1090,6573,1036,7668,30,10826,1067,23,6230,343,1020,16,23,1,24,6,7297,371,1067,6230,28,343,1095,6573,2,1,0,41
Clark,11/15/20,6,19,19,683,11124,556,11830,121,22385,585,98,9908,1216,490,66,6,0,89,32,10493,1337,585,9908,121,1216,706,11124,5,5,0,47
Clay,11/15/20,18,21,21,680,7743,519,8441,142,15061,577,103,6379,1364,466,53,15,3,95,47,6956,1485,577,6379,121,1364,698,7743,10,5,0,52
Cleburne,11/15/20,18,23,23,598,10426,506,11032,74,25230,506,92,9342,1084,441,65,18,0,47,27,9848,1184,506,9342,100,1084,606,10426,5,4,0,80
Cleveland,11/15/20,13,25,25,301,4368,255,4676,33,8226,254,47,4212,156,225,30,12,1,17,16,4466,210,254,4212,54,156,308,4368,3,3,0,18
Columbia,11/15/20,22,27,27,870,8375,762,9288,86,23892,701,169,7495,880,635,127,22,0,44,42,8196,1092,701,7495,212,880,913,8375,5,4,0,21
Conway,11/15/20,6,29,29,500,9581,372,10087,122,20906,456,44,9081,500,346,26,6,0,104,18,9537,550,456,9081,50,500,506,9581,14,1,0,99
Craighead,11/15/20,62,31,31,5993,56853,5110,62956,820,105701,5471,522,52304,4549,4758,352,58,4,654,166,57775,5181,5471,52304,632,4549,6103,56853,40,63,2,375
Crawford,11/15/20,33,33,33,2646,32521,2240,35177,373,62472,2418,228,31938,583,2103,137,31,2,284,89,34356,821,2418,31938,238,583,2656,32521,33,23,0,204
Crittenden,11/15/20,54,35,35,2879,19146,2580,22039,244,49013,2748,131,18757,389,2485,95,47,7,215,29,21505,534,2748,18757,145,389,2893,19146,3,15,1,90
Cross,11/15/20,24,37,37,675,7383,603,8061,48,16998,594,81,7063,320,539,64,22,2,33,15,7657,404,594,7063,84,320,678,7383,3,4,0,37
Dallas,11/15/20,6,39,39,232,3152,184,3385,42,7432,225,7,3053,99,181,3,6,0,38,4,3278,107,225,3053,8,99,233,3152,3,0,0,18
Desha,11/15/20,8,41,41,479,5627,433,6123,38,11887,444,35,5362,265,408,25,7,1,29,9,5806,317,444,5362,52,265,496,5627,3,7,0,28
Drew,11/15/20,7,43,43,515,8711,453,9233,55,18502,460,55,7838,873,419,34,6,1,35,20,8298,935,460,7838,62,873,522,8711,4,6,0,63
Faulkner,11/15/20,43,45,45,4100,57469,3587,61644,470,122416,3700,400,53843,3626,3295,292,38,5,367,103,57543,4101,3700,53843,475,3626,4175,57469,28,28,-1,297
Franklin,11/15/20,5,47,47,660,10012,589,10693,66,17780,587,73,9750,262,532,57,5,0,50,16,10337,356,587,9750,94,262,681,10012,3,4,1,26
Fulton,11/15/20,12,49,49,434,3252,352,3699,70,12139,343,91,2695,557,296,56,10,2,37,33,3038,661,343,2695,104,557,447,3252,4,2,0,22
Garland,11/15/20,86,51,51,3210,44937,2679,48188,445,98296,3006,204,43474,1463,2544,135,81,5,381,64,46480,1708,3006,43474,245,1463,3251,44937,10,11,3,115
Grant,11/15/20,5,53,53,464,7764,388,8238,71,18086,408,56,7152,612,352,36,4,1,52,19,7560,678,408,7152,66,612,474,7764,11,3,1,32
Greene,11/15/20,25,55,55,2192,23224,1753,25461,414,44623,1835,357,21240,1984,1538,215,23,2,274,140,23075,2386,1835,21240,402,1984,2237,23224,3,17,1,50
Hempstead,11/15/20,6,57,57,722,7928,629,8669,87,22018,620,102,7637,291,551,78,6,0,63,24,8257,412,620,7637,121,291,741,7928,3,1,0,33
HotSpring,11/15/20,40,59,59,2591,20619,2277,23230,274,33520,2529,62,19603,1016,2245,32,38,2,246,28,22132,1098,2529,19603,82,1016,2611,20619,17,5,1,153
Howard,11/15/20,15,61,61,721,4981,632,5713,74,13389,612,109,4421,560,555,77,15,0,42,32,5033,680,612,4421,120,560,732,4981,6,5,0,47
Independence,11/15/20,68,63,63,1852,17191,1506,19085,278,37264,1459,393,16344,847,1214,292,58,10,187,91,17803,1282,1459,16344,435,847,1894,17191,9,7,0,27
Izard,11/15/20,4,65,65,886,7098,686,7997,196,13559,806,80,6207,891,633,53,4,0,169,27,7013,984,806,6207,93,891,899,7098,2,4,0,20
Jackson,11/15/20,6,67,67,1268,11958,935,13307,327,17225,1003,265,11145,813,715,220,5,1,283,44,12148,1159,1003,11145,346,813,1349,11958,9,5,0,26
Jefferson,11/15/20,104,69,69,4758,45204,4241,50075,411,70424,4490,268,44254,950,4092,149,99,5,297,114,48744,1331,4490,44254,381,950,4871,45204,10,13,1,122
Johnson,11/15/20,11,71,71,1142,11735,1068,12887,63,26291,1079,63,11368,367,1021,47,10,1,48,15,12447,440,1079,11368,73,367,1152,11735,7,13,0,62
Lafayette,11/15/20,3,73,73,230,1710,208,1951,19,6915,192,38,1629,81,176,32,3,0,13,6,1821,130,192,1629,49,81,241,1710,1,1,0,6
Lawrence,11/15/20,26,75,75,1018,7141,893,8179,99,16669,888,130,6800,341,789,104,26,0,73,26,7688,491,888,6800,150,341,1038,7141,3,9,1,66
Lee,11/15/20,18,77,77,1136,5676,1095,6816,23,9398,1125,11,5617,59,1089,6,17,1,19,4,6742,74,1125,5617,15,59,1140,5676,0,2,0,11
Lincoln,11/15/20,18,79,79,2364,10419,2319,12795,27,13695,2334,30,10271,148,2295,24,17,1,22,5,12605,190,2334,10271,42,148,2376,10419,-1,0,0,90
LittleRiver,11/15/20,39,81,81,558,2777,469,3334,50,12417,476,82,2553,224,416,53,34,5,26,24,3029,305,476,2553,81,224,557,2777,2,1,0,13
Logan,11/15/20,5,83,83,741,11789,622,12542,114,21757,691,50,10823,966,596,26,5,0,90,24,11514,1028,691,10823,62,966,753,11789,11,2,0,46
Lonoke,11/15/20,36,85,85,2266,32226,1905,34599,325,72206,1796,470,28267,3959,1542,363,34,2,220,105,30063,4536,1796,28267,577,3959,2373,32226,10,14,0,129
Madison,11/15/20,6,87,87,526,6195,453,6733,67,16076,477,49,5901,294,420,33,6,0,51,16,6378,355,477,5901,61,294,538,6195,3,4,0,33
Marion,11/15/20,2,89,89,293,4233,196,4531,95,16438,242,51,3928,305,164,32,1,1,77,18,4170,361,242,3928,56,305,298,4233,17,8,0,57
Miller,11/15/20,22,91,91,1894,10011,1715,11945,157,43759,1476,418,9465,546,1366,349,16,6,94,63,10941,1004,1476,9465,458,546,1934,10011,3,28,0,55
MissingCountyInfo,11/15/20,0,5,5,2166,81897,1359,84086,807,NA,1881,285,81873,24,1182,177,0,0,699,108,83754,332,1881,81873,308,24,2189,81897,60,11,0,2164
Mississippi,11/15/20,75,93,93,2818,16790,2431,19610,311,42831,2613,205,15700,1090,2294,137,62,13,256,55,18313,1297,2613,15700,207,1090,2820,16790,14,21,0,73
Monroe,11/15/20,4,95,95,267,3509,238,3780,25,7249,251,16,3410,99,225,13,4,0,22,3,3661,119,251,3410,20,99,271,3509,5,4,0,22
Montgomery,11/15/20,10,97,97,217,3345,187,3562,20,8993,210,7,2816,529,183,4,9,1,18,2,3026,536,210,2816,7,529,217,3345,2,1,1,11
Nevada,11/15/20,14,99,99,389,5676,336,6065,39,8440,348,41,5524,152,305,31,13,1,30,9,5872,193,348,5524,41,152,389,5676,3,4,0,16
Newton,11/15/20,22,101,101,374,3009,315,3378,37,7848,333,41,2363,646,287,28,19,3,27,10,2696,682,333,2363,36,646,369,3009,2,1,1,10
Ouachita,11/15/20,11,103,103,494,8292,404,8806,78,24106,459,35,7990,302,383,21,11,0,64,14,8449,357,459,7990,55,302,514,8292,4,2,2,28
Perry,11/15/20,3,105,105,197,5514,165,5718,29,10322,180,17,5304,210,154,11,3,0,23,6,5484,234,180,5304,24,210,204,5514,0,4,0,27
Phillips,11/15/20,16,107,107,835,9678,776,10535,43,19034,806,29,9459,219,755,21,16,0,35,8,10265,270,806,9459,51,219,857,9678,1,2,0,4
Pike,11/15/20,1,109,109,317,3171,284,3488,32,10808,291,26,2974,197,270,14,0,1,21,11,3265,223,291,2974,26,197,317,3171,1,-1,0,16
Poinsett,11/15/20,33,111,111,1466,13644,1212,15147,221,24054,1328,138,13196,448,1115,97,30,3,183,38,14524,623,1328,13196,175,448,1503,13644,15,11,1,75
Polk,11/15/20,6,113,113,567,6655,406,7234,155,20163,525,42,6394,261,380,26,6,0,139,16,6919,315,525,6394,54,261,579,6655,12,12,0,80
Pope,11/15/20,39,115,115,3213,34090,2868,37321,306,63644,2895,318,33067,1023,2662,206,35,4,198,108,35962,1359,2895,33067,336,1023,3231,34090,12,15,0,135
Prairie,11/15/20,5,117,117,317,3552,260,3882,52,8244,263,54,3174,378,222,38,5,0,36,16,3437,445,263,3174,67,378,330,3552,5,3,0,27
Pulaski,11/15/20,236,119,119,14391,198910,12506,213522,1647,393463,13391,1000,190283,8627,11804,702,221,15,1364,283,203674,9848,13391,190283,1221,8627,14612,198910,135,79,1,1934
Randolph,11/15/20,28,121,121,828,8415,688,9276,112,17603,654,174,7592,823,536,152,22,6,96,16,8246,1030,654,7592,207,823,861,8415,2,3,1,36
Saline,11/15/20,46,125,125,3845,47930,3154,51882,644,118009,3275,570,43742,4188,2821,333,44,2,409,235,47017,4865,3275,43742,677,4188,3952,47930,25,41,0,194
Scott,11/15/20,2,127,127,298,5158,247,5459,49,10442,247,51,5028,130,221,26,2,0,24,25,5275,184,247,5028,54,130,301,5158,1,6,0,14
Searcy,11/15/20,1,129,129,258,3570,221,3827,36,7923,220,38,3194,376,203,18,1,0,16,20,3414,413,220,3194,37,376,257,3570,2,2,0,8
Sebastian,11/15/20,111,131,131,6117,72352,5182,78498,822,127461,5645,472,71275,1077,4896,286,103,8,644,178,76920,1578,5645,71275,501,1077,6146,72352,50,49,1,420
Sevier,11/15/20,16,133,133,1577,8407,1458,10002,103,17193,1335,242,7667,740,1272,186,16,0,47,56,9002,1000,1335,7667,260,740,1595,8407,6,14,0,27
Sharp,11/15/20,13,135,135,526,7066,391,7607,122,17043,411,115,6557,509,323,68,13,0,75,47,6968,639,411,6557,130,509,541,7066,6,8,0,23
St.Francis,11/15/20,11,123,123,1910,15734,1806,17657,93,26294,1868,42,15584,150,1774,32,11,0,83,10,17452,205,1868,15584,55,150,1923,15734,7,5,0,49
Stone,11/15/20,22,137,137,430,4819,391,5254,17,12446,412,18,4600,219,374,17,22,0,16,1,5012,242,412,4600,23,219,435,4819,2,0,0,23
Union,11/15/20,54,139,139,1336,13244,1200,14610,82,39732,1161,175,11706,1538,1055,145,47,7,59,23,12867,1743,1161,11706,205,1538,1366,13244,3,9,0,15
VanBuren,11/15/20,3,141,141,270,6321,231,6606,36,16684,253,17,5905,416,220,11,3,0,30,6,6158,448,253,5905,32,416,285,6321,4,1,0,27
Washington,11/15/20,164,143,143,13474,113470,12019,127161,1290,228529,11627,1847,104265,9205,10717,1302,146,18,764,526,115892,11269,11627,104265,2064,9205,13691,113470,49,82,1,616
White,11/15/20,42,145,145,2314,26124,1716,28515,556,78804,1823,491,23095,3029,1433,283,37,5,353,203,24918,3597,1823,23095,568,3029,2391,26124,33,9,1,103
Woodruff,11/15/20,0,147,147,168,2704,147,2876,21,6660,143,25,2589,115,126,21,0,0,17,4,2732,144,143,2589,29,115,172,2704,1,1,0,23
Yell,11/15/20,33,149,149,1504,15486,1345,16993,126,21573,1451,53,15184,302,1327,18,30,3,94,32,16635,358,1451,15184,56,302,1507,15486,8,5,0,100
Arkansas_all_counties,11/14/20,2159,5630,5630,132166,1457257,113440,1591588,16553,2990671,118136,14030,1378534,78723,103997,9443,1979,180,12147,4406,1496670,94918,118136,1378534,16195,78723,134331,1457257,1848,1057,11,15576
Arkansas_county,11/14/20,20,1,1,833,10752,716,11633,97,18124,683,150,8547,2205,609,107,20,0,54,43,9230,2403,683,8547,198,2205,881,10752,15,9,0,124
Ashley,11/14/20,13,3,3,675,7321,578,8010,84,20537,617,58,7026,295,546,32,13,0,58,26,7643,367,617,7026,72,295,689,7321,3,7,0,25
Baxter,11/14/20,17,5,5,1079,8319,815,9410,247,41219,847,232,7593,726,659,156,17,0,171,76,8440,970,847,7593,244,726,1091,8319,30,20,0,106
Benton,11/14/20,134,7,7,10285,99757,8747,110201,1403,258980,8900,1385,95996,3761,7877,870,117,17,905,498,104896,5305,8900,95996,1544,3761,10444,99757,158,73,1,555
Boone,11/14/20,40,9,9,1350,16319,1093,17707,217,37288,1170,180,15886,433,963,130,38,2,169,48,17056,651,1170,15886,218,433,1388,16319,23,7,0,71
Bradley,11/14/20,8,11,11,393,5117,367,5511,18,10948,373,20,4249,868,357,10,7,1,9,9,4622,889,373,4249,21,868,394,5117,2,0,0,33
Calhoun,11/14/20,0,13,13,105,2118,65,2225,40,5202,94,11,2055,63,59,6,0,0,35,5,2149,76,94,2055,13,63,107,2118,5,3,0,16
Carroll,11/14/20,21,15,15,1170,10127,1042,11309,107,27887,1108,62,9995,132,996,46,21,0,91,16,11103,206,1108,9995,74,132,1182,10127,14,6,0,79
Chicot,11/14/20,24,17,17,1088,6534,1035,7627,29,10826,1065,23,6203,331,1019,16,23,1,23,6,7268,359,1065,6203,28,331,1093,6534,6,1,0,45
Clark,11/14/20,6,19,19,678,11082,551,11783,121,22385,581,97,9869,1213,485,66,6,0,90,31,10450,1333,581,9869,120,1213,701,11082,11,7,0,86
Clay,11/14/20,18,21,21,670,7701,514,8388,137,15061,568,102,6343,1358,465,49,15,3,87,50,6911,1477,568,6343,119,1358,687,7701,18,8,1,106
Cleburne,11/14/20,18,23,23,593,10351,502,10952,73,25230,502,91,9288,1063,438,64,18,0,46,27,9790,1162,502,9288,99,1063,601,10351,12,4,0,123
Cleveland,11/14/20,13,25,25,298,4353,252,4658,33,8226,251,47,4197,156,225,27,12,1,14,19,4448,210,251,4197,54,156,305,4353,1,3,0,69
Columbia,11/14/20,22,27,27,865,8359,758,9267,85,23892,698,167,7485,874,632,126,22,0,44,41,8183,1084,698,7485,210,874,908,8359,13,8,0,46
Conway,11/14/20,6,29,29,486,9496,371,9987,109,20906,446,40,8996,500,345,26,6,0,95,14,9442,545,446,8996,45,500,491,9496,20,5,1,152
Craighead,11/14/20,60,31,31,5953,56518,5047,62578,845,105701,5436,517,51976,4542,4707,340,56,4,672,173,57412,5166,5436,51976,624,4542,6060,56518,68,65,1,705
Crawford,11/14/20,33,33,33,2613,32350,2217,34973,363,62472,2395,218,31779,571,2082,135,31,2,282,81,34174,799,2395,31779,228,571,2623,32350,34,23,0,217
Crittenden,11/14/20,53,35,35,2876,19059,2565,21948,257,49013,2744,132,18670,389,2474,91,46,7,223,34,21414,534,2744,18670,145,389,2889,19059,26,22,0,107
Cross,11/14/20,24,37,37,672,7349,599,8024,49,16998,591,81,7033,316,536,63,22,2,33,16,7624,400,591,7033,84,316,675,7349,9,2,0,41
Dallas,11/14/20,6,39,39,229,3137,184,3367,39,7432,223,6,3038,99,181,3,6,0,36,3,3261,106,223,3038,7,99,230,3137,5,0,0,51
Desha,11/14/20,8,41,41,476,5602,426,6095,42,11887,442,34,5337,265,402,24,7,1,33,9,5779,316,442,5337,51,265,493,5602,4,3,0,24
Drew,11/14/20,7,43,43,511,8652,447,9170,57,18502,456,55,7779,873,416,31,6,1,34,23,8235,935,456,7779,62,873,518,8652,8,4,0,27
Faulkner,11/14/20,44,45,45,4072,57200,3559,61343,469,122416,3672,400,53601,3599,3276,283,38,6,358,111,57273,4070,3672,53601,471,3599,4143,57200,63,26,0,701
Franklin,11/14/20,4,47,47,657,9989,585,10666,68,17780,585,72,9728,261,529,56,4,0,52,16,10313,353,585,9728,92,261,677,9989,11,5,0,82
Fulton,11/14/20,12,49,49,430,3234,350,3677,68,12139,341,89,2677,557,296,54,10,2,35,33,3018,659,341,2677,102,557,443,3234,7,3,0,20
Garland,11/14/20,83,51,51,3200,44832,2668,48069,449,98296,2993,207,43389,1443,2537,131,78,5,378,71,46382,1687,2993,43389,244,1443,3237,44832,36,29,1,233
Grant,11/14/20,4,53,53,453,7743,385,8206,64,18086,397,56,7130,613,350,35,4,0,43,21,7527,679,397,7130,66,613,463,7743,14,4,0,74
Greene,11/14/20,24,55,55,2189,23177,1736,25411,429,44623,1830,359,21195,1982,1526,210,22,2,282,147,23025,2386,1830,21195,404,1982,2234,23177,59,28,0,217
Hempstead,11/14/20,6,57,57,719,7898,628,8636,85,22018,617,102,7608,290,550,78,6,0,61,24,8225,411,617,7608,121,290,738,7898,8,8,1,150
HotSpring,11/14/20,39,59,59,2574,20483,2272,23077,263,33520,2514,60,19468,1015,2240,32,37,2,237,26,21982,1095,2514,19468,80,1015,2594,20483,23,39,0,246
Howard,11/14/20,15,61,61,715,4940,627,5666,73,13389,606,109,4406,534,551,76,15,0,40,33,5012,654,606,4406,120,534,726,4940,6,4,0,101
Independence,11/14/20,68,63,63,1843,17173,1499,19058,276,37264,1455,388,16331,842,1210,289,58,10,187,89,17786,1272,1455,16331,430,842,1885,17173,19,6,0,84
Izard,11/14/20,4,65,65,884,7080,682,7977,198,13559,804,80,6190,890,631,51,4,0,169,29,6994,983,804,6190,93,890,897,7080,15,47,0,371
Jackson,11/14/20,6,67,67,1259,11941,930,13281,323,17225,998,261,11128,813,711,219,5,1,282,41,12126,1155,998,11128,342,813,1340,11941,39,7,0,150
Jefferson,11/14/20,103,69,69,4748,45092,4228,49952,415,70424,4481,267,44145,947,4081,147,98,5,300,115,48626,1326,4481,44145,379,947,4860,45092,34,17,0,282
Johnson,11/14/20,11,71,71,1135,11680,1055,12825,69,26291,1073,62,11314,366,1011,44,10,1,52,17,12387,438,1073,11314,72,366,1145,11680,6,-2,0,146
Lafayette,11/14/20,3,73,73,229,1705,207,1945,19,6915,191,38,1624,81,175,32,3,0,13,6,1815,130,191,1624,49,81,240,1705,1,2,0,21
Lawrence,11/14/20,25,75,75,1015,7078,884,8113,106,16669,886,129,6751,327,786,98,25,0,75,31,7637,476,886,6751,149,327,1035,7078,17,7,0,58
Lee,11/14/20,18,77,77,1136,5665,1093,6805,25,9398,1125,11,5606,59,1088,5,17,1,20,5,6731,74,1125,5606,15,59,1140,5665,6,0,0,76
Lincoln,11/14/20,18,79,79,2365,10328,2319,12705,28,13695,2334,31,10180,148,2295,24,17,1,22,6,12514,191,2334,10180,43,148,2377,10328,0,2,0,12
LittleRiver,11/14/20,39,81,81,556,2766,468,3320,49,12417,474,82,2544,222,415,53,34,5,25,24,3018,302,474,2544,80,222,554,2766,9,2,0,50
Logan,11/14/20,5,83,83,730,11754,620,12496,105,21757,680,50,10788,966,595,25,5,0,80,25,11468,1028,680,10788,62,966,742,11754,10,5,0,58
Lonoke,11/14/20,36,85,85,2256,32107,1891,34469,329,72206,1785,471,28149,3958,1532,359,34,2,219,110,29934,4535,1785,28149,577,3958,2362,32107,33,19,0,229
Madison,11/14/20,6,87,87,523,6165,449,6698,68,16076,476,47,5880,285,416,33,6,0,54,14,6356,342,476,5880,57,285,533,6165,11,2,0,138
Marion,11/14/20,2,89,89,276,4193,188,4474,86,16438,230,46,3889,304,162,26,1,1,67,19,4119,355,230,3889,51,304,281,4193,14,1,0,41
Miller,11/14/20,22,91,91,1891,9959,1687,11888,182,43759,1474,417,9414,545,1348,339,16,6,110,72,10888,1000,1474,9414,455,545,1929,9959,9,25,0,61
MissingCountyInfo,11/14/20,0,5,5,2106,79793,1348,81893,758,NA,1823,283,79769,24,1176,172,0,0,647,111,81592,301,1823,79769,277,24,2100,79793,-32,-4,0,3237
Mississippi,11/14/20,75,93,93,2804,16731,2410,19537,318,42831,2600,204,15641,1090,2274,136,62,13,263,55,18241,1296,2600,15641,206,1090,2806,16731,33,28,2,130
Monroe,11/14/20,4,95,95,262,3492,234,3758,24,7249,247,15,3393,99,221,13,4,0,22,2,3640,118,247,3393,19,99,266,3492,1,4,0,33
Montgomery,11/14/20,9,97,97,215,3336,186,3552,20,8993,209,6,2807,529,182,4,9,0,18,2,3016,536,209,2807,7,529,216,3336,2,1,0,10
Nevada,11/14/20,14,99,99,386,5663,332,6051,40,8440,347,39,5511,152,301,31,13,1,33,7,5858,193,347,5511,41,152,388,5663,5,7,0,59
Newton,11/14/20,21,101,101,372,3001,314,3368,37,7848,331,41,2355,646,286,28,18,3,27,10,2686,682,331,2355,36,646,367,3001,8,3,0,10
Ouachita,11/14/20,9,103,103,490,8268,402,8776,78,24106,455,35,7966,302,381,21,9,0,64,14,8421,355,455,7966,53,302,508,8268,9,4,0,44
Perry,11/14/20,3,105,105,197,5487,161,5690,33,10322,179,18,5279,208,150,11,3,0,26,7,5458,232,179,5279,24,208,203,5487,3,3,0,44
Phillips,11/14/20,16,107,107,834,9675,774,10531,44,19034,805,29,9455,220,753,21,16,0,36,8,10260,271,805,9455,51,220,856,9675,4,3,0,36
Pike,11/14/20,1,109,109,316,3156,285,3471,30,10808,292,24,2959,197,271,14,0,1,21,9,3251,220,292,2959,23,197,315,3156,4,1,0,21
Poinsett,11/14/20,32,111,111,1451,13584,1201,15072,218,24054,1314,137,13138,446,1107,94,30,2,177,41,14452,620,1314,13138,174,446,1488,13584,12,24,0,110
Polk,11/14/20,6,113,113,555,6587,394,7154,155,20163,514,41,6328,259,372,22,6,0,136,19,6842,312,514,6328,53,259,567,6587,16,6,1,82
Pope,11/14/20,39,115,115,3201,33967,2853,37186,309,63644,2884,317,32948,1019,2654,199,35,4,195,114,35832,1354,2884,32948,335,1019,3219,33967,54,23,0,249
Prairie,11/14/20,5,117,117,312,3530,257,3855,50,8244,259,53,3153,377,219,38,5,0,35,15,3412,443,259,3153,66,377,325,3530,4,10,0,34
Pulaski,11/14/20,235,119,119,14256,197111,12427,211585,1592,393463,13262,994,188607,8504,11736,691,220,15,1304,288,201869,9716,13262,188607,1212,8504,14474,197111,205,112,1,2208
Randolph,11/14/20,27,121,121,826,8381,685,9240,114,17603,653,173,7560,821,533,152,21,6,99,15,8213,1027,653,7560,206,821,859,8381,11,3,0,54
Saline,11/14/20,46,125,125,3820,47761,3113,51686,660,118009,3256,564,43584,4177,2788,325,44,2,423,237,46840,4846,3256,43584,669,4177,3925,47761,93,28,0,519
Scott,11/14/20,2,127,127,297,5145,241,5445,54,10442,247,50,5016,129,217,24,2,0,28,26,5263,182,247,5016,53,129,300,5145,4,5,0,20
Searcy,11/14/20,1,129,129,256,3564,219,3819,36,7923,220,36,3188,376,202,17,1,0,17,19,3408,411,220,3188,35,376,255,3564,5,0,0,14
Sebastian,11/14/20,110,131,131,6067,71982,5133,78076,822,127461,5611,456,70931,1051,4859,274,102,8,648,174,76542,1534,5611,70931,483,1051,6094,71982,83,69,0,355
Sevier,11/14/20,16,133,133,1571,8386,1444,9975,111,17193,1333,238,7651,735,1268,176,16,0,49,62,8984,991,1333,7651,256,735,1589,8386,6,10,0,122
Sharp,11/14/20,13,135,135,520,7049,383,7582,124,17043,404,116,6542,507,318,65,13,0,73,51,6946,636,404,6542,129,507,533,7049,16,6,0,60
St.Francis,11/14/20,11,123,123,1903,15692,1801,17608,91,26294,1861,42,15544,148,1769,32,11,0,81,10,17405,203,1861,15544,55,148,1916,15692,10,6,0,82
Stone,11/14/20,22,137,137,428,4798,391,5231,15,12446,410,18,4585,213,374,17,22,0,14,1,4995,236,410,4585,23,213,433,4798,3,2,0,25
Union,11/14/20,54,139,139,1333,13232,1191,14595,88,39732,1160,173,11693,1539,1047,144,47,7,66,22,12853,1742,1160,11693,203,1539,1363,13232,13,12,0,69
VanBuren,11/14/20,3,141,141,266,6298,230,6579,33,16684,249,17,5882,416,219,11,3,0,27,6,6131,448,249,5882,32,416,281,6298,2,0,0,38
Washington,11/14/20,163,143,143,13425,112903,11937,126542,1324,228529,11602,1823,103881,9022,10659,1278,145,18,798,526,115483,11059,11602,103881,2037,9022,13639,112903,236,71,1,1169
White,11/14/20,41,145,145,2281,26054,1707,28406,533,78804,1814,467,23034,3020,1428,279,36,5,350,183,24848,3558,1814,23034,538,3020,2352,26054,81,43,0,225
Woodruff,11/14/20,0,147,147,167,2682,146,2853,21,6660,143,24,2567,115,125,21,0,0,18,3,2710,143,143,2567,28,115,171,2682,5,7,0,36
Yell,11/14/20,33,149,149,1496,15394,1340,16892,123,21573,1441,55,15092,302,1324,16,30,3,87,36,16533,359,1441,15092,57,302,1498,15394,17,4,0,72
Arkansas_all_counties,11/13/20,2148,5630,5630,130318,1443529,112383,1575894,15773,2990671,116787,13531,1367077,76452,103151,9232,1968,180,11655,4118,1483864,92030,116787,1367077,15578,76452,132365,1443529,2312,1026,4,17760
Arkansas_county,11/13/20,20,1,1,818,10643,707,11501,91,18124,673,145,8497,2146,606,101,20,0,47,44,9170,2331,673,8497,185,2146,858,10643,11,9,0,96
Ashley,11/13/20,13,3,3,672,7299,571,7985,88,20537,616,56,7009,290,539,32,13,0,64,24,7625,360,616,7009,70,290,686,7299,29,9,0,98
Baxter,11/13/20,17,5,5,1049,8243,795,9304,237,41219,825,224,7524,719,646,149,17,0,162,75,8349,955,825,7524,236,719,1061,8243,33,7,1,220
Benton,11/13/20,133,7,7,10127,99360,8674,109629,1319,258980,8807,1320,95715,3645,7827,847,116,17,863,456,104522,5107,8807,95715,1462,3645,10269,99360,150,79,0,886
Boone,11/13/20,40,9,9,1327,16271,1086,17635,201,37288,1151,176,15860,411,956,130,38,2,157,44,17011,624,1151,15860,213,411,1364,16271,19,6,0,94
Bradley,11/13/20,8,11,11,391,5086,367,5478,16,10948,371,20,4225,861,357,10,7,1,7,9,4596,882,371,4225,21,861,392,5086,1,1,0,28
Calhoun,11/13/20,0,13,13,100,2107,62,2209,38,5202,91,9,2044,63,56,6,0,0,35,3,2135,74,91,2044,11,63,102,2107,5,1,0,15
Carroll,11/13/20,21,15,15,1156,10062,1036,11230,99,27887,1095,61,9934,128,990,46,21,0,84,15,11029,201,1095,9934,73,128,1168,10062,15,5,1,57
Chicot,11/13/20,24,17,17,1082,6495,1034,7582,24,10826,1059,23,6165,330,1018,16,23,1,18,6,7224,358,1059,6165,28,330,1087,6495,9,0,0,36
Clark,11/13/20,6,19,19,667,11007,544,11697,117,22385,578,89,9812,1195,482,62,6,0,90,27,10390,1307,578,9812,112,1195,690,11007,19,8,0,180
Clay,11/13/20,17,21,21,652,7613,506,8281,128,15061,552,100,6307,1306,460,46,14,3,77,51,6859,1422,552,6307,116,1306,668,7613,43,3,0,367
Cleburne,11/13/20,18,23,23,581,10240,498,10828,65,25230,492,89,9214,1026,436,62,18,0,38,27,9706,1122,492,9214,96,1026,588,10240,11,6,0,155
Cleveland,11/13/20,13,25,25,297,4285,249,4589,35,8226,251,46,4131,154,222,27,12,1,17,18,4382,207,251,4131,53,154,304,4285,11,1,0,65
Columbia,11/13/20,22,27,27,852,8326,750,9220,80,23892,692,160,7461,865,625,125,22,0,45,35,8153,1067,692,7461,202,865,894,8326,13,6,0,140
Conway,11/13/20,5,29,29,466,9364,366,9835,95,20906,430,36,8862,502,341,25,5,0,84,11,9292,543,430,8862,41,502,471,9364,13,5,0,137
Craighead,11/13/20,59,31,31,5885,55881,4982,61869,843,105701,5385,500,51476,4405,4653,329,55,4,676,167,56861,5008,5385,51476,603,4405,5988,55881,119,72,0,659
Crawford,11/13/20,33,33,33,2579,32167,2194,34756,352,62472,2365,214,31616,551,2060,134,31,2,274,78,33981,775,2365,31616,224,551,2589,32167,60,18,0,424
Crittenden,11/13/20,53,35,35,2850,18978,2543,21840,253,49013,2719,131,18592,386,2458,85,46,7,214,39,21311,529,2719,18592,143,386,2862,18978,35,33,0,227
Cross,11/13/20,24,37,37,663,7317,597,7983,42,16998,587,76,7002,315,535,62,22,2,30,12,7589,394,587,7002,79,315,666,7317,10,3,0,60
Dallas,11/13/20,6,39,39,224,3091,184,3316,34,7432,218,6,2998,93,181,3,6,0,31,3,3216,100,218,2998,7,93,225,3091,13,0,0,70
Desha,11/13/20,8,41,41,472,5582,423,6069,41,11887,440,32,5322,260,400,23,7,1,33,8,5762,307,440,5322,47,260,487,5582,3,1,0,23
Drew,11/13/20,7,43,43,503,8633,443,9143,53,18502,451,52,7762,871,414,29,6,1,31,22,8213,930,451,7762,59,871,510,8633,15,3,0,91
Faulkner,11/13/20,44,45,45,4009,56562,3533,60636,432,122416,3620,389,52970,3592,3258,275,38,6,324,108,56590,4046,3620,52970,454,3592,4074,56562,67,38,0,497
Franklin,11/13/20,4,47,47,646,9918,580,10584,62,17780,577,69,9660,258,525,55,4,0,48,14,10237,347,577,9660,89,258,666,9918,2,15,0,65
Fulton,11/13/20,12,49,49,423,3221,347,3656,64,12139,336,87,2665,556,294,53,10,2,32,32,3001,655,336,2665,99,556,435,3221,8,8,0,37
Garland,11/13/20,82,51,51,3164,44635,2639,47836,443,98296,2968,196,43219,1416,2514,125,77,5,377,66,46187,1649,2968,43219,233,1416,3201,44635,111,14,0,337
Grant,11/13/20,4,53,53,439,7683,381,8132,54,18086,387,52,7087,596,346,35,4,0,37,17,7474,658,387,7087,62,596,449,7683,5,2,0,53
Greene,11/13/20,24,55,55,2130,23019,1708,25189,398,44623,1803,327,21093,1926,1499,209,22,2,282,116,22896,2293,1803,21093,367,1926,2170,23019,63,29,0,444
Hempstead,11/13/20,5,57,57,711,7756,620,8486,86,22018,610,101,7470,286,545,75,5,0,60,26,8080,406,610,7470,120,286,730,7756,12,10,0,101
HotSpring,11/13/20,39,59,59,2551,20260,2233,22830,279,33520,2490,61,19349,911,2202,31,37,2,251,28,21839,991,2490,19349,80,911,2570,20260,29,8,0,222
Howard,11/13/20,15,61,61,709,4845,623,5565,71,13389,604,105,4378,467,548,75,15,0,41,30,4982,583,604,4378,116,467,720,4845,7,8,0,27
Independence,11/13/20,68,63,63,1824,17108,1493,18974,263,37264,1450,374,16308,800,1207,286,58,10,185,78,17758,1216,1450,16308,416,800,1866,17108,29,9,0,179
Izard,11/13/20,4,65,65,869,6724,635,7605,230,13559,802,67,6173,551,586,49,4,0,212,18,6975,630,802,6173,79,551,881,6724,7,2,0,116
Jackson,11/13/20,6,67,67,1220,11830,923,13129,291,17225,971,249,11057,773,705,218,5,1,261,30,12028,1101,971,11057,328,773,1299,11830,84,107,0,425
Jefferson,11/13/20,103,69,69,4714,44844,4211,49672,398,70424,4457,257,43905,939,4069,142,98,5,288,110,48362,1310,4457,43905,371,939,4828,44844,35,17,0,357
Johnson,11/13/20,11,71,71,1129,11540,1057,12679,61,26291,1068,61,11184,356,1013,44,10,1,45,16,12252,427,1068,11184,71,356,1139,11540,17,8,0,99
Lafayette,11/13/20,3,73,73,228,1685,205,1924,20,6915,190,38,1605,80,173,32,3,0,14,6,1795,129,190,1605,49,80,239,1685,1,14,0,18
Lawrence,11/13/20,25,75,75,998,7037,877,8055,96,16669,879,119,6717,320,780,97,25,0,74,22,7596,459,879,6717,139,320,1018,7037,12,5,0,77
Lee,11/13/20,18,77,77,1130,5595,1093,6729,19,9398,1120,10,5536,59,1088,5,17,1,15,4,6656,73,1120,5536,14,59,1134,5595,1,0,0,117
Lincoln,11/13/20,18,79,79,2365,10316,2317,12693,30,13695,2334,31,10168,148,2293,24,17,1,24,6,12502,191,2334,10168,43,148,2377,10316,2,-1,0,106
LittleRiver,11/13/20,39,81,81,547,2725,466,3269,42,12417,470,77,2522,203,414,52,34,5,22,20,2992,277,470,2522,74,203,544,2725,11,2,0,37
Logan,11/13/20,5,83,83,720,11706,615,12438,100,21757,674,46,10748,958,591,24,5,0,78,22,11422,1016,674,10748,58,958,732,11706,24,3,0,334
Lonoke,11/13/20,36,85,85,2223,31911,1872,34238,315,72206,1766,457,27981,3930,1515,357,34,2,217,98,29747,4491,1766,27981,561,3930,2327,31911,43,9,0,320
Madison,11/13/20,6,87,87,512,6038,447,6556,59,16076,467,45,5772,266,414,33,6,0,47,12,6239,317,467,5772,51,266,518,6038,5,6,0,52
Marion,11/13/20,2,89,89,262,4166,187,4433,73,16438,218,44,3862,304,161,26,1,1,56,17,4080,353,218,3862,49,304,267,4166,16,8,0,51
Miller,11/13/20,22,91,91,1882,9907,1662,11827,198,43759,1470,412,9369,538,1332,330,16,6,122,76,10839,988,1470,9369,450,538,1920,9907,32,25,0,107
MissingCountyInfo,11/13/20,0,5,5,2138,76524,1352,78666,786,NA,1800,338,76500,24,1167,185,0,0,633,153,78300,366,1800,76500,342,24,2142,76524,125,18,0,1424
Mississippi,11/13/20,73,93,93,2771,16634,2382,19408,315,42831,2570,201,15555,1079,2252,130,60,13,257,58,18125,1283,2570,15555,204,1079,2774,16634,39,21,0,228
Monroe,11/13/20,4,95,95,261,3460,230,3724,27,7249,245,16,3363,97,216,14,4,0,25,2,3608,116,245,3363,19,97,264,3460,1,5,0,29
Montgomery,11/13/20,9,97,97,213,3328,185,3542,19,8993,207,6,2802,526,181,4,9,0,17,2,3009,533,207,2802,7,526,214,3328,5,3,0,111
Nevada,11/13/20,14,99,99,381,5609,325,5992,42,8440,345,36,5458,151,295,30,13,1,37,5,5803,189,345,5458,38,151,383,5609,3,7,0,140
Newton,11/13/20,21,101,101,364,2999,311,3358,32,7848,329,35,2354,645,283,28,18,3,28,4,2683,675,329,2354,30,645,359,2999,4,0,0,56
Ouachita,11/13/20,9,103,103,481,8233,398,8731,73,24106,448,33,7933,300,377,21,9,0,61,12,8381,350,448,7933,50,300,498,8233,16,4,0,88
Perry,11/13/20,3,105,105,194,5446,158,5646,33,10322,176,18,5239,207,148,10,3,0,25,8,5415,231,176,5239,24,207,200,5446,2,4,0,37
Phillips,11/13/20,16,107,107,830,9643,771,10494,43,19034,802,28,9433,210,750,21,16,0,36,7,10235,259,802,9433,49,210,851,9643,5,2,0,56
Pike,11/13/20,1,109,109,312,3139,284,3450,27,10808,290,22,2944,195,271,13,0,1,19,8,3234,216,290,2944,21,195,311,3139,5,2,0,21
Poinsett,11/13/20,32,111,111,1439,13486,1177,14962,230,24054,1307,132,13054,432,1086,91,30,2,191,39,14361,601,1307,13054,169,432,1476,13486,25,10,0,170
Polk,11/13/20,5,113,113,539,6521,388,7072,146,20163,500,39,6267,254,370,18,5,0,125,21,6767,305,500,6267,51,254,551,6521,32,6,0,77
Pope,11/13/20,39,115,115,3147,33772,2830,36933,278,63644,2844,303,32778,994,2642,188,35,4,167,111,35622,1311,2844,32778,317,994,3161,33772,73,15,0,424
Prairie,11/13/20,5,117,117,308,3500,247,3821,56,8244,256,52,3124,376,209,38,5,0,42,14,3380,441,256,3124,65,376,321,3500,0,3,0,57
Pulaski,11/13/20,234,119,119,14051,195108,12315,209369,1500,393463,13094,957,186823,8285,11636,679,219,15,1237,263,199917,9452,13094,186823,1167,8285,14261,195108,196,68,0,2020
Randolph,11/13/20,27,121,121,815,8338,682,9182,106,17603,642,173,7529,809,529,153,21,6,92,14,8171,1011,642,7529,202,809,844,8338,16,3,0,259
Saline,11/13/20,46,125,125,3727,47335,3085,51162,595,118009,3192,535,43259,4076,2767,318,44,2,380,215,46451,4711,3192,43259,635,4076,3827,47335,79,35,2,509
Scott,11/13/20,2,127,127,293,5129,236,5425,55,10442,245,48,5002,127,213,23,2,0,30,25,5247,178,245,5002,51,127,296,5129,6,5,0,97
Searcy,11/13/20,1,129,129,251,3555,219,3805,31,7923,219,32,3183,372,202,17,1,0,16,15,3402,403,219,3183,31,372,250,3555,10,3,0,22
Sebastian,11/13/20,110,131,131,5984,71710,5064,77722,808,127461,5550,434,70689,1021,4804,260,102,8,642,166,76239,1483,5550,70689,462,1021,6012,71710,97,36,0,1011
Sevier,11/13/20,16,133,133,1565,8270,1434,9851,115,17193,1329,236,7559,711,1265,169,16,0,48,67,8888,963,1329,7559,252,711,1581,8270,20,15,0,67
Sharp,11/13/20,13,135,135,504,7005,377,7522,114,17043,401,103,6515,490,315,62,13,0,73,41,6916,606,401,6515,116,490,517,7005,22,7,0,70
St.Francis,11/13/20,11,123,123,1893,15620,1795,17526,87,26294,1854,39,15473,147,1764,31,11,0,79,8,17327,199,1854,15473,52,147,1906,15620,9,4,0,69
Stone,11/13/20,22,137,137,425,4776,389,5206,14,12446,407,18,4567,209,372,17,22,0,13,1,4974,232,407,4567,23,209,430,4776,2,0,0,73
Union,11/13/20,54,139,139,1320,13176,1179,14522,87,39732,1153,167,11645,1531,1038,141,47,7,68,19,12798,1724,1153,11645,193,1531,1346,13176,18,14,0,175
VanBuren,11/13/20,3,141,141,264,6262,230,6540,31,16684,246,18,5847,415,219,11,3,0,24,7,6093,447,246,5847,32,415,278,6262,6,0,0,36
Washington,11/13/20,162,143,143,13189,111970,11866,125336,1160,228529,11446,1743,103350,8620,10612,1254,144,18,690,470,114796,10540,11446,103350,1920,8620,13366,111970,140,74,0,1327
White,11/13/20,41,145,145,2200,25910,1664,28177,495,78804,1744,456,22924,2986,1394,270,36,5,314,181,24668,3509,1744,22924,523,2986,2267,25910,78,34,0,553
Woodruff,11/13/20,0,147,147,162,2651,139,2816,23,6660,137,25,2537,114,119,20,0,0,18,5,2674,142,137,2537,28,114,165,2651,2,3,0,44
Yell,11/13/20,33,149,149,1479,15339,1336,16820,110,21573,1430,49,15045,294,1321,15,30,3,79,31,16475,345,1430,15045,51,294,1481,15339,16,3,0,204
Arkansas_all_counties,11/12/20,2144,5630,5630,128006,1428081,111357,1558007,14491,2990671,115228,12778,1354919,73162,102355,9002,1964,180,10896,3595,1470147,87860,115228,1354919,14698,73162,129926,1428081,1809,992,18,15925
Arkansas_county,11/12/20,20,1,1,807,10558,698,11405,89,18124,672,135,8428,2130,602,96,20,0,50,39,9100,2305,672,8428,175,2130,847,10558,9,4,0,114
Ashley,11/12/20,13,3,3,643,7230,562,7886,68,20537,599,44,6942,288,531,31,13,0,55,13,7541,345,599,6942,57,288,656,7230,11,10,0,90
Baxter,11/12/20,16,5,5,1016,8056,788,9084,212,41219,812,204,7381,675,642,146,16,0,154,58,8193,891,812,7381,216,675,1028,8056,19,18,1,109
Benton,11/12/20,133,7,7,9977,98624,8595,108740,1248,258980,8733,1244,95118,3506,7771,824,116,17,845,403,103851,4889,8733,95118,1383,3506,10116,98624,139,84,0,960
Boone,11/12/20,40,9,9,1308,16196,1080,17541,188,37288,1138,170,15810,386,952,128,38,2,148,40,16948,593,1138,15810,207,386,1345,16196,46,8,0,342
Bradley,11/12/20,8,11,11,390,5059,366,5450,16,10948,371,19,4207,852,356,10,7,1,8,8,4578,872,371,4207,20,852,391,5059,2,3,0,23
Calhoun,11/12/20,0,13,13,95,2097,61,2194,34,5202,84,11,2036,61,55,6,0,0,29,5,2120,74,84,2036,13,61,97,2097,4,2,0,16
Carroll,11/12/20,20,15,15,1141,10020,1031,11173,90,27887,1081,60,9894,126,986,45,20,0,75,15,10975,198,1081,9894,72,126,1153,10020,13,6,0,84
Chicot,11/12/20,24,17,17,1073,6468,1034,7546,15,10826,1056,17,6140,328,1018,16,23,1,15,0,7196,350,1056,6140,22,328,1078,6468,4,1,1,59
Clark,11/12/20,6,19,19,648,10846,536,11518,106,22385,563,85,9732,1114,476,60,6,0,81,25,10295,1223,563,9732,109,1114,672,10846,9,7,0,181
Clay,11/12/20,17,21,21,609,7289,503,7910,88,15061,530,79,6202,1087,458,45,14,3,57,31,6732,1178,530,6202,91,1087,621,7289,19,2,0,116
Cleburne,11/12/20,18,23,23,570,10096,492,10673,60,25230,484,86,9155,941,431,61,18,0,35,25,9639,1034,484,9155,93,941,577,10096,7,7,0,143
Cleveland,11/12/20,13,25,25,286,4231,248,4523,25,8226,247,39,4081,150,221,27,12,1,14,11,4328,195,247,4081,45,150,292,4231,1,3,0,28
Columbia,11/12/20,22,27,27,839,8199,744,9071,73,23892,682,157,7352,847,622,122,22,0,38,35,8034,1037,682,7352,190,847,872,8199,7,4,0,171
Conway,11/12/20,5,29,29,453,9240,361,9697,87,20906,421,32,8804,436,337,24,5,0,79,8,9225,472,421,8804,36,436,457,9240,26,2,1,96
Craighead,11/12/20,59,31,31,5766,55341,4910,61204,796,105701,5302,464,51000,4341,4590,320,55,4,656,140,56302,4902,5302,51000,561,4341,5863,55341,68,62,1,637
Crawford,11/12/20,33,33,33,2519,31803,2176,34332,310,62472,2318,201,31262,541,2045,131,31,2,242,68,33580,752,2318,31262,211,541,2529,31803,42,29,0,278
Crittenden,11/12/20,53,35,35,2815,18786,2510,21612,251,49013,2691,124,18401,385,2426,84,46,7,218,33,21092,520,2691,18401,135,385,2826,18786,24,30,0,184
Cross,11/12/20,24,37,37,653,7267,594,7923,35,16998,581,72,6971,296,532,62,22,2,27,8,7552,371,581,6971,75,296,656,7267,5,2,1,62
Dallas,11/12/20,6,39,39,211,3034,184,3246,21,7432,207,4,2945,89,181,3,6,0,20,1,3152,94,207,2945,5,89,212,3034,4,1,0,54
Desha,11/12/20,8,41,41,469,5562,422,6044,39,11887,438,31,5304,258,399,23,7,1,32,7,5742,302,438,5304,44,258,482,5562,4,5,0,49
Drew,11/12/20,7,43,43,488,8557,440,9051,41,18502,448,40,7692,865,412,28,6,1,30,11,8140,911,448,7692,46,865,494,8557,5,3,0,196
Faulkner,11/12/20,44,45,45,3942,56132,3495,60138,403,122416,3567,375,52649,3483,3225,270,38,6,304,99,56216,3922,3567,52649,439,3483,4006,56132,71,23,0,518
Franklin,11/12/20,4,47,47,644,9855,565,10519,75,17780,576,68,9613,242,513,52,4,0,59,16,10189,330,576,9613,88,242,664,9855,3,7,0,70
Fulton,11/12/20,12,49,49,415,3192,339,3619,64,12139,329,86,2640,552,290,49,10,2,29,35,2969,650,329,2640,98,552,427,3192,5,1,0,39
Garland,11/12/20,82,51,51,3053,44409,2625,47489,346,98296,2865,188,43023,1386,2505,120,77,5,283,63,45888,1601,2865,43023,215,1386,3080,44409,35,26,0,796
Grant,11/12/20,4,53,53,434,7635,379,8079,51,18086,386,48,7048,587,345,34,4,0,37,14,7434,645,386,7048,58,587,444,7635,10,2,0,117
Greene,11/12/20,24,55,55,2067,22638,1679,24742,364,44623,1751,316,20788,1850,1477,202,22,2,252,112,22539,2203,1751,20788,353,1850,2104,22638,49,38,0,460
Hempstead,11/12/20,5,57,57,699,7667,610,8385,84,22018,601,98,7388,279,542,68,5,0,54,30,7989,396,601,7388,117,279,718,7667,12,7,0,84
HotSpring,11/12/20,39,59,59,2522,20067,2225,22603,258,33520,2461,61,19190,877,2194,31,37,2,230,28,21651,952,2461,19190,75,877,2536,20067,27,15,0,306
Howard,11/12/20,15,61,61,702,4825,615,5538,72,13389,601,101,4368,457,542,73,15,0,44,28,4969,569,601,4368,112,457,713,4825,5,7,0,60
Independence,11/12/20,68,63,63,1795,16958,1484,18791,243,37264,1431,364,16205,753,1204,280,58,10,169,74,17636,1155,1431,16205,402,753,1833,16958,10,8,0,371
Izard,11/12/20,4,65,65,862,6615,633,7489,225,13559,797,65,6078,537,585,48,4,0,208,17,6875,614,797,6078,77,537,874,6615,9,3,0,78
Jackson,11/12/20,6,67,67,1136,11489,816,12692,314,17225,891,245,10905,584,603,213,5,1,283,31,11796,896,891,10905,312,584,1203,11489,34,8,0,433
Jefferson,11/12/20,103,69,69,4679,44522,4194,49310,380,70424,4437,242,43666,856,4058,136,98,5,279,101,48103,1207,4437,43666,351,856,4788,44522,50,21,0,419
Johnson,11/12/20,11,71,71,1112,11458,1049,12579,52,26291,1057,55,11117,341,1006,43,10,1,41,11,12174,405,1057,11117,64,341,1121,11458,7,8,0,72
Lafayette,11/12/20,3,73,73,227,1668,191,1906,33,6915,190,37,1595,73,162,29,3,0,25,8,1785,121,190,1595,48,73,238,1668,1,6,0,17
Lawrence,11/12/20,25,75,75,986,6972,872,7976,89,16669,869,117,6659,313,776,96,25,0,68,21,7528,448,869,6659,135,313,1004,6972,10,6,0,70
Lee,11/12/20,18,77,77,1129,5479,1093,6612,18,9398,1119,10,5420,59,1088,5,17,1,14,4,6539,73,1119,5420,14,59,1133,5479,3,0,0,19
Lincoln,11/12/20,18,79,79,2363,10212,2318,12587,27,13695,2334,29,10065,147,2294,24,17,1,23,4,12399,188,2334,10065,41,147,2375,10212,3,1,0,62
LittleRiver,11/12/20,39,81,81,536,2699,464,3232,33,12417,464,72,2513,186,413,51,34,5,17,16,2977,255,464,2513,69,186,533,2699,10,5,0,77
Logan,11/12/20,5,83,83,696,11396,612,12102,79,21757,655,41,10641,755,588,24,5,0,62,17,11296,806,655,10641,51,755,706,11396,13,3,0,177
Lonoke,11/12/20,36,85,85,2180,31634,1863,33917,281,72206,1746,434,27770,3864,1510,353,34,2,202,79,29516,4401,1746,27770,537,3864,2283,31634,31,20,1,404
Madison,11/12/20,6,87,87,507,5991,441,6504,60,16076,462,45,5737,254,409,32,6,0,47,13,6199,305,462,5737,51,254,513,5991,11,2,0,37
Marion,11/12/20,2,89,89,246,4131,179,4382,65,16438,211,35,3828,303,156,23,1,1,54,11,4039,343,211,3828,40,303,251,4131,9,6,0,46
Miller,11/12/20,22,91,91,1850,9832,1637,11719,191,43759,1454,396,9337,495,1319,318,16,6,119,72,10791,928,1454,9337,433,495,1887,9832,19,32,0,162
MissingCountyInfo,11/12/20,0,5,5,2013,75225,1334,77240,679,NA,1721,292,75201,24,1152,182,0,0,569,110,76922,318,1721,75201,294,24,2015,75225,65,19,0,99
Mississippi,11/12/20,73,93,93,2732,16445,2361,19176,297,42831,2542,190,15448,997,2238,123,60,13,243,54,17990,1186,2542,15448,189,997,2731,16445,37,16,1,173
Monroe,11/12/20,4,95,95,260,3432,225,3695,31,7249,244,16,3337,95,211,14,4,0,29,2,3581,114,244,3337,19,95,263,3432,2,3,1,41
Montgomery,11/12/20,9,97,97,208,3222,182,3431,17,8993,202,6,2801,421,179,3,9,0,14,3,3003,428,202,2801,7,421,209,3222,3,0,0,32
Nevada,11/12/20,14,99,99,378,5472,318,5851,46,8440,341,37,5323,149,287,31,13,1,41,5,5664,187,341,5323,38,149,379,5472,4,4,0,28
Newton,11/12/20,21,101,101,360,2947,311,3302,28,7848,325,35,2351,596,283,28,18,3,24,4,2676,626,325,2351,30,596,355,2947,5,5,0,30
Ouachita,11/12/20,9,103,103,465,8161,394,8641,61,24106,435,30,7872,289,373,21,9,0,52,9,8307,334,435,7872,45,289,480,8161,14,3,0,153
Perry,11/12/20,3,105,105,192,5411,154,5609,35,10322,176,16,5208,203,144,10,3,0,29,6,5384,225,176,5208,22,203,198,5411,4,5,1,81
Phillips,11/12/20,16,107,107,825,9592,769,10438,40,19034,801,24,9383,209,748,21,16,0,37,3,10184,254,801,9383,45,209,846,9592,7,7,0,67
Pike,11/12/20,1,109,109,307,3123,282,3429,24,10808,286,21,2929,194,270,12,0,1,16,8,3215,214,286,2929,20,194,306,3123,1,2,0,39
Poinsett,11/12/20,32,111,111,1414,13341,1167,14792,215,24054,1290,124,12921,420,1078,89,30,2,182,33,14211,581,1290,12921,161,420,1451,13341,26,11,0,167
Polk,11/12/20,5,113,113,507,6476,382,6989,120,20163,468,39,6234,242,366,16,5,0,97,23,6702,287,468,6234,45,242,513,6476,19,4,0,79
Pope,11/12/20,39,115,115,3074,33421,2815,36510,220,63644,2809,265,32461,960,2628,187,35,4,146,74,35270,1240,2809,32461,280,960,3089,33421,27,24,0,366
Prairie,11/12/20,5,117,117,308,3443,244,3764,59,8244,257,51,3077,366,206,38,5,0,46,13,3334,430,257,3077,64,366,321,3443,4,4,0,30
Pulaski,11/12/20,234,119,119,13855,193284,12247,207342,1372,393463,12951,904,185299,7985,11572,675,219,15,1158,214,198250,9092,12951,185299,1107,7985,14058,193284,203,80,3,1738
Randolph,11/12/20,27,121,121,799,8095,679,8923,93,17603,632,167,7304,791,527,152,21,6,84,9,7936,987,632,7304,196,791,828,8095,10,8,1,130
Saline,11/12/20,44,125,125,3648,46905,3050,50645,553,118009,3138,510,42984,3921,2744,306,42,2,351,202,46122,4523,3138,42984,602,3921,3740,46905,74,31,0,478
Scott,11/12/20,2,127,127,287,5038,231,5328,54,10442,241,46,4919,119,209,22,2,0,30,24,5160,168,241,4919,49,119,290,5038,4,2,0,114
Searcy,11/12/20,1,129,129,241,3543,216,3783,24,7923,215,26,3177,366,199,17,1,0,15,9,3392,391,215,3177,25,366,240,3543,3,3,0,19
Sebastian,11/12/20,110,131,131,5887,70796,5028,76710,747,127461,5470,417,69829,967,4777,251,102,8,589,158,75299,1411,5470,69829,444,967,5914,70796,96,61,3,686
Sevier,11/12/20,16,133,133,1545,8223,1419,9782,110,17193,1318,227,7537,686,1261,158,16,0,41,69,8855,927,1318,7537,241,686,1559,8223,4,15,0,86
Sharp,11/12/20,13,135,135,482,6957,370,7449,99,17043,384,98,6473,484,307,63,13,0,64,35,6857,592,384,6473,108,484,492,6957,16,3,0,238
St.Francis,11/12/20,11,123,123,1884,15560,1791,17455,82,26294,1844,40,15422,138,1757,34,11,0,76,6,17266,189,1844,15422,51,138,1895,15560,8,11,0,157
Stone,11/12/20,22,137,137,423,4705,389,5133,12,12446,405,18,4501,204,372,17,22,0,11,1,4906,227,405,4501,23,204,428,4705,2,1,0,31
Union,11/12/20,54,139,139,1302,13019,1165,14345,83,39732,1136,166,11544,1475,1028,137,47,7,61,22,12680,1665,1136,11544,190,1475,1326,13019,14,2,1,176
VanBuren,11/12/20,3,141,141,258,6232,230,6504,25,16684,243,15,5824,408,219,11,3,0,21,4,6067,437,243,5824,29,408,272,6232,4,3,0,54
Washington,11/12/20,162,143,143,13049,110783,11792,124003,1094,228529,11378,1671,102578,8205,10566,1226,144,18,668,426,113956,10047,11378,102578,1842,8205,13220,110783,178,82,0,1138
White,11/12/20,41,145,145,2122,25435,1630,27616,451,78804,1711,411,22506,2929,1372,258,36,5,303,148,24217,3399,1711,22506,470,2929,2181,25435,57,31,0,283
Woodruff,11/12/20,0,147,147,160,2609,136,2773,24,6660,136,24,2495,114,117,19,0,0,19,5,2631,142,136,2495,28,114,164,2609,2,1,0,34
Yell,11/12/20,33,149,149,1463,15151,1333,16616,97,21573,1417,46,14881,270,1318,15,30,3,69,28,16298,318,1417,14881,48,270,1465,15151,11,3,1,292
Arkansas_all_counties,11/11/20,2126,5630,5630,126197,1413965,110365,1542003,13691,2990671,113943,12254,1343051,70914,101583,8782,1947,179,10399,3292,1456994,85009,113943,1343051,14095,70914,128038,1413965,1962,1130,14,15464
Arkansas_county,11/11/20,20,1,1,798,10453,694,11291,84,18124,664,134,8327,2126,598,96,20,0,46,38,8991,2300,664,8327,174,2126,838,10453,11,9,0,137
Ashley,11/11/20,13,3,3,632,7151,552,7796,67,20537,589,43,6871,280,521,31,13,0,55,12,7460,336,589,6871,56,280,645,7151,5,7,0,50
Baxter,11/11/20,15,5,5,997,7966,770,8975,212,41219,796,201,7292,674,627,143,15,0,154,58,8088,887,796,7292,213,674,1009,7966,28,13,0,158
Benton,11/11/20,133,7,7,9838,97803,8511,107779,1193,258980,8673,1165,94386,3417,7710,801,116,17,846,347,103059,4720,8673,94386,1303,3417,9976,97803,161,93,0,592
Boone,11/11/20,40,9,9,1262,15900,1072,17194,150,37288,1106,156,15545,355,948,124,38,2,120,30,16651,543,1106,15545,188,355,1294,15900,21,9,2,69
Bradley,11/11/20,8,11,11,388,5038,363,5427,17,10948,370,18,4192,846,356,7,7,1,7,10,4562,865,370,4192,19,846,389,5038,4,0,0,28
Calhoun,11/11/20,0,13,13,91,2085,59,2178,32,5202,82,9,2025,60,54,5,0,0,28,4,2107,71,82,2025,11,60,93,2085,4,1,0,13
Carroll,11/11/20,20,15,15,1128,9949,1025,11089,83,27887,1069,59,9825,124,980,45,20,0,69,14,10894,195,1069,9825,71,124,1140,9949,12,9,0,117
Chicot,11/11/20,23,17,17,1069,6413,1033,7487,13,10826,1052,17,6116,297,1017,16,22,1,13,0,7168,319,1052,6116,22,297,1074,6413,4,2,0,14
Clark,11/11/20,6,19,19,639,10674,529,11337,104,22385,554,85,9572,1102,472,57,6,0,76,28,10126,1211,554,9572,109,1102,663,10674,20,7,0,160
Clay,11/11/20,17,21,21,590,7192,501,7794,71,15061,519,71,6144,1048,456,45,14,3,48,23,6663,1131,519,6144,83,1048,602,7192,4,7,1,43
Cleburne,11/11/20,18,23,23,563,9960,485,10530,60,25230,478,85,9026,934,429,56,18,0,31,29,9504,1026,478,9026,92,934,570,9960,10,2,0,129
Cleveland,11/11/20,13,25,25,285,4204,245,4495,27,8226,248,37,4056,148,218,27,12,1,18,9,4304,191,248,4056,43,148,291,4204,0,6,0,117
Columbia,11/11/20,22,27,27,832,8035,740,8900,70,23892,677,155,7206,829,619,121,22,0,36,34,7883,1017,677,7206,188,829,865,8035,1,11,0,69
Conway,11/11/20,4,29,29,427,9170,359,9601,63,20906,397,30,8748,422,335,24,4,0,57,6,9145,456,397,8748,34,422,431,9170,9,1,0,85
Craighead,11/11/20,58,31,31,5698,54772,4848,60564,791,105701,5239,459,50586,4186,4548,300,54,4,636,155,55825,4739,5239,50586,553,4186,5792,54772,70,67,0,504
Crawford,11/11/20,33,33,33,2477,31567,2147,34053,297,62472,2286,191,31032,535,2030,117,31,2,225,72,33318,735,2286,31032,200,535,2486,31567,45,23,0,271
Crittenden,11/11/20,53,35,35,2791,18626,2480,21426,257,49013,2669,122,18243,383,2398,82,46,7,224,33,20912,514,2669,18243,131,383,2800,18626,47,37,0,168
Cross,11/11/20,23,37,37,648,7210,592,7861,33,16998,576,72,6927,283,530,62,21,2,25,8,7503,358,576,6927,75,283,651,7210,1,6,0,104
Dallas,11/11/20,6,39,39,207,2984,183,3192,18,7432,203,4,2897,87,180,3,6,0,17,1,3100,92,203,2897,5,87,208,2984,2,1,0,37
Desha,11/11/20,8,41,41,465,5517,417,5994,40,11887,434,31,5261,256,394,23,7,1,33,7,5695,299,434,5261,43,256,477,5517,4,5,0,21
Drew,11/11/20,7,43,43,483,8366,437,8855,39,18502,443,40,7573,793,410,27,6,1,27,12,8016,839,443,7573,46,793,489,8366,3,2,0,35
Faulkner,11/11/20,44,45,45,3871,55685,3472,59615,355,122416,3519,352,52322,3363,3206,266,38,6,275,80,55841,3774,3519,52322,411,3363,3930,55685,65,22,0,498
Franklin,11/11/20,4,47,47,641,9788,558,10449,79,17780,573,68,9550,238,508,50,4,0,61,18,10123,326,573,9550,88,238,661,9788,8,1,0,54
Fulton,11/11/20,12,49,49,410,3158,338,3579,60,12139,325,85,2608,550,289,49,10,2,26,34,2933,646,325,2608,96,550,421,3158,18,4,1,155
Garland,11/11/20,82,51,51,3018,43648,2599,46693,337,98296,2832,186,42284,1364,2478,121,77,5,277,60,45116,1577,2832,42284,213,1364,3045,43648,137,103,0,370
Grant,11/11/20,4,53,53,424,7528,377,7962,43,18086,379,45,6950,578,343,34,4,0,32,11,7329,633,379,6950,55,578,434,7528,9,6,0,58
Greene,11/11/20,24,55,55,2018,22227,1641,24279,353,44623,1723,295,20474,1753,1444,197,22,2,257,96,22197,2082,1723,20474,329,1753,2052,22227,26,17,1,170
Hempstead,11/11/20,5,57,57,687,7595,603,8301,79,22018,592,95,7326,269,537,66,5,0,50,29,7918,383,592,7326,114,269,706,7595,2,8,0,118
HotSpring,11/11/20,39,59,59,2495,19788,2210,22297,246,33520,2438,57,18921,867,2179,31,37,2,222,24,21359,938,2438,18921,71,867,2509,19788,48,13,0,338
Howard,11/11/20,15,61,61,697,4770,608,5479,74,13389,598,99,4352,418,536,72,15,0,47,27,4950,529,598,4352,111,418,709,4770,3,7,0,30
Independence,11/11/20,68,63,63,1785,16597,1476,18416,241,37264,1426,359,15862,735,1199,277,58,10,169,72,17288,1128,1426,15862,393,735,1819,16597,30,5,2,110
Izard,11/11/20,4,65,65,853,6546,630,7411,219,13559,793,60,6018,528,583,47,4,0,206,13,6811,600,793,6018,72,528,865,6546,8,8,1,42
Jackson,11/11/20,6,67,67,1102,11090,808,12257,288,17225,859,243,10757,333,597,211,5,1,257,31,11616,641,859,10757,308,333,1167,11090,29,13,0,108
Jefferson,11/11/20,103,69,69,4629,44153,4173,48890,351,70424,4422,207,43305,848,4043,130,98,5,279,72,47727,1163,4422,43305,315,848,4737,44153,34,24,1,485
Johnson,11/11/20,11,71,71,1105,11393,1041,12507,53,26291,1051,54,11060,333,998,43,10,1,43,10,12111,396,1051,11060,63,333,1114,11393,6,2,0,189
Lafayette,11/11/20,3,73,73,226,1652,185,1886,38,6915,187,39,1581,71,159,26,3,0,25,13,1768,118,187,1581,47,71,234,1652,3,1,0,26
Lawrence,11/11/20,25,75,75,976,6912,866,7906,85,16669,860,116,6606,306,771,95,25,0,64,21,7466,440,860,6606,134,306,994,6912,11,15,1,44
Lee,11/11/20,18,77,77,1126,5463,1093,6593,15,9398,1117,9,5406,57,1088,5,17,1,12,3,6523,70,1117,5406,13,57,1130,5463,6,0,0,51
Lincoln,11/11/20,18,79,79,2360,10153,2317,12524,25,13695,2332,28,10008,145,2293,24,17,1,22,3,12340,184,2332,10008,39,145,2371,10153,4,1,0,29
LittleRiver,11/11/20,39,81,81,526,2632,459,3155,28,12417,460,66,2491,141,410,49,34,5,16,12,2951,204,460,2491,63,141,523,2632,3,2,1,24
Logan,11/11/20,5,83,83,683,11232,609,11925,69,21757,645,38,10483,749,586,23,5,0,54,15,11128,797,645,10483,48,749,693,11232,16,8,0,101
Lonoke,11/11/20,35,85,85,2149,31261,1843,33509,271,72206,1717,432,27448,3813,1495,348,33,2,189,82,29165,4344,1717,27448,531,3813,2248,31261,36,26,0,339
Madison,11/11/20,6,87,87,496,5965,439,6467,51,16076,455,41,5714,251,408,31,6,0,41,10,6169,298,455,5714,47,251,502,5965,7,6,0,39
Marion,11/11/20,2,89,89,237,4094,173,4336,62,16438,202,35,3792,302,152,21,1,1,49,13,3994,342,202,3792,40,302,242,4094,5,6,0,53
Miller,11/11/20,22,91,91,1831,9689,1605,11558,204,43759,1443,388,9241,448,1295,310,16,6,132,72,10684,874,1443,9241,426,448,1869,9689,15,14,0,131
MissingCountyInfo,11/11/20,0,5,5,1948,75191,1315,77136,633,NA,1668,280,75171,20,1134,181,0,0,534,99,76839,297,1668,75171,277,20,1945,75191,101,21,0,3140
Mississippi,11/11/20,72,93,93,2695,16309,2345,19002,277,42831,2509,186,15359,950,2224,121,59,13,225,52,17868,1134,2509,15359,184,950,2693,16309,31,29,0,106
Monroe,11/11/20,3,95,95,258,3393,222,3654,33,7249,242,16,3299,94,208,14,3,0,31,2,3541,113,242,3299,19,94,261,3393,4,5,0,26
Montgomery,11/11/20,9,97,97,205,3193,182,3399,14,8993,200,5,2777,416,179,3,9,0,12,2,2977,422,200,2777,6,416,206,3193,4,1,0,13
Nevada,11/11/20,14,99,99,374,5448,314,5823,46,8440,338,36,5303,145,283,31,13,1,42,4,5641,182,338,5303,37,145,375,5448,4,3,0,101
Newton,11/11/20,21,101,101,355,2922,306,3272,28,7848,322,33,2330,592,281,25,18,3,23,5,2652,620,322,2330,28,592,350,2922,1,7,0,10
Ouachita,11/11/20,9,103,103,451,8022,391,8487,50,24106,421,30,7733,289,370,21,9,0,41,9,8154,333,421,7733,44,289,465,8022,9,4,0,54
Perry,11/11/20,2,105,105,188,5334,149,5528,37,10322,174,14,5140,194,139,10,2,0,33,4,5314,214,174,5140,20,194,194,5334,5,9,0,145
Phillips,11/11/20,16,107,107,818,9532,762,10371,40,19034,794,24,9328,204,741,21,16,0,37,3,10122,249,794,9328,45,204,839,9532,4,1,0,135
Pike,11/11/20,1,109,109,306,3085,280,3390,25,10808,286,20,2902,183,268,12,0,1,18,7,3188,202,286,2902,19,183,305,3085,11,5,0,32
Poinsett,11/11/20,32,111,111,1388,13200,1156,14624,200,24054,1263,125,12793,407,1069,87,30,2,164,36,14056,568,1263,12793,161,407,1424,13200,17,26,0,88
Polk,11/11/20,5,113,113,488,6416,378,6910,105,20163,449,39,6177,239,363,15,5,0,81,24,6626,284,449,6177,45,239,494,6416,22,6,0,113
Pope,11/11/20,39,115,115,3047,33082,2791,36145,217,63644,2792,255,32133,949,2615,176,35,4,142,75,34925,1220,2792,32133,271,949,3063,33082,38,21,0,286
Prairie,11/11/20,5,117,117,304,3417,240,3734,59,8244,253,51,3051,366,203,37,5,0,45,14,3304,430,253,3051,64,366,317,3417,16,4,0,60
Pulaski,11/11/20,231,119,119,13652,191749,12167,205598,1252,393463,12789,863,183996,7753,11501,666,216,15,1070,182,196785,8813,12789,183996,1060,7753,13849,191749,177,97,1,1841
Randolph,11/11/20,26,121,121,789,7975,671,8791,92,17603,620,169,7209,766,521,150,20,6,79,13,7829,962,620,7209,196,766,816,7975,10,8,0,93
Saline,11/11/20,44,125,125,3574,46501,3019,50164,510,118009,3093,481,42646,3855,2719,300,42,2,331,179,45739,4425,3093,42646,570,3855,3663,46501,93,32,2,681
Scott,11/11/20,2,127,127,283,4928,229,5214,52,10442,240,43,4819,109,207,22,2,0,31,21,5059,155,240,4819,46,109,286,4928,12,2,0,73
Searcy,11/11/20,1,129,129,238,3527,213,3764,24,7923,212,26,3163,364,197,16,1,0,14,10,3375,389,212,3163,25,364,237,3527,5,1,0,47
Sebastian,11/11/20,107,131,131,5791,70206,4967,76022,715,127461,5403,388,69273,933,4728,239,99,8,574,141,74676,1346,5403,69273,413,933,5816,70206,115,47,0,498
Sevier,11/11/20,16,133,133,1541,8141,1404,9696,121,17193,1316,225,7515,626,1256,148,16,0,44,77,8831,865,1316,7515,239,626,1555,8141,19,15,0,86
Sharp,11/11/20,13,135,135,466,6735,367,7203,86,17043,371,95,6254,481,306,61,13,0,52,34,6625,578,371,6254,97,481,468,6735,9,3,0,64
St.Francis,11/11/20,11,123,123,1876,15411,1780,17296,85,26294,1836,40,15273,138,1748,32,11,0,77,8,17109,187,1836,15273,49,138,1885,15411,15,13,0,59
Stone,11/11/20,22,137,137,421,4676,388,5102,11,12446,403,18,4476,200,371,17,22,0,10,1,4879,223,403,4476,23,200,426,4676,2,5,0,23
Union,11/11/20,53,139,139,1288,12857,1163,14169,72,39732,1131,157,11402,1455,1026,137,47,6,58,14,12533,1636,1131,11402,181,1455,1312,12857,11,11,0,101
VanBuren,11/11/20,3,141,141,254,6182,227,6450,24,16684,240,14,5803,379,216,11,3,0,21,3,6043,407,240,5803,28,379,268,6182,4,0,0,24
Washington,11/11/20,162,143,143,12871,109823,11710,122856,998,228529,11303,1568,101807,8016,10507,1203,144,18,652,346,113110,9746,11303,101807,1730,8016,13033,109823,141,81,0,721
White,11/11/20,41,145,145,2065,25209,1599,27328,425,78804,1660,405,22437,2772,1345,254,36,5,279,146,24097,3231,1660,22437,459,2772,2119,25209,62,32,0,208
Woodruff,11/11/20,0,147,147,158,2577,135,2739,23,6660,135,23,2469,108,116,19,0,0,19,4,2604,135,135,2469,27,108,162,2577,1,5,0,16
Yell,11/11/20,32,149,149,1452,14870,1330,16324,90,21573,1408,44,14604,266,1315,15,29,3,64,26,16012,312,1408,14604,46,266,1454,14870,24,6,0,137
Arkansas_all_counties,11/10/20,2112,5630,5630,124235,1400463,109235,1526495,12874,2990671,112736,11499,1332008,68455,100684,8551,1934,178,10105,2769,1444744,81751,112736,1332008,13296,68455,126032,1400463,1424,1034,4,12043
Arkansas_county,11/10/20,20,1,1,787,10327,685,11154,82,18124,658,129,8288,2039,589,96,20,0,49,33,8946,2208,658,8288,169,2039,827,10327,5,9,0,77
Ashley,11/10/20,13,3,3,627,7106,545,7745,69,20537,584,43,6828,278,515,30,13,0,56,13,7412,333,584,6828,55,278,639,7106,5,7,0,18
Baxter,11/10/20,15,5,5,969,7836,757,8817,197,41219,789,180,7167,669,618,139,15,0,156,41,7956,861,789,7167,192,669,981,7836,29,13,0,119
Benton,11/10/20,133,7,7,9677,97372,8418,107185,1125,258980,8625,1052,94058,3314,7650,768,116,17,858,267,102683,4502,8625,94058,1188,3314,9813,97372,116,83,0,847
Boone,11/10/20,38,9,9,1241,15852,1063,17122,140,37288,1089,152,15501,351,941,122,36,2,112,28,16590,532,1089,15501,181,351,1270,15852,23,20,0,90
Bradley,11/10/20,8,11,11,384,5014,363,5399,13,10948,370,14,4177,837,356,7,7,1,7,6,4547,852,370,4177,15,837,385,5014,1,1,0,17
Calhoun,11/10/20,0,13,13,87,2076,58,2165,29,5202,79,8,2021,55,53,5,0,0,26,3,2100,65,79,2021,10,55,89,2076,6,2,0,15
Carroll,11/10/20,20,15,15,1116,9844,1016,10971,80,27887,1059,57,9720,124,970,46,20,0,69,11,10779,192,1059,9720,68,124,1127,9844,19,7,0,94
Chicot,11/10/20,23,17,17,1065,6403,1031,7473,11,10826,1048,17,6108,295,1016,15,22,1,10,1,7156,317,1048,6108,22,295,1070,6403,0,0,0,46
Clark,11/10/20,6,19,19,619,10534,522,11176,91,22385,543,76,9506,1028,468,54,6,0,69,22,10049,1127,543,9506,99,1028,642,10534,11,6,0,69
Clay,11/10/20,16,21,21,586,7153,494,7750,75,15061,515,71,6117,1036,450,44,14,2,50,25,6632,1118,515,6117,82,1036,597,7153,4,4,0,27
Cleburne,11/10/20,18,23,23,553,9841,483,10401,52,25230,471,82,8986,855,427,56,18,0,26,26,9457,944,471,8986,89,855,560,9841,3,8,0,42
Cleveland,11/10/20,13,25,25,285,4087,239,4378,33,8226,247,38,3939,148,215,24,12,1,20,13,4186,192,247,3939,44,148,291,4087,4,2,0,24
Columbia,11/10/20,22,27,27,831,7967,729,8831,80,23892,677,154,7173,794,612,117,22,0,43,37,7850,981,677,7173,187,794,864,7967,24,8,0,80
Conway,11/10/20,4,29,29,418,9094,358,9514,56,20906,388,30,8687,407,334,24,4,0,50,6,9075,439,388,8687,32,407,420,9094,6,6,0,50
Craighead,11/10/20,58,31,31,5628,54338,4781,60056,788,105701,5177,451,50275,4063,4486,295,54,4,636,152,55452,4604,5177,50275,541,4063,5718,54338,90,80,1,737
Crawford,11/10/20,33,33,33,2432,31341,2124,33782,275,62472,2255,177,30813,528,2009,115,31,2,215,60,33068,714,2255,30813,186,528,2441,31341,31,29,0,266
Crittenden,11/10/20,53,35,35,2744,18505,2443,21256,247,49013,2630,114,18136,369,2366,77,46,7,217,30,20766,490,2630,18136,121,369,2751,18505,17,25,0,121
Cross,11/10/20,23,37,37,647,7107,586,7757,38,16998,575,72,6828,279,524,62,21,2,30,8,7403,354,575,6828,75,279,650,7107,6,4,0,49
Dallas,11/10/20,6,39,39,205,2949,182,3155,17,7432,201,4,2865,84,179,3,6,0,16,1,3066,89,201,2865,5,84,206,2949,4,0,0,20
Desha,11/10/20,8,41,41,461,5500,412,5972,41,11887,430,31,5255,245,390,22,7,1,33,8,5685,287,430,5255,42,245,472,5500,3,7,0,14
Drew,11/10/20,7,43,43,480,8334,435,8820,38,18502,440,40,7552,782,408,27,6,1,26,12,7992,828,440,7552,46,782,486,8334,3,5,0,34
Faulkner,11/10/20,44,45,45,3806,55252,3450,59115,312,122416,3475,331,52076,3176,3188,262,38,6,249,63,55551,3564,3475,52076,388,3176,3863,55252,34,21,0,377
Franklin,11/10/20,4,47,47,633,9742,557,10395,72,17780,568,65,9508,234,507,50,4,0,57,15,10076,319,568,9508,85,234,653,9742,8,11,0,101
Fulton,11/10/20,11,49,49,392,3021,334,3424,47,12139,323,69,2582,439,286,48,9,2,28,19,2905,519,323,2582,80,439,403,3021,8,5,0,33
Garland,11/10/20,82,51,51,2881,43415,2496,46324,303,98296,2709,172,42105,1310,2385,111,77,5,247,56,44814,1510,2709,42105,200,1310,2909,43415,31,18,0,252
Grant,11/10/20,4,53,53,415,7479,371,7904,40,18086,375,40,6925,554,338,33,4,0,33,7,7300,604,375,6925,50,554,425,7479,4,2,0,44
Greene,11/10/20,23,55,55,1992,22083,1624,24109,345,44623,1707,285,20407,1676,1436,188,21,2,250,95,22114,1995,1707,20407,319,1676,2026,22083,60,30,0,198
Hempstead,11/10/20,5,57,57,685,7479,595,8182,85,22018,590,95,7220,259,530,65,5,0,55,30,7810,372,590,7220,113,259,703,7479,13,15,0,45
HotSpring,11/10/20,39,59,59,2447,19498,2197,21956,211,33520,2398,49,18703,795,2165,32,37,2,196,15,21101,855,2398,18703,60,795,2458,19498,16,6,0,117
Howard,11/10/20,15,61,61,694,4743,601,5449,78,13389,598,96,4332,411,533,68,15,0,50,28,4930,519,598,4332,108,411,706,4743,4,2,0,31
Independence,11/10/20,66,63,63,1755,16517,1471,18306,218,37264,1416,339,15816,701,1198,273,56,10,162,56,17232,1074,1416,15816,373,701,1789,16517,67,7,0,201
Izard,11/10/20,3,65,65,845,6512,622,7369,220,13559,786,59,5991,521,576,46,3,0,207,13,6777,592,786,5991,71,521,857,6512,9,49,0,56
Jackson,11/10/20,6,67,67,1073,11011,795,12148,272,17225,834,239,10689,322,585,210,5,1,244,28,11523,625,834,10689,303,322,1137,11011,37,10,0,216
Jefferson,11/10/20,102,69,69,4595,43702,4149,48403,342,70424,4405,190,42870,832,4024,125,97,5,282,60,47275,1128,4405,42870,296,832,4701,43702,36,30,0,200
Johnson,11/10/20,11,71,71,1099,11210,1039,12318,49,26291,1046,53,10886,324,997,42,10,1,39,10,11932,386,1046,10886,62,324,1108,11210,4,5,0,36
Lafayette,11/10/20,3,73,73,223,1629,184,1860,36,6915,187,36,1560,69,158,26,3,0,26,10,1747,113,187,1560,44,69,231,1629,3,5,0,17
Lawrence,11/10/20,24,75,75,965,6879,851,7862,90,16669,849,116,6580,299,756,95,24,0,69,21,7429,433,849,6580,134,299,983,6879,10,7,0,60
Lee,11/10/20,18,77,77,1120,5418,1093,6542,9,9398,1112,8,5366,52,1088,5,17,1,7,2,6478,64,1112,5366,12,52,1124,5418,1,-1,0,18
Lincoln,11/10/20,18,79,79,2356,10128,2316,12495,22,13695,2330,26,9984,144,2292,24,17,1,21,1,12314,181,2330,9984,37,144,2367,10128,1,23,0,12
LittleRiver,11/10/20,38,81,81,523,2611,457,3131,28,12417,458,65,2478,133,409,48,33,5,16,12,2936,195,458,2478,62,133,520,2611,4,6,1,32
Logan,11/10/20,5,83,83,667,11147,601,11824,61,21757,634,33,10403,744,581,20,5,0,48,13,11037,787,634,10403,43,744,677,11147,14,1,0,97
Lonoke,11/10/20,35,85,85,2113,30958,1817,33168,261,72206,1706,407,27223,3735,1476,341,33,2,197,64,28929,4239,1706,27223,504,3735,2210,30958,36,22,0,254
Madison,11/10/20,6,87,87,489,5933,433,6428,50,16076,449,40,5692,241,402,31,6,0,41,9,6141,287,449,5692,46,241,495,5933,9,4,0,44
Marion,11/10/20,2,89,89,232,4046,167,4283,63,16438,200,32,3754,292,147,20,1,1,52,11,3954,329,200,3754,37,292,237,4046,12,5,0,48
Miller,11/10/20,22,91,91,1816,9573,1591,11427,203,43759,1438,378,9129,444,1283,308,16,6,139,64,10567,860,1438,9129,416,444,1854,9573,20,26,0,128
MissingCountyInfo,11/10/20,0,5,5,1847,72152,1294,73997,553,NA,1560,287,72134,18,1120,174,0,0,440,113,73694,303,1560,72134,285,18,1845,72152,-85,10,0,381
Mississippi,11/10/20,72,93,93,2664,16234,2316,18896,275,42831,2489,175,15293,941,2199,117,59,13,230,45,17782,1114,2489,15293,173,941,2662,16234,23,26,0,381
Monroe,11/10/20,3,95,95,254,3371,217,3628,34,7249,239,15,3287,84,203,14,3,0,33,1,3526,102,239,3287,18,84,257,3371,3,1,1,23
Montgomery,11/10/20,9,97,97,201,3184,181,3386,11,8993,196,5,2770,414,178,3,9,0,9,2,2966,420,196,2770,6,414,202,3184,2,0,0,19
Nevada,11/10/20,14,99,99,370,5351,311,5722,45,8440,337,33,5213,138,282,29,13,1,42,3,5550,172,337,5213,34,138,371,5351,2,4,0,42
Newton,11/10/20,21,101,101,354,2913,299,3261,34,7848,320,34,2322,591,275,24,18,3,27,7,2642,619,320,2322,28,591,348,2913,8,3,0,67
Ouachita,11/10/20,9,103,103,442,7977,387,8432,45,24106,415,27,7694,283,367,20,9,0,38,7,8109,323,415,7694,40,283,455,7977,7,3,0,41
Perry,11/10/20,2,105,105,183,5194,140,5383,41,10322,169,14,5005,189,132,8,2,0,35,6,5174,209,169,5005,20,189,189,5194,2,1,0,27
Phillips,11/10/20,16,107,107,814,9401,761,10236,37,19034,790,24,9206,195,740,21,16,0,34,3,9996,240,790,9206,45,195,835,9401,5,6,0,35
Pike,11/10/20,1,109,109,295,3064,275,3359,19,10808,277,18,2887,177,264,11,0,1,13,6,3164,195,277,2887,18,177,295,3064,4,4,0,11
Poinsett,11/10/20,32,111,111,1371,13129,1130,14536,209,24054,1247,124,12735,394,1049,81,30,2,168,41,13982,554,1247,12735,160,394,1407,13129,17,24,0,79
Polk,11/10/20,5,113,113,466,6325,372,6797,89,20163,430,36,6090,235,359,13,5,0,66,23,6520,277,430,6090,42,235,472,6325,21,6,0,153
Pope,11/10/20,39,115,115,3009,32834,2770,35859,200,63644,2769,240,31923,911,2598,172,35,4,136,64,34692,1167,2769,31923,256,911,3025,32834,18,19,0,192
Prairie,11/10/20,5,117,117,288,3373,236,3674,47,8244,242,46,3014,359,201,35,5,0,36,11,3256,418,242,3014,59,359,301,3373,7,4,0,29
Pulaski,11/10/20,230,119,119,13475,190085,12070,203746,1173,393463,12675,800,182601,7484,11417,653,215,15,1041,132,195276,8470,12675,182601,986,7484,13661,190085,133,70,0,1817
Randolph,11/10/20,26,121,121,779,7892,663,8697,90,17603,612,167,7151,741,515,148,20,6,77,13,7763,934,612,7151,193,741,805,7892,23,6,0,90
Saline,11/10/20,42,125,125,3481,45913,2987,49481,451,118009,3070,411,42280,3633,2695,292,40,2,334,117,45350,4131,3070,42280,498,3633,3568,45913,65,26,0,583
Scott,11/10/20,2,127,127,271,4867,227,5141,42,10442,235,36,4762,105,207,20,2,0,26,16,4997,144,235,4762,39,105,274,4867,4,1,0,35
Searcy,11/10/20,1,129,129,233,3485,212,3717,20,7923,210,23,3157,328,196,16,1,0,13,7,3367,350,210,3157,22,328,232,3485,6,3,0,57
Sebastian,11/10/20,107,131,131,5676,69823,4920,75523,647,127461,5335,341,68922,901,4689,231,99,8,545,102,74257,1266,5335,68922,365,901,5700,69823,58,46,1,586
Sevier,11/10/20,16,133,133,1522,8074,1389,9611,117,17193,1315,207,7485,589,1249,140,16,0,50,67,8800,811,1315,7485,222,589,1537,8074,17,12,0,68
Sharp,11/10/20,13,135,135,457,6680,364,7140,80,17043,366,91,6219,461,305,59,13,0,48,32,6585,555,366,6219,94,461,460,6680,8,4,0,40
St.Francis,11/10/20,11,123,123,1861,15367,1767,17238,83,26294,1827,34,15230,137,1739,28,11,0,77,6,17057,181,1827,15230,44,137,1871,15367,6,5,0,130
Stone,11/10/20,22,137,137,419,4655,383,5079,14,12446,402,17,4463,192,368,15,22,0,12,2,4865,214,402,4463,22,192,424,4655,1,0,0,51
Union,11/10/20,53,139,139,1277,12767,1152,14068,72,39732,1126,151,11385,1382,1015,137,47,6,64,8,12511,1557,1126,11385,175,1382,1301,12767,16,12,0,93
VanBuren,11/10/20,3,141,141,250,6162,227,6426,20,16684,237,13,5789,373,216,11,3,0,18,2,6026,400,237,5789,27,373,264,6162,4,0,0,31
Washington,11/10/20,162,143,143,12730,109243,11629,122132,938,228529,11232,1498,101424,7819,10449,1180,144,18,639,299,112656,9476,11232,101424,1657,7819,12889,109243,125,73,0,1118
White,11/10/20,41,145,145,2003,25063,1567,27119,395,78804,1636,367,22330,2733,1317,250,36,5,283,112,23966,3153,1636,22330,420,2733,2056,25063,60,30,0,309
Woodruff,11/10/20,0,147,147,157,2562,130,2723,27,6660,135,22,2462,100,114,16,0,0,21,6,2597,126,135,2462,26,100,161,2562,3,0,0,20
Yell,11/10/20,32,149,149,1428,14757,1324,16187,72,21573,1400,28,14496,261,1310,14,29,3,61,11,15896,291,1400,14496,30,261,1430,14757,10,0,0,62
Arkansas_all_counties,11/9/20,2108,5630,5630,122811,1389844,108201,1514385,12488,2990671,111761,11050,1324655,65189,99861,8340,1930,178,9957,2531,1436416,77969,111761,1324655,12780,65189,124541,1389844,945,914,23,9522
Arkansas_county,11/9/20,20,1,1,782,10255,676,11078,86,18124,661,121,8267,1988,583,93,20,0,58,28,8928,2150,661,8267,162,1988,823,10255,4,10,0,234
Ashley,11/9/20,13,3,3,622,7093,538,7727,71,20537,580,42,6818,275,510,28,13,0,57,14,7398,329,580,6818,54,275,634,7093,5,6,0,63
Baxter,11/9/20,15,5,5,940,7746,744,8696,181,41219,764,176,7111,635,608,136,15,0,141,40,7875,821,764,7111,186,635,950,7746,24,11,2,138
Benton,11/9/20,133,7,7,9561,96641,8335,106334,1092,258980,8557,1004,93480,3161,7601,734,116,17,839,253,102037,4297,8557,93480,1136,3161,9693,96641,53,52,3,918
Boone,11/9/20,38,9,9,1218,15785,1043,17032,137,37288,1069,149,15459,326,928,115,36,2,105,32,16528,504,1069,15459,178,326,1247,15785,21,13,0,195
Bradley,11/9/20,8,11,11,383,4998,362,5382,13,10948,369,14,4166,832,355,7,7,1,7,6,4535,847,369,4166,15,832,384,4998,0,0,0,12
Calhoun,11/9/20,0,13,13,81,2067,56,2150,25,5202,73,8,2013,54,51,5,0,0,22,3,2086,64,73,2013,10,54,83,2067,2,1,0,17
Carroll,11/9/20,20,15,15,1097,9769,1009,10877,68,27887,1044,53,9651,118,965,44,20,0,59,9,10695,182,1044,9651,64,118,1108,9769,3,6,0,70
Chicot,11/9/20,23,17,17,1065,6357,1031,7427,11,10826,1048,17,6064,293,1016,15,22,1,10,1,7112,315,1048,6064,22,293,1070,6357,0,2,0,87
Clark,11/9/20,6,19,19,608,10476,516,11107,86,22385,534,74,9470,1006,463,53,6,0,65,21,10004,1103,534,9470,97,1006,631,10476,6,3,0,94
Clay,11/9/20,16,21,21,582,7130,490,7723,75,15061,515,67,6105,1025,447,43,14,2,53,22,6620,1103,515,6105,78,1025,593,7130,5,2,0,72
Cleburne,11/9/20,18,23,23,550,9802,475,10359,57,25230,472,78,8961,841,419,56,18,0,35,22,9433,926,472,8961,85,841,557,9802,3,3,0,46
Cleveland,11/9/20,13,25,25,281,4067,237,4354,31,8226,245,36,3920,147,213,24,12,1,20,11,4165,189,245,3920,42,147,287,4067,0,4,0,7
Columbia,11/9/20,22,27,27,807,7911,721,8746,64,23892,664,143,7144,767,605,116,22,0,37,27,7808,938,664,7144,171,767,835,7911,2,11,0,41
Conway,11/9/20,4,29,29,412,9050,352,9464,56,20906,384,28,8656,394,329,23,4,0,51,5,9040,424,384,8656,30,394,414,9050,10,3,0,53
Craighead,11/9/20,57,31,31,5538,53691,4701,59317,779,105701,5111,427,50008,3683,4418,283,53,4,639,140,55119,4198,5111,50008,515,3683,5626,53691,29,45,2,416
Crawford,11/9/20,33,33,33,2401,31106,2095,33517,273,62472,2237,164,30584,522,1982,113,31,2,224,49,32821,696,2237,30584,174,522,2411,31106,25,22,0,396
Crittenden,11/9/20,53,35,35,2727,18401,2418,21135,255,49013,2618,109,18036,365,2343,75,46,7,228,27,20654,481,2618,18036,116,365,2734,18401,22,23,0,185
Cross,11/9/20,23,37,37,641,7064,582,7708,36,16998,572,69,6789,275,519,63,21,2,32,4,7361,347,572,6789,72,275,644,7064,2,6,0,33
Dallas,11/9/20,6,39,39,201,2933,182,3134,13,7432,197,4,2851,82,179,3,6,0,12,1,3048,86,197,2851,4,82,201,2933,3,1,0,8
Desha,11/9/20,8,41,41,458,5489,405,5958,45,11887,427,31,5249,240,384,21,7,1,36,9,5676,282,427,5249,42,240,469,5489,0,1,0,48
Drew,11/9/20,7,43,43,477,8303,430,8785,40,18502,439,38,7525,778,405,25,6,1,28,12,7964,821,439,7525,43,778,482,8303,4,3,0,128
Faulkner,11/9/20,44,45,45,3772,54909,3429,58736,299,122416,3459,313,51845,3064,3174,255,38,6,247,52,55304,3432,3459,51845,368,3064,3827,54909,24,28,0,330
Franklin,11/9/20,4,47,47,625,9649,546,10294,75,17780,561,64,9417,232,497,49,4,0,60,15,9978,316,561,9417,84,232,645,9649,3,3,1,79
Fulton,11/9/20,11,49,49,384,2996,329,3391,44,12139,317,67,2567,429,282,47,9,2,26,18,2884,507,317,2567,78,429,395,2996,1,6,0,26
Garland,11/9/20,82,51,51,2850,43194,2478,46071,290,98296,2689,161,41922,1272,2371,107,77,5,241,49,44611,1460,2689,41922,188,1272,2877,43194,12,18,4,199
Grant,11/9/20,4,53,53,411,7439,369,7860,38,18086,372,39,6892,547,336,33,4,0,32,6,7264,596,372,6892,49,547,421,7439,1,2,0,51
Greene,11/9/20,23,55,55,1932,21945,1594,23912,315,44623,1667,265,20347,1598,1416,178,21,2,230,85,22014,1898,1667,20347,300,1598,1967,21945,15,34,0,190
Hempstead,11/9/20,5,57,57,672,7447,580,8137,87,22018,583,89,7196,251,516,64,5,0,62,25,7779,358,583,7196,107,251,690,7447,2,6,0,67
HotSpring,11/9/20,39,59,59,2431,19397,2191,21839,201,33520,2385,46,18626,771,2160,31,37,2,188,13,21011,828,2385,18626,57,771,2442,19397,13,5,0,97
Howard,11/9/20,15,61,61,690,4716,599,5418,76,13389,598,92,4317,399,532,67,15,0,51,25,4915,503,598,4317,104,399,702,4716,3,8,0,7
Independence,11/9/20,66,63,63,1688,16383,1464,18102,158,37264,1366,322,15750,633,1192,272,56,10,118,40,17116,986,1366,15750,353,633,1719,16383,75,8,0,425
Izard,11/9/20,3,65,65,836,6465,573,7313,260,13559,779,57,5975,490,528,45,3,0,248,12,6754,559,779,5975,69,490,848,6465,1,5,1,152
Jackson,11/9/20,6,67,67,1036,10832,785,11927,245,17225,807,229,10525,307,579,206,5,1,223,22,11332,595,807,10525,288,307,1095,10832,7,18,0,35
Jefferson,11/9/20,102,69,69,4559,43538,4119,48197,336,70424,4384,175,42714,824,3999,120,97,5,286,50,47098,1099,4384,42714,275,824,4659,43538,12,24,0,188
Johnson,11/9/20,11,71,71,1095,11178,1034,12280,50,26291,1042,53,10864,314,995,39,10,1,37,13,11906,374,1042,10864,60,314,1102,11178,5,8,0,52
Lafayette,11/9/20,3,73,73,220,1615,179,1841,38,6915,185,35,1550,65,155,24,3,0,27,11,1735,106,185,1550,41,65,226,1615,0,3,0,6
Lawrence,11/9/20,24,75,75,955,6829,844,7801,87,16669,840,115,6546,283,749,95,24,0,67,20,7386,415,840,6546,132,283,972,6829,0,13,1,140
Lee,11/9/20,18,77,77,1119,5401,1094,6523,7,9398,1112,7,5352,49,1089,5,17,1,6,1,6464,59,1112,5352,10,49,1122,5401,1,1,0,8
Lincoln,11/9/20,18,79,79,2355,10117,2293,12483,44,13695,2329,26,9973,144,2270,23,17,1,42,2,12302,181,2329,9973,37,144,2366,10117,0,1,0,45
LittleRiver,11/9/20,37,81,81,519,2583,451,3099,31,12417,457,62,2471,112,404,47,32,5,21,10,2928,171,457,2471,59,112,516,2583,2,7,0,16
Logan,11/9/20,5,83,83,653,11064,600,11725,48,21757,623,30,10328,736,580,20,5,0,38,10,10951,774,623,10328,38,736,661,11064,3,1,0,45
Lonoke,11/9/20,35,85,85,2077,30740,1795,32914,247,72206,1683,394,27078,3662,1457,338,33,2,193,54,28761,4153,1683,27078,491,3662,2174,30740,23,22,1,205
Madison,11/9/20,6,87,87,480,5898,429,6384,45,16076,445,35,5667,231,399,30,6,0,40,5,6112,272,445,5667,41,231,486,5898,7,2,0,46
Marion,11/9/20,2,89,89,220,4010,162,4235,56,16438,188,32,3731,279,145,17,1,1,42,14,3919,316,188,3731,37,279,225,4010,1,3,0,50
Miller,11/9/20,22,91,91,1796,9465,1565,11300,209,43759,1430,366,9093,372,1263,302,16,6,151,58,10523,777,1430,9093,405,372,1835,9465,13,30,0,106
MissingCountyInfo,11/9/20,0,5,5,1932,71686,1284,73615,648,NA,1652,280,71671,15,1110,174,0,0,542,106,73323,292,1652,71671,277,15,1929,71686,64,4,0,-2253
Mississippi,11/9/20,72,93,93,2641,15876,2290,18514,278,42831,2470,171,15236,640,2177,113,59,13,233,45,17706,808,2470,15236,168,640,2638,15876,19,39,1,210
Monroe,11/9/20,2,95,95,251,3351,216,3605,33,7249,236,15,3272,79,202,14,2,0,32,1,3508,97,236,3272,18,79,254,3351,2,2,0,30
Montgomery,11/9/20,9,97,97,199,3167,181,3367,9,8993,195,4,2760,407,178,3,9,0,8,1,2955,412,195,2760,5,407,200,3167,1,0,0,8
Nevada,11/9/20,14,99,99,368,5311,307,5679,47,8440,335,33,5176,135,279,28,13,1,43,4,5511,168,335,5176,33,135,368,5311,2,5,0,122
Newton,11/9/20,21,101,101,346,2854,296,3194,29,7848,314,32,2305,549,273,23,18,3,23,6,2619,575,314,2305,26,549,340,2854,1,1,0,13
Ouachita,11/9/20,9,103,103,435,7943,384,8390,41,24106,410,25,7668,275,363,21,9,0,37,4,8078,312,410,7668,37,275,447,7943,1,1,0,67
Perry,11/9/20,2,105,105,181,5169,139,5356,40,10322,166,15,4988,181,131,8,2,0,33,7,5154,202,166,4988,21,181,187,5169,1,1,0,70
Phillips,11/9/20,16,107,107,809,9371,755,10200,38,19034,787,22,9184,187,734,21,16,0,37,1,9971,229,787,9184,42,187,829,9371,2,7,0,60
Pike,11/9/20,1,109,109,291,3057,271,3347,19,10808,275,16,2881,176,260,11,0,1,15,4,3156,191,275,2881,15,176,290,3057,3,1,0,16
Poinsett,11/9/20,32,111,111,1354,13067,1106,14456,216,24054,1229,125,12696,371,1028,78,30,2,171,45,13925,531,1229,12696,160,371,1389,13067,22,23,1,132
Polk,11/9/20,5,113,113,445,6193,366,6644,74,20163,413,32,6044,149,355,11,5,0,53,21,6457,187,413,6044,38,149,451,6193,10,4,0,53
Pope,11/9/20,39,115,115,2991,32660,2751,35666,201,63644,2760,231,31775,885,2585,166,35,4,140,61,34535,1131,2760,31775,246,885,3006,32660,10,12,1,316
Prairie,11/9/20,5,117,117,281,3351,232,3644,44,8244,240,41,3003,348,198,34,5,0,37,7,3243,401,240,3003,53,348,293,3351,6,4,0,14
Pulaski,11/9/20,230,119,119,13342,188401,12000,201924,1110,393463,12551,791,181249,7152,11354,646,215,15,980,130,193800,8124,12551,181249,972,7152,13523,188401,119,134,0,1551
Randolph,11/9/20,26,121,121,756,7825,657,8607,73,17603,593,163,7122,703,510,147,20,6,63,10,7715,892,593,7122,189,703,782,7825,2,9,0,70
Saline,11/9/20,42,125,125,3416,45395,2961,48895,412,118009,3023,393,41950,3445,2676,285,40,2,306,106,44973,3922,3023,41950,477,3445,3500,45395,34,26,1,319
Scott,11/9/20,2,127,127,267,4836,226,5105,39,10442,233,34,4731,105,206,20,2,0,25,14,4964,141,233,4731,36,105,269,4836,2,6,0,48
Searcy,11/9/20,1,129,129,227,3434,209,3660,17,7923,208,19,3152,282,194,15,1,0,13,4,3360,300,208,3152,18,282,226,3434,0,0,0,18
Sebastian,11/9/20,106,131,131,5618,69295,4874,74937,636,127461,5281,337,68437,858,4647,227,98,8,534,102,73718,1219,5281,68437,361,858,5642,69295,56,35,0,914
Sevier,11/9/20,16,133,133,1505,8023,1377,9547,112,17193,1311,194,7474,549,1242,135,16,0,53,59,8785,762,1311,7474,213,549,1524,8023,7,13,0,25
Sharp,11/9/20,13,135,135,449,6648,360,7099,76,17043,362,87,6204,444,303,57,13,0,46,30,6566,533,362,6204,89,444,451,6648,3,5,1,122
St.Francis,11/9/20,11,123,123,1855,15243,1762,17107,82,26294,1822,33,15108,135,1735,27,11,0,76,6,16930,177,1822,15108,42,135,1864,15243,12,8,1,96
Stone,11/9/20,22,137,137,418,4605,383,5027,13,12446,400,18,4427,178,367,16,22,0,11,2,4827,200,400,4427,22,178,422,4605,2,0,0,35
Union,11/9/20,53,139,139,1261,12690,1140,13972,68,39732,1110,151,11358,1332,1008,132,47,6,55,13,12468,1504,1110,11358,172,1332,1282,12690,0,4,0,16
VanBuren,11/9/20,3,141,141,246,6135,227,6394,16,16684,234,12,5772,363,217,10,3,0,14,2,6006,388,234,5772,25,363,259,6135,0,1,0,29
Washington,11/9/20,162,143,143,12605,108250,11556,121006,886,228529,11142,1463,100783,7467,10396,1160,144,18,602,284,111925,9081,11142,100783,1614,7467,12756,108250,82,60,0,1383
White,11/9/20,41,145,145,1943,24814,1537,26809,365,78804,1604,339,22242,2572,1297,240,36,5,271,94,23846,2963,1604,22242,391,2572,1995,24814,26,16,2,144
Woodruff,11/9/20,0,147,147,154,2545,130,2703,24,6660,132,22,2452,93,114,16,0,0,18,6,2584,119,132,2452,26,93,158,2545,2,5,0,10
Yell,11/9/20,32,149,149,1418,14705,1324,16124,62,21573,1392,26,14462,243,1311,13,29,3,52,10,15854,270,1392,14462,27,243,1419,14705,7,4,0,58
Arkansas_all_counties,11/8/20,2085,5630,5630,121866,1381267,107287,1504796,12480,2990671,110932,10934,1316939,64328,99179,8108,1907,178,9833,2647,1427871,76925,110932,1316939,12597,64328,123529,1381267,1038,693,17,9943
Arkansas_county,11/8/20,20,1,1,778,10025,666,10843,92,18124,659,119,8143,1882,576,90,20,0,63,29,8802,2041,659,8143,159,1882,818,10025,6,11,0,81
Ashley,11/8/20,13,3,3,617,7035,532,7663,72,20537,575,42,6762,273,504,28,13,0,58,14,7337,326,575,6762,53,273,628,7035,0,2,0,16
Baxter,11/8/20,13,5,5,916,7632,733,8558,170,41219,741,175,6997,635,601,132,13,0,127,43,7738,820,741,6997,185,635,926,7632,10,6,0,63
Benton,11/8/20,130,7,7,9508,95776,8283,105418,1094,258980,8511,997,92800,2976,7571,712,113,17,826,268,101311,4107,8511,92800,1131,2976,9642,95776,78,49,1,410
Boone,11/8/20,38,9,9,1197,15611,1030,16832,129,37288,1047,150,15287,324,916,114,36,2,95,34,16334,498,1047,15287,174,324,1221,15611,6,6,0,29
Bradley,11/8/20,8,11,11,383,4986,362,5370,13,10948,369,14,4154,832,355,7,7,1,7,6,4523,847,369,4154,15,832,384,4986,0,0,0,8
Calhoun,11/8/20,0,13,13,79,2052,55,2133,24,5202,71,8,1998,54,50,5,0,0,21,3,2069,64,71,1998,10,54,81,2052,3,1,0,4
Carroll,11/8/20,20,15,15,1094,9702,1003,10807,71,27887,1041,53,9585,117,959,44,20,0,62,9,10626,181,1041,9585,64,117,1105,9702,1,4,0,9
Chicot,11/8/20,23,17,17,1065,6270,1029,7340,13,10826,1048,17,5977,293,1014,15,22,1,12,1,7025,315,1048,5977,22,293,1070,6270,3,1,0,46
Clark,11/8/20,6,19,19,602,10388,513,11013,83,22385,530,72,9386,1002,461,52,6,0,63,20,9916,1097,530,9386,95,1002,625,10388,7,3,0,92
Clay,11/8/20,16,21,21,577,7063,488,7650,72,15061,510,67,6042,1021,446,42,14,2,49,23,6552,1098,510,6042,77,1021,587,7063,9,3,1,35
Cleburne,11/8/20,18,23,23,547,9759,472,10313,57,25230,471,76,8924,835,418,54,18,0,35,22,9395,918,471,8924,83,835,554,9759,3,4,0,49
Cleveland,11/8/20,13,25,25,281,4060,233,4346,35,8226,245,36,3913,147,211,22,12,1,22,13,4158,188,245,3913,41,147,286,4060,0,7,0,14
Columbia,11/8/20,22,27,27,805,7872,710,8704,73,23892,662,143,7123,749,597,113,22,0,43,30,7785,919,662,7123,170,749,832,7872,7,5,0,31
Conway,11/8/20,4,29,29,402,9007,349,9411,49,20906,374,28,8615,392,326,23,4,0,44,5,8989,422,374,8615,30,392,404,9007,1,0,0,157
Craighead,11/8/20,55,31,31,5509,53304,4656,58900,797,105701,5087,422,49633,3671,4382,274,51,4,653,144,54720,4180,5087,49633,509,3671,5596,53304,57,35,1,449
Crawford,11/8/20,33,33,33,2376,30735,2073,33120,270,62472,2214,162,30219,516,1963,110,31,2,220,50,32433,687,2214,30219,171,516,2385,30735,19,19,1,199
Crittenden,11/8/20,53,35,35,2705,18238,2395,20949,256,49013,2596,109,17874,364,2323,72,46,7,226,30,20470,479,2596,17874,115,364,2711,18238,17,16,0,76
Cross,11/8/20,23,37,37,639,7033,576,7673,40,16998,570,69,6764,269,516,60,21,2,33,7,7334,339,570,6764,70,269,640,7033,0,0,0,15
Dallas,11/8/20,6,39,39,198,2928,181,3126,11,7432,194,4,2846,82,178,3,6,0,10,1,3040,86,194,2846,4,82,198,2928,1,0,0,7
Desha,11/8/20,8,41,41,458,5441,404,5909,46,11887,426,32,5207,234,383,21,7,1,36,10,5633,276,426,5207,42,234,468,5441,2,1,0,31
Drew,11/8/20,7,43,43,473,8179,427,8657,39,18502,435,38,7402,777,402,25,6,1,27,12,7837,820,435,7402,43,777,478,8179,1,2,0,27
Faulkner,11/8/20,44,45,45,3748,54603,3401,58405,303,122416,3434,314,51555,3048,3155,246,38,6,241,62,54989,3416,3434,51555,368,3048,3802,54603,29,26,0,395
Franklin,11/8/20,3,47,47,622,9573,543,10215,76,17780,559,63,9341,232,495,48,3,0,61,15,9900,315,559,9341,83,232,642,9573,1,4,0,61
Fulton,11/8/20,11,49,49,383,2971,323,3365,49,12139,316,67,2544,427,278,45,9,2,29,20,2860,505,316,2544,78,427,394,2971,1,1,0,5
Garland,11/8/20,78,51,51,2838,43007,2460,45872,300,98296,2676,162,41737,1270,2359,101,73,5,244,56,44413,1459,2676,41737,189,1270,2865,43007,20,10,2,127
Grant,11/8/20,4,53,53,410,7389,367,7808,39,18086,371,39,6844,545,334,33,4,0,33,6,7215,593,371,6844,48,545,419,7389,2,1,0,23
Greene,11/8/20,23,55,55,1917,21770,1560,23721,334,44623,1654,263,20173,1597,1396,164,21,2,237,97,21827,1894,1654,20173,297,1597,1951,21770,11,27,0,86
Hempstead,11/8/20,5,57,57,670,7382,574,8070,91,22018,581,89,7131,251,510,64,5,0,66,25,7712,358,581,7131,107,251,688,7382,5,3,0,15
HotSpring,11/8/20,39,59,59,2418,19313,2186,21742,193,33520,2371,47,18544,769,2156,30,37,2,178,15,20915,827,2371,18544,58,769,2429,19313,31,17,1,142
Howard,11/8/20,15,61,61,687,4712,591,5408,81,13389,594,93,4314,398,525,66,15,0,54,27,4908,500,594,4314,102,398,696,4712,11,5,0,16
Independence,11/8/20,66,63,63,1613,16033,1456,17676,91,37264,1295,318,15431,602,1190,266,56,10,49,42,16726,950,1295,15431,348,602,1643,16033,14,3,0,43
Izard,11/8/20,2,65,65,835,6314,568,7161,265,13559,777,58,5825,489,524,44,2,0,251,14,6602,559,777,5825,70,489,847,6314,39,2,0,71
Jackson,11/8/20,6,67,67,1029,10804,767,11883,256,17225,799,230,10497,307,570,197,5,1,224,32,11296,587,799,10497,280,307,1079,10804,46,10,0,240
Jefferson,11/8/20,102,69,69,4547,43362,4095,48001,348,70424,4376,171,42540,822,3977,118,97,5,300,48,46916,1085,4376,42540,263,822,4639,43362,22,20,0,383
Johnson,11/8/20,11,71,71,1090,11131,1026,12228,53,26291,1037,53,10818,313,989,37,10,1,38,15,11855,373,1037,10818,60,313,1097,11131,1,2,0,36
Lafayette,11/8/20,3,73,73,220,1609,176,1835,41,6915,185,35,1544,65,154,22,3,0,28,13,1729,106,185,1544,41,65,226,1609,0,1,0,4
Lawrence,11/8/20,23,75,75,955,6689,831,7661,101,16669,838,117,6415,274,738,93,23,0,77,24,7253,408,838,6415,134,274,972,6689,12,10,1,35
Lee,11/8/20,18,77,77,1118,5394,1093,6515,7,9398,1111,7,5345,49,1089,4,17,1,5,2,6456,59,1111,5345,10,49,1121,5394,0,1,0,7
Lincoln,11/8/20,18,79,79,2355,10072,2292,12438,45,13695,2329,26,9928,144,2269,23,17,1,43,2,12257,181,2329,9928,37,144,2366,10072,0,2,0,64
LittleRiver,11/8/20,37,81,81,517,2569,444,3082,36,12417,455,62,2458,111,399,45,32,5,24,12,2913,169,455,2458,58,111,513,2569,2,4,0,9
Logan,11/8/20,5,83,83,650,11022,599,11680,46,21757,620,30,10288,734,580,19,5,0,35,11,10908,772,620,10288,38,734,658,11022,3,1,0,35
Lonoke,11/8/20,34,85,85,2054,30558,1773,32707,247,72206,1659,395,26926,3632,1444,329,32,2,183,64,28585,4122,1659,26926,490,3632,2149,30558,13,15,0,122
Madison,11/8/20,6,87,87,473,5859,427,6338,40,16076,439,34,5631,228,397,30,6,0,36,4,6070,268,439,5631,40,228,479,5859,2,1,0,14
Marion,11/8/20,2,89,89,219,3961,159,4184,58,16438,187,32,3682,279,142,17,1,1,44,14,3869,315,187,3682,36,279,223,3961,3,4,0,9
Miller,11/8/20,22,91,91,1783,9372,1535,11195,226,43759,1422,361,9032,340,1243,292,16,6,163,63,10454,741,1422,9032,401,340,1823,9372,6,16,0,59
MissingCountyInfo,11/8/20,0,5,5,1868,74003,1280,75867,588,NA,1624,244,73989,14,1105,175,0,0,519,69,75613,254,1624,73989,240,14,1864,74003,113,13,0,2282
Mississippi,11/8/20,71,93,93,2622,15685,2251,18303,299,42831,2454,168,15116,569,2141,110,58,13,254,45,17570,733,2454,15116,164,569,2618,15685,23,14,1,84
Monroe,11/8/20,2,95,95,249,3323,214,3575,33,7249,234,15,3247,76,201,13,2,0,31,2,3481,94,234,3247,18,76,252,3323,1,1,0,16
Montgomery,11/8/20,9,97,97,198,3160,181,3359,8,8993,194,4,2753,407,178,3,9,0,7,1,2947,412,194,2753,5,407,199,3160,0,0,0,3
Nevada,11/8/20,14,99,99,366,5191,302,5557,50,8440,333,33,5056,135,276,26,13,1,44,6,5389,168,333,5056,33,135,366,5191,5,3,0,13
Newton,11/8/20,21,101,101,345,2842,295,3181,29,7848,313,32,2293,549,273,22,18,3,22,7,2606,575,313,2293,26,549,339,2842,1,1,0,7
Ouachita,11/8/20,9,103,103,434,7877,383,8323,41,24106,409,25,7602,275,361,22,9,0,38,3,8011,312,409,7602,37,275,446,7877,0,4,0,14
Perry,11/8/20,2,105,105,180,5100,138,5286,40,10322,166,14,4920,180,130,8,2,0,34,6,5086,200,166,4920,20,180,186,5100,5,0,0,97
Phillips,11/8/20,16,107,107,807,9313,748,10139,43,19034,784,23,9127,186,726,22,16,0,42,1,9911,228,784,9127,42,186,826,9313,0,2,0,18
Pike,11/8/20,1,109,109,288,3044,270,3332,17,10808,274,14,2868,176,259,11,0,1,15,2,3142,190,274,2868,14,176,288,3044,0,0,0,9
Poinsett,11/8/20,31,111,111,1332,12957,1083,14317,218,24054,1216,116,12589,368,1016,67,29,2,171,47,13805,512,1216,12589,144,368,1360,12957,8,7,2,88
Polk,11/8/20,5,113,113,435,6150,362,6589,68,20163,402,33,6004,146,353,9,5,0,44,24,6406,183,402,6004,37,146,439,6150,4,4,0,76
Pope,11/8/20,38,115,115,2981,32354,2739,35350,204,63644,2753,228,31469,885,2577,162,34,4,142,62,34222,1128,2753,31469,243,885,2996,32354,8,8,0,205
Prairie,11/8/20,5,117,117,275,3343,228,3630,42,8244,236,39,2997,346,198,30,5,0,33,9,3233,397,236,2997,51,346,287,3343,4,1,0,23
Pulaski,11/8/20,230,119,119,13223,186969,11866,200367,1125,393463,12430,793,179842,7127,11232,634,215,15,981,144,192272,8095,12430,179842,968,7127,13398,186969,97,63,2,1331
Randolph,11/8/20,26,121,121,754,7757,648,8537,80,17603,593,161,7060,697,507,141,20,6,66,14,7653,884,593,7060,187,697,780,7757,5,1,0,34
Saline,11/8/20,41,125,125,3382,45110,2935,48575,405,118009,2994,388,41668,3442,2654,281,39,2,300,105,44662,3913,2994,41668,471,3442,3465,45110,31,34,1,198
Scott,11/8/20,2,127,127,265,4790,220,5057,43,10442,232,33,4686,104,203,17,2,0,27,16,4918,139,232,4686,35,104,267,4790,3,4,0,16
Searcy,11/8/20,1,129,129,227,3416,209,3642,17,7923,208,19,3136,280,194,15,1,0,13,4,3344,298,208,3136,18,280,226,3416,0,3,0,3
Sebastian,11/8/20,106,131,131,5562,68437,4839,74023,615,127461,5231,331,67590,847,4623,216,98,8,508,107,72821,1202,5231,67590,355,847,5586,68437,101,36,1,680
Sevier,11/8/20,16,133,133,1498,8005,1364,9517,118,17193,1304,194,7459,546,1238,126,16,0,50,68,8763,754,1304,7459,208,546,1512,8005,1,1,0,11
Sharp,11/8/20,12,135,135,446,6529,355,6977,79,17043,359,87,6086,443,301,54,12,0,46,33,6445,532,359,6086,89,443,448,6529,10,6,0,31
St.Francis,11/8/20,10,123,123,1843,15159,1754,17008,79,26294,1809,34,15024,135,1731,23,10,0,68,11,16833,175,1809,15024,40,135,1849,15159,2,54,0,18
Stone,11/8/20,22,137,137,416,4572,383,4992,11,12446,398,18,4397,175,367,16,22,0,9,2,4795,197,398,4397,22,175,420,4572,1,2,0,13
Union,11/8/20,53,139,139,1261,12674,1136,13956,72,39732,1110,151,11342,1332,1005,131,47,6,58,14,12452,1504,1110,11342,172,1332,1282,12674,9,5,0,32
VanBuren,11/8/20,3,141,141,246,6106,226,6365,17,16684,234,12,5759,347,216,10,3,0,15,2,5993,372,234,5759,25,347,259,6106,1,3,0,21
Washington,11/8/20,162,143,143,12523,106949,11496,119623,864,228529,11079,1444,99680,7269,10351,1145,144,18,584,280,110759,8864,11079,99680,1595,7269,12674,106949,78,49,1,524
White,11/8/20,39,145,145,1917,24696,1521,26665,357,78804,1582,335,22131,2565,1282,239,34,5,266,91,23713,2952,1582,22131,387,2565,1969,24696,15,13,1,123
Woodruff,11/8/20,0,147,147,152,2537,125,2693,27,6660,130,22,2444,93,109,16,0,0,21,6,2574,119,130,2444,26,93,156,2537,0,0,0,6
Yell,11/8/20,32,149,149,1411,14654,1320,16066,59,21573,1386,25,14411,243,1307,13,29,3,50,9,15797,269,1386,14411,26,243,1412,14654,7,0,0,118
Arkansas_all_counties,11/7/20,2068,5630,5630,120828,1372362,106594,1494770,12152,2990671,110016,10812,1308477,63885,98643,7951,1890,178,9470,2682,1418493,76277,110016,1308477,12392,63885,122408,1372362,1598,848,12,14155
Arkansas_county,11/7/20,20,1,1,772,9950,655,10760,97,18124,657,115,8123,1827,566,89,20,0,71,26,8780,1980,657,8123,153,1827,810,9950,6,4,0,126
Ashley,11/7/20,13,3,3,617,7019,530,7647,74,20537,576,41,6748,271,502,28,13,0,61,13,7324,323,576,6748,52,271,628,7019,12,8,0,97
Baxter,11/7/20,13,5,5,906,7579,727,8495,166,41219,731,175,6949,630,598,129,13,0,120,46,7680,815,731,6949,185,630,916,7579,26,22,1,119
Benton,11/7/20,129,7,7,9430,95444,8234,105001,1066,258980,8447,983,92480,2964,7533,701,112,17,801,265,100927,4074,8447,92480,1110,2964,9557,95444,204,65,0,737
Boone,11/7/20,38,9,9,1191,15588,1024,16801,129,37288,1042,149,15265,323,913,111,36,2,93,36,16307,494,1042,15265,171,323,1213,15588,26,6,0,139
Bradley,11/7/20,8,11,11,383,4978,362,5362,13,10948,369,14,4146,832,355,7,7,1,7,6,4515,847,369,4146,15,832,384,4978,1,0,0,181
Calhoun,11/7/20,0,13,13,76,2051,54,2128,22,5202,67,9,1997,54,50,4,0,0,17,5,2064,64,67,1997,10,54,77,2051,2,0,0,9
Carroll,11/7/20,20,15,15,1093,9694,999,10796,74,27887,1040,53,9577,117,955,44,20,0,65,9,10617,179,1040,9577,62,117,1102,9694,6,4,1,62
Chicot,11/7/20,23,17,17,1062,6227,1028,7294,11,10826,1045,17,5934,293,1013,15,22,1,10,1,6979,315,1045,5934,22,293,1067,6227,3,2,0,36
Clark,11/7/20,6,19,19,595,10303,510,10917,79,22385,519,76,9311,992,458,52,6,0,55,24,9830,1087,519,9311,95,992,614,10303,14,7,0,176
Clay,11/7/20,15,21,21,568,7037,485,7614,67,15061,502,66,6018,1019,443,42,13,2,45,22,6520,1094,502,6018,75,1019,577,7037,11,9,0,45
Cleburne,11/7/20,18,23,23,544,9713,468,10264,58,25230,468,76,8881,832,417,51,18,0,33,25,9349,915,468,8881,83,832,551,9713,4,1,0,106
Cleveland,11/7/20,13,25,25,281,4046,226,4332,42,8226,245,36,3901,145,205,21,12,1,28,14,4146,186,245,3901,41,145,286,4046,6,4,0,30
Columbia,11/7/20,22,27,27,798,7848,705,8669,71,23892,656,142,7113,735,595,110,22,0,39,32,7769,900,656,7113,165,735,821,7848,8,7,0,52
Conway,11/7/20,4,29,29,401,8851,349,9253,48,20906,372,29,8458,393,326,23,4,0,42,6,8830,423,372,8458,30,393,402,8851,11,3,0,159
Craighead,11/7/20,54,31,31,5452,52912,4621,58445,776,105701,5030,422,49255,3657,4357,264,50,4,622,154,54285,4160,5030,49255,503,3657,5533,52912,124,54,0,672
Crawford,11/7/20,32,33,33,2357,30555,2054,32918,271,62472,2201,156,30041,514,1944,110,30,2,227,44,32242,676,2201,30041,162,514,2363,30555,23,21,1,311
Crittenden,11/7/20,53,35,35,2688,18179,2379,20873,255,49013,2579,109,17835,344,2308,71,46,7,224,31,20414,459,2579,17835,115,344,2694,18179,30,20,0,113
Cross,11/7/20,23,37,37,639,7018,576,7658,40,16998,570,69,6754,264,516,60,21,2,33,7,7324,334,570,6754,70,264,640,7018,4,6,0,35
Dallas,11/7/20,6,39,39,197,2922,181,3119,10,7432,193,4,2841,81,178,3,6,0,9,1,3034,85,193,2841,4,81,197,2922,1,0,0,12
Desha,11/7/20,8,41,41,456,5412,403,5878,45,11887,424,32,5178,234,382,21,7,1,35,10,5602,276,424,5178,42,234,466,5412,2,6,0,31
Drew,11/7/20,7,43,43,472,8153,425,8630,40,18502,435,37,7377,776,400,25,6,1,29,11,7812,818,435,7377,42,776,477,8153,7,2,0,109
Faulkner,11/7/20,44,45,45,3719,54237,3375,58009,300,122416,3405,314,51203,3034,3137,238,38,6,230,70,54608,3401,3405,51203,367,3034,3772,54237,36,31,0,536
Franklin,11/7/20,3,47,47,621,9513,539,10154,79,17780,558,63,9284,229,492,47,3,0,63,16,9842,312,558,9284,83,229,641,9513,19,8,1,96
Fulton,11/7/20,11,49,49,382,2967,322,3360,49,12139,315,67,2540,427,277,45,9,2,29,20,2855,505,315,2540,78,427,393,2967,5,6,0,30
Garland,11/7/20,76,51,51,2818,42900,2450,45742,292,98296,2660,158,41649,1251,2351,99,71,5,238,54,44309,1433,2660,41649,182,1251,2842,42900,29,24,0,207
Grant,11/7/20,4,53,53,408,7368,366,7785,38,18086,369,39,6826,542,333,33,4,0,32,6,7195,590,369,6826,48,542,417,7368,4,5,0,38
Greene,11/7/20,23,55,55,1906,21695,1533,23635,350,44623,1645,261,20099,1596,1375,158,21,2,249,101,21744,1891,1645,20099,295,1596,1940,21695,48,35,1,189
Hempstead,11/7/20,5,57,57,665,7372,571,8054,89,22018,575,90,7121,251,507,64,5,0,63,26,7696,358,575,7121,107,251,682,7372,14,6,0,153
HotSpring,11/7/20,38,59,59,2387,19202,2169,21599,180,33520,2339,48,18443,759,2141,28,36,2,162,18,20782,817,2339,18443,58,759,2397,19202,8,6,0,113
Howard,11/7/20,15,61,61,676,4707,586,5392,75,13389,586,90,4309,398,522,64,15,0,49,26,4895,497,586,4309,99,398,685,4707,8,4,1,40
Independence,11/7/20,66,63,63,1599,16004,1453,17631,80,37264,1289,310,15407,597,1188,265,56,10,45,35,16696,935,1289,15407,338,597,1627,16004,8,4,0,105
Izard,11/7/20,2,65,65,796,6282,566,7088,228,13559,739,57,5793,489,524,42,2,0,213,15,6532,556,739,5793,67,489,806,6282,9,2,0,43
Jackson,11/7/20,6,67,67,983,10610,757,11638,220,17225,753,230,10305,305,561,196,5,1,187,33,11058,580,753,10305,275,305,1028,10610,6,50,0,318
Jefferson,11/7/20,102,69,69,4525,43001,4075,47617,346,70424,4354,171,42192,809,3961,114,97,5,294,52,46546,1071,4354,42192,262,809,4616,43001,65,20,0,559
Johnson,11/7/20,11,71,71,1089,11096,1024,12192,54,26291,1036,53,10783,313,987,37,10,1,39,15,11819,373,1036,10783,60,313,1096,11096,5,1,0,71
Lafayette,11/7/20,3,73,73,220,1605,175,1831,42,6915,185,35,1541,64,154,21,3,0,28,14,1726,105,185,1541,41,64,226,1605,2,-1,0,20
Lawrence,11/7/20,22,75,75,943,6666,821,7620,100,16669,824,119,6394,272,732,89,22,0,70,30,7218,402,824,6394,130,272,954,6666,5,6,0,70
Lee,11/7/20,18,77,77,1118,5387,1092,6508,8,9398,1111,7,5337,50,1088,4,17,1,6,2,6448,60,1111,5337,10,50,1121,5387,1,1,0,18
Lincoln,11/7/20,18,79,79,2355,10008,2290,12374,47,13695,2329,26,9865,143,2267,23,17,1,45,2,12194,180,2329,9865,37,143,2366,10008,1,2,0,18
LittleRiver,11/7/20,37,81,81,515,2562,440,3073,38,12417,454,61,2451,111,398,42,32,5,24,14,2905,168,454,2451,57,111,511,2562,3,2,0,57
Logan,11/7/20,5,83,83,647,10990,598,11645,44,21757,617,30,10256,734,579,19,5,0,33,11,10873,772,617,10256,38,734,655,10990,10,2,0,60
Lonoke,11/7/20,34,85,85,2041,30449,1758,32583,249,72206,1647,394,26820,3629,1437,321,32,2,178,71,28467,4116,1647,26820,487,3629,2134,30449,36,20,0,305
Madison,11/7/20,6,87,87,471,5847,426,6324,39,16076,439,32,5620,227,396,30,6,0,37,2,6059,265,439,5620,38,227,477,5847,11,2,0,138
Marion,11/7/20,2,89,89,216,3955,155,4175,59,16438,184,32,3676,279,138,17,1,1,45,14,3860,315,184,3676,36,279,220,3955,6,2,0,40
Miller,11/7/20,22,91,91,1777,9319,1519,11132,236,43759,1414,363,8992,327,1236,283,16,6,162,74,10406,726,1414,8992,399,327,1813,9319,19,16,0,106
MissingCountyInfo,11/7/20,0,5,5,1755,71834,1267,73583,488,NA,1533,222,71820,14,1105,162,0,0,428,60,73353,230,1533,71820,216,14,1749,71834,44,5,0,2342
Mississippi,11/7/20,70,93,93,2599,15624,2237,18219,291,42831,2434,165,15056,568,2130,107,57,13,246,45,17490,729,2434,15056,161,568,2595,15624,56,13,0,161
Monroe,11/7/20,2,95,95,248,3308,213,3559,33,7249,233,15,3232,76,200,13,2,0,31,2,3465,94,233,3232,18,76,251,3308,2,4,0,28
Montgomery,11/7/20,9,97,97,198,3157,181,3356,8,8993,194,4,2750,407,178,3,9,0,7,1,2944,412,194,2750,5,407,199,3157,2,1,1,14
Nevada,11/7/20,14,99,99,361,5183,299,5543,48,8440,328,33,5048,135,273,26,13,1,42,6,5376,167,328,5048,32,135,360,5183,7,1,0,133
Newton,11/7/20,21,101,101,344,2836,294,3174,29,7848,312,32,2287,549,272,22,18,3,22,7,2599,575,312,2287,26,549,338,2836,2,4,0,51
Ouachita,11/7/20,9,103,103,434,7863,379,8309,45,24106,409,25,7591,272,357,22,9,0,42,3,8000,309,409,7591,37,272,446,7863,8,7,0,40
Perry,11/7/20,2,105,105,175,5008,138,5189,35,10322,161,14,4828,180,130,8,2,0,29,6,4989,200,161,4828,20,180,181,5008,3,1,0,57
Phillips,11/7/20,16,107,107,807,9295,746,10121,45,19034,784,23,9114,181,724,22,16,0,44,1,9898,223,784,9114,42,181,826,9295,6,11,0,25
Pike,11/7/20,1,109,109,288,3035,270,3323,17,10808,274,14,2860,175,259,11,0,1,15,2,3134,189,274,2860,14,175,288,3035,0,0,0,15
Poinsett,11/7/20,29,111,111,1324,12877,1076,14229,219,24054,1209,115,12514,363,1009,67,27,2,173,46,13723,506,1209,12514,143,363,1352,12877,19,25,1,83
Polk,11/7/20,5,113,113,431,6078,358,6514,68,20163,401,30,5932,146,349,9,5,0,47,21,6333,181,401,5932,35,146,436,6078,9,2,0,53
Pope,11/7/20,38,115,115,2973,32157,2731,35145,204,63644,2746,227,31276,881,2572,159,34,4,140,64,34022,1123,2746,31276,242,881,2988,32157,29,19,0,236
Prairie,11/7/20,5,117,117,271,3324,227,3607,39,8244,232,39,2978,346,197,30,5,0,30,9,3210,397,232,2978,51,346,283,3324,4,8,0,42
Pulaski,11/7/20,228,119,119,13126,185735,11803,199030,1093,393463,12342,784,178725,7010,11175,628,213,15,952,141,191067,7963,12342,178725,953,7010,13295,185735,134,55,0,1102
Randolph,11/7/20,26,121,121,749,7728,647,8500,76,17603,587,162,7038,690,506,141,20,6,61,15,7625,875,587,7038,185,690,772,7728,19,7,0,209
Saline,11/7/20,40,125,125,3351,44943,2901,48374,409,118009,2970,381,41517,3426,2632,269,38,2,299,110,44487,3887,2970,41517,461,3426,3431,44943,64,29,0,360
Scott,11/7/20,2,127,127,262,4777,216,5041,44,10442,229,33,4675,102,200,16,2,0,27,17,4904,137,229,4675,35,102,264,4777,5,5,0,26
Searcy,11/7/20,1,129,129,227,3413,206,3639,20,7923,208,19,3134,279,192,14,1,0,15,5,3342,297,208,3134,18,279,226,3413,1,3,0,13
Sebastian,11/7/20,105,131,131,5461,67858,4803,73342,551,127461,5136,325,67031,827,4590,213,97,8,447,104,72167,1175,5136,67031,348,827,5484,67858,72,37,0,564
Sevier,11/7/20,16,133,133,1497,7995,1363,9505,118,17193,1301,196,7449,546,1237,126,16,0,48,70,8750,755,1301,7449,209,546,1510,7995,11,5,0,113
Sharp,11/7/20,12,135,135,436,6508,349,6946,75,17043,350,86,6069,439,297,52,12,0,41,34,6419,527,350,6069,88,439,438,6508,16,9,1,75
St.Francis,11/7/20,10,123,123,1841,15143,1700,16990,131,26294,1807,34,15008,135,1679,21,10,0,118,13,16815,175,1807,15008,40,135,1847,15143,11,5,0,80
Stone,11/7/20,22,137,137,415,4560,381,4979,12,12446,397,18,4391,169,366,15,22,0,9,3,4788,191,397,4391,22,169,419,4560,2,0,0,45
Union,11/7/20,53,139,139,1252,12651,1131,13922,68,39732,1101,151,11327,1324,1001,130,47,6,53,15,12428,1494,1101,11327,170,1324,1271,12651,8,6,0,25
VanBuren,11/7/20,3,141,141,245,6086,223,6344,19,16684,233,12,5742,344,213,10,3,0,17,2,5975,369,233,5742,25,344,258,6086,3,3,0,31
Washington,11/7/20,161,143,143,12445,106503,11447,119097,836,228529,11034,1411,99222,7281,10316,1131,143,18,575,261,110256,8841,11034,99222,1560,7281,12594,106503,120,63,2,1131
White,11/7/20,38,145,145,1902,24588,1508,26540,356,78804,1568,334,22036,2552,1273,235,33,5,262,94,23604,2936,1568,22036,384,2552,1952,24588,42,13,1,296
Woodruff,11/7/20,0,147,147,152,2531,125,2687,27,6660,130,22,2439,92,109,16,0,0,21,6,2569,118,130,2439,26,92,156,2531,2,1,0,44
Yell,11/7/20,32,149,149,1404,14543,1320,15948,52,21573,1378,26,14300,243,1307,13,29,3,42,10,15678,270,1378,14300,27,243,1405,14543,8,1,0,74
Arkansas_all_counties,11/6/20,2056,5630,5630,119230,1359805,105746,1480504,11414,2990671,108738,10492,1298264,61541,97997,7749,1878,178,8850,2564,1407002,73502,108738,1298264,11961,61541,120699,1359805,1870,930,19,16530
Arkansas_county,11/6/20,20,1,1,766,9830,651,10632,95,18124,653,113,8091,1739,563,88,20,0,70,25,8744,1888,653,8091,149,1739,802,9830,6,8,0,98
Ashley,11/6/20,13,3,3,605,6934,522,7550,70,20537,570,35,6670,264,494,28,13,0,63,7,7240,310,570,6670,46,264,616,6934,11,3,0,64
Baxter,11/6/20,12,5,5,880,7486,705,8375,163,41219,710,170,6858,628,580,125,12,0,118,45,7568,807,710,6858,179,628,889,7486,32,13,0,121
Benton,11/6/20,129,7,7,9226,94911,8169,104238,927,258980,8270,956,92092,2819,7485,684,112,17,672,255,100362,3876,8270,92092,1057,2819,9327,94911,166,67,2,1193
Boone,11/6/20,38,9,9,1165,15475,1018,16662,109,37288,1026,139,15206,269,909,109,36,2,81,28,16232,430,1026,15206,161,269,1187,15475,20,23,0,211
Bradley,11/6/20,8,11,11,382,4798,362,5181,12,10948,368,14,4130,668,355,7,7,1,6,6,4498,683,368,4130,15,668,383,4798,2,1,0,21
Calhoun,11/6/20,0,13,13,74,2044,54,2118,20,5202,65,9,1993,51,50,4,0,0,15,5,2058,60,65,1993,9,51,74,2044,3,1,0,11
Carroll,11/6/20,19,15,15,1087,9638,995,10734,73,27887,1035,52,9523,115,951,44,19,0,65,8,10558,176,1035,9523,61,115,1096,9638,17,6,0,131
Chicot,11/6/20,23,17,17,1059,6194,1026,7258,10,10826,1042,17,5908,286,1011,15,22,1,9,1,6950,308,1042,5908,22,286,1064,6194,0,2,0,69
Clark,11/6/20,6,19,19,581,10141,503,10741,72,22385,510,71,9166,975,455,48,6,0,49,23,9676,1065,510,9166,90,975,600,10141,17,10,0,234
Clay,11/6/20,15,21,21,557,7003,476,7568,65,15061,497,60,5989,1014,439,37,13,2,44,21,6486,1082,497,5989,68,1014,565,7003,13,7,0,105
Cleburne,11/6/20,18,23,23,540,9611,467,10158,55,25230,465,75,8816,795,416,51,18,0,31,24,9281,877,465,8816,82,795,547,9611,6,9,1,138
Cleveland,11/6/20,13,25,25,275,4022,222,4302,40,8226,243,32,3883,139,203,19,12,1,28,12,4126,176,243,3883,37,139,280,4022,1,3,0,22
Columbia,11/6/20,22,27,27,790,7804,698,8617,70,23892,652,138,7103,701,594,104,22,0,36,34,7755,862,652,7103,161,701,813,7804,13,14,0,175
Conway,11/6/20,4,29,29,390,8703,346,9093,40,20906,362,28,8329,374,323,23,4,0,35,5,8691,402,362,8329,28,374,390,8703,8,3,0,69
Craighead,11/6/20,54,31,31,5328,52364,4567,57771,706,105701,4939,389,48875,3489,4310,257,50,4,578,128,53814,3957,4939,48875,468,3489,5407,52364,135,75,2,937
Crawford,11/6/20,31,33,33,2334,30267,2033,32606,270,62472,2179,155,29761,506,1925,108,29,2,225,45,31940,666,2179,29761,160,506,2339,30267,43,25,0,349
Crittenden,11/6/20,53,35,35,2658,18096,2359,20759,245,49013,2549,109,17771,325,2289,70,46,7,213,32,20320,439,2549,17771,114,325,2663,18096,44,24,0,184
Cross,11/6/20,23,37,37,635,6987,570,7622,42,16998,566,69,6723,264,512,58,21,2,33,9,7289,333,566,6723,69,264,635,6987,6,7,0,168
Dallas,11/6/20,6,39,39,196,2911,181,3107,9,7432,192,4,2835,76,178,3,6,0,8,1,3027,80,192,2835,4,76,196,2911,4,0,0,39
Desha,11/6/20,8,41,41,454,5383,397,5846,49,11887,422,32,5160,223,378,19,7,1,37,12,5582,264,422,5160,41,223,463,5383,7,9,0,155
Drew,11/6/20,7,43,43,465,8051,423,8521,35,18502,432,33,7333,718,400,23,6,1,26,9,7765,756,432,7333,38,718,470,8051,1,4,0,60
Faulkner,11/6/20,44,45,45,3683,53737,3344,57469,295,122416,3374,309,50798,2939,3113,231,38,6,223,72,54172,3297,3374,50798,358,2939,3732,53737,35,11,2,403
Franklin,11/6/20,2,47,47,602,9436,531,10058,69,17780,545,57,9209,227,487,44,2,0,56,13,9754,304,545,9209,77,227,622,9436,7,6,0,112
Fulton,11/6/20,11,49,49,377,2942,316,3329,50,12139,310,67,2516,426,271,45,9,2,30,20,2826,503,310,2516,77,426,387,2942,4,5,0,34
Garland,11/6/20,76,51,51,2789,42722,2426,45535,287,98296,2640,149,41502,1220,2335,91,71,5,234,53,44142,1393,2640,41502,173,1220,2813,42722,41,28,0,477
Grant,11/6/20,4,53,53,404,7334,361,7747,39,18086,367,37,6794,540,329,32,4,0,34,5,7161,586,367,6794,46,540,413,7334,4,1,0,35
Greene,11/6/20,22,55,55,1858,21554,1498,23443,338,44623,1616,242,20028,1526,1355,143,20,2,241,97,21644,1799,1616,20028,273,1526,1889,21554,65,26,1,569
Hempstead,11/6/20,5,57,57,651,7233,565,7901,81,22018,566,85,6989,244,503,62,5,0,58,23,7555,346,566,6989,102,244,668,7233,16,12,0,58
HotSpring,11/6/20,38,59,59,2379,19097,2163,21486,178,33520,2335,44,18349,748,2136,27,36,2,163,15,20684,802,2335,18349,54,748,2389,19097,18,6,0,133
Howard,11/6/20,14,61,61,668,4675,582,5352,72,13389,582,86,4289,386,518,64,14,0,50,22,4871,481,582,4289,95,386,677,4675,10,3,0,31
Independence,11/6/20,66,63,63,1591,15907,1449,17525,76,37264,1283,308,15328,579,1186,263,56,10,41,35,16611,914,1283,15328,335,579,1618,15907,18,6,4,121
Izard,11/6/20,2,65,65,787,6248,564,7045,221,13559,732,55,5762,486,522,42,2,0,208,13,6494,551,732,5762,65,486,797,6248,96,2,0,217
Jackson,11/6/20,6,67,67,977,10298,707,11318,264,17225,748,229,10188,110,514,193,5,1,229,35,10936,382,748,10188,272,110,1020,10298,9,18,0,70
Jefferson,11/6/20,102,69,69,4460,42507,4055,47058,301,70424,4298,162,41710,797,3943,112,97,5,256,45,46008,1050,4298,41710,253,797,4551,42507,44,20,0,213
Johnson,11/6/20,11,71,71,1084,11030,1023,12121,50,26291,1032,52,10725,305,986,37,10,1,36,14,11757,364,1032,10725,59,305,1091,11030,9,7,2,135
Lafayette,11/6/20,3,73,73,218,1587,176,1811,39,6915,183,35,1530,57,155,21,3,0,25,14,1713,98,183,1530,41,57,224,1587,4,0,0,16
Lawrence,11/6/20,22,75,75,938,6601,815,7550,101,16669,821,117,6348,253,726,89,22,0,73,28,7169,381,821,6348,128,253,949,6601,12,7,0,71
Lee,11/6/20,18,77,77,1117,5370,1091,6490,8,9398,1110,7,5320,50,1087,4,17,1,6,2,6430,60,1110,5320,10,50,1120,5370,1,2,0,230
Lincoln,11/6/20,18,79,79,2354,9991,2288,12355,48,13695,2328,26,9850,141,2265,23,17,1,46,2,12178,177,2328,9850,36,141,2364,9991,3,1,0,91
LittleRiver,11/6/20,37,81,81,512,2508,438,3016,37,12417,453,59,2399,109,397,41,32,5,24,13,2852,164,453,2399,55,109,508,2508,5,4,0,43
Logan,11/6/20,5,83,83,637,10940,596,11585,36,21757,608,29,10210,730,577,19,5,0,26,10,10818,767,608,10210,37,730,645,10940,12,2,0,301
Lonoke,11/6/20,34,85,85,2005,30180,1738,32276,233,72206,1616,389,26612,3568,1426,312,32,2,158,75,28228,4048,1616,26612,480,3568,2096,30180,54,22,0,268
Madison,11/6/20,6,87,87,460,5720,424,6185,30,16076,428,32,5506,214,394,30,6,0,28,2,5934,251,428,5506,37,214,465,5720,2,1,0,49
Marion,11/6/20,2,89,89,210,3921,153,4135,55,16438,178,32,3647,274,137,16,1,1,40,15,3825,310,178,3647,36,274,214,3921,7,3,0,39
Miller,11/6/20,22,91,91,1758,9232,1503,11025,233,43759,1404,354,8947,285,1224,279,16,6,164,69,10351,674,1404,8947,389,285,1793,9232,29,28,0,102
MissingCountyInfo,11/6/20,0,5,5,1711,69536,1262,71245,449,NA,1483,228,69523,13,1103,159,0,0,380,69,71006,239,1483,69523,226,13,1709,69536,112,-1,0,1360
Mississippi,11/6/20,70,93,93,2543,15519,2224,18056,248,42831,2384,159,14966,553,2122,102,57,13,204,44,17350,706,2384,14966,153,553,2537,15519,32,25,0,176
Monroe,11/6/20,2,95,95,246,3282,209,3531,35,7249,231,15,3207,75,197,12,2,0,32,3,3438,93,231,3207,18,75,249,3282,2,2,0,26
Montgomery,11/6/20,8,97,97,196,3145,180,3342,8,8993,192,4,2740,405,177,3,8,0,7,1,2932,410,192,2740,5,405,197,3145,1,1,0,114
Nevada,11/6/20,14,99,99,354,5057,298,5410,42,8440,321,33,4927,130,272,26,13,1,36,6,5248,162,321,4927,32,130,353,5057,3,1,0,69
Newton,11/6/20,21,101,101,342,2787,290,3123,31,7848,311,31,2280,507,269,21,18,3,24,7,2591,532,311,2280,25,507,336,2787,10,4,0,41
Ouachita,11/6/20,9,103,103,426,7831,372,8269,44,24106,402,24,7564,267,350,22,9,0,42,2,7966,303,402,7564,36,267,438,7831,8,5,0,45
Perry,11/6/20,2,105,105,172,4954,137,5132,33,10322,158,14,4776,178,129,8,2,0,27,6,4934,198,158,4776,20,178,178,4954,4,2,0,31
Phillips,11/6/20,16,107,107,801,9276,735,10096,50,19034,778,23,9097,179,715,20,16,0,47,3,9875,221,778,9097,42,179,820,9276,6,4,0,232
Pike,11/6/20,1,109,109,288,3020,270,3308,17,10808,274,14,2848,172,258,12,0,1,16,1,3122,186,274,2848,14,172,288,3020,1,0,0,13
Poinsett,11/6/20,28,111,111,1305,12813,1051,14144,226,24054,1192,113,12458,355,986,65,26,2,180,46,13650,494,1192,12458,139,355,1331,12813,24,18,0,203
Polk,11/6/20,5,113,113,422,6034,356,6461,61,20163,395,27,5898,136,347,9,5,0,43,18,6293,168,395,5898,32,136,427,6034,12,4,0,116
Pope,11/6/20,38,115,115,2944,31950,2712,34907,194,63644,2724,220,31086,864,2562,150,34,4,128,66,33810,1097,2724,31086,233,864,2957,31950,20,25,0,311
Prairie,11/6/20,5,117,117,267,3286,219,3565,43,8244,228,39,2941,345,196,23,5,0,27,16,3169,396,228,2941,51,345,279,3286,1,13,0,21
Pulaski,11/6/20,228,119,119,12992,184767,11748,197925,1014,393463,12231,761,177893,6874,11127,621,213,15,889,125,190124,7801,12231,177893,927,6874,13158,184767,129,78,2,1556
Randolph,11/6/20,26,121,121,730,7538,640,8285,64,17603,570,160,6915,623,501,139,20,6,49,15,7485,800,570,6915,177,623,747,7538,12,7,0,180
Saline,11/6/20,40,125,125,3287,44647,2872,48006,374,118009,2920,367,41270,3377,2611,261,38,2,270,104,44190,3816,2920,41270,439,3377,3359,44647,58,43,1,334
Scott,11/6/20,2,127,127,257,4756,211,5015,44,10442,225,32,4656,100,196,15,2,0,27,17,4881,134,225,4656,34,100,259,4756,8,7,0,37
Searcy,11/6/20,1,129,129,226,3401,203,3626,22,7923,206,20,3126,275,189,14,1,0,16,6,3332,294,206,3126,19,275,225,3401,1,2,0,24
Sebastian,11/6/20,105,131,131,5389,67366,4766,72776,516,127461,5077,312,66569,797,4561,205,97,8,417,99,71646,1130,5077,66569,333,797,5410,67366,92,29,0,864
Sevier,11/6/20,16,133,133,1486,7893,1358,9390,112,17193,1295,191,7369,524,1236,122,16,0,43,69,8664,726,1295,7369,202,524,1497,7893,8,10,0,82
Sharp,11/6/20,11,135,135,420,6449,340,6870,69,17043,342,78,6022,427,289,51,11,0,42,27,6364,506,342,6022,79,427,421,6449,13,1,1,101
St.Francis,11/6/20,10,123,123,1830,15074,1695,16909,125,26294,1797,33,14942,132,1675,20,10,0,112,13,16739,170,1797,14942,38,132,1835,15074,12,3,0,217
Stone,11/6/20,22,137,137,413,4517,381,4933,10,12446,395,18,4352,165,366,15,22,0,7,3,4747,186,395,4352,21,165,416,4517,1,0,0,44
Union,11/6/20,53,139,139,1244,12634,1125,13897,66,39732,1096,148,11318,1316,999,126,47,6,50,16,12414,1483,1096,11318,167,1316,1263,12634,10,7,1,103
VanBuren,11/6/20,3,141,141,242,6058,220,6312,19,16684,229,13,5717,341,211,9,3,0,15,4,5946,366,229,5717,25,341,254,6058,19,16,0,170
Washington,11/6/20,159,143,143,12325,105492,11384,117939,781,228529,10941,1384,98564,6928,10268,1116,141,18,532,249,109505,8434,10941,98564,1506,6928,12447,105492,134,48,0,1167
White,11/6/20,37,145,145,1860,24334,1495,26243,328,78804,1535,325,21833,2501,1263,232,32,5,240,88,23368,2875,1535,21833,374,2501,1909,24334,62,29,0,383
Woodruff,11/6/20,0,147,147,150,2489,124,2643,26,6660,129,21,2398,91,110,14,0,0,19,7,2527,116,129,2398,25,91,154,2489,3,8,0,20
Yell,11/6/20,32,149,149,1396,14477,1319,15872,45,21573,1373,23,14238,239,1306,13,29,3,38,7,15611,261,1373,14238,22,239,1395,14477,12,4,0,118
Arkansas_all_counties,11/5/20,2037,5630,5630,117360,1345145,104816,1463888,10493,2990671,107292,10068,1285613,59532,97276,7540,1863,174,8140,2353,1392905,70983,107292,1285613,11451,59532,118743,1345145,1548,1054,11,15562
Arkansas_county,11/5/20,20,1,1,760,9738,643,10532,97,18124,649,111,8031,1707,555,88,20,0,74,23,8680,1852,649,8031,145,1707,794,9738,16,15,0,188
Ashley,11/5/20,13,3,3,594,6881,519,7482,62,20537,562,32,6629,252,492,27,13,0,57,5,7191,291,562,6629,39,252,601,6881,8,5,0,86
Baxter,11/5/20,12,5,5,848,7397,692,8254,144,41219,686,162,6771,626,573,119,12,0,101,43,7457,797,686,6771,171,626,857,7397,24,29,0,104
Benton,11/5/20,127,7,7,9060,93884,8102,103037,830,258980,8155,905,91178,2706,7443,659,110,17,601,229,99333,3704,8155,91178,998,2706,9153,93884,222,100,1,1195
Boone,11/5/20,38,9,9,1145,15284,995,16444,112,37288,1008,137,15030,254,888,107,36,2,84,28,16038,406,1008,15030,152,254,1160,15284,15,8,0,178
Bradley,11/5/20,8,11,11,380,4779,361,5160,11,10948,366,14,4121,658,354,7,7,1,5,6,4487,673,366,4121,15,658,381,4779,4,3,0,26
Calhoun,11/5/20,0,13,13,71,2036,53,2107,18,5202,63,8,1986,50,50,3,0,0,13,5,2049,58,63,1986,8,50,71,2036,11,0,0,20
Carroll,11/5/20,19,15,15,1070,9524,989,10603,62,27887,1019,51,9413,111,945,44,19,0,55,7,10432,171,1019,9413,60,111,1079,9524,6,6,0,115
Chicot,11/5/20,23,17,17,1059,6125,1024,7189,12,10826,1042,17,5851,274,1009,15,22,1,11,1,6893,296,1042,5851,22,274,1064,6125,0,2,0,52
Clark,11/5/20,6,19,19,564,9924,493,10506,65,22385,496,68,8957,967,450,43,6,0,40,25,9453,1053,496,8957,86,967,582,9924,11,6,0,90
Clay,11/5/20,15,21,21,544,6911,469,7462,59,15061,486,58,5905,1006,433,36,13,2,39,20,6391,1071,486,5905,65,1006,551,6911,8,4,0,78
Cleburne,11/5/20,17,23,23,534,9479,458,10020,59,25230,463,71,8698,781,408,50,17,0,38,21,9161,859,463,8698,78,781,541,9479,18,3,0,87
Cleveland,11/5/20,13,25,25,274,4001,219,4280,42,8226,242,32,3863,138,202,17,12,1,28,14,4105,175,242,3863,37,138,279,4001,4,2,0,22
Columbia,11/5/20,22,27,27,777,7642,684,8441,71,23892,646,131,7002,640,586,98,22,0,38,33,7648,793,646,7002,153,640,799,7642,9,6,0,180
Conway,11/5/20,4,29,29,382,8642,343,9024,35,20906,356,26,8272,370,320,23,4,0,32,3,8628,396,356,8272,26,370,382,8642,15,2,0,81
Craighead,11/5/20,52,31,31,5193,51562,4492,56835,648,105701,4827,366,48168,3394,4244,248,48,4,534,114,52995,3840,4827,48168,446,3394,5273,51562,76,48,2,640
Crawford,11/5/20,31,33,33,2291,29961,2008,32256,252,62472,2143,148,29469,492,1904,104,29,2,210,42,31612,644,2143,29469,152,492,2295,29961,41,19,0,262
Crittenden,11/5/20,53,35,35,2614,17956,2335,20575,225,49013,2512,102,17647,309,2270,65,46,7,195,30,20159,416,2512,17647,107,309,2619,17956,26,26,0,224
Cross,11/5/20,23,37,37,629,6825,563,7454,43,16998,562,67,6576,249,507,56,21,2,34,9,7138,316,562,6576,67,249,629,6825,-6,5,1,46
Dallas,11/5/20,6,39,39,192,2876,181,3068,5,7432,188,4,2801,75,178,3,6,0,4,1,2989,79,188,2801,4,75,192,2876,2,0,0,40
Desha,11/5/20,8,41,41,447,5235,388,5691,51,11887,415,32,5016,219,373,15,7,1,35,16,5431,260,415,5016,41,219,456,5235,6,2,1,38
Drew,11/5/20,7,43,43,464,7992,419,8461,38,18502,432,32,7275,717,397,22,6,1,29,9,7707,754,432,7275,37,717,469,7992,10,0,0,112
Faulkner,11/5/20,42,45,45,3648,53369,3333,57064,273,122416,3345,303,50466,2903,3104,229,36,6,205,68,53811,3253,3345,50466,350,2903,3695,53369,38,20,0,420
Franklin,11/5/20,2,47,47,595,9331,525,9943,68,17780,540,55,9121,210,484,41,2,0,54,14,9661,282,540,9121,72,210,612,9331,6,21,0,97
Fulton,11/5/20,11,49,49,373,2912,311,3294,51,12139,306,67,2493,419,266,45,9,2,31,20,2799,495,306,2493,76,419,382,2912,18,6,0,53
Garland,11/5/20,76,51,51,2748,42286,2398,45057,274,98296,2606,142,41103,1183,2313,85,71,5,222,52,43709,1348,2606,41103,165,1183,2771,42286,48,57,0,560
Grant,11/5/20,4,53,53,400,7303,360,7712,36,18086,364,36,6768,535,328,32,4,0,32,4,7132,580,364,6768,45,535,409,7303,8,3,0,68
Greene,11/5/20,21,55,55,1793,21050,1472,22872,300,44623,1562,231,19592,1458,1338,134,19,2,205,95,21154,1718,1562,19592,260,1458,1822,21050,31,35,1,329
Hempstead,11/5/20,5,57,57,635,7191,553,7840,77,22018,558,77,6956,235,499,54,5,0,54,23,7514,326,558,6956,91,235,649,7191,8,5,0,60
HotSpring,11/5/20,38,59,59,2361,18982,2157,21353,166,33520,2324,37,18250,732,2132,25,36,2,156,10,20574,779,2324,18250,47,732,2371,18982,9,40,1,260
Howard,11/5/20,14,61,61,658,4654,579,5318,65,13389,576,82,4277,377,515,64,14,0,47,18,4853,465,576,4277,88,377,664,4654,27,7,0,54
Independence,11/5/20,62,63,63,1573,15804,1443,17400,68,37264,1274,299,15265,539,1183,260,55,7,36,32,16539,861,1274,15265,322,539,1596,15804,15,10,1,112
Izard,11/5/20,2,65,65,691,6127,562,6828,127,13559,638,53,5645,482,522,40,2,0,114,13,6283,545,638,5645,63,482,701,6127,2,1,0,97
Jackson,11/5/20,6,67,67,968,10237,689,11247,273,17225,747,221,10127,110,500,189,5,1,242,31,10874,373,747,10127,263,110,1010,10237,33,6,0,87
Jefferson,11/5/20,102,69,69,4416,42338,4035,46845,277,70424,4257,159,41544,794,3924,111,97,5,234,43,45801,1044,4257,41544,250,794,4507,42338,23,11,0,234
Johnson,11/5/20,9,71,71,1075,10904,1016,11986,50,26291,1027,48,10608,296,982,34,8,1,37,13,11635,351,1027,10608,55,296,1082,10904,6,8,0,97
Lafayette,11/5/20,3,73,73,214,1575,176,1795,35,6915,182,32,1524,51,155,21,3,0,24,11,1706,89,182,1524,38,51,220,1575,1,5,0,26
Lawrence,11/5/20,22,75,75,926,6542,808,7479,96,16669,813,113,6299,243,721,87,22,0,70,26,7112,367,813,6299,124,243,937,6542,9,13,0,72
Lee,11/5/20,18,77,77,1116,5141,1089,6260,9,9398,1110,6,5095,46,1085,4,17,1,8,1,6205,55,1110,5095,9,46,1119,5141,-1,0,0,9
Lincoln,11/5/20,18,79,79,2351,9903,2287,12264,46,13695,2325,26,9762,141,2264,23,17,1,44,2,12087,177,2325,9762,36,141,2361,9903,2,9,0,49
LittleRiver,11/5/20,37,81,81,507,2470,434,2973,36,12417,449,58,2372,98,395,39,32,5,22,14,2821,152,449,2372,54,98,503,2470,5,5,0,15
Logan,11/5/20,5,83,83,625,10651,594,11284,26,21757,599,26,10121,530,575,19,5,0,19,7,10720,564,599,10121,34,530,633,10651,6,9,0,159
Lonoke,11/5/20,34,85,85,1951,29966,1716,32007,201,72206,1573,378,26475,3491,1408,308,32,2,133,68,28048,3959,1573,26475,468,3491,2041,29966,28,29,0,240
Madison,11/5/20,6,87,87,458,5673,423,6136,29,16076,426,32,5472,201,393,30,6,0,27,2,5898,238,426,5472,37,201,463,5673,3,2,0,64
Marion,11/5/20,2,89,89,203,3889,150,4096,51,16438,171,32,3620,269,135,15,1,1,35,16,3791,305,171,3620,36,269,207,3889,10,0,0,45
Miller,11/5/20,22,91,91,1729,9159,1475,10918,232,43759,1380,349,8886,273,1207,268,16,6,157,75,10266,652,1380,8886,379,273,1759,9159,28,35,0,97
MissingCountyInfo,11/5/20,0,5,5,1599,68288,1263,69882,336,NA,1401,198,68275,13,1103,160,0,0,298,38,69676,206,1401,68275,193,13,1594,68288,-5,21,0,1650
Mississippi,11/5/20,70,93,93,2511,15375,2199,17880,241,42831,2360,151,14843,532,2103,96,57,13,199,42,17203,677,2360,14843,145,532,2505,15375,33,23,0,200
Monroe,11/5/20,2,95,95,244,3258,207,3505,35,7249,229,15,3183,75,195,12,2,0,32,3,3412,93,229,3183,18,75,247,3258,9,1,0,61
Montgomery,11/5/20,8,97,97,195,3032,179,3227,8,8993,191,4,2723,309,175,4,8,0,8,0,2914,313,191,2723,4,309,195,3032,0,1,0,10
Nevada,11/5/20,14,99,99,351,4991,297,5341,40,8440,319,32,4864,127,271,26,13,1,35,5,5183,158,319,4864,31,127,350,4991,5,6,0,46
Newton,11/5/20,21,101,101,332,2756,286,3082,25,7848,303,29,2251,505,267,19,18,3,18,7,2554,528,303,2251,23,505,326,2756,4,3,0,96
Ouachita,11/5/20,9,103,103,418,7794,367,8224,41,24106,396,22,7530,264,346,21,9,0,40,1,7926,298,396,7530,34,264,430,7794,8,6,0,67
Perry,11/5/20,2,105,105,168,4927,135,5100,31,10322,154,14,4751,176,127,8,2,0,25,6,4905,195,154,4751,19,176,173,4927,3,2,0,43
Phillips,11/5/20,16,107,107,795,9050,731,9864,48,19034,773,22,8877,173,712,19,16,0,45,3,9650,214,773,8877,41,173,814,9050,2,10,0,36
Pike,11/5/20,1,109,109,287,3008,270,3295,16,10808,273,14,2837,171,258,12,0,1,15,1,3110,185,273,2837,14,171,287,3008,6,5,0,23
Poinsett,11/5/20,28,111,111,1281,12634,1033,13941,220,24054,1173,108,12301,333,968,65,26,2,179,41,13474,467,1173,12301,134,333,1307,12634,23,33,0,124
Polk,11/5/20,5,113,113,410,5930,352,6344,53,20163,383,27,5798,132,344,8,5,0,34,19,6181,163,383,5798,31,132,414,5930,16,1,0,64
Pope,11/5/20,38,115,115,2924,31659,2687,34592,199,63644,2711,213,30826,833,2544,143,34,4,133,66,33537,1055,2711,30826,222,833,2933,31659,28,10,0,382
Prairie,11/5/20,5,117,117,266,3266,206,3544,55,8244,227,39,2923,343,185,21,5,0,37,18,3150,394,227,2923,51,343,278,3266,4,7,0,35
Pulaski,11/5/20,226,119,119,12863,183340,11670,196364,965,393463,12122,741,176580,6760,11057,613,212,14,851,114,188702,7662,12122,176580,902,6760,13024,183340,144,84,0,1783
Randolph,11/5/20,26,121,121,718,7370,633,8105,59,17603,560,158,6762,608,498,135,20,6,42,17,7322,783,560,6762,175,608,735,7370,4,9,0,106
Saline,11/5/20,39,125,125,3229,44371,2829,47666,360,118009,2867,362,41074,3297,2578,251,37,2,251,109,43941,3725,2867,41074,428,3297,3295,44371,56,26,1,560
Scott,11/5/20,2,127,127,249,4727,204,4977,43,10442,221,28,4635,92,192,12,2,0,27,16,4856,121,221,4635,29,92,250,4727,13,3,0,115
Searcy,11/5/20,1,129,129,225,3378,201,3602,23,7923,205,20,3108,270,188,13,1,0,16,7,3313,289,205,3108,19,270,224,3378,3,11,0,22
Sebastian,11/5/20,105,131,131,5297,66594,4737,71911,453,127461,4999,298,65843,751,4537,200,97,8,363,90,70842,1069,4999,65843,318,751,5317,66594,78,31,0,719
Sevier,11/5/20,16,133,133,1478,7819,1348,9307,114,17193,1291,187,7312,507,1229,119,16,0,46,68,8603,704,1291,7312,197,507,1488,7819,20,5,0,122
Sharp,11/5/20,10,135,135,407,6361,339,6769,58,17043,337,70,5945,416,289,50,10,0,38,20,6282,487,337,5945,71,416,408,6361,6,6,0,78
St.Francis,11/5/20,10,123,123,1818,14869,1692,16691,116,26294,1787,31,14749,120,1671,21,10,0,106,10,16536,155,1787,14749,35,120,1822,14869,2,5,0,79
Stone,11/5/20,22,137,137,412,4474,381,4889,9,12446,394,18,4315,159,366,15,22,0,6,3,4709,180,394,4315,21,159,415,4474,1,2,0,39
Union,11/5/20,52,139,139,1234,12541,1118,13793,64,39732,1088,146,11232,1309,994,124,46,6,48,16,12320,1473,1088,11232,164,1309,1252,12541,14,12,0,376
VanBuren,11/5/20,3,141,141,223,5907,204,6139,16,16684,209,14,5581,326,195,9,3,0,11,5,5790,349,209,5581,23,326,232,5907,6,2,0,41
Washington,11/5/20,159,143,143,12191,104459,11336,116769,695,228529,10861,1330,97887,6572,10233,1103,141,18,487,208,108748,8021,10861,97887,1449,6572,12310,104459,94,51,2,1021
White,11/5/20,37,145,145,1798,24013,1466,25856,295,78804,1495,303,21575,2438,1237,229,32,5,226,69,23070,2786,1495,21575,348,2438,1843,24013,71,44,0,185
Woodruff,11/5/20,0,147,147,147,2472,116,2623,31,6660,128,19,2382,90,102,14,0,0,26,5,2510,113,128,2382,23,90,151,2472,1,2,0,39
Yell,11/5/20,32,149,149,1384,14371,1315,15754,37,21573,1365,19,14151,220,1303,12,29,3,33,4,15516,238,1365,14151,18,220,1383,14371,10,4,0,272
Arkansas_all_counties,11/4/20,2026,5630,5630,115812,1331131,103762,1448268,10010,2990671,106137,9675,1273985,57146,96433,7329,1854,172,7837,2173,1380122,68146,106137,1273985,11000,57146,117137,1331131,1293,1096,23,14168
Arkansas_county,11/4/20,20,1,1,744,9566,628,10342,96,18124,638,106,7915,1651,548,80,20,0,70,26,8553,1789,638,7915,138,1651,776,9566,10,6,0,53
Ashley,11/4/20,13,3,3,586,6803,514,7395,59,20537,554,32,6569,234,488,26,13,0,53,6,7123,272,554,6569,38,234,592,6803,6,4,0,27
Baxter,11/4/20,12,5,5,824,7317,663,8145,149,41219,663,161,6697,620,543,120,12,0,108,41,7360,785,663,6697,165,620,828,7317,23,11,1,259
Benton,11/4/20,126,7,7,8838,92911,8002,101837,709,258980,7977,861,90294,2617,7371,631,109,17,496,213,98271,3566,7977,90294,949,2617,8926,92911,91,98,-1,580
Boone,11/4/20,38,9,9,1130,15121,987,16266,105,37288,997,133,14877,244,881,106,36,2,80,25,15874,392,997,14877,148,244,1145,15121,16,14,1,88
Bradley,11/4/20,8,11,11,376,4757,358,5134,10,10948,364,12,4104,653,351,7,7,1,6,4,4468,666,364,4104,13,653,377,4757,1,2,0,23
Calhoun,11/4/20,0,13,13,60,2027,53,2087,7,5202,55,5,1981,46,50,3,0,0,5,2,2036,51,55,1981,5,46,60,2027,0,2,0,5
Carroll,11/4/20,19,15,15,1064,9415,983,10488,62,27887,1013,51,9306,109,940,43,19,0,54,8,10319,169,1013,9306,60,109,1073,9415,8,15,0,41
Chicot,11/4/20,23,17,17,1059,6073,1022,7137,14,10826,1042,17,5800,273,1008,14,22,1,12,2,6842,295,1042,5800,22,273,1064,6073,2,2,0,30
Clark,11/4/20,6,19,19,553,9845,487,10412,60,22385,484,69,8884,961,445,42,6,0,33,27,9368,1044,484,8884,83,961,567,9845,10,0,0,301
Clay,11/4/20,15,21,21,536,6841,465,7382,55,15061,477,59,5871,970,429,36,13,2,34,21,6348,1034,477,5871,64,970,541,6841,12,8,0,95
Cleburne,11/4/20,17,23,23,516,9410,455,9932,44,25230,451,65,8642,768,407,48,17,0,27,17,9093,839,451,8642,71,768,522,9410,10,4,0,74
Cleveland,11/4/20,13,25,25,270,3983,217,4258,40,8226,239,31,3846,137,200,17,12,1,27,13,4085,173,239,3846,36,137,275,3983,8,3,0,68
Columbia,11/4/20,22,27,27,768,7471,678,8260,68,23892,642,126,6867,604,582,96,22,0,38,30,7509,751,642,6867,147,604,789,7471,4,8,0,56
Conway,11/4/20,4,29,29,367,8576,341,8943,22,20906,343,24,8216,360,320,21,4,0,19,3,8559,384,343,8216,24,360,367,8576,7,5,0,79
Craighead,11/4/20,50,31,31,5117,50998,4444,56194,622,105701,4770,347,47837,3161,4207,237,46,4,516,106,52607,3587,4770,47837,426,3161,5196,50998,112,55,0,688
Crawford,11/4/20,31,33,33,2250,29740,1989,31993,230,62472,2111,139,29259,481,1888,101,29,2,194,36,31370,623,2111,29259,142,481,2253,29740,26,22,1,199
Crittenden,11/4/20,53,35,35,2588,17758,2309,20349,225,49013,2491,97,17526,232,2251,58,46,7,193,32,20017,332,2491,17526,100,232,2591,17758,27,30,0,234
Cross,11/4/20,22,37,37,635,6773,558,7408,55,16998,561,74,6540,233,505,53,20,2,36,19,7101,307,561,6540,74,233,635,6773,0,6,0,73
Dallas,11/4/20,6,39,39,190,2838,181,3028,3,7432,186,4,2766,72,178,3,6,0,2,1,2952,76,186,2766,4,72,190,2838,2,1,0,18
Desha,11/4/20,7,41,41,441,5203,386,5652,48,11887,411,30,4988,215,371,15,7,0,33,15,5399,253,411,4988,38,215,449,5203,6,7,0,26
Drew,11/4/20,7,43,43,454,7890,419,8349,28,18502,426,28,7176,714,397,22,6,1,23,5,7602,747,426,7176,33,714,459,7890,10,6,0,61
Faulkner,11/4/20,42,45,45,3610,52987,3313,56642,255,122416,3314,296,50126,2861,3091,222,36,6,187,68,53440,3202,3314,50126,341,2861,3655,52987,28,22,1,442
Franklin,11/4/20,2,47,47,589,9240,504,9846,83,17780,534,55,9031,209,465,39,2,0,67,16,9565,281,534,9031,72,209,606,9240,4,5,0,53
Fulton,11/4/20,11,49,49,355,2877,305,3242,39,12139,300,55,2464,413,261,44,9,2,30,9,2764,478,300,2464,65,413,365,2877,4,6,1,89
Garland,11/4/20,76,51,51,2700,41774,2341,44496,283,98296,2562,138,40637,1137,2257,84,71,5,234,49,43199,1297,2562,40637,160,1137,2722,41774,34,28,3,287
Grant,11/4/20,4,53,53,392,7243,357,7644,31,18086,356,36,6731,512,325,32,4,0,27,4,7087,557,356,6731,45,512,401,7243,6,2,0,132
Greene,11/4/20,20,55,55,1762,20752,1437,22544,305,44623,1544,218,19438,1314,1310,127,19,1,215,90,20982,1562,1544,19438,248,1314,1792,20752,48,25,0,312
Hempstead,11/4/20,5,57,57,627,7139,548,7780,74,22018,555,72,6917,222,495,53,5,0,55,19,7472,308,555,6917,86,222,641,7139,22,10,0,156
HotSpring,11/4/20,37,59,59,2352,18731,2117,21092,198,33520,2317,35,18029,702,2092,25,35,2,190,8,20346,746,2317,18029,44,702,2361,18731,50,6,0,210
Howard,11/4/20,14,61,61,631,4627,572,5264,45,13389,561,70,4263,364,511,61,14,0,36,9,4824,440,561,4263,76,364,637,4627,3,5,0,42
Independence,11/4/20,61,63,63,1558,15707,1433,17288,64,37264,1269,289,15197,510,1178,255,54,7,37,27,16466,822,1269,15197,312,510,1581,15707,17,16,1,324
Izard,11/4/20,2,65,65,689,6032,561,6731,126,13559,637,52,5553,479,522,39,2,0,113,13,6190,541,637,5553,62,479,699,6032,4,3,0,93
Jackson,11/4/20,6,67,67,935,10183,683,11160,246,17225,716,219,10085,98,498,185,5,1,213,33,10801,359,716,10085,261,98,977,10183,5,10,0,133
Jefferson,11/4/20,102,69,69,4393,42127,4024,46610,265,70424,4242,151,41364,763,3914,110,97,5,229,36,45606,1004,4242,41364,241,763,4483,42127,64,20,0,599
Johnson,11/4/20,9,71,71,1069,10813,1008,11889,52,26291,1022,47,10529,284,975,33,8,1,39,13,11551,338,1022,10529,54,284,1076,10813,4,13,0,206
Lafayette,11/4/20,3,73,73,213,1550,171,1768,39,6915,181,32,1502,48,151,20,3,0,27,12,1683,85,181,1502,37,48,218,1550,6,2,0,25
Lawrence,11/4/20,22,75,75,917,6479,795,7407,100,16669,808,109,6254,225,709,86,22,0,77,23,7062,345,808,6254,120,225,928,6479,15,14,0,49
Lee,11/4/20,18,77,77,1117,5131,1089,6251,10,9398,1110,7,5084,47,1085,4,17,1,8,2,6194,57,1110,5084,10,47,1120,5131,2,2,0,12
Lincoln,11/4/20,18,79,79,2349,9856,2278,12215,53,13695,2324,25,9716,140,2255,23,17,1,52,1,12040,175,2324,9716,35,140,2359,9856,10,67,0,210
LittleRiver,11/4/20,37,81,81,502,2460,429,2958,36,12417,447,55,2367,93,393,36,32,5,22,14,2814,144,447,2367,51,93,498,2460,11,7,0,27
Logan,11/4/20,5,83,83,619,10498,585,11125,29,21757,593,26,9972,526,568,17,5,0,20,9,10565,560,593,9972,34,526,627,10498,2,3,0,53
Lonoke,11/4/20,34,85,85,1923,29754,1687,31766,202,72206,1555,368,26299,3455,1390,297,32,2,133,69,27854,3912,1555,26299,457,3455,2012,29754,25,22,0,443
Madison,11/4/20,6,87,87,455,5612,421,6071,28,16076,421,34,5413,199,390,31,6,0,25,3,5834,237,421,5413,38,199,459,5612,5,1,0,38
Marion,11/4/20,2,89,89,193,3854,150,4051,41,16438,163,30,3587,267,135,15,1,1,27,14,3750,301,163,3587,34,267,197,3854,10,2,0,124
Miller,11/4/20,22,91,91,1701,9090,1440,10820,239,43759,1367,334,8852,238,1181,259,16,6,170,69,10219,601,1367,8852,363,238,1730,9090,38,39,0,270
MissingCountyInfo,11/4/20,0,5,5,1604,66633,1242,68236,362,NA,1396,208,66624,9,1085,157,0,0,311,51,68020,216,1396,66624,207,9,1603,66633,-134,-20,0,1166
Mississippi,11/4/20,70,93,93,2478,15208,2176,17681,231,42831,2337,141,14762,446,2084,92,57,13,195,36,17099,582,2337,14762,136,446,2473,15208,30,36,1,182
Monroe,11/4/20,2,95,95,235,3206,206,3444,27,7249,221,14,3132,74,195,11,2,0,24,3,3353,91,221,3132,17,74,238,3206,0,1,0,12
Montgomery,11/4/20,8,97,97,195,3022,178,3216,9,8993,191,4,2715,307,174,4,8,0,9,0,2906,310,191,2715,3,307,194,3022,4,1,0,15
Nevada,11/4/20,14,99,99,346,4950,291,5295,41,8440,314,32,4827,123,267,24,13,1,34,7,5141,154,314,4827,31,123,345,4950,6,4,0,121
Newton,11/4/20,21,101,101,328,2664,283,2986,24,7848,300,28,2229,435,264,19,18,3,18,6,2529,457,300,2229,22,435,322,2664,1,2,0,9
Ouachita,11/4/20,9,103,103,410,7735,361,8157,39,24106,389,21,7477,258,340,21,9,0,39,0,7866,291,389,7477,33,258,422,7735,3,9,0,24
Perry,11/4/20,2,105,105,165,4887,133,5057,30,10322,152,13,4715,172,126,7,2,0,24,6,4867,190,152,4715,18,172,170,4887,9,0,0,169
Phillips,11/4/20,16,107,107,793,9016,721,9827,56,19034,771,22,8849,167,703,18,16,0,52,4,9620,207,771,8849,40,167,811,9016,1,8,0,27
Pike,11/4/20,1,109,109,281,2991,265,3272,15,10808,269,12,2820,171,255,10,0,1,14,1,3089,183,269,2820,12,171,281,2991,3,3,0,32
Poinsett,11/4/20,28,111,111,1258,12533,1000,13811,230,24054,1160,98,12228,305,937,63,26,2,197,33,13388,423,1160,12228,118,305,1278,12533,33,17,1,223
Polk,11/4/20,5,113,113,394,5882,351,6280,38,20163,373,21,5752,130,343,8,5,0,25,13,6125,155,373,5752,25,130,398,5882,9,3,0,51
Pope,11/4/20,38,115,115,2896,31305,2677,34210,181,63644,2691,205,30505,800,2536,141,34,4,121,60,33196,1014,2691,30505,214,800,2905,31305,38,26,1,261
Prairie,11/4/20,5,117,117,262,3235,199,3509,58,8244,224,38,2899,336,180,19,5,0,39,19,3123,386,224,2899,50,336,274,3235,10,3,0,36
Pulaski,11/4/20,226,119,119,12719,181701,11586,194573,905,393463,11997,722,175190,6511,10989,597,212,14,794,111,187187,7386,11997,175190,875,6511,12872,181701,128,100,4,1451
Randolph,11/4/20,26,121,121,714,7268,624,7997,64,17603,556,158,6680,588,494,130,20,6,42,22,7236,761,556,6680,173,588,729,7268,14,7,0,81
Saline,11/4/20,38,125,125,3173,43867,2803,47103,331,118009,2834,339,40784,3083,2562,241,36,2,235,96,43618,3485,2834,40784,402,3083,3236,43867,63,29,2,442
Scott,11/4/20,2,127,127,236,4625,201,4862,33,10442,212,24,4540,85,189,12,2,0,21,12,4752,110,212,4540,25,85,237,4625,1,6,0,78
Searcy,11/4/20,1,129,129,222,3359,190,3580,31,7923,204,18,3093,266,177,13,1,0,26,5,3297,283,204,3093,17,266,221,3359,3,4,0,20
Sebastian,11/4/20,105,131,131,5219,65953,4706,71191,406,127461,4943,276,65231,722,4508,198,97,8,336,70,70174,1017,4943,65231,295,722,5238,65953,53,34,2,442
Sevier,11/4/20,16,133,133,1458,7717,1343,9185,99,17193,1283,175,7235,482,1226,117,16,0,41,58,8518,667,1283,7235,185,482,1468,7717,22,13,0,78
Sharp,11/4/20,10,135,135,401,6289,333,6690,58,17043,336,65,5882,407,285,48,10,0,41,17,6218,472,336,5882,65,407,401,6289,7,6,0,223
St.Francis,11/4/20,10,123,123,1816,14792,1687,16612,119,26294,1781,35,14682,110,1666,21,10,0,105,14,16463,149,1781,14682,39,110,1820,14792,3,7,0,53
Stone,11/4/20,22,137,137,411,4436,379,4850,10,12446,393,18,4285,151,364,15,22,0,7,3,4678,172,393,4285,21,151,414,4436,1,3,0,28
Union,11/4/20,52,139,139,1220,12179,1106,13416,62,39732,1079,141,11071,1108,986,120,46,6,47,15,12150,1266,1079,11071,158,1108,1237,12179,21,9,0,54
VanBuren,11/4/20,3,141,141,217,5872,202,6098,12,16684,206,11,5551,321,194,8,3,0,9,3,5757,341,206,5551,20,321,226,5872,0,1,0,14
Washington,11/4/20,157,143,143,12097,103532,11285,115745,654,228529,10814,1283,97105,6427,10197,1088,139,18,478,176,107919,7826,10814,97105,1399,6427,12213,103532,102,92,2,1074
White,11/4/20,37,145,145,1727,23899,1422,25668,268,78804,1437,290,21497,2402,1197,225,32,5,208,60,22934,2734,1437,21497,332,2402,1769,23899,50,46,2,232
Woodruff,11/4/20,0,147,147,146,2434,114,2584,32,6660,126,20,2356,78,100,14,0,0,26,6,2482,102,126,2356,24,78,150,2434,2,6,0,3
Yell,11/4/20,32,149,149,1374,14109,1311,15482,31,21573,1355,19,13898,211,1299,12,29,3,27,4,15253,229,1355,13898,18,211,1373,14109,2,1,0,160
Arkansas_all_counties,11/3/20,2003,5630,5630,114519,1318256,102666,1434044,9836,2990671,105223,9296,1263662,54594,95563,7103,1833,170,7814,2022,1368885,65159,105223,1263662,10565,54594,115788,1318256,878,1159,18,7754
Arkansas_county,11/3/20,20,1,1,734,9523,622,10289,92,18124,633,101,7883,1640,544,78,20,0,69,23,8516,1773,633,7883,133,1640,766,9523,6,8,1,104
Ashley,11/3/20,13,3,3,580,6782,510,7368,57,20537,552,28,6552,230,484,26,13,0,55,2,7104,264,552,6552,34,230,586,6782,4,4,2,23
Baxter,11/3/20,11,5,5,801,7081,652,7886,138,41219,656,145,6465,616,535,117,11,0,110,28,7121,765,656,6465,149,616,805,7081,16,15,0,31
Benton,11/3/20,127,7,7,8747,92422,7904,101251,715,258980,7918,829,89902,2520,7297,607,110,17,510,205,97820,3431,7918,89902,911,2520,8829,92422,96,59,0,487
Boone,11/3/20,37,9,9,1114,15049,973,16178,104,37288,989,125,14813,236,869,104,35,2,85,19,15802,376,989,14813,140,236,1129,15049,10,9,0,32
Bradley,11/3/20,8,11,11,375,4735,356,5111,11,10948,364,11,4089,646,349,7,7,1,8,3,4453,658,364,4089,12,646,376,4735,1,1,0,16
Calhoun,11/3/20,0,13,13,60,2022,51,2082,9,5202,54,6,1977,45,48,3,0,0,6,3,2031,51,54,1977,6,45,60,2022,0,0,0,3
Carroll,11/3/20,19,15,15,1056,9382,968,10447,69,27887,1009,47,9275,107,929,39,19,0,61,8,10284,163,1009,9275,56,107,1065,9382,5,7,0,40
Chicot,11/3/20,23,17,17,1057,6045,1020,7106,14,10826,1040,17,5793,252,1005,15,22,1,13,1,6833,273,1040,5793,21,252,1061,6045,0,2,0,5
Clark,11/3/20,6,19,19,543,9554,487,10111,50,22385,475,68,8682,872,444,43,6,0,25,25,9157,954,475,8682,82,872,557,9554,10,2,1,79
Clay,11/3/20,15,21,21,524,6758,457,7286,51,15061,469,55,5840,918,423,34,13,2,32,19,6309,977,469,5840,59,918,528,6758,5,6,1,75
Cleburne,11/3/20,17,23,23,506,9346,451,9857,38,25230,447,59,8594,752,405,46,17,0,25,13,9041,816,447,8594,64,752,511,9346,4,4,1,92
Cleveland,11/3/20,13,25,25,262,3923,214,4190,35,8226,237,25,3787,136,198,16,12,1,27,8,4024,166,237,3787,30,136,267,3923,3,3,0,54
Columbia,11/3/20,22,27,27,764,7419,670,8203,72,23892,641,123,6845,574,579,91,22,0,40,32,7486,717,641,6845,143,574,784,7419,4,5,0,39
Conway,11/3/20,4,29,29,360,8504,336,8864,20,20906,337,23,8166,338,316,20,4,0,17,3,8503,361,337,8166,23,338,360,8504,-1,0,0,28
Craighead,11/3/20,50,31,31,5005,50422,4389,55503,565,105701,4697,308,47455,2967,4163,226,46,4,487,78,52152,3351,4697,47455,384,2967,5081,50422,33,79,0,494
Crawford,11/3/20,30,33,33,2224,29567,1967,31794,227,62472,2094,130,29124,443,1867,100,28,2,199,28,31218,576,2094,29124,133,443,2227,29567,20,29,0,251
Crittenden,11/3/20,53,35,35,2561,17551,2279,20113,228,49013,2471,90,17337,214,2225,54,46,7,199,29,19808,305,2471,17337,91,214,2562,17551,18,17,0,101
Cross,11/3/20,22,37,37,635,6700,552,7335,61,16998,561,74,6469,231,502,50,20,2,39,22,7030,305,561,6469,74,231,635,6700,7,4,0,37
Dallas,11/3/20,6,39,39,188,2822,180,3010,2,7432,185,3,2752,70,178,2,6,0,1,1,2937,73,185,2752,3,70,188,2822,0,0,0,8
Desha,11/3/20,7,41,41,435,5183,379,5625,49,11887,405,30,4970,213,364,15,7,0,34,15,5375,250,405,4970,37,213,442,5183,2,5,0,33
Drew,11/3/20,7,43,43,444,7839,413,8288,24,18502,418,26,7134,705,391,22,6,1,21,3,7552,736,418,7134,31,705,449,7839,1,0,0,28
Faulkner,11/3/20,41,45,45,3582,52573,3291,56199,250,122416,3292,290,49936,2637,3077,214,35,6,180,70,53228,2971,3292,49936,334,2637,3626,52573,28,27,0,230
Franklin,11/3/20,2,47,47,585,9191,499,9793,84,17780,532,53,8990,201,462,37,2,0,68,16,9522,271,532,8990,70,201,602,9191,5,4,0,93
Fulton,11/3/20,10,49,49,351,2792,299,3153,42,12139,297,54,2426,366,256,43,8,2,33,9,2723,430,297,2426,64,366,361,2792,1,3,0,12
Garland,11/3/20,73,51,51,2666,41521,2313,44207,280,98296,2539,127,40421,1100,2231,82,68,5,240,40,42960,1247,2539,40421,147,1100,2686,41521,6,19,0,82
Grant,11/3/20,4,53,53,386,7117,355,7510,27,18086,352,34,6632,485,323,32,4,0,25,2,6984,526,352,6632,41,485,393,7117,3,5,0,26
Greene,11/3/20,20,55,55,1714,20488,1412,22232,282,44623,1504,210,19210,1278,1294,118,19,1,191,91,20714,1518,1504,19210,240,1278,1744,20488,33,35,0,195
Hempstead,11/3/20,5,57,57,605,7005,538,7625,62,22018,537,68,6789,216,487,51,5,0,45,17,7326,299,537,6789,83,216,620,7005,6,9,0,35
HotSpring,11/3/20,37,59,59,2302,18571,2111,20882,154,33520,2270,32,17931,640,2087,24,35,2,148,6,20201,681,2270,17931,41,640,2311,18571,2,12,0,100
Howard,11/3/20,14,61,61,628,4588,567,5223,47,13389,560,68,4245,343,508,59,14,0,38,9,4805,418,560,4245,75,343,635,4588,3,8,0,16
Independence,11/3/20,60,63,63,1541,15400,1417,16958,64,37264,1261,280,14916,484,1167,250,54,6,40,24,16177,781,1261,14916,297,484,1558,15400,11,10,0,59
Izard,11/3/20,2,65,65,685,5943,558,6638,125,13559,636,49,5483,460,521,37,2,0,113,12,6119,519,636,5483,59,460,695,5943,6,126,0,19
Jackson,11/3/20,6,67,67,930,10055,673,11027,251,17225,715,215,9962,93,493,180,5,1,217,34,10677,350,715,9962,257,93,972,10055,10,36,0,28
Jefferson,11/3/20,102,69,69,4329,41592,4004,46001,221,70424,4189,140,40837,755,3898,106,97,5,192,29,45026,975,4189,40837,220,755,4409,41592,17,55,0,148
Johnson,11/3/20,9,71,71,1065,10611,995,11683,61,26291,1020,45,10343,268,962,33,8,1,50,11,11363,320,1020,10343,52,268,1072,10611,1,7,1,38
Lafayette,11/3/20,3,73,73,207,1531,169,1742,35,6915,179,28,1486,45,151,18,3,0,25,10,1665,77,179,1486,32,45,211,1531,3,3,0,7
Lawrence,11/3/20,22,75,75,902,6445,781,7358,99,16669,798,104,6224,221,698,83,22,0,78,21,7022,336,798,6224,115,221,913,6445,9,15,0,44
Lee,11/3/20,18,77,77,1115,5121,1087,6239,10,9398,1108,7,5073,48,1083,4,17,1,8,2,6181,58,1108,5073,10,48,1118,5121,1,0,0,10
Lincoln,11/3/20,18,79,79,2339,9656,2211,12004,110,13695,2314,25,9520,136,2189,22,17,1,108,2,11834,170,2314,9520,34,136,2348,9656,1,4,0,57
LittleRiver,11/3/20,37,81,81,491,2444,422,2931,32,12417,442,49,2355,89,389,33,32,5,21,11,2797,134,442,2355,45,89,487,2444,1,5,0,38
Logan,11/3/20,5,83,83,617,10447,582,11072,30,21757,593,24,9922,525,565,17,5,0,23,7,10515,557,593,9922,32,525,625,10447,1,5,0,121
Lonoke,11/3/20,34,85,85,1898,29336,1665,31324,199,72206,1539,359,25933,3403,1373,292,32,2,134,65,27472,3852,1539,25933,449,3403,1988,29336,11,31,0,167
Madison,11/3/20,6,87,87,450,5579,420,6032,24,16076,417,33,5390,189,389,31,6,0,22,2,5807,225,417,5390,36,189,453,5579,5,3,0,18
Marion,11/3/20,2,89,89,183,3740,148,3927,33,16438,160,23,3478,262,134,14,1,1,25,8,3638,289,160,3478,27,262,187,3740,3,1,0,20
Miller,11/3/20,22,91,91,1663,8858,1401,10547,240,43759,1345,318,8624,234,1149,252,16,6,180,60,9969,578,1345,8624,344,234,1689,8858,26,38,1,42
MissingCountyInfo,11/3/20,0,5,5,1738,65333,1262,67082,476,NA,1436,302,65326,7,1096,166,0,0,340,136,66762,320,1436,65326,313,7,1749,65333,63,8,0,689
Mississippi,11/3/20,69,93,93,2448,15056,2140,17497,238,42831,2319,129,14682,374,2054,86,56,13,208,30,17001,496,2319,14682,122,374,2441,15056,26,23,0,130
Monroe,11/3/20,2,95,95,235,3194,205,3432,28,7249,221,14,3119,75,195,10,2,0,24,4,3340,92,221,3119,17,75,238,3194,0,2,0,7
Montgomery,11/3/20,8,97,97,191,3011,177,3201,6,8993,188,3,2705,306,174,3,8,0,6,0,2893,308,188,2705,2,306,190,3011,3,1,0,9
Nevada,11/3/20,14,99,99,340,4835,287,5174,39,8440,309,31,4714,121,263,24,13,1,33,6,5023,151,309,4714,30,121,339,4835,1,4,0,65
Newton,11/3/20,21,101,101,327,2656,281,2977,25,7848,299,28,2222,434,262,19,18,3,19,6,2521,456,299,2222,22,434,321,2656,3,4,0,55
Ouachita,11/3/20,9,103,103,407,7714,352,8133,45,24106,386,21,7458,256,331,21,9,0,45,0,7844,289,386,7458,33,256,419,7714,3,8,0,32
Perry,11/3/20,2,105,105,156,4727,133,4888,21,10322,144,12,4559,168,126,7,2,0,16,5,4703,185,144,4559,17,168,161,4727,2,1,0,13
Phillips,11/3/20,16,107,107,792,8990,713,9799,63,19034,770,22,8830,160,695,18,16,0,59,4,9600,199,770,8830,39,160,809,8990,6,10,0,24
Pike,11/3/20,1,109,109,278,2962,262,3240,15,10808,266,12,2794,168,253,9,0,1,13,2,3060,180,266,2794,12,168,278,2962,1,2,0,4
Poinsett,11/3/20,27,111,111,1225,12343,983,13587,215,24054,1133,92,12057,286,921,62,25,2,187,28,13190,397,1133,12057,111,286,1244,12343,15,22,3,106
Polk,11/3/20,5,113,113,385,5840,348,6229,32,20163,368,17,5728,112,340,8,5,0,23,9,6096,133,368,5728,21,112,389,5840,7,1,0,23
Pope,11/3/20,37,115,115,2858,31082,2651,33948,170,63644,2675,183,30297,785,2517,134,33,4,125,45,32972,976,2675,30297,191,785,2866,31082,18,21,0,102
Prairie,11/3/20,5,117,117,252,3209,196,3473,51,8244,215,37,2876,333,180,16,5,0,30,21,3091,382,215,2876,49,333,264,3209,1,2,0,13
Pulaski,11/3/20,222,119,119,12591,180378,11486,193115,881,393463,11884,707,174103,6275,10904,582,208,14,770,111,185987,7128,11884,174103,853,6275,12737,180378,73,117,1,794
Randolph,11/3/20,26,121,121,700,7201,617,7916,57,17603,549,151,6656,545,492,125,20,6,37,20,7205,711,549,6656,166,545,715,7201,5,10,0,65
Saline,11/3/20,36,125,125,3110,43488,2774,46656,299,118009,2795,315,40596,2892,2541,233,34,2,219,80,43391,3265,2795,40596,373,2892,3168,43488,27,28,2,430
Scott,11/3/20,2,127,127,235,4548,195,4784,38,10442,212,23,4466,82,183,12,2,0,27,11,4678,106,212,4466,24,82,236,4548,2,5,0,19
Searcy,11/3/20,1,129,129,219,3342,186,3560,32,7923,202,17,3083,259,175,11,1,0,26,6,3285,275,202,3083,16,259,218,3342,5,2,0,86
Sebastian,11/3/20,103,131,131,5166,65564,4672,70750,389,127461,4910,256,64865,699,4480,192,96,7,332,57,69775,975,4910,64865,276,699,5186,65564,33,39,2,348
Sevier,11/3/20,16,133,133,1436,7661,1330,9107,90,17193,1280,156,7210,451,1221,109,16,0,43,47,8490,617,1280,7210,166,451,1446,7661,19,11,0,45
Sharp,11/3/20,10,135,135,394,6073,327,6467,57,17043,331,63,5763,310,280,47,10,0,41,16,6094,373,331,5763,63,310,394,6073,6,4,0,23
St.Francis,11/3/20,10,123,123,1813,14742,1680,16559,123,26294,1779,34,14639,103,1661,19,10,0,108,15,16418,141,1779,14639,38,103,1817,14742,8,11,0,85
Stone,11/3/20,22,137,137,410,4409,376,4822,12,12446,393,17,4261,148,363,13,22,0,8,4,4654,168,393,4261,20,148,413,4409,1,1,0,42
Union,11/3/20,52,139,139,1199,12146,1097,13356,50,39732,1066,133,11057,1089,980,117,46,6,40,10,12123,1233,1066,11057,144,1089,1210,12146,1,9,0,52
VanBuren,11/3/20,3,141,141,217,5858,201,6084,13,16684,206,11,5543,315,193,8,3,0,10,3,5749,335,206,5543,20,315,226,5858,2,1,0,32
Washington,11/3/20,155,143,143,11995,102560,11193,114665,646,228529,10753,1242,96562,5998,10128,1065,137,18,488,158,107315,7350,10753,96562,1352,5998,12105,102560,83,64,1,630
White,11/3/20,35,145,145,1677,23717,1376,25436,266,78804,1406,271,21365,2352,1160,216,30,5,216,50,22771,2665,1406,21365,313,2352,1719,23717,26,20,1,137
Woodruff,11/3/20,0,147,147,144,2433,108,2581,36,6660,124,20,2355,78,96,12,0,0,28,8,2479,102,124,2355,24,78,148,2433,1,4,0,7
Yell,11/3/20,32,149,149,1372,13951,1310,15322,30,21573,1353,19,13741,210,1298,12,29,3,26,4,15094,228,1353,13741,18,210,1371,13951,0,4,0,22
Arkansas_all_counties,11/2/20,1985,5630,5630,113641,1311380,101507,1426271,10135,2990671,104703,8938,1258726,52654,94664,6843,1817,168,8209,1926,1363429,62842,104703,1258726,10188,52654,114891,1311380,584,841,27,8432
Arkansas_county,11/2/20,19,1,1,728,9425,614,10185,95,18124,629,99,7871,1554,539,75,19,0,71,24,8500,1685,629,7871,131,1554,760,9425,2,3,2,43
Ashley,11/2/20,11,3,3,576,6763,506,7345,59,20537,548,28,6545,218,482,24,11,0,55,4,7093,252,548,6545,34,218,582,6763,3,5,0,91
Baxter,11/2/20,11,5,5,785,7066,637,7855,137,41219,647,138,6451,615,525,112,11,0,111,26,7098,757,647,6451,142,615,789,7066,9,13,0,50
Benton,11/2/20,127,7,7,8651,92031,7845,100765,678,258980,7863,788,89659,2372,7260,585,110,17,492,186,97522,3243,7863,89659,871,2372,8734,92031,32,46,2,1002
Boone,11/2/20,37,9,9,1104,15027,964,16146,103,37288,981,123,14794,233,862,102,35,2,84,19,15775,371,981,14794,138,233,1119,15027,5,11,1,122
Bradley,11/2/20,8,11,11,374,4720,355,5095,11,10948,365,9,4078,642,348,7,7,1,10,1,4443,652,365,4078,10,642,375,4720,1,1,0,168
Calhoun,11/2/20,0,13,13,60,2019,51,2080,9,5202,55,5,1975,44,48,3,0,0,7,2,2030,50,55,1975,6,44,61,2019,1,1,0,13
Carroll,11/2/20,19,15,15,1051,9347,961,10407,71,27887,1007,44,9244,103,922,39,19,0,66,5,10251,156,1007,9244,53,103,1060,9347,2,11,0,106
Chicot,11/2/20,23,17,17,1057,6040,1018,7101,16,10826,1040,17,5788,252,1004,14,22,1,14,2,6828,273,1040,5788,21,252,1061,6040,1,1,0,25
Clark,11/2/20,5,19,19,533,9485,485,10032,43,22385,473,60,8655,830,443,42,5,0,25,18,9128,904,473,8655,74,830,547,9485,3,2,0,30
Clay,11/2/20,14,21,21,519,6688,451,7211,53,15061,467,52,5817,871,419,32,12,2,35,18,6284,927,467,5817,56,871,523,6688,2,3,1,55
Cleburne,11/2/20,16,23,23,502,9258,447,9765,39,25230,445,57,8561,697,402,45,16,0,27,12,9006,759,445,8561,62,697,507,9258,2,3,0,40
Cleveland,11/2/20,13,25,25,259,3872,211,4136,35,8226,234,25,3736,136,196,15,12,1,26,9,3970,166,234,3736,30,136,264,3872,2,3,0,26
Columbia,11/2/20,22,27,27,760,7384,665,8164,73,23892,638,122,6838,546,575,90,22,0,41,32,7476,688,638,6838,142,546,780,7384,3,8,1,70
Conway,11/2/20,4,29,29,361,8475,336,8836,21,20906,338,23,8143,332,316,20,4,0,18,3,8481,355,338,8143,23,332,361,8475,0,4,0,33
Craighead,11/2/20,50,31,31,4972,49961,4310,55010,611,105701,4668,304,47200,2761,4089,221,46,4,532,79,51868,3142,4668,47200,381,2761,5049,49961,34,62,2,461
Crawford,11/2/20,30,33,33,2204,29336,1938,31543,236,62472,2081,123,28912,424,1845,93,28,2,208,28,30993,550,2081,28912,126,424,2207,29336,15,13,0,339
Crittenden,11/2/20,53,35,35,2543,17468,2262,20012,227,49013,2454,89,17260,208,2210,52,46,7,197,30,19714,298,2454,17260,90,208,2544,17468,11,30,0,142
Cross,11/2/20,22,37,37,628,6670,548,7298,58,16998,557,71,6451,219,499,49,20,2,38,20,7008,290,557,6451,71,219,628,6670,12,8,0,54
Dallas,11/2/20,6,39,39,188,2814,180,3002,2,7432,185,3,2744,70,178,2,6,0,1,1,2929,73,185,2744,3,70,188,2814,0,0,0,14
Desha,11/2/20,7,41,41,433,5152,374,5592,52,11887,403,30,4946,206,359,15,7,0,37,15,5349,243,403,4946,37,206,440,5152,2,2,0,37
Drew,11/2/20,7,43,43,443,7812,413,8260,23,18502,417,26,7118,694,392,21,6,1,19,4,7535,725,417,7118,31,694,448,7812,3,8,0,104
Faulkner,11/2/20,41,45,45,3554,52371,3264,55968,249,122416,3277,277,49800,2571,3060,204,35,6,182,67,53077,2891,3277,49800,320,2571,3597,52371,11,16,2,286
Franklin,11/2/20,2,47,47,580,9103,495,9700,83,17780,527,53,8906,197,461,34,2,0,64,19,9433,267,527,8906,70,197,597,9103,5,11,0,100
Fulton,11/2/20,10,49,49,350,2781,296,3142,44,12139,300,50,2425,356,254,42,8,2,38,6,2725,417,300,2425,61,356,361,2781,2,4,0,26
Garland,11/2/20,73,51,51,2660,41445,2294,44125,293,98296,2536,124,40364,1081,2216,78,68,5,252,41,42900,1225,2536,40364,144,1081,2680,41445,15,18,3,313
Grant,11/2/20,4,53,53,383,7094,350,7484,29,18086,350,33,6615,479,319,31,4,0,27,2,6965,519,350,6615,40,479,390,7094,1,6,0,35
Greene,11/2/20,20,55,55,1681,20326,1377,22036,284,44623,1481,200,19113,1213,1270,107,19,1,192,92,20594,1442,1481,19113,229,1213,1710,20326,15,28,0,193
Hempstead,11/2/20,5,57,57,599,6976,529,7590,65,22018,534,65,6763,213,481,48,5,0,48,17,7297,293,534,6763,80,213,614,6976,6,6,0,88
HotSpring,11/2/20,37,59,59,2300,18473,2099,20782,164,33520,2267,33,17870,603,2077,22,35,2,155,9,20137,645,2267,17870,42,603,2309,18473,3,7,0,92
Howard,11/2/20,14,61,61,625,4575,559,5207,52,13389,558,67,4235,340,506,53,14,0,38,14,4793,414,558,4235,74,340,632,4575,0,5,0,23
Independence,11/2/20,60,63,63,1530,15352,1407,16898,63,37264,1257,273,14899,453,1163,244,54,6,40,23,16156,742,1257,14899,289,453,1546,15352,2,11,2,316
Izard,11/2/20,2,65,65,679,5930,432,6619,245,13559,632,47,5473,457,395,37,2,0,235,10,6105,514,632,5473,57,457,689,5930,6,2,0,101
Jackson,11/2/20,6,67,67,920,10037,637,10999,277,17225,708,212,9949,88,465,172,5,1,238,39,10657,342,708,9949,254,88,962,10037,13,2,0,173
Jefferson,11/2/20,102,69,69,4312,41461,3949,45852,259,70424,4173,139,40717,744,3850,99,97,5,224,35,44890,962,4173,40717,218,744,4391,41461,10,23,0,234
Johnson,11/2/20,8,71,71,1064,10574,988,11645,68,26291,1019,45,10317,257,958,30,8,0,53,15,11336,309,1019,10317,52,257,1071,10574,1,8,0,57
Lafayette,11/2/20,3,73,73,204,1527,166,1735,35,6915,176,28,1484,43,148,18,3,0,25,10,1660,75,176,1484,32,43,208,1527,3,5,0,14
Lawrence,11/2/20,22,75,75,893,6410,766,7314,105,16669,793,100,6201,209,684,82,22,0,87,18,6994,320,793,6201,111,209,904,6410,9,12,1,125
Lee,11/2/20,18,77,77,1114,5112,1087,6229,9,9398,1107,7,5066,46,1083,4,17,1,7,2,6173,56,1107,5066,10,46,1117,5112,1,0,0,12
Lincoln,11/2/20,18,79,79,2338,9600,2207,11947,113,13695,2313,25,9468,132,2187,20,17,1,109,4,11781,166,2313,9468,34,132,2347,9600,1,3,0,98
LittleRiver,11/2/20,37,81,81,490,2407,417,2893,36,12417,441,49,2318,89,384,33,32,5,25,11,2759,134,441,2318,45,89,486,2407,1,4,0,15
Logan,11/2/20,5,83,83,616,10327,577,10951,34,21757,594,22,9804,523,561,16,5,0,28,6,10398,553,594,9804,30,523,624,10327,-1,5,0,53
Lonoke,11/2/20,34,85,85,1887,29180,1634,31157,219,72206,1536,351,25826,3354,1350,284,32,2,154,65,27362,3795,1536,25826,441,3354,1977,29180,10,29,1,162
Madison,11/2/20,6,87,87,445,5566,417,6014,22,16076,414,31,5384,182,387,30,6,0,21,1,5798,216,414,5384,34,182,448,5566,1,1,0,46
Marion,11/2/20,2,89,89,180,3723,147,3907,31,16438,159,21,3466,257,135,12,1,1,23,8,3625,282,159,3466,25,257,184,3723,0,3,0,60
Miller,11/2/20,21,91,91,1637,8842,1363,10504,253,43759,1337,300,8610,232,1131,232,16,5,190,63,9947,557,1337,8610,325,232,1662,8842,24,38,0,85
MissingCountyInfo,11/2/20,0,5,5,1675,64707,1254,66395,421,NA,1434,241,64700,7,1088,166,0,0,346,75,66134,261,1434,64700,254,7,1688,64707,35,21,0,-2326
Mississippi,11/2/20,69,93,93,2422,14952,2117,17366,235,42831,2298,124,14622,330,2034,83,56,13,207,28,16920,446,2298,14622,116,330,2414,14952,10,27,0,124
Monroe,11/2/20,2,95,95,235,3187,203,3425,30,7249,221,14,3114,73,193,10,2,0,26,4,3335,90,221,3114,17,73,238,3187,5,1,0,27
Montgomery,11/2/20,8,97,97,188,3005,176,3192,4,8993,185,3,2702,303,173,3,8,0,4,0,2887,305,185,2702,2,303,187,3005,0,0,0,5
Nevada,11/2/20,14,99,99,339,4771,283,5109,42,8440,308,31,4652,119,261,22,13,1,34,8,4960,149,308,4652,30,119,338,4771,4,8,0,77
Newton,11/2/20,21,101,101,324,2604,277,2922,26,7848,298,26,2180,424,258,19,18,3,22,4,2478,444,298,2180,20,424,318,2604,0,1,1,60
Ouachita,11/2/20,9,103,103,404,7685,344,8101,50,24106,383,21,7440,245,326,18,9,0,47,3,7823,278,383,7440,33,245,416,7685,3,2,0,84
Perry,11/2/20,2,105,105,154,4716,132,4874,20,10322,142,12,4552,164,125,7,2,0,15,5,4694,180,142,4552,16,164,158,4716,2,2,0,33
Phillips,11/2/20,16,107,107,786,8972,703,9771,67,19034,763,23,8820,152,687,16,16,0,60,7,9583,188,763,8820,36,152,799,8972,5,1,0,53
Pike,11/2/20,1,109,109,277,2959,260,3234,16,10808,264,13,2791,168,251,9,0,1,13,3,3055,179,264,2791,11,168,275,2959,1,0,0,10
Poinsett,11/2/20,24,111,111,1210,12252,961,13482,225,24054,1123,87,11990,262,900,61,22,2,201,24,13113,369,1123,11990,107,262,1230,12252,7,9,1,160
Polk,11/2/20,5,113,113,378,5824,347,6206,26,20163,365,13,5717,107,339,8,5,0,21,5,6082,124,365,5717,17,107,382,5824,4,3,0,29
Pope,11/2/20,37,115,115,2840,30998,2630,33844,173,63644,2664,176,30233,765,2501,129,33,4,130,43,32897,947,2664,30233,182,765,2846,30998,5,14,0,238
Prairie,11/2/20,5,117,117,251,3197,194,3460,52,8244,214,37,2866,331,179,15,5,0,30,22,3080,380,214,2866,49,331,263,3197,3,3,1,30
Pulaski,11/2/20,221,119,119,12518,179657,11369,192320,926,393463,11828,690,173539,6118,10808,561,207,14,811,115,185367,6953,11828,173539,835,6118,12663,179657,51,82,1,1164
Randolph,11/2/20,26,121,121,695,7141,607,7851,62,17603,545,150,6625,516,489,118,20,6,36,26,7170,681,545,6625,165,516,710,7141,2,9,0,45
Saline,11/2/20,34,125,125,3083,43085,2746,46222,302,118009,2781,302,40360,2725,2527,219,32,2,221,81,43141,3081,2781,40360,356,2725,3137,43085,27,26,0,487
Scott,11/2/20,2,127,127,233,4531,190,4764,41,10442,212,21,4454,77,180,10,2,0,30,11,4666,98,212,4454,21,77,233,4531,0,6,0,22
Searcy,11/2/20,1,129,129,214,3261,184,3474,29,7923,198,16,3080,181,174,10,1,0,23,6,3278,196,198,3080,15,181,213,3261,2,0,0,15
Sebastian,11/2/20,101,131,131,5133,65249,4633,70398,397,127461,4882,251,64572,677,4451,182,94,7,335,62,69454,944,4882,64572,267,677,5149,65249,29,32,2,852
Sevier,11/2/20,16,133,133,1417,7635,1319,9062,82,17193,1274,143,7192,443,1217,102,16,0,41,41,8466,596,1274,7192,153,443,1427,7635,8,9,0,37
Sharp,11/2/20,10,135,135,388,6056,323,6444,55,17043,328,60,5753,303,277,46,10,0,41,14,6081,363,328,5753,60,303,388,6056,4,7,0,41
St.Francis,11/2/20,10,123,123,1805,14665,1669,16474,126,26294,1773,32,14566,99,1651,18,10,0,112,14,16339,135,1773,14566,36,99,1809,14665,11,6,0,129
Stone,11/2/20,22,137,137,409,4368,375,4780,12,12446,393,16,4229,139,362,13,22,0,9,3,4622,158,393,4229,19,139,412,4368,0,-1,1,23
Union,11/2/20,52,139,139,1198,12095,1088,13304,58,39732,1065,133,11043,1052,973,115,46,6,46,12,12108,1196,1065,11043,144,1052,1209,12095,11,11,0,98
VanBuren,11/2/20,3,141,141,215,5828,200,6052,12,16684,205,10,5531,297,192,8,3,0,10,2,5736,316,205,5531,19,297,224,5828,0,1,0,23
Washington,11/2/20,154,143,143,11912,102013,11129,114035,628,228529,10707,1205,96182,5831,10083,1046,136,18,488,140,106889,7146,10707,96182,1315,5831,12022,102013,31,55,0,886
White,11/2/20,34,145,145,1651,23606,1356,25298,261,78804,1390,261,21291,2315,1141,215,29,5,220,41,22681,2617,1390,21291,302,2315,1692,23606,29,18,1,173
Woodruff,11/2/20,0,147,147,143,2427,104,2574,39,6660,123,20,2349,78,92,12,0,0,31,8,2472,102,123,2349,24,78,147,2427,7,1,0,34
Yell,11/2/20,32,149,149,1372,13929,1306,15300,34,21573,1353,19,13722,207,1294,12,29,3,30,4,15075,225,1353,13722,18,207,1371,13929,4,2,1,67
Arkansas_all_counties,11/1/20,1958,5630,5630,113057,1303532,100666,1417792,10420,2990671,104239,8818,1251780,51752,94032,6634,1791,167,8404,2016,1356019,61773,104239,1251780,10021,51752,114260,1303532,867,599,33,9530
Arkansas_county,11/1/20,17,1,1,726,9384,611,10142,98,18124,628,98,7843,1541,537,74,17,0,74,24,8471,1671,628,7843,130,1541,758,9384,17,4,1,111
Ashley,11/1/20,11,3,3,573,6675,501,7252,61,20537,544,29,6460,215,478,23,11,0,55,6,7004,248,544,6460,33,215,577,6675,10,7,0,26
Baxter,11/1/20,11,5,5,776,7025,624,7805,141,41219,638,138,6412,613,515,109,11,0,112,29,7050,755,638,6412,142,613,780,7025,27,13,0,47
Benton,11/1/20,125,7,7,8619,91061,7799,99762,694,258980,7836,783,88716,2345,7221,578,108,17,506,188,96552,3210,7836,88716,865,2345,8701,91061,110,58,2,330
Boone,11/1/20,36,9,9,1099,14910,953,16024,110,37288,977,122,14682,228,852,101,34,2,91,19,15659,365,977,14682,137,228,1114,14910,11,6,1,164
Bradley,11/1/20,8,11,11,373,4553,354,4927,11,10948,364,9,4071,482,347,7,7,1,10,1,4435,492,364,4071,10,482,374,4553,0,1,0,14
Calhoun,11/1/20,0,13,13,59,2007,50,2067,9,5202,54,5,1964,43,47,3,0,0,7,2,2018,49,54,1964,6,43,60,2007,2,2,0,11
Carroll,11/1/20,19,15,15,1049,9243,950,10301,80,27887,1005,44,9141,102,912,38,19,0,74,6,10146,155,1005,9141,53,102,1058,9243,10,8,2,30
Chicot,11/1/20,23,17,17,1056,6016,1017,7076,16,10826,1039,17,5769,247,1003,14,22,1,14,2,6808,268,1039,5769,21,247,1060,6016,1,2,0,8
Clark,11/1/20,5,19,19,530,9458,483,10001,42,22385,470,60,8630,828,441,42,5,0,24,18,9100,901,470,8630,73,828,543,9458,10,6,0,40
Clay,11/1/20,13,21,21,517,6635,448,7156,55,15061,467,50,5767,868,416,32,11,2,39,16,6234,922,467,5767,54,868,521,6635,7,9,0,43
Cleburne,11/1/20,16,23,23,500,9220,444,9725,40,25230,443,57,8537,683,399,45,16,0,28,12,8980,745,443,8537,62,683,505,9220,25,16,1,78
Cleveland,11/1/20,13,25,25,257,3848,208,4106,36,8226,232,25,3718,130,193,15,12,1,27,9,3950,156,232,3718,26,130,258,3848,3,3,0,21
Columbia,11/1/20,21,27,27,757,7317,657,8094,79,23892,636,121,6792,525,570,87,21,0,45,34,7428,666,636,6792,141,525,777,7317,12,9,0,29
Conway,11/1/20,4,29,29,361,8442,332,8803,25,20906,338,23,8116,326,313,19,4,0,21,4,8454,349,338,8116,23,326,361,8442,2,2,1,59
Craighead,11/1/20,48,31,31,4938,49534,4248,54549,641,105701,4636,302,46787,2747,4036,212,44,4,555,86,51423,3126,4636,46787,379,2747,5015,49534,117,71,0,403
Crawford,11/1/20,30,33,33,2189,29012,1925,31205,234,62472,2072,117,28588,424,1835,90,28,2,209,25,30660,545,2072,28588,121,424,2193,29012,41,21,1,207
Crittenden,11/1/20,53,35,35,2532,17337,2232,19870,246,49013,2447,85,17133,204,2185,47,46,7,215,31,19580,290,2447,17133,86,204,2533,17337,19,8,0,49
Cross,11/1/20,22,37,37,616,6628,540,7244,54,16998,554,62,6409,219,492,48,20,2,42,12,6963,281,554,6409,62,219,616,6628,4,6,0,27
Dallas,11/1/20,6,39,39,188,2800,180,2988,2,7432,185,3,2734,66,178,2,6,0,1,1,2919,69,185,2734,3,66,188,2800,7,9,0,10
Desha,11/1/20,7,41,41,431,5117,372,5555,52,11887,402,29,4919,198,357,15,7,0,38,14,5321,234,402,4919,36,198,438,5117,7,2,0,29
Drew,11/1/20,7,43,43,440,7711,405,8156,28,18502,415,25,7066,645,385,20,6,1,24,4,7481,675,415,7066,30,645,445,7711,0,5,0,50
Faulkner,11/1/20,39,45,45,3543,52096,3248,55680,256,122416,3270,273,49593,2503,3047,201,33,6,190,66,52863,2817,3270,49593,314,2503,3584,52096,43,42,1,182
Franklin,11/1/20,2,47,47,575,9008,484,9600,89,17780,523,52,8811,197,454,30,2,0,67,22,9334,266,523,8811,69,197,592,9008,6,5,0,71
Fulton,11/1/20,10,49,49,348,2757,292,3116,46,12139,298,50,2403,354,251,41,8,2,39,7,2701,415,298,2403,61,354,359,2757,5,5,0,24
Garland,11/1/20,70,51,51,2645,41147,2276,43812,299,98296,2525,120,40080,1067,2203,73,65,5,257,42,42605,1207,2525,40080,140,1067,2665,41147,25,27,2,85
Grant,11/1/20,4,53,53,382,7060,344,7449,34,18086,349,33,6583,477,314,30,4,0,31,3,6932,517,349,6583,40,477,389,7060,3,0,0,27
Greene,11/1/20,20,55,55,1666,20148,1349,21842,297,44623,1471,195,18942,1206,1253,96,19,1,199,98,20413,1429,1471,18942,223,1206,1694,20148,38,17,0,104
Hempstead,11/1/20,5,57,57,593,6894,523,7502,65,22018,529,64,6691,203,478,45,5,0,46,19,7220,282,529,6691,79,203,608,6894,9,0,0,25
HotSpring,11/1/20,37,59,59,2297,18384,2092,20690,168,33520,2264,33,17785,599,2070,22,35,2,159,9,20049,641,2264,17785,42,599,2306,18384,22,13,0,130
Howard,11/1/20,14,61,61,625,4552,554,5184,57,13389,558,67,4224,328,503,51,14,0,41,16,4782,402,558,4224,74,328,632,4552,8,4,0,18
Independence,11/1/20,58,63,63,1528,15038,1396,16582,74,37264,1255,273,14594,444,1158,238,52,6,45,29,15849,733,1255,14594,289,444,1544,15038,35,28,1,74
Izard,11/1/20,2,65,65,673,5835,430,6518,241,13559,627,46,5381,454,394,36,2,0,231,10,6008,510,627,5381,56,454,683,5835,52,15,0,122
Jackson,11/1/20,6,67,67,907,9877,635,10826,266,17225,698,209,9796,81,465,170,5,1,228,38,10494,332,698,9796,251,81,949,9877,8,8,0,22
Jefferson,11/1/20,102,69,69,4302,41237,3926,45611,272,70424,4164,138,40497,740,3830,96,97,5,235,37,44661,950,4164,40497,210,740,4374,41237,13,38,0,104
Johnson,11/1/20,8,71,71,1063,10518,980,11588,75,26291,1018,45,10263,255,950,30,8,0,60,15,11281,307,1018,10263,52,255,1070,10518,8,13,0,216
Lafayette,11/1/20,3,73,73,201,1516,161,1720,37,6915,173,28,1475,41,144,17,3,0,26,11,1648,72,173,1475,31,41,204,1516,9,3,0,17
Lawrence,11/1/20,21,75,75,884,6294,754,7189,109,16669,786,98,6091,203,674,80,21,0,91,18,6877,312,786,6091,109,203,895,6294,11,9,1,56
Lee,11/1/20,18,77,77,1113,5101,1087,6217,8,9398,1107,6,5055,46,1083,4,17,1,7,1,6162,55,1107,5055,9,46,1116,5101,0,2,0,12
Lincoln,11/1/20,18,79,79,2337,9503,2204,11849,115,13695,2312,25,9372,131,2184,20,17,1,111,4,11684,165,2312,9372,34,131,2346,9503,2,0,0,43
LittleRiver,11/1/20,37,81,81,489,2393,413,2878,39,12417,440,49,2308,85,381,32,32,5,27,12,2748,130,440,2308,45,85,485,2393,11,10,0,12
Logan,11/1/20,5,83,83,617,10273,572,10898,40,21757,594,23,9751,522,557,15,5,0,32,8,10345,553,594,9751,31,522,625,10273,6,10,0,83
Lonoke,11/1/20,33,85,85,1877,29028,1605,30994,239,72206,1532,345,25704,3324,1331,274,31,2,170,69,27236,3758,1532,25704,434,3324,1966,29028,12,23,3,116
Madison,11/1/20,6,87,87,444,5521,416,5968,22,16076,412,32,5341,180,387,29,6,0,19,3,5753,215,412,5341,35,180,447,5521,2,5,0,18
Marion,11/1/20,2,89,89,180,3663,144,3847,34,16438,159,21,3406,257,133,11,1,1,25,9,3565,282,159,3406,25,257,184,3663,4,2,0,15
Miller,11/1/20,21,91,91,1613,8781,1325,10418,267,43759,1324,289,8551,230,1114,211,16,5,194,73,9875,543,1324,8551,313,230,1637,8781,30,22,0,84
MissingCountyInfo,11/1/20,0,5,5,1640,67068,1233,68708,407,NA,1401,239,67059,9,1080,153,0,0,321,86,68460,248,1401,67059,239,9,1640,67068,-471,-397,0,1489
Mississippi,11/1/20,69,93,93,2412,14838,2090,17243,253,42831,2289,123,14513,325,2010,80,56,13,223,30,16802,441,2289,14513,116,325,2405,14838,21,11,0,86
Monroe,11/1/20,2,95,95,230,3165,202,3395,26,7249,217,13,3096,69,192,10,2,0,23,3,3313,82,217,3096,13,69,230,3165,3,0,0,26
Montgomery,11/1/20,8,97,97,188,3000,176,3187,4,8993,185,3,2697,303,173,3,8,0,4,0,2882,305,185,2697,2,303,187,3000,2,2,0,7
Nevada,11/1/20,14,99,99,335,4698,275,5032,46,8440,304,31,4579,119,256,19,13,1,35,11,4883,149,304,4579,30,119,334,4698,4,6,0,16
Newton,11/1/20,20,101,101,324,2544,276,2862,28,7848,298,26,2161,383,258,18,17,3,23,5,2459,403,298,2161,20,383,318,2544,2,4,0,53
Ouachita,11/1/20,9,103,103,401,7604,342,8017,49,24106,380,21,7360,244,325,17,9,0,45,4,7740,277,380,7360,33,244,413,7604,6,7,0,18
Perry,11/1/20,2,105,105,152,4685,130,4841,20,10322,141,11,4527,158,124,6,2,0,15,5,4668,173,141,4527,15,158,156,4685,2,0,1,16
Phillips,11/1/20,16,107,107,781,8924,702,9718,63,19034,758,23,8776,148,685,17,16,0,57,6,9534,184,758,8776,36,148,794,8924,4,6,0,27
Pike,11/1/20,1,109,109,276,2950,260,3224,15,10808,263,13,2782,168,251,9,0,1,12,3,3045,179,263,2782,11,168,274,2950,2,3,0,8
Poinsett,11/1/20,23,111,111,1203,12099,952,13322,228,24054,1118,85,11840,259,893,59,21,2,204,24,12958,364,1118,11840,105,259,1223,12099,37,17,2,101
Polk,11/1/20,5,113,113,374,5799,344,6177,25,20163,361,13,5693,106,336,8,5,0,20,5,6054,123,361,5693,17,106,378,5799,4,2,0,20
Pope,11/1/20,37,115,115,2835,30765,2616,33606,182,63644,2661,174,30020,745,2490,126,33,4,138,44,32681,925,2661,30020,180,745,2841,30765,24,19,0,617
Prairie,11/1/20,4,117,117,248,3170,191,3428,53,8244,212,36,2845,325,177,14,4,0,31,22,3057,371,212,2845,46,325,258,3170,8,2,0,20
Pulaski,11/1/20,220,119,119,12467,178544,11287,191155,958,393463,11783,684,172480,6064,10731,556,206,14,844,114,184263,6892,11783,172480,828,6064,12611,178544,117,106,4,1790
Randolph,11/1/20,26,121,121,693,7098,598,7804,69,17603,544,149,6585,513,486,112,21,5,37,32,7129,675,544,6585,162,513,706,7098,7,6,1,42
Saline,11/1/20,34,125,125,3056,42625,2720,45733,301,118009,2755,301,39946,2679,2506,214,32,2,216,85,42701,3032,2755,39946,353,2679,3108,42625,42,42,1,226
Scott,11/1/20,2,127,127,233,4509,184,4742,47,10442,212,21,4432,77,174,10,2,0,36,11,4644,98,212,4432,21,77,233,4509,1,2,1,13
Searcy,11/1/20,1,129,129,212,3248,184,3459,27,7923,196,16,3069,179,174,10,1,0,21,6,3265,194,196,3069,15,179,211,3248,4,3,0,18
Sebastian,11/1/20,99,131,131,5104,64426,4601,69546,402,127461,4858,246,63753,673,4425,176,92,7,339,63,68611,935,4858,63753,262,673,5120,64426,59,43,3,469
Sevier,11/1/20,16,133,133,1409,7606,1310,9025,83,17193,1273,136,7179,427,1214,96,16,0,43,40,8452,573,1273,7179,146,427,1419,7606,15,10,0,26
Sharp,11/1/20,10,135,135,384,6019,316,6403,58,17043,326,58,5719,300,273,43,10,0,43,15,6045,358,326,5719,58,300,384,6019,5,5,0,26
St.Francis,11/1/20,10,123,123,1794,14547,1663,16345,121,26294,1768,26,14448,99,1645,18,10,0,113,8,16216,129,1768,14448,30,99,1798,14547,9,3,0,61
Stone,11/1/20,21,137,137,409,4345,376,4757,12,12446,393,16,4209,136,363,13,21,0,9,3,4602,155,393,4209,19,136,412,4345,1,2,0,9
Union,11/1/20,52,139,139,1187,12008,1077,13205,58,39732,1057,130,11026,982,969,108,46,6,42,16,12083,1122,1057,11026,140,982,1197,12008,26,26,2,42
VanBuren,11/1/20,3,141,141,215,5805,199,6029,13,16684,205,10,5510,295,191,8,3,0,11,2,5715,314,205,5510,19,295,224,5805,0,2,0,6
Washington,11/1/20,154,143,143,11881,101158,11074,113148,652,228529,10681,1200,95368,5790,10048,1026,136,18,497,155,106049,7099,10681,95368,1309,5790,11990,101158,77,67,1,455
White,11/1/20,33,145,145,1622,23462,1338,25124,251,78804,1364,258,21170,2292,1130,208,28,5,206,45,22534,2590,1364,21170,298,2292,1662,23462,42,21,0,202
Woodruff,11/1/20,0,147,147,136,2400,103,2539,33,6660,117,19,2322,78,91,12,0,0,26,7,2439,100,117,2322,22,78,139,2400,5,6,0,29
Yell,11/1/20,31,149,149,1368,13866,1304,15232,33,21573,1349,19,13665,201,1292,12,28,3,29,4,15014,218,1349,13665,17,201,1366,13866,5,4,0,166
Arkansas_all_counties,10/31/20,1925,5630,5630,112190,1294869,100067,1408192,10185,2990671,103482,8708,1243490,51379,93554,6513,1758,167,8158,2027,1346972,61220,103482,1243490,9841,51379,113323,1294869,1316,902,25,12562
Arkansas_county,10/31/20,16,1,1,709,9290,607,10029,86,18124,613,96,7782,1508,536,71,16,0,61,25,8395,1634,613,7782,126,1508,739,9290,9,10,0,101
Ashley,10/31/20,11,3,3,563,6659,494,7226,58,20537,534,29,6444,215,472,22,11,0,51,7,6978,248,534,6444,33,215,567,6659,4,4,0,37
Baxter,10/31/20,11,5,5,749,7005,611,7758,127,41219,612,137,6395,610,506,105,11,0,95,32,7007,751,612,6395,141,610,753,7005,37,23,0,159
Benton,10/31/20,123,7,7,8509,90841,7741,99425,644,258980,7735,774,88536,2305,7168,573,106,17,460,184,96271,3154,7735,88536,849,2305,8584,90841,68,60,3,475
Boone,10/31/20,35,9,9,1088,14757,947,15857,106,37288,968,120,14529,228,848,99,33,2,87,19,15497,360,968,14529,132,228,1100,14757,12,12,0,50
Bradley,10/31/20,8,11,11,373,4539,353,4913,12,10948,364,9,4056,483,347,6,7,1,10,2,4420,493,364,4056,10,483,374,4539,0,0,0,21
Calhoun,10/31/20,0,13,13,57,1998,48,2056,9,5202,53,4,1955,43,45,3,0,0,8,1,2008,48,53,1955,5,43,58,1998,3,0,0,5
Carroll,10/31/20,17,15,15,1039,9223,942,10271,80,27887,996,43,9121,102,906,36,17,0,73,7,10117,154,996,9121,52,102,1048,9223,11,5,0,59
Chicot,10/31/20,23,17,17,1055,6009,1015,7068,17,10826,1039,16,5762,247,1003,12,22,1,14,3,6801,267,1039,5762,20,247,1059,6009,1,3,0,6
Clark,10/31/20,5,19,19,520,9428,477,9961,38,22385,461,59,8602,826,435,42,5,0,21,17,9063,898,461,8602,72,826,533,9428,9,9,0,109
Clay,10/31/20,13,21,21,510,6599,439,7113,57,15061,464,46,5734,865,407,32,11,2,45,12,6198,915,464,5734,50,865,514,6599,11,7,0,91
Cleburne,10/31/20,15,23,23,475,9167,428,9646,32,25230,418,57,8485,682,382,46,15,0,21,11,8903,743,418,8485,61,682,479,9167,5,2,0,92
Cleveland,10/31/20,13,25,25,254,3830,205,4085,36,8226,229,25,3700,130,192,13,12,1,25,11,3929,156,229,3700,26,130,255,3830,5,6,0,29
Columbia,10/31/20,21,27,27,745,7300,648,8065,76,23892,626,119,6781,519,563,85,21,0,42,34,7407,658,626,6781,139,519,765,7300,14,3,0,126
Conway,10/31/20,3,29,29,359,8385,330,8744,26,20906,336,23,8068,317,311,19,3,0,22,4,8404,340,336,8068,23,317,359,8385,6,1,0,222
Craighead,10/31/20,48,31,31,4821,49248,4177,54141,595,105701,4521,300,46550,2698,3968,209,44,4,508,87,51071,3070,4521,46550,372,2698,4893,49248,122,49,0,749
Crawford,10/31/20,29,33,33,2148,28846,1904,30998,215,62472,2037,111,28422,424,1817,87,27,2,193,22,30459,539,2037,28422,115,424,2152,28846,29,14,2,252
Crittenden,10/31/20,53,35,35,2513,17307,2224,19821,235,49013,2430,83,17103,204,2177,47,46,7,206,29,19533,288,2430,17103,84,204,2514,17307,46,16,0,93
Cross,10/31/20,22,37,37,612,6605,534,7218,56,16998,551,61,6386,219,488,46,20,2,43,13,6937,281,551,6386,62,219,613,6605,9,4,0,64
Dallas,10/31/20,6,39,39,181,2797,171,2978,4,7432,178,3,2731,66,169,2,6,0,3,1,2909,69,178,2731,3,66,181,2797,0,0,0,4
Desha,10/31/20,7,41,41,424,5095,370,5526,47,11887,397,27,4898,197,355,15,7,0,35,12,5295,231,397,4898,34,197,431,5095,3,4,0,6
Drew,10/31/20,7,43,43,440,7661,400,8106,33,18502,415,25,7016,645,380,20,6,1,29,4,7431,675,415,7016,30,645,445,7661,0,0,0,18
Faulkner,10/31/20,38,45,45,3500,51957,3206,55495,256,122416,3228,272,49451,2506,3007,199,32,6,189,67,52679,2816,3228,49451,310,2506,3538,51957,34,36,2,581
Franklin,10/31/20,2,47,47,569,8943,479,9529,88,17780,518,51,8745,198,450,29,2,0,66,22,9263,266,518,8745,68,198,586,8943,18,7,-1,135
Fulton,10/31/20,10,49,49,343,2738,287,3091,46,12139,293,50,2386,352,247,40,8,2,38,8,2679,412,293,2386,60,352,353,2738,7,0,1,29
Garland,10/31/20,68,51,51,2620,41087,2249,43726,303,98296,2506,114,40025,1062,2180,69,63,5,263,40,42531,1195,2506,40025,133,1062,2639,41087,15,14,1,121
Grant,10/31/20,4,53,53,379,7036,344,7422,31,18086,346,33,6560,476,314,30,4,0,28,3,6906,516,346,6560,40,476,386,7036,4,2,0,44
Greene,10/31/20,20,55,55,1628,20082,1332,21738,276,44623,1436,192,18885,1197,1241,91,19,1,176,100,20321,1417,1436,18885,220,1197,1656,20082,33,20,0,205
Hempstead,10/31/20,5,57,57,584,6878,523,7477,56,22018,521,63,6675,203,477,46,5,0,39,17,7196,281,521,6675,78,203,599,6878,5,5,0,116
HotSpring,10/31/20,37,59,59,2275,18276,2079,20560,159,33520,2242,33,17680,596,2058,21,35,2,149,10,19922,638,2242,17680,42,596,2284,18276,30,4,-1,214
Howard,10/31/20,14,61,61,617,4542,550,5166,53,13389,553,64,4214,328,500,50,14,0,39,14,4767,399,553,4214,71,328,624,4542,5,6,0,57
Independence,10/31/20,57,63,63,1493,14999,1368,16505,68,37264,1220,273,14558,441,1130,238,51,6,39,29,15778,727,1220,14558,286,441,1506,14999,13,5,0,60
Izard,10/31/20,2,65,65,621,5765,415,6396,204,13559,577,44,5311,454,381,34,2,0,194,10,5888,508,577,5311,54,454,631,5765,2,6,0,16
Jackson,10/31/20,6,67,67,899,9863,627,10797,266,17225,690,209,9783,80,462,165,5,1,223,43,10473,324,690,9783,244,80,934,9863,87,10,0,310
Jefferson,10/31/20,102,69,69,4289,41146,3888,45507,297,70424,4155,134,40407,739,3798,90,97,5,258,39,44562,945,4155,40407,206,739,4361,41146,19,19,0,558
Johnson,10/31/20,8,71,71,1055,10310,967,11372,80,26291,1011,44,10055,255,941,26,8,0,62,18,11066,306,1011,10055,51,255,1062,10310,7,7,0,141
Lafayette,10/31/20,3,73,73,192,1508,158,1703,31,6915,170,22,1468,40,141,17,3,0,26,5,1638,65,170,1468,25,40,195,1508,2,2,0,17
Lawrence,10/31/20,20,75,75,873,6249,745,7133,108,16669,777,96,6051,198,665,80,20,0,92,16,6828,305,777,6051,107,198,884,6249,14,9,1,65
Lee,10/31/20,18,77,77,1113,5089,1085,6205,10,9398,1107,6,5043,46,1081,4,17,1,9,1,6150,55,1107,5043,9,46,1116,5089,0,1,0,18
Lincoln,10/31/20,18,79,79,2335,9462,2204,11806,113,13695,2310,25,9331,131,2185,19,17,1,108,5,11641,165,2310,9331,34,131,2344,9462,2,21,1,16
LittleRiver,10/31/20,37,81,81,478,2392,403,2865,38,12417,431,47,2307,85,371,32,32,5,28,10,2738,127,431,2307,42,85,473,2392,2,4,-1,26
Logan,10/31/20,5,83,83,611,10196,562,10815,44,21757,590,21,9674,522,548,14,5,0,37,7,10264,551,590,9674,29,522,619,10196,8,8,1,63
Lonoke,10/31/20,30,85,85,1865,28924,1582,30877,253,72206,1524,341,25609,3315,1319,263,28,2,177,76,27133,3744,1524,25609,429,3315,1953,28924,25,23,1,256
Madison,10/31/20,6,87,87,442,5505,411,5950,25,16076,410,32,5329,176,382,29,6,0,22,3,5739,211,410,5329,35,176,445,5505,8,4,0,110
Marion,10/31/20,2,89,89,176,3652,142,3831,32,16438,155,21,3395,257,131,11,1,1,23,9,3550,281,155,3395,24,257,179,3652,7,2,0,45
Miller,10/31/20,21,91,91,1583,8727,1303,10326,259,43759,1297,286,8497,230,1099,204,16,5,182,77,9794,532,1297,8497,302,230,1599,8727,51,50,5,138
MissingCountyInfo,10/31/20,0,5,5,2111,65108,1630,67220,481,NA,1861,250,65099,9,1458,172,0,0,403,78,66960,260,1861,65099,251,9,2112,65108,-4,4,0,1748
Mississippi,10/31/20,69,93,93,2391,14773,2079,17156,243,42831,2267,124,14449,324,2000,79,56,13,211,32,16716,440,2267,14449,116,324,2383,14773,40,41,1,202
Monroe,10/31/20,2,95,95,227,3142,202,3368,23,7249,214,13,3072,70,192,10,2,0,20,3,3286,82,214,3072,12,70,226,3142,7,-1,1,42
Montgomery,10/31/20,8,97,97,186,2995,174,3180,4,8993,183,3,2694,301,171,3,8,0,4,0,2877,303,183,2694,2,301,185,2995,0,2,0,7
Nevada,10/31/20,14,99,99,331,4686,269,5016,48,8440,300,31,4567,119,250,19,13,1,37,11,4867,149,300,4567,30,119,330,4686,7,4,0,55
Newton,10/31/20,20,101,101,322,2493,272,2809,30,7848,296,26,2145,348,255,17,17,3,24,6,2441,368,296,2145,20,348,316,2493,0,1,0,8
Ouachita,10/31/20,9,103,103,395,7592,335,7998,50,24106,374,21,7349,243,318,17,9,0,46,4,7723,275,374,7349,32,243,406,7592,1,4,0,27
Perry,10/31/20,1,105,105,150,4671,130,4825,19,10322,140,10,4507,164,124,6,1,0,15,4,4647,178,140,4507,14,164,154,4671,5,1,0,59
Phillips,10/31/20,16,107,107,777,8901,696,9691,65,19034,754,23,8754,147,679,17,16,0,59,6,9508,183,754,8754,36,147,790,8901,5,6,0,33
Pike,10/31/20,1,109,109,274,2944,257,3216,16,10808,261,13,2777,167,248,9,0,1,13,3,3038,178,261,2777,11,167,272,2944,4,2,0,32
Poinsett,10/31/20,21,111,111,1166,12035,935,13221,210,24054,1081,85,11782,253,878,57,19,2,184,26,12863,358,1081,11782,105,253,1186,12035,17,11,0,104
Polk,10/31/20,5,113,113,370,5783,342,6157,23,20163,359,11,5681,102,334,8,5,0,20,3,6040,117,359,5681,15,102,374,5783,5,1,0,21
Pope,10/31/20,37,115,115,2811,30172,2597,32989,177,63644,2641,170,29429,743,2475,122,33,4,133,44,32070,919,2641,29429,176,743,2817,30172,11,17,-1,284
Prairie,10/31/20,4,117,117,240,3158,189,3408,47,8244,204,36,2833,325,175,14,4,0,25,22,3037,371,204,2833,46,325,250,3158,1,1,0,33
Pulaski,10/31/20,216,119,119,12350,176871,11181,189362,951,393463,11678,672,170844,6027,10643,538,202,14,831,120,182522,6840,11678,170844,813,6027,12491,176871,107,93,3,1529
Randolph,10/31/20,25,121,121,686,7063,592,7762,69,17603,538,148,6564,499,481,111,20,5,37,32,7102,660,538,6564,161,499,699,7063,12,11,1,90
Saline,10/31/20,33,125,125,3014,42441,2678,45506,302,118009,2713,301,39774,2667,2469,209,31,2,212,90,42487,3019,2713,39774,352,2667,3065,42441,49,28,2,384
Scott,10/31/20,1,127,127,232,4497,182,4729,49,10442,211,21,4420,77,172,10,1,0,38,11,4631,98,211,4420,21,77,232,4497,4,14,0,24
Searcy,10/31/20,1,129,129,208,3234,181,3441,26,7923,192,16,3056,178,171,10,1,0,20,6,3248,193,192,3056,15,178,207,3234,3,2,0,15
Sebastian,10/31/20,96,131,131,5045,64016,4558,69076,389,127461,4807,238,63344,672,4387,171,89,7,329,60,68151,925,4807,63344,253,672,5060,64016,73,35,1,566
Sevier,10/31/20,16,133,133,1394,7595,1300,8993,78,17193,1265,129,7172,423,1209,91,16,0,40,38,8437,556,1265,7172,133,423,1398,7595,15,15,0,110
Sharp,10/31/20,10,135,135,379,5998,311,6377,58,17043,322,57,5702,296,269,42,10,0,43,15,6024,353,322,5702,57,296,379,5998,2,7,0,37
St.Francis,10/31/20,10,123,123,1785,14495,1660,16284,115,26294,1759,26,14396,99,1642,18,10,0,107,8,16155,129,1759,14396,30,99,1789,14495,6,1,0,57
Stone,10/31/20,21,137,137,408,4337,374,4748,13,12446,392,16,4203,134,361,13,21,0,10,3,4595,153,392,4203,19,134,411,4337,3,4,0,19
Union,10/31/20,50,139,139,1161,11992,1051,13162,60,39732,1033,128,11009,983,946,105,44,6,43,17,12042,1120,1033,11009,137,983,1170,11992,11,4,1,39
VanBuren,10/31/20,3,141,141,215,5799,197,6023,15,16684,205,10,5501,298,189,8,3,0,13,2,5706,317,205,5501,19,298,224,5799,2,0,0,34
Washington,10/31/20,153,143,143,11804,100780,11007,112684,643,228529,10607,1197,95035,5745,9992,1015,135,18,480,163,105642,7042,10607,95035,1297,5745,11904,100780,87,64,1,672
White,10/31/20,33,145,145,1580,23302,1317,24918,230,78804,1325,255,21032,2270,1110,207,28,5,187,43,22357,2561,1325,21032,291,2270,1616,23302,29,23,0,145
Woodruff,10/31/20,0,147,147,131,2376,97,2510,34,6660,112,19,2298,78,85,12,0,0,27,7,2410,100,112,2298,22,78,134,2376,3,5,0,15
Yell,10/31/20,31,149,149,1363,13705,1300,15066,32,21573,1344,19,13507,198,1288,12,28,3,28,4,14851,215,1344,13507,17,198,1361,13705,9,5,0,62
Arkansas_all_counties,10/30/20,1900,5630,5630,110874,1283623,99165,1395529,9796,2990671,102405,8469,1234166,49457,92827,6338,1737,163,7829,1967,1336571,58958,102405,1234166,9501,49457,111906,1283623,1162,825,6,13879
Arkansas_county,10/30/20,16,1,1,700,9198,597,9926,87,18124,605,95,7730,1468,528,69,16,0,61,26,8335,1591,605,7730,123,1468,728,9198,8,3,0,134
Ashley,10/30/20,11,3,3,559,6626,490,7189,58,20537,530,29,6413,213,470,20,11,0,49,9,6943,246,530,6413,33,213,563,6626,7,0,0,66
Baxter,10/30/20,11,5,5,712,6883,588,7596,113,41219,589,123,6310,573,488,100,11,0,90,23,6899,697,589,6310,124,573,713,6883,17,6,0,117
Benton,10/30/20,120,7,7,8441,90434,7681,98946,639,258980,7688,753,88223,2211,7118,563,103,17,466,173,95911,3035,7688,88223,824,2211,8512,90434,101,47,-1,983
Boone,10/30/20,35,9,9,1076,14719,935,15807,106,37288,961,115,14495,224,844,91,33,2,84,22,15456,351,961,14495,127,224,1088,14719,19,4,0,77
Bradley,10/30/20,8,11,11,373,4518,353,4892,12,10948,364,9,4038,480,347,6,7,1,10,2,4402,490,364,4038,10,480,374,4518,0,3,0,17
Calhoun,10/30/20,0,13,13,54,1996,48,2050,6,5202,50,4,1953,43,45,3,0,0,5,1,2003,47,50,1953,4,43,54,1996,1,0,0,7
Carroll,10/30/20,17,15,15,1028,9175,937,10212,74,27887,985,43,9079,96,902,35,17,0,66,8,10064,148,985,9079,52,96,1037,9175,14,11,0,115
Chicot,10/30/20,23,17,17,1054,6004,1012,7062,19,10826,1038,16,5757,247,1000,12,22,1,16,3,6795,267,1038,5757,20,247,1058,6004,1,6,0,34
Clark,10/30/20,5,19,19,511,9328,468,9850,38,22385,458,53,8580,748,427,41,5,0,26,12,9038,812,458,8580,64,748,522,9328,5,6,0,52
Clay,10/30/20,13,21,21,499,6519,432,7023,53,15061,457,42,5663,856,403,29,11,2,42,11,6120,903,457,5663,47,856,504,6519,3,9,0,155
Cleburne,10/30/20,15,23,23,470,9080,426,9554,29,25230,415,55,8440,640,380,46,15,0,20,9,8855,699,415,8440,59,640,474,9080,7,3,0,147
Cleveland,10/30/20,13,25,25,249,3806,199,4055,37,8226,226,23,3678,128,189,10,12,1,25,12,3904,151,226,3678,23,128,249,3806,8,3,0,20
Columbia,10/30/20,21,27,27,731,7188,645,7937,65,23892,619,112,6763,425,561,84,21,0,37,28,7382,555,619,6763,130,425,749,7188,11,1,0,61
Conway,10/30/20,3,29,29,353,8169,329,8522,21,20906,330,23,7857,312,310,19,3,0,17,4,8187,335,330,7857,23,312,353,8169,1,-1,0,56
Craighead,10/30/20,48,31,31,4699,48621,4128,53386,522,105701,4420,279,46187,2434,3924,204,44,4,451,71,50607,2779,4420,46187,345,2434,4765,48621,53,63,0,754
Crawford,10/30/20,27,33,33,2119,28623,1890,30745,202,62472,2012,107,28207,416,1807,83,25,2,180,22,30219,526,2012,28207,110,416,2122,28623,33,23,0,206
Crittenden,10/30/20,53,35,35,2467,17260,2208,19724,205,49013,2382,85,17058,202,2162,46,46,7,173,32,19440,284,2382,17058,82,202,2464,17260,25,22,1,128
Cross,10/30/20,22,37,37,603,6550,530,7154,51,16998,544,59,6350,200,486,44,20,2,38,13,6894,260,544,6350,60,200,604,6550,5,4,0,33
Dallas,10/30/20,6,39,39,181,2793,171,2974,4,7432,178,3,2728,65,169,2,6,0,3,1,2906,68,178,2728,3,65,181,2793,1,0,0,24
Desha,10/30/20,7,41,41,421,5092,366,5520,48,11887,396,25,4899,193,351,15,7,0,38,10,5295,225,396,4899,32,193,428,5092,1,0,0,50
Drew,10/30/20,7,43,43,440,7643,400,8088,33,18502,415,25,7000,643,379,21,6,1,30,3,7415,673,415,7000,30,643,445,7643,5,7,0,83
Faulkner,10/30/20,36,45,45,3466,51410,3170,54911,260,122416,3197,269,48952,2458,2977,193,30,6,190,70,52149,2762,3197,48952,304,2458,3501,51410,36,30,0,656
Franklin,10/30/20,3,47,47,551,8826,472,9393,76,17780,504,47,8635,191,445,27,3,0,56,20,9139,254,504,8635,63,191,567,8826,11,11,0,162
Fulton,10/30/20,9,49,49,336,2716,287,3062,40,12139,289,47,2367,349,247,40,8,1,34,6,2656,406,289,2367,57,349,346,2716,4,11,0,24
Garland,10/30/20,67,51,51,2605,40981,2235,43601,303,98296,2492,113,39951,1030,2168,67,62,5,262,41,42443,1158,2492,39951,128,1030,2620,40981,14,19,0,129
Grant,10/30/20,4,53,53,375,6996,342,7378,29,18086,342,33,6526,470,313,29,4,0,25,4,6868,510,342,6526,40,470,382,6996,1,4,0,28
Greene,10/30/20,20,55,55,1595,19910,1312,21532,263,44623,1417,178,18806,1104,1225,87,19,1,173,90,20223,1309,1417,18806,205,1104,1622,19910,38,32,0,420
Hempstead,10/30/20,5,57,57,579,6767,518,7358,56,22018,520,59,6573,194,475,43,5,0,40,16,7093,265,520,6573,71,194,591,6767,15,2,0,84
HotSpring,10/30/20,38,59,59,2245,18092,2075,20344,132,33520,2213,32,17512,580,2054,21,36,2,123,9,19725,619,2213,17512,39,580,2252,18092,18,6,0,185
Howard,10/30/20,14,61,61,612,4490,544,5107,54,13389,549,63,4192,298,496,48,14,0,39,15,4741,366,549,4192,68,298,617,4490,13,3,0,31
Independence,10/30/20,57,63,63,1480,14952,1363,16445,60,37264,1215,265,14526,426,1129,234,51,6,35,25,15741,704,1215,14526,278,426,1493,14952,4,3,2,81
Izard,10/30/20,2,65,65,619,5751,409,6380,208,13559,575,44,5300,451,379,30,2,0,194,14,5875,505,575,5300,54,451,629,5751,5,2,0,55
Jackson,10/30/20,6,67,67,812,9640,617,10484,189,17225,607,205,9561,79,452,165,5,1,150,39,10168,316,607,9561,237,79,844,9640,24,17,0,182
Jefferson,10/30/20,102,69,69,4270,40607,3869,44943,297,70424,4133,137,39870,737,3779,90,97,5,255,42,44003,940,4133,39870,203,737,4336,40607,27,22,0,276
Johnson,10/30/20,8,71,71,1048,10176,960,11231,80,26291,1005,43,9933,243,935,25,8,0,62,18,10938,293,1005,9933,50,243,1055,10176,6,8,0,97
Lafayette,10/30/20,3,73,73,190,1493,156,1686,31,6915,168,22,1457,36,139,17,3,0,26,5,1625,61,168,1457,25,36,193,1493,14,2,0,70
Lawrence,10/30/20,19,75,75,859,6198,736,7067,104,16669,765,94,6019,179,661,75,19,0,85,19,6784,283,765,6019,104,179,869,6198,11,8,0,46
Lee,10/30/20,18,77,77,1113,5071,1084,6187,11,9398,1107,6,5025,46,1080,4,17,1,10,1,6132,55,1107,5025,9,46,1116,5071,2,1,0,10
Lincoln,10/30/20,17,79,79,2333,9448,2183,11790,133,13695,2308,25,9318,130,2165,18,16,1,127,6,11626,164,2308,9318,34,130,2342,9448,0,11,0,38
LittleRiver,10/30/20,38,81,81,476,2368,399,2838,39,12417,430,46,2287,81,367,32,33,5,30,9,2717,121,430,2287,40,81,470,2368,11,1,0,48
Logan,10/30/20,4,83,83,603,10141,554,10752,45,21757,584,19,9623,518,540,14,4,0,40,5,10207,545,584,9623,27,518,611,10141,0,4,0,265
Lonoke,10/30/20,29,85,85,1840,28693,1559,30618,252,72206,1507,333,25422,3271,1306,253,27,2,174,78,26929,3689,1507,25422,418,3271,1925,28693,34,18,0,234
Madison,10/30/20,6,87,87,434,5403,407,5840,21,16076,402,32,5232,171,379,28,6,0,17,4,5634,206,402,5232,35,171,437,5403,1,1,0,26
Marion,10/30/20,2,89,89,169,3614,140,3785,27,16438,151,18,3364,250,128,12,1,1,22,5,3515,270,151,3364,20,250,171,3614,8,4,0,78
Miller,10/30/20,16,91,91,1532,8640,1253,10185,263,43759,1267,265,8422,218,1075,178,14,2,178,85,9689,496,1267,8422,278,218,1545,8640,52,19,0,190
MissingCountyInfo,10/30/20,0,5,5,2115,63356,1626,65461,489,NA,1822,293,63347,9,1437,189,0,0,385,104,65169,292,1822,63347,283,9,2105,63356,30,34,0,1149
Mississippi,10/30/20,68,93,93,2351,14611,2038,16954,245,42831,2233,118,14311,300,1960,78,55,13,218,27,16544,410,2233,14311,110,300,2343,14611,13,13,0,92
Monroe,10/30/20,1,95,95,220,3107,203,3327,16,7249,209,11,3039,68,193,10,1,0,15,1,3248,79,209,3039,11,68,220,3107,4,1,0,41
Montgomery,10/30/20,8,97,97,186,2988,172,3173,6,8993,183,3,2687,301,169,3,8,0,6,0,2870,303,183,2687,2,301,185,2988,2,0,0,10
Nevada,10/30/20,14,99,99,324,4638,265,4961,45,8440,295,29,4539,99,246,19,13,1,36,9,4834,127,295,4539,28,99,323,4638,7,3,0,90
Newton,10/30/20,20,101,101,322,2485,271,2802,31,7848,297,25,2137,348,254,17,17,3,26,5,2434,368,297,2137,20,348,317,2485,3,2,0,19
Ouachita,10/30/20,9,103,103,394,7566,331,7971,53,24106,373,21,7333,233,315,16,9,0,48,5,7706,265,373,7333,32,233,405,7566,3,5,0,37
Perry,10/30/20,1,105,105,145,4617,129,4766,15,10322,136,9,4460,157,123,6,1,0,12,3,4596,170,136,4460,13,157,149,4617,3,1,0,42
Phillips,10/30/20,16,107,107,772,8873,690,9658,66,19034,749,23,8729,144,673,17,16,0,60,6,9478,180,749,8729,36,144,785,8873,5,7,0,70
Pike,10/30/20,1,109,109,270,2916,255,3184,14,10808,258,12,2763,153,246,9,0,1,12,2,3021,163,258,2763,10,153,268,2916,0,0,0,8
Poinsett,10/30/20,21,111,111,1149,11948,924,13115,204,24054,1065,84,11707,241,866,58,19,2,180,24,12772,343,1065,11707,102,241,1167,11948,16,13,1,123
Polk,10/30/20,5,113,113,365,5767,341,6136,19,20163,356,9,5666,101,333,8,5,0,18,1,6022,114,356,5666,13,101,369,5767,1,2,0,23
Pope,10/30/20,38,115,115,2800,29899,2580,32703,182,63644,2629,171,29187,712,2461,119,34,4,134,48,31816,887,2629,29187,175,712,2804,29899,26,11,0,506
Prairie,10/30/20,4,117,117,239,3126,188,3375,47,8244,203,36,2804,322,174,14,4,0,25,22,3007,368,203,2804,46,322,249,3126,3,1,0,22
Pulaski,10/30/20,213,119,119,12243,175449,11088,187831,940,393463,11584,659,169621,5828,10562,526,199,14,821,119,181205,6626,11584,169621,798,5828,12382,175449,91,107,1,1339
Randolph,10/30/20,24,121,121,674,6985,581,7670,69,17603,530,144,6537,448,476,105,19,5,35,34,7067,603,530,6537,155,448,685,6985,6,8,0,57
Saline,10/30/20,31,125,125,2965,42106,2650,45115,283,118009,2673,292,39556,2550,2448,202,29,2,195,88,42229,2886,2673,39556,336,2550,3009,42106,49,31,1,354
Scott,10/30/20,1,127,127,228,4477,168,4705,59,10442,210,18,4402,75,161,7,1,0,48,11,4612,93,210,4402,18,75,228,4477,3,5,0,47
Searcy,10/30/20,1,129,129,205,3222,179,3426,25,7923,191,14,3047,175,170,9,1,0,20,5,3238,188,191,3047,13,175,204,3222,0,1,0,13
Sebastian,10/30/20,95,131,131,4972,63523,4523,68507,352,127461,4749,223,62868,655,4357,166,88,7,302,50,67617,890,4749,62868,235,655,4984,63523,52,30,1,595
Sevier,10/30/20,16,133,133,1379,7500,1285,8878,78,17193,1257,122,7156,344,1203,82,16,0,38,40,8413,465,1257,7156,121,344,1378,7500,8,3,0,64
Sharp,10/30/20,10,135,135,377,5963,304,6340,63,17043,320,57,5674,289,265,39,10,0,45,18,5994,346,320,5674,57,289,377,5963,4,7,0,59
St.Francis,10/30/20,10,123,123,1779,14444,1659,16227,110,26294,1756,23,14349,95,1641,18,10,0,105,5,16105,122,1756,14349,27,95,1783,14444,5,8,0,34
Stone,10/30/20,21,137,137,405,4321,370,4729,14,12446,389,16,4192,129,358,12,21,0,10,4,4581,148,389,4192,19,129,408,4321,1,1,0,54
Union,10/30/20,49,139,139,1150,11964,1047,13123,54,39732,1025,125,10986,978,945,102,43,6,37,17,12011,1112,1025,10986,134,978,1159,11964,6,5,0,98
VanBuren,10/30/20,3,141,141,213,5767,197,5989,13,16684,204,9,5485,282,189,8,3,0,12,1,5689,300,204,5485,18,282,222,5767,1,1,0,43
Washington,10/30/20,152,143,143,11717,100195,10943,112007,621,228529,10551,1166,94583,5612,9938,1005,134,18,479,142,105134,6873,10551,94583,1261,5612,11812,100195,101,48,0,1128
White,10/30/20,33,145,145,1551,23186,1294,24768,224,78804,1303,248,20977,2209,1096,198,28,5,179,45,22280,2488,1303,20977,279,2209,1582,23186,35,14,0,617
Woodruff,10/30/20,0,147,147,128,2364,92,2495,36,6660,111,17,2288,76,80,12,0,0,31,5,2399,96,111,2288,20,76,131,2364,2,4,0,39
Yell,10/30/20,31,149,149,1354,13652,1295,15004,28,21573,1335,19,13455,197,1284,11,28,3,23,5,14790,214,1335,13455,17,197,1352,13652,7,0,0,372
Arkansas_all_counties,10/29/20,1894,5630,5630,109712,1270906,98340,1381586,9466,2990671,101588,8124,1223702,47204,92172,6168,1732,162,7672,1794,1325290,56296,101588,1223702,9092,47204,110680,1270906,1072,890,19,14604
Arkansas_county,10/29/20,16,1,1,692,9072,594,9789,82,18124,600,92,7685,1387,527,67,16,0,57,25,8285,1504,600,7685,117,1387,717,9072,16,9,0,131
Ashley,10/29/20,11,3,3,552,6567,490,7123,51,20537,523,29,6354,213,471,19,11,0,41,10,6877,246,523,6354,33,213,556,6567,5,3,0,77
Baxter,10/29/20,11,5,5,695,6783,582,7479,102,41219,578,117,6213,570,484,98,11,0,83,19,6791,688,578,6213,118,570,696,6783,18,17,1,153
Benton,10/29/20,121,7,7,8340,89552,7634,97957,584,258980,7623,717,87411,2141,7085,549,104,17,433,151,95034,2923,7623,87411,782,2141,8405,89552,78,55,2,678
Boone,10/29/20,35,9,9,1057,14661,931,15730,91,37288,948,109,14437,224,839,92,33,2,76,15,15385,345,948,14437,121,224,1069,14661,12,17,1,350
Bradley,10/29/20,8,11,11,373,4501,350,4875,15,10948,365,8,4024,477,345,5,7,1,13,2,4389,486,365,4024,9,477,374,4501,2,2,0,137
Calhoun,10/29/20,0,13,13,53,1990,48,2043,5,5202,50,3,1949,41,45,3,0,0,5,0,1999,44,50,1949,3,41,53,1990,0,2,0,17
Carroll,10/29/20,17,15,15,1014,9074,926,10097,71,27887,972,42,8978,96,892,34,17,0,63,8,9950,147,972,8978,51,96,1023,9074,7,7,1,74
Chicot,10/29/20,23,17,17,1053,5971,1006,7028,24,10826,1037,16,5736,235,994,12,22,1,21,3,6773,255,1037,5736,20,235,1057,5971,0,1,0,46
Clark,10/29/20,5,19,19,506,9281,462,9797,39,22385,457,49,8542,739,422,40,5,0,30,9,8999,798,457,8542,59,739,516,9281,5,7,0,194
Clay,10/29/20,13,21,21,496,6367,423,6868,59,15061,456,40,5627,740,395,28,11,2,49,10,6083,785,456,5627,45,740,501,6367,3,7,1,68
Cleburne,10/29/20,15,23,23,463,8940,423,9407,25,25230,412,51,8339,601,379,44,15,0,18,7,8751,656,412,8339,55,601,467,8940,1,3,0,68
Cleveland,10/29/20,13,25,25,241,3794,196,4035,32,8226,221,20,3666,128,187,9,12,1,22,10,3887,148,221,3666,20,128,241,3794,3,2,0,37
Columbia,10/29/20,21,27,27,720,7138,644,7874,55,23892,614,106,6736,402,561,83,21,0,32,23,7350,524,614,6736,122,402,736,7138,9,4,0,194
Conway,10/29/20,3,29,29,352,8114,330,8466,19,20906,329,23,7809,305,311,19,3,0,15,4,8138,328,329,7809,23,305,352,8114,3,2,0,48
Craighead,10/29/20,48,31,31,4646,47920,4065,52619,532,105701,4379,267,45847,2073,3873,192,44,4,461,71,50226,2393,4379,45847,320,2073,4699,47920,63,65,3,643
Crawford,10/29/20,27,33,33,2086,28450,1867,30538,192,62472,1980,106,28049,401,1785,82,25,2,170,22,30029,509,1980,28049,108,401,2088,28450,23,16,1,279
Crittenden,10/29/20,52,35,35,2442,17157,2186,19593,203,49013,2360,82,16958,199,2140,46,45,7,174,29,19318,275,2360,16958,76,199,2436,17157,14,15,0,203
Cross,10/29/20,22,37,37,598,6522,526,7120,50,16998,541,57,6330,192,485,41,20,2,36,14,6871,249,541,6330,57,192,598,6522,5,5,0,159
Dallas,10/29/20,6,39,39,180,2770,171,2950,3,7432,177,3,2705,65,169,2,6,0,2,1,2882,68,177,2705,3,65,180,2770,0,0,0,51
Desha,10/29/20,7,41,41,420,5043,366,5469,47,11887,394,26,4854,189,350,16,7,0,37,10,5248,221,394,4854,32,189,426,5043,6,3,0,39
Drew,10/29/20,7,43,43,435,7565,393,8005,35,18502,411,24,6975,590,373,20,6,1,32,3,7386,619,411,6975,29,590,440,7565,2,3,0,108
Faulkner,10/29/20,36,45,45,3430,50790,3140,54255,254,122416,3171,259,48443,2347,2949,191,30,6,192,62,51614,2641,3171,48443,294,2347,3465,50790,41,13,0,430
Franklin,10/29/20,3,47,47,540,8675,461,9230,76,17780,494,46,8501,174,434,27,3,0,57,19,8995,235,494,8501,61,174,555,8675,3,6,0,82
Fulton,10/29/20,9,49,49,332,2696,276,3039,47,12139,286,46,2348,348,237,39,8,1,41,6,2634,405,286,2348,57,348,343,2696,2,6,0,45
Garland,10/29/20,67,51,51,2591,40866,2216,43466,308,98296,2486,105,39859,1007,2155,61,62,5,269,39,42345,1121,2486,39859,114,1007,2600,40866,110,16,1,985
Grant,10/29/20,4,53,53,374,6969,338,7350,32,18086,341,33,6500,469,310,28,4,0,27,5,6841,509,341,6500,40,469,381,6969,6,5,0,114
Greene,10/29/20,20,55,55,1557,19528,1280,21109,257,44623,1397,160,18500,1028,1198,82,19,1,180,77,19897,1212,1397,18500,184,1028,1581,19528,16,25,0,331
Hempstead,10/29/20,5,57,57,564,6698,516,7273,43,22018,511,53,6522,176,473,43,5,0,33,10,7033,240,511,6522,64,176,575,6698,7,4,0,52
HotSpring,10/29/20,38,59,59,2227,17925,2069,20159,120,33520,2197,30,17352,573,2049,20,36,2,112,8,19549,610,2197,17352,37,573,2234,17925,15,8,0,339
Howard,10/29/20,14,61,61,599,4472,541,5076,44,13389,543,56,4176,296,493,48,14,0,36,8,4719,357,543,4176,61,296,604,4472,9,6,0,36
Independence,10/29/20,55,63,63,1476,14875,1360,16364,61,37264,1211,265,14481,394,1128,232,50,5,33,28,15692,672,1211,14481,278,394,1489,14875,4,-1,2,119
Izard,10/29/20,2,65,65,614,5701,407,6325,205,13559,573,41,5263,438,378,29,2,0,193,12,5836,489,573,5263,51,438,624,5701,10,2,0,100
Jackson,10/29/20,6,67,67,788,9482,600,10302,182,17225,584,204,9409,73,438,162,5,1,141,41,9993,309,584,9409,236,73,820,9482,15,11,0,105
Jefferson,10/29/20,102,69,69,4243,40358,3847,44667,292,70424,4115,128,39631,727,3762,85,97,5,254,38,43746,921,4115,39631,194,727,4309,40358,12,16,0,218
Johnson,10/29/20,8,71,71,1042,10085,952,11134,82,26291,1002,40,9849,236,930,22,8,0,64,18,10851,283,1002,9849,47,236,1049,10085,17,8,0,98
Lafayette,10/29/20,3,73,73,176,1437,154,1616,19,6915,156,20,1402,35,137,17,3,0,16,3,1558,58,156,1402,23,35,179,1437,3,1,0,16
Lawrence,10/29/20,19,75,75,848,6163,728,7019,101,16669,755,93,5990,173,654,74,19,0,82,19,6745,274,755,5990,101,173,856,6163,15,9,1,124
Lee,10/29/20,18,77,77,1111,5063,1083,6177,10,9398,1106,5,5019,44,1079,4,17,1,10,0,6125,52,1106,5019,8,44,1114,5063,1,3,0,31
Lincoln,10/29/20,17,79,79,2333,9410,2172,11752,144,13695,2308,25,9280,130,2154,18,16,1,138,6,11588,164,2308,9280,34,130,2342,9410,0,17,0,109
LittleRiver,10/29/20,38,81,81,465,2331,398,2790,29,12417,423,42,2260,71,366,32,33,5,24,5,2683,107,423,2260,36,71,459,2331,6,1,0,59
Logan,10/29/20,4,83,83,603,9876,550,10487,49,21757,584,19,9554,322,537,13,4,0,43,6,10138,349,584,9554,27,322,611,9876,8,10,0,136
Lonoke,10/29/20,29,85,85,1806,28493,1541,30385,236,72206,1484,322,25267,3226,1297,244,27,2,160,76,26751,3634,1484,25267,408,3226,1892,28493,25,20,1,281
Madison,10/29/20,6,87,87,433,5378,406,5814,21,16076,400,33,5207,171,378,28,6,0,16,5,5607,207,400,5207,36,171,436,5378,2,2,0,30
Marion,10/29/20,2,89,89,161,3544,136,3706,23,16438,145,16,3294,250,126,10,1,1,18,5,3439,267,145,3294,17,250,162,3544,6,3,0,56
Miller,10/29/20,16,91,91,1480,8502,1234,9990,230,43759,1238,242,8309,193,1063,171,14,2,161,69,9547,443,1238,8309,250,193,1488,8502,23,17,0,142
MissingCountyInfo,10/29/20,0,5,5,2085,62237,1592,64312,493,NA,1796,289,62228,9,1416,176,0,0,380,113,64024,288,1796,62228,279,9,2075,62237,-10,6,0,832
Mississippi,10/29/20,68,93,93,2338,14532,2025,16861,245,42831,2223,115,14251,281,1949,76,55,13,219,26,16474,387,2223,14251,106,281,2329,14532,22,57,0,161
Monroe,10/29/20,1,95,95,216,3070,202,3286,13,7249,205,11,3004,66,192,10,1,0,12,1,3209,77,205,3004,11,66,216,3070,4,3,0,39
Montgomery,10/29/20,8,97,97,184,2980,172,3163,4,8993,181,3,2679,301,169,3,8,0,4,0,2860,303,181,2679,2,301,183,2980,1,1,0,24
Nevada,10/29/20,14,99,99,317,4555,262,4871,41,8440,290,27,4458,97,244,18,13,1,33,8,4748,123,290,4458,26,97,316,4555,6,3,0,35
Newton,10/29/20,20,101,101,319,2469,269,2783,30,7848,295,24,2121,348,253,16,17,3,25,5,2416,367,295,2121,19,348,314,2469,5,0,0,41
Ouachita,10/29/20,9,103,103,391,7532,326,7934,55,24106,371,20,7302,230,313,13,9,0,48,7,7673,261,371,7302,31,230,402,7532,6,6,0,91
Perry,10/29/20,1,105,105,142,4578,128,4724,13,10322,135,7,4426,152,122,6,1,0,12,1,4561,163,135,4426,11,152,146,4578,3,1,1,32
Phillips,10/29/20,16,107,107,767,8808,683,9588,68,19034,744,23,8669,139,666,17,16,0,62,6,9413,175,744,8669,36,139,780,8808,10,11,0,158
Pike,10/29/20,1,109,109,270,2908,255,3176,14,10808,258,12,2756,152,246,9,0,1,12,2,3014,162,258,2756,10,152,268,2908,1,1,0,19
Poinsett,10/29/20,20,111,111,1133,11841,911,12989,202,24054,1054,79,11640,201,856,55,18,2,180,22,12694,295,1054,11640,94,201,1148,11841,18,19,0,150
Polk,10/29/20,5,113,113,364,5745,339,6113,20,20163,356,8,5653,92,332,7,5,0,19,1,6009,104,356,5653,12,92,368,5745,4,2,0,48
Pope,10/29/20,38,115,115,2774,29419,2569,32197,167,63644,2608,166,28739,680,2452,117,34,4,122,45,31347,850,2608,28739,170,680,2778,29419,15,24,0,252
Prairie,10/29/20,4,117,117,236,3107,187,3352,45,8244,200,36,2788,319,173,14,4,0,23,22,2988,364,200,2788,45,319,245,3107,5,1,0,31
Pulaski,10/29/20,212,119,119,12152,174201,10981,186489,957,393463,11511,641,168461,5740,10465,516,198,14,846,111,179972,6517,11511,168461,777,5740,12288,174201,94,103,1,1425
Randolph,10/29/20,24,121,121,668,6934,573,7613,71,17603,526,142,6492,442,473,100,19,5,34,37,7018,595,526,6492,153,442,679,6934,9,7,0,144
Saline,10/29/20,30,125,125,2916,41801,2619,44759,266,118009,2646,270,39282,2519,2425,194,28,2,192,74,41928,2831,2646,39282,312,2519,2958,41801,32,28,0,421
Scott,10/29/20,1,127,127,225,4433,163,4658,61,10442,209,16,4369,64,156,7,1,0,52,9,4578,80,209,4369,16,64,225,4433,5,5,0,189
Searcy,10/29/20,1,129,129,205,3209,178,3413,26,7923,191,14,3036,173,169,9,1,0,21,5,3227,186,191,3036,13,173,204,3209,3,0,0,58
Sebastian,10/29/20,94,131,131,4920,62980,4493,67912,331,127461,4709,211,62364,616,4333,160,87,7,287,44,67073,839,4709,62364,223,616,4932,62980,43,29,1,886
Sevier,10/29/20,16,133,133,1371,7444,1282,8812,73,17193,1252,119,7126,318,1202,80,16,0,34,39,8378,434,1252,7126,116,318,1368,7444,9,6,0,43
Sharp,10/29/20,10,135,135,373,5908,297,6281,66,17043,317,56,5627,281,260,37,10,0,47,19,5944,337,317,5627,56,281,373,5908,8,4,0,100
St.Francis,10/29/20,10,123,123,1774,14415,1651,16193,113,26294,1753,21,14321,94,1633,18,10,0,110,3,16074,119,1753,14321,25,94,1778,14415,12,4,0,147
Stone,10/29/20,21,137,137,404,4268,369,4675,14,12446,388,16,4143,125,357,12,21,0,10,4,4531,144,388,4143,19,125,407,4268,0,0,0,22
Union,10/29/20,49,139,139,1144,11872,1042,13025,53,39732,1019,125,10927,945,941,101,43,6,35,18,11946,1079,1019,10927,134,945,1153,11872,14,5,0,167
VanBuren,10/29/20,3,141,141,212,5725,196,5945,13,16684,204,8,5452,273,188,8,3,0,13,0,5656,289,204,5452,16,273,220,5725,1,2,0,29
Washington,10/29/20,152,143,143,11616,99168,10895,110878,569,228529,10497,1119,93848,5320,9901,994,134,18,462,107,104345,6533,10497,93848,1213,5320,11710,99168,94,81,1,890
White,10/29/20,33,145,145,1516,22604,1280,24150,203,78804,1274,242,20544,2060,1088,192,28,5,158,45,21818,2332,1274,20544,272,2060,1546,22604,23,21,0,188
Woodruff,10/29/20,0,147,147,126,2327,88,2455,38,6660,108,18,2257,70,77,11,0,0,31,7,2365,90,108,2257,20,70,128,2327,2,1,0,42
Yell,10/29/20,31,149,149,1347,13287,1295,14632,21,21573,1331,16,13099,188,1284,11,28,3,19,2,14430,202,1331,13099,14,188,1345,13287,2,6,0,148
Arkansas_all_counties,10/28/20,1875,5630,5630,108640,1257374,97450,1366917,9303,2990671,100751,7889,1212191,45183,91441,6009,1714,161,7584,1719,1312942,53975,100751,1212191,8792,45183,109543,1257374,961,1128,18,13751
Arkansas_county,10/28/20,16,1,1,676,8957,585,9658,75,18124,587,89,7606,1351,520,65,16,0,51,24,8193,1465,587,7606,114,1351,701,8957,3,17,0,124
Ashley,10/28/20,11,3,3,547,6495,487,7046,49,20537,519,28,6292,203,468,19,11,0,40,9,6811,235,519,6292,32,203,551,6495,8,3,0,67
Baxter,10/28/20,10,5,5,677,6648,565,7326,102,41219,563,114,6081,567,468,97,10,0,85,17,6644,682,563,6081,115,567,678,6648,9,11,0,264
Benton,10/28/20,119,7,7,8262,88952,7579,97274,563,258980,7568,694,86885,2067,7045,534,103,16,419,144,94453,2821,7568,86885,754,2067,8322,88952,85,60,1,524
Boone,10/28/20,34,9,9,1045,14323,914,15379,97,37288,940,105,14105,218,822,92,32,2,86,11,15045,334,940,14105,116,218,1056,14323,5,8,1,53
Bradley,10/28/20,8,11,11,371,4366,348,4738,15,10948,365,6,4007,359,344,4,7,1,14,1,4372,366,365,4007,7,359,372,4366,1,0,0,20
Calhoun,10/28/20,0,13,13,53,1973,46,2026,7,5202,50,3,1935,38,43,3,0,0,7,0,1985,41,50,1935,3,38,53,1973,0,0,0,7
Carroll,10/28/20,16,15,15,1007,9007,919,10023,72,27887,966,41,8914,93,885,34,16,0,65,7,9880,143,966,8914,50,93,1016,9007,7,10,1,46
Chicot,10/28/20,23,17,17,1053,5925,1005,6982,25,10826,1037,16,5709,216,993,12,22,1,22,3,6746,236,1037,5709,20,216,1057,5925,3,2,1,25
Clark,10/28/20,5,19,19,501,9092,455,9603,41,22385,454,47,8504,588,415,40,5,0,34,7,8958,645,454,8504,57,588,511,9092,4,6,0,238
Clay,10/28/20,12,21,21,493,6302,416,6799,64,15061,452,41,5568,734,391,25,10,2,50,14,6020,779,452,5568,45,734,497,6302,3,7,0,34
Cleburne,10/28/20,15,23,23,462,8873,420,9339,27,25230,411,51,8285,588,376,44,15,0,20,7,8696,643,411,8285,55,588,466,8873,1,5,0,54
Cleveland,10/28/20,13,25,25,238,3760,194,3998,31,8226,219,19,3639,121,186,8,12,1,21,10,3858,140,219,3639,19,121,238,3760,4,2,0,114
Columbia,10/28/20,21,27,27,711,6953,640,7679,50,23892,609,102,6606,347,559,81,21,0,29,21,7215,464,609,6606,117,347,726,6953,7,8,0,49
Conway,10/28/20,3,29,29,349,8069,328,8418,18,20906,327,22,7773,296,310,18,3,0,14,4,8100,318,327,7773,22,296,349,8069,3,3,0,72
Craighead,10/28/20,45,31,31,4583,47340,4000,51971,537,105701,4327,256,45428,1912,3822,178,41,4,463,74,49755,2216,4327,45428,304,1912,4631,47340,39,55,0,531
Crawford,10/28/20,26,33,33,2063,28194,1851,30258,186,62472,1961,102,27810,384,1769,82,24,2,168,18,29771,487,1961,27810,103,384,2064,28194,28,30,0,161
Crittenden,10/28/20,52,35,35,2428,16968,2171,19391,204,49013,2350,78,16784,184,2126,45,45,7,178,26,19134,257,2350,16784,73,184,2423,16968,31,24,0,178
Cross,10/28/20,22,37,37,593,6368,521,6961,50,16998,536,57,6190,178,483,38,20,2,33,17,6726,235,536,6190,57,178,593,6368,6,5,0,79
Dallas,10/28/20,6,39,39,180,2719,171,2899,3,7432,177,3,2663,56,169,2,6,0,2,1,2840,59,177,2663,3,56,180,2719,1,0,1,20
Desha,10/28/20,7,41,41,414,5010,363,5429,44,11887,389,25,4824,186,349,14,7,0,33,11,5213,216,389,4824,30,186,419,5010,4,1,0,31
Drew,10/28/20,7,43,43,433,7459,390,7897,36,18502,409,24,6919,540,370,20,6,1,33,3,7328,569,409,6919,29,540,438,7459,3,7,0,49
Faulkner,10/28/20,36,45,45,3389,50401,3127,53824,226,122416,3149,240,48155,2246,2938,189,30,6,181,45,51304,2520,3149,48155,274,2246,3423,50401,31,43,1,435
Franklin,10/28/20,3,47,47,537,8596,455,9148,79,17780,492,45,8427,169,429,26,3,0,60,19,8919,229,492,8427,60,169,552,8596,8,11,0,97
Fulton,10/28/20,9,49,49,330,2653,270,2993,51,12139,283,47,2311,342,232,38,8,1,43,8,2594,399,283,2311,57,342,340,2653,7,6,0,52
Garland,10/28/20,66,51,51,2481,39991,2200,42481,215,98296,2381,100,39028,963,2144,56,61,5,176,39,41409,1072,2381,39028,109,963,2490,39991,24,34,0,262
Grant,10/28/20,4,53,53,368,6861,333,7235,31,18086,336,32,6459,402,308,25,4,0,24,7,6795,440,336,6459,38,402,374,6861,4,11,0,70
Greene,10/28/20,20,55,55,1541,19213,1255,20778,266,44623,1391,150,18219,994,1176,79,19,1,196,70,19610,1168,1391,18219,174,994,1565,19213,34,25,1,156
Hempstead,10/28/20,5,57,57,557,6653,512,7221,40,22018,506,51,6485,168,469,43,5,0,32,8,6991,230,506,6485,62,168,568,6653,3,11,0,121
HotSpring,10/28/20,38,59,59,2212,17601,2061,19820,113,33520,2182,30,17140,461,2042,19,36,2,104,9,19322,498,2182,17140,37,461,2219,17601,4,14,2,203
Howard,10/28/20,14,61,61,590,4445,535,5040,41,13389,534,56,4153,292,489,46,14,0,31,10,4687,353,534,4153,61,292,595,4445,8,6,0,64
Independence,10/28/20,53,63,63,1472,14760,1361,16245,58,37264,1209,263,14397,363,1128,233,48,5,33,25,15606,639,1209,14397,276,363,1485,14760,6,15,2,324
Izard,10/28/20,2,65,65,604,5611,405,6225,197,13559,567,37,5231,380,376,29,2,0,189,8,5798,427,567,5231,47,380,614,5611,48,32,0,238
Jackson,10/28/20,6,67,67,773,9392,589,10197,178,17225,579,194,9329,63,432,157,5,1,142,36,9908,289,579,9329,226,63,805,9392,13,24,0,69
Jefferson,10/28/20,102,69,69,4231,40152,3831,44447,296,70424,4106,125,39451,701,3751,80,97,5,256,40,43557,890,4106,39451,189,701,4295,40152,37,51,0,722
Johnson,10/28/20,8,71,71,1025,10004,944,11034,73,26291,989,36,9777,227,925,19,8,0,56,17,10766,268,989,9777,41,227,1030,10004,8,13,0,308
Lafayette,10/28/20,3,73,73,173,1424,153,1600,17,6915,154,19,1389,35,136,17,3,0,15,2,1543,57,154,1389,22,35,176,1424,1,2,0,15
Lawrence,10/28/20,18,75,75,833,6054,719,6894,96,16669,740,93,5891,163,646,73,18,0,76,20,6631,263,740,5891,100,163,840,6054,10,12,1,66
Lee,10/28/20,18,77,77,1110,5033,1080,6146,12,9398,1105,5,4999,34,1077,3,17,1,11,1,6104,42,1105,4999,8,34,1113,5033,0,1,0,10
Lincoln,10/28/20,17,79,79,2333,9301,2155,11643,161,13695,2309,24,9172,129,2137,18,16,1,156,5,11481,162,2309,9172,33,129,2342,9301,18,7,0,109
LittleRiver,10/28/20,38,81,81,459,2278,397,2731,24,12417,419,40,2209,69,365,32,33,5,21,3,2628,103,419,2209,34,69,453,2278,8,4,0,25
Logan,10/28/20,4,83,83,595,9748,540,10351,51,21757,577,18,9428,320,528,12,4,0,45,6,10005,346,577,9428,26,320,603,9748,1,8,0,81
Lonoke,10/28/20,28,85,85,1781,28237,1521,30103,232,72206,1468,313,25078,3159,1286,235,26,2,156,76,26546,3557,1468,25078,398,3159,1866,28237,29,25,0,586
Madison,10/28/20,6,87,87,431,5350,404,5783,21,16076,400,31,5180,170,376,28,6,0,18,3,5580,203,400,5180,33,170,433,5350,1,2,0,27
Marion,10/28/20,2,89,89,155,3494,133,3649,20,16438,139,16,3250,244,123,10,1,1,15,5,3389,260,139,3250,16,244,155,3494,2,0,0,69
Miller,10/28/20,16,91,91,1457,8383,1217,9847,224,43759,1227,230,8190,193,1051,166,14,2,162,62,9417,430,1227,8190,237,193,1464,8383,22,63,0,208
MissingCountyInfo,10/28/20,0,5,5,2095,61395,1586,63478,509,NA,1813,282,61386,9,1415,171,0,0,398,111,63199,279,1813,61386,270,9,2083,61395,-3,34,0,1757
Mississippi,10/28/20,68,93,93,2316,14393,1968,16700,280,42831,2200,116,14128,265,1895,73,55,13,250,30,16328,372,2200,14128,107,265,2307,14393,19,35,0,113
Monroe,10/28/20,1,95,95,212,3035,199,3247,12,7249,201,11,2970,65,189,10,1,0,11,1,3171,76,201,2970,11,65,212,3035,0,1,0,21
Montgomery,10/28/20,8,97,97,183,2957,171,3139,4,8993,180,3,2658,299,168,3,8,0,4,0,2838,301,180,2658,2,299,182,2957,0,1,0,95
Nevada,10/28/20,14,99,99,311,4526,259,4835,38,8440,285,26,4439,87,241,18,13,1,31,7,4724,111,285,4439,24,87,309,4526,10,1,0,54
Newton,10/28/20,20,101,101,314,2433,269,2742,25,7848,290,24,2093,340,253,16,17,3,20,5,2383,359,290,2093,19,340,309,2433,7,1,1,14
Ouachita,10/28/20,9,103,103,385,7447,320,7842,55,24106,364,21,7232,215,307,13,9,0,47,8,7596,246,364,7232,31,215,395,7447,6,0,0,59
Perry,10/28/20,0,105,105,139,4549,127,4692,12,10322,132,7,4407,142,121,6,0,0,11,1,4539,153,132,4407,11,142,143,4549,2,1,0,88
Phillips,10/28/20,16,107,107,757,8660,672,9429,69,19034,734,23,8518,142,657,15,16,0,61,8,9252,177,734,8518,35,142,769,8660,11,11,0,40
Pike,10/28/20,1,109,109,269,2890,254,3156,14,10808,257,12,2743,147,246,8,0,1,11,3,3000,156,257,2743,9,147,266,2890,2,0,0,36
Poinsett,10/28/20,20,111,111,1115,11709,892,12838,203,24054,1040,75,11523,186,838,54,18,2,184,19,12563,275,1040,11523,89,186,1129,11709,44,14,0,285
Polk,10/28/20,5,113,113,360,5701,337,6065,18,20163,354,6,5614,87,331,6,5,0,18,0,5968,97,354,5614,10,87,364,5701,2,2,0,18
Pope,10/28/20,38,115,115,2759,29182,2545,31944,176,63644,2601,158,28523,659,2433,112,34,4,134,42,31124,820,2601,28523,161,659,2762,29182,34,24,0,383
Prairie,10/28/20,4,117,117,231,3081,186,3321,41,8244,197,34,2768,313,172,14,4,0,21,20,2965,356,197,2768,43,313,240,3081,7,3,0,56
Pulaski,10/28/20,211,119,119,12058,172870,10878,185051,967,393463,11429,629,167249,5621,10376,502,197,14,854,113,178678,6373,11429,167249,752,5621,12181,172870,61,72,2,1203
Randolph,10/28/20,24,121,121,659,6799,566,7469,69,17603,520,139,6380,419,469,97,19,5,32,37,6900,569,520,6380,150,419,670,6799,9,10,0,218
Saline,10/28/20,30,125,125,2884,41412,2591,44329,262,118009,2623,261,39037,2375,2399,192,28,2,195,67,41660,2669,2623,39037,294,2375,2917,41412,30,29,1,518
Scott,10/28/20,1,127,127,220,4249,158,4469,61,10442,205,15,4189,60,152,6,1,0,52,9,4394,75,205,4189,15,60,220,4249,1,12,0,22
Searcy,10/28/20,1,129,129,202,3154,178,3355,23,7923,189,13,3014,140,169,9,1,0,19,4,3203,152,189,3014,12,140,201,3154,3,2,0,58
Sebastian,10/28/20,93,131,131,4877,62137,4464,67026,318,127461,4677,200,61527,610,4308,156,86,7,281,37,66204,822,4677,61527,212,610,4889,62137,28,48,0,494
Sevier,10/28/20,16,133,133,1362,7410,1276,8769,70,17193,1247,115,7111,299,1201,75,16,0,30,40,8358,411,1247,7111,112,299,1359,7410,11,12,0,62
Sharp,10/28/20,10,135,135,365,5816,293,6181,62,17043,312,53,5547,269,257,36,10,0,45,17,5859,322,312,5547,53,269,365,5816,4,3,0,109
St.Francis,10/28/20,10,123,123,1762,14280,1647,16046,105,26294,1740,22,14193,87,1629,18,10,0,101,4,15933,113,1740,14193,26,87,1766,14280,2,5,0,46
Stone,10/28/20,21,137,137,404,4246,369,4653,14,12446,388,16,4123,123,357,12,21,0,10,4,4511,142,388,4123,19,123,407,4246,3,2,0,21
Union,10/28/20,49,139,139,1130,11719,1037,12858,44,39732,1007,123,10783,936,938,99,43,6,26,18,11790,1068,1007,10783,132,936,1139,11719,8,4,0,101
VanBuren,10/28/20,3,141,141,211,5697,194,5916,14,16684,203,8,5438,259,187,7,3,0,13,1,5641,275,203,5438,16,259,219,5697,1,3,0,53
Washington,10/28/20,151,143,143,11522,98372,10814,109982,557,228529,10415,1107,93146,5226,9835,979,133,18,447,110,103561,6421,10415,93146,1195,5226,11610,98372,54,90,1,428
White,10/28/20,33,145,145,1493,22439,1259,23959,201,78804,1252,241,20403,2036,1067,192,28,5,157,44,21655,2304,1252,20403,268,2036,1520,22439,15,18,1,142
Woodruff,10/28/20,0,147,147,124,2287,87,2413,37,6660,108,16,2218,69,76,11,0,0,32,5,2326,87,108,2218,18,69,126,2287,4,4,0,22
Yell,10/28/20,31,149,149,1345,13141,1289,14484,25,21573,1330,15,12956,185,1278,11,28,3,24,1,14286,198,1330,12956,13,185,1343,13141,4,2,0,178
Arkansas_all_counties,10/27/20,1857,5630,5630,107679,1244584,96322,1353129,9490,2990671,100061,7618,1203175,41409,90559,5763,1696,161,7796,1694,1303236,49893,100061,1203175,8484,41409,108545,1244584,952,1008,24,10823
Arkansas_county,10/27/20,16,1,1,673,8836,568,9534,89,18124,585,88,7547,1289,511,57,16,0,58,31,8132,1402,585,7547,113,1289,698,8836,5,8,0,55
Ashley,10/27/20,11,3,3,539,6436,484,6979,44,20537,512,27,6237,199,468,16,11,0,33,11,6749,230,512,6237,31,199,543,6436,2,5,0,24
Baxter,10/27/20,10,5,5,668,6393,554,7064,104,41219,558,110,6005,388,461,93,10,0,87,17,6563,501,558,6005,113,388,671,6393,10,15,1,68
Benton,10/27/20,118,7,7,8177,88513,7519,96747,539,258980,7513,664,86789,1724,7007,512,102,16,403,136,94302,2445,7513,86789,721,1724,8234,88513,79,43,0,645
Boone,10/27/20,33,9,9,1040,14275,906,15326,101,37288,937,103,14067,208,814,92,31,2,92,9,15004,322,937,14067,114,208,1051,14275,8,10,1,71
Bradley,10/27/20,8,11,11,370,4347,348,4718,14,10948,364,6,3993,354,344,4,7,1,13,1,4357,361,364,3993,7,354,371,4347,1,2,0,176
Calhoun,10/27/20,0,13,13,53,1966,46,2019,7,5202,50,3,1931,35,44,2,0,0,6,1,1981,38,50,1931,3,35,53,1966,4,2,0,11
Carroll,10/27/20,15,15,15,1000,8968,909,9977,76,27887,960,40,8877,91,875,34,15,0,70,6,9837,140,960,8877,49,91,1009,8968,8,12,0,112
Chicot,10/27/20,22,17,17,1050,5903,1003,6957,25,10826,1034,16,5695,208,994,9,21,1,19,6,6729,228,1034,5695,20,208,1054,5903,1,2,0,45
Clark,10/27/20,5,19,19,497,8858,449,9365,43,22385,452,45,8309,549,409,40,5,0,38,5,8761,604,452,8309,55,549,507,8858,2,5,0,20
Clay,10/27/20,12,21,21,490,6271,409,6765,68,15061,450,40,5544,727,384,25,10,2,55,13,5994,771,450,5544,44,727,494,6271,8,9,-1,84
Cleburne,10/27/20,15,23,23,461,8820,415,9284,31,25230,409,52,8243,577,372,43,15,0,22,9,8652,632,409,8243,55,577,464,8820,6,5,0,47
Cleveland,10/27/20,13,25,25,234,3650,192,3884,29,8226,216,18,3540,110,185,7,12,1,19,10,3756,128,216,3540,18,110,234,3650,1,2,0,27
Columbia,10/27/20,21,27,27,704,6911,632,7630,51,23892,607,97,6582,329,556,76,21,0,30,21,7189,441,607,6582,112,329,719,6911,8,3,1,41
Conway,10/27/20,3,29,29,346,8000,325,8345,18,20906,324,22,7741,259,307,18,3,0,14,4,8065,280,324,7741,21,259,345,8000,2,3,0,39
Craighead,10/27/20,45,31,31,4544,46848,3945,51439,553,105701,4299,245,45129,1719,3775,170,41,4,482,71,49428,2011,4299,45129,292,1719,4591,46848,72,55,2,524
Crawford,10/27/20,26,33,33,2035,28061,1821,30097,188,62472,1942,93,27717,344,1747,74,24,2,171,17,29659,438,1942,27717,94,344,2036,28061,17,17,1,328
Crittenden,10/27/20,52,35,35,2397,16821,2147,19213,197,49013,2325,72,16639,182,2107,40,45,7,172,25,18964,249,2325,16639,67,182,2392,16821,30,16,1,121
Cross,10/27/20,22,37,37,587,6295,516,6882,49,16998,534,53,6124,171,479,37,20,2,35,14,6658,224,534,6124,53,171,587,6295,8,8,0,44
Dallas,10/27/20,5,39,39,179,2700,171,2879,3,7432,176,3,2646,54,169,2,5,0,2,1,2822,57,176,2646,3,54,179,2700,0,1,0,11
Desha,10/27/20,7,41,41,410,4983,362,5398,41,11887,387,23,4807,176,348,14,7,0,32,9,5194,204,387,4807,28,176,415,4983,0,7,0,31
Drew,10/27/20,7,43,43,430,7413,383,7848,40,18502,407,23,6887,526,367,16,6,1,34,6,7294,554,407,6887,28,526,435,7413,1,3,0,87
Faulkner,10/27/20,35,45,45,3358,49997,3084,53386,239,122416,3129,229,47981,2016,2905,179,29,6,195,44,51110,2276,3129,47981,260,2016,3389,49997,38,37,4,451
Franklin,10/27/20,3,47,47,529,8507,444,9051,82,17780,488,41,8359,148,423,21,3,0,62,20,8847,204,488,8359,56,148,544,8507,7,14,0,73
Fulton,10/27/20,9,49,49,323,2608,264,2941,50,12139,277,46,2288,320,227,37,8,1,42,8,2565,376,277,2288,56,320,333,2608,4,7,0,32
Garland,10/27/20,66,51,51,2457,39753,2166,42218,225,98296,2360,97,38880,873,2109,57,61,5,190,35,41240,978,2360,38880,105,873,2465,39753,9,23,2,248
Grant,10/27/20,4,53,53,364,6795,322,7165,38,18086,332,32,6432,363,299,23,4,0,29,9,6764,401,332,6432,38,363,370,6795,4,1,0,21
Greene,10/27/20,19,55,55,1507,19091,1230,20620,258,44623,1378,129,18135,956,1157,73,18,1,203,55,19513,1107,1378,18135,151,956,1529,19091,41,25,2,174
Hempstead,10/27/20,5,57,57,554,6535,501,7100,48,22018,505,49,6374,161,457,44,5,0,43,5,6879,221,505,6374,60,161,565,6535,7,8,0,33
HotSpring,10/27/20,36,59,59,2208,17402,2047,19616,125,33520,2180,28,17014,388,2029,18,34,2,117,8,19194,422,2180,17014,34,388,2214,17402,5,5,0,156
Howard,10/27/20,14,61,61,582,4389,529,4976,39,13389,528,54,4133,256,484,45,14,0,30,9,4661,315,528,4133,59,256,587,4389,4,5,0,49
Independence,10/27/20,51,63,63,1466,14442,1346,15921,69,37264,1209,257,14105,337,1119,227,46,5,44,25,15314,607,1209,14105,270,337,1479,14442,9,3,4,44
Izard,10/27/20,2,65,65,556,5421,373,5987,181,13559,519,37,5048,373,345,28,2,0,172,9,5567,420,519,5048,47,373,566,5421,0,4,0,29
Jackson,10/27/20,6,67,67,760,9336,565,10127,189,17225,575,185,9278,58,412,153,5,1,158,31,9853,274,575,9278,216,58,791,9336,10,10,0,87
Jefferson,10/27/20,102,69,69,4194,39467,3780,43721,310,70424,4076,118,38937,530,3704,76,97,5,273,37,43013,708,4076,38937,178,530,4254,39467,34,59,0,311
Johnson,10/27/20,8,71,71,1017,9704,931,10727,78,26291,985,32,9494,210,918,13,8,0,59,19,10479,248,985,9494,38,210,1023,9704,4,5,0,43
Lafayette,10/27/20,3,73,73,172,1410,151,1584,18,6915,153,19,1377,33,136,15,3,0,14,4,1530,54,153,1377,21,33,174,1410,2,6,0,14
Lawrence,10/27/20,17,75,75,823,5998,707,6828,99,16669,730,93,5845,153,639,68,17,0,74,25,6575,253,730,5845,100,153,830,5998,15,54,0,38
Lee,10/27/20,18,77,77,1110,5023,1079,6136,13,9398,1105,5,4989,34,1076,3,17,1,12,1,6094,42,1105,4989,8,34,1113,5023,0,4,0,8
Lincoln,10/27/20,17,79,79,2315,9210,2148,11534,150,13695,2292,23,9097,113,2132,16,16,1,144,6,11389,145,2292,9097,32,113,2324,9210,9,6,0,137
LittleRiver,10/27/20,38,81,81,451,2261,393,2706,20,12417,413,38,2194,67,363,30,33,5,17,3,2607,99,413,2194,32,67,445,2261,4,6,0,30
Logan,10/27/20,4,83,83,594,9668,532,10270,58,21757,576,18,9355,313,522,10,4,0,50,8,9931,339,576,9355,26,313,602,9668,2,3,1,113
Lonoke,10/27/20,28,85,85,1752,27680,1496,29514,228,72206,1449,303,24647,3033,1272,224,26,2,151,77,26096,3418,1449,24647,385,3033,1834,27680,29,30,2,272
Madison,10/27/20,6,87,87,430,5324,402,5756,22,16076,399,31,5170,154,374,28,6,0,19,3,5569,187,399,5170,33,154,432,5324,4,4,0,38
Marion,10/27/20,2,89,89,153,3427,133,3580,18,16438,138,15,3228,199,123,10,1,1,14,4,3366,214,138,3228,15,199,153,3427,2,4,0,16
Miller,10/27/20,16,91,91,1435,8197,1154,9638,265,43759,1213,222,8010,187,995,159,14,2,204,61,9223,415,1213,8010,228,187,1441,8197,16,27,0,71
MissingCountyInfo,10/27/20,0,5,5,2098,59635,1552,61723,546,NA,1825,273,59628,7,1391,161,0,0,434,112,61453,270,1825,59628,263,7,2088,59635,-107,-14,0,324
Mississippi,10/27/20,68,93,93,2297,14299,1933,16587,296,42831,2189,108,14078,221,1866,67,55,13,268,28,16267,320,2189,14078,99,221,2288,14299,30,20,0,109
Monroe,10/27/20,1,95,95,212,3014,198,3226,13,7249,201,11,2948,66,189,9,1,0,11,2,3149,77,201,2948,11,66,212,3014,0,6,0,6
Montgomery,10/27/20,8,97,97,183,2862,170,3044,5,8993,180,3,2649,213,167,3,8,0,5,0,2829,215,180,2649,2,213,182,2862,1,2,0,11
Nevada,10/27/20,14,99,99,301,4482,258,4781,29,8440,275,26,4401,81,240,18,13,1,22,7,4676,105,275,4401,24,81,299,4482,2,7,0,25
Newton,10/27/20,19,101,101,307,2426,268,2728,20,7848,283,24,2088,338,252,16,16,3,15,5,2371,357,283,2088,19,338,302,2426,1,2,-1,24
Ouachita,10/27/20,9,103,103,379,7394,320,7783,49,24106,359,20,7192,202,307,13,9,0,42,7,7551,232,359,7192,30,202,389,7394,2,4,0,27
Perry,10/27/20,0,105,105,137,4463,126,4604,11,10322,130,7,4331,132,120,6,0,0,10,1,4461,143,130,4331,11,132,141,4463,0,1,0,92
Phillips,10/27/20,16,107,107,746,8631,661,9389,69,19034,724,22,8493,138,648,13,16,0,60,9,9217,172,724,8493,34,138,758,8631,5,4,0,65
Pike,10/27/20,1,109,109,267,2856,254,3120,12,10808,255,12,2728,128,246,8,0,1,9,3,2983,137,255,2728,9,128,264,2856,1,1,0,21
Poinsett,10/27/20,20,111,111,1071,11468,878,12551,173,24054,998,73,11299,169,827,51,18,2,153,20,12297,254,998,11299,85,169,1083,11468,32,18,2,161
Polk,10/27/20,5,113,113,358,5685,335,6047,18,20163,352,6,5599,86,329,6,5,0,18,0,5951,96,352,5599,10,86,362,5685,4,7,0,24
Pope,10/27/20,38,115,115,2725,28833,2521,31561,166,63644,2577,148,28264,569,2415,106,34,4,128,38,30841,720,2577,28264,151,569,2728,28833,18,27,1,113
Prairie,10/27/20,4,117,117,224,3032,183,3265,37,8244,191,33,2727,305,169,14,4,0,18,19,2918,347,191,2727,42,305,233,3032,17,0,0,40
Pulaski,10/27/20,209,119,119,11997,171728,10806,183841,981,393463,11373,624,166538,5190,10308,498,195,14,869,112,177911,5930,11373,166538,740,5190,12113,171728,167,146,0,2428
Randolph,10/27/20,24,121,121,650,6590,556,7251,70,17603,514,136,6194,396,461,95,19,5,34,36,6708,543,514,6194,147,396,661,6590,10,6,0,54
Saline,10/27/20,29,125,125,2854,40924,2562,43811,262,118009,2606,248,38870,2054,2380,182,27,2,198,64,41476,2335,2606,38870,281,2054,2887,40924,64,28,0,661
Scott,10/27/20,1,127,127,219,4228,146,4447,72,10442,205,14,4174,54,141,5,1,0,63,9,4379,68,205,4174,14,54,219,4228,6,6,0,102
Searcy,10/27/20,1,129,129,199,3099,176,3297,22,7923,188,11,3005,94,167,9,1,0,20,2,3193,104,188,3005,10,94,198,3099,1,2,0,11
Sebastian,10/27/20,93,131,131,4849,61671,4416,66531,339,127461,4660,189,61161,510,4268,148,86,7,305,34,65821,710,4660,61161,200,510,4860,61671,29,32,1,411
Sevier,10/27/20,16,133,133,1351,7359,1264,8707,71,17193,1243,108,7093,266,1196,68,16,0,31,40,8336,371,1243,7093,105,266,1348,7359,10,6,0,61
Sharp,10/27/20,10,135,135,361,5711,290,6072,61,17043,308,53,5451,260,255,35,10,0,43,18,5759,313,308,5451,53,260,361,5711,3,5,0,20
St.Francis,10/27/20,10,123,123,1760,14236,1642,16000,108,26294,1739,21,14149,87,1624,18,10,0,105,3,15888,112,1739,14149,25,87,1764,14236,10,5,0,62
Stone,10/27/20,21,137,137,401,4228,367,4632,13,12446,387,14,4110,118,355,12,21,0,11,2,4497,135,387,4110,17,118,404,4228,3,0,0,55
Union,10/27/20,49,139,139,1122,11626,1033,12757,40,39732,1004,118,10759,867,936,97,43,6,25,15,11763,994,1004,10759,127,867,1131,11626,2,8,0,20
VanBuren,10/27/20,3,141,141,210,5645,191,5863,16,16684,202,8,5421,224,185,6,3,0,14,2,5623,240,202,5421,16,224,218,5645,1,1,0,31
Washington,10/27/20,150,143,143,11468,97998,10724,109550,594,228529,10375,1093,93080,4918,9773,951,132,18,470,124,103455,6095,10375,93080,1177,4918,11552,97998,76,70,0,515
White,10/27/20,32,145,145,1478,22312,1241,23812,205,78804,1237,241,20325,1987,1053,188,27,5,157,48,21562,2250,1237,20325,263,1987,1500,22312,26,19,0,207
Woodruff,10/27/20,0,147,147,120,2269,83,2391,37,6660,105,15,2206,63,72,11,0,0,33,4,2311,80,105,2206,17,63,122,2269,4,1,0,13
Yell,10/27/20,31,149,149,1341,12967,1287,14306,23,21573,1326,15,12795,172,1276,11,28,3,22,1,14121,185,1326,12795,13,172,1339,12967,2,5,0,31
Arkansas_all_counties,10/26/20,1833,5630,5630,106727,1234713,95314,1342249,9571,2990671,99410,7317,1195435,39278,89730,5584,1676,157,7995,1576,1294845,47404,99410,1195435,8126,39278,107536,1234713,612,786,21,7464
Arkansas_county,10/26/20,16,1,1,668,8786,560,9479,92,18124,586,82,7528,1258,505,55,16,0,65,27,8114,1365,586,7528,107,1258,693,8786,6,9,1,51
Ashley,10/26/20,11,3,3,537,6414,479,6955,47,20537,511,26,6222,192,464,15,11,0,36,11,6733,222,511,6222,30,192,541,6414,1,2,0,41
Baxter,10/26/20,9,5,5,658,6335,539,6996,110,41219,552,106,5950,385,448,91,9,0,95,15,6502,494,552,5950,109,385,661,6335,9,20,0,73
Benton,10/26/20,118,7,7,8098,87947,7476,96103,503,258980,7470,628,86260,1687,6983,493,102,16,384,119,93730,2373,7470,86260,686,1687,8156,87947,33,56,1,945
Boone,10/26/20,32,9,9,1032,14212,896,15254,104,37288,931,101,14011,201,805,91,30,2,96,8,14942,312,931,14011,111,201,1042,14212,7,5,1,250
Bradley,10/26/20,8,11,11,369,4172,346,4541,15,10948,363,6,3980,192,342,4,7,1,14,1,4343,198,363,3980,6,192,369,4172,0,1,0,15
Calhoun,10/26/20,0,13,13,49,1959,44,2008,5,5202,47,2,1926,33,43,1,0,0,4,1,1973,35,47,1926,2,33,49,1959,1,2,0,8
Carroll,10/26/20,15,15,15,992,8864,897,9865,80,27887,954,38,8781,83,864,33,15,0,75,5,9735,130,954,8781,47,83,1001,8864,5,7,2,63
Chicot,10/26/20,22,17,17,1049,5859,1001,6912,26,10826,1032,17,5688,171,992,9,21,1,19,7,6720,192,1032,5688,21,171,1053,5859,0,1,0,21
Clark,10/26/20,5,19,19,495,8840,444,9344,46,22385,452,43,8300,540,405,39,5,0,42,4,8752,592,452,8300,52,540,504,8840,2,4,0,96
Clay,10/26/20,13,21,21,482,6195,400,6682,68,15061,446,36,5510,685,377,23,11,2,57,11,5956,726,446,5510,41,685,487,6195,2,1,0,55
Cleburne,10/26/20,15,23,23,455,8779,410,9237,30,25230,407,48,8219,560,367,43,15,0,25,5,8626,611,407,8219,51,560,458,8779,1,6,0,49
Cleveland,10/26/20,13,25,25,233,3624,190,3857,30,8226,216,17,3520,104,184,6,12,1,20,10,3736,121,216,3520,17,104,233,3624,2,1,0,13
Columbia,10/26/20,20,27,27,696,6878,629,7589,47,23892,601,95,6574,304,553,76,20,0,28,19,7175,414,601,6574,110,304,711,6878,6,2,1,40
Conway,10/26/20,3,29,29,344,7963,322,8306,19,20906,324,20,7724,239,304,18,3,0,17,2,8048,258,324,7724,19,239,343,7963,2,4,0,32
Craighead,10/26/20,43,31,31,4472,46396,3890,50910,538,105701,4236,236,44890,1506,3723,167,39,4,473,65,49126,1784,4236,44890,278,1506,4514,46396,40,57,3,351
Crawford,10/26/20,25,33,33,2018,27750,1804,29769,189,62472,1927,91,27438,312,1731,73,23,2,173,16,29365,404,1927,27438,92,312,2019,27750,11,15,0,261
Crittenden,10/26/20,51,35,35,2367,16730,2131,19091,185,49013,2298,69,16558,172,2089,42,44,7,165,20,18856,235,2298,16558,63,172,2361,16730,18,32,0,113
Cross,10/26/20,22,37,37,579,6259,508,6838,49,16998,530,49,6103,156,474,34,20,2,36,13,6633,205,530,6103,49,156,579,6259,2,4,0,41
Dallas,10/26/20,5,39,39,179,2689,170,2868,4,7432,176,3,2641,48,168,2,5,0,3,1,2817,51,176,2641,3,48,179,2689,0,2,0,8
Desha,10/26/20,7,41,41,410,4952,355,5367,48,11887,388,22,4791,161,345,10,7,0,36,12,5179,188,388,4791,27,161,415,4952,2,3,0,36
Drew,10/26/20,7,43,43,429,7327,380,7761,42,18502,406,23,6855,472,365,15,6,1,35,7,7261,500,406,6855,28,472,434,7327,0,1,0,52
Faulkner,10/26/20,31,45,45,3320,49584,3047,52928,242,122416,3108,212,47770,1814,2875,172,26,5,207,35,50878,2050,3108,47770,236,1814,3344,49584,10,28,0,329
Franklin,10/26/20,3,47,47,522,8441,430,8978,89,17780,485,37,8297,144,410,20,3,0,72,17,8782,196,485,8297,52,144,537,8441,1,6,1,53
Fulton,10/26/20,9,49,49,319,2580,257,2909,53,12139,276,43,2267,313,221,36,8,1,47,6,2543,366,276,2267,53,313,329,2580,4,5,0,28
Garland,10/26/20,64,51,51,2448,39514,2143,41969,241,98296,2353,95,38665,849,2092,51,59,5,202,39,41018,951,2353,38665,102,849,2455,39514,7,12,1,225
Grant,10/26/20,4,53,53,360,6778,321,7144,35,18086,331,29,6415,363,298,23,4,0,29,6,6746,398,331,6415,35,363,366,6778,1,4,0,37
Greene,10/26/20,17,55,55,1466,18958,1205,20443,244,44623,1351,115,18042,916,1135,70,17,0,199,45,19393,1050,1351,18042,134,916,1485,18958,19,26,1,172
Hempstead,10/26/20,5,57,57,547,6509,493,7067,49,22018,499,48,6356,153,452,41,5,0,42,7,6855,212,499,6356,59,153,558,6509,5,4,0,51
HotSpring,10/26/20,36,59,59,2203,17251,2042,19460,125,33520,2176,27,16874,377,2025,17,34,2,117,8,19050,410,2176,16874,33,377,2209,17251,13,6,2,96
Howard,10/26/20,14,61,61,578,4344,524,4927,40,13389,524,54,4129,215,479,45,14,0,31,9,4653,274,524,4129,59,215,583,4344,1,2,0,13
Independence,10/26/20,47,63,63,1457,14407,1343,15877,67,37264,1206,251,14100,307,1116,227,43,4,47,20,15306,571,1206,14100,264,307,1470,14407,6,10,1,210
Izard,10/26/20,2,65,65,556,5392,369,5958,185,13559,519,37,5029,363,343,26,2,0,174,11,5548,410,519,5029,47,363,566,5392,0,3,0,84
Jackson,10/26/20,6,67,67,750,9259,555,10040,189,17225,568,182,9208,51,404,151,5,1,159,30,9776,264,568,9208,213,51,781,9259,3,3,0,153
Jefferson,10/26/20,102,69,69,4160,39190,3721,43409,335,70424,4053,107,38665,525,3647,74,97,5,307,28,42718,691,4053,38665,166,525,4219,39190,24,11,0,313
Johnson,10/26/20,8,71,71,1013,9665,926,10684,79,26291,985,28,9470,195,913,13,8,0,64,15,10455,229,985,9470,34,195,1019,9665,1,2,0,61
Lafayette,10/26/20,3,73,73,170,1398,145,1570,22,6915,151,19,1373,25,131,14,3,0,17,5,1524,46,151,1373,21,25,172,1398,2,2,0,7
Lawrence,10/26/20,17,75,75,808,5975,653,6790,138,16669,721,87,5832,143,585,68,17,0,119,19,6553,237,721,5832,94,143,815,5975,4,26,0,77
Lee,10/26/20,18,77,77,1110,5015,1075,6128,17,9398,1105,5,4985,30,1072,3,17,1,16,1,6090,38,1105,4985,8,30,1113,5015,2,0,0,18
Lincoln,10/26/20,17,79,79,2306,9082,2142,11397,147,13695,2283,23,8973,109,2127,15,16,1,140,7,11256,141,2283,8973,32,109,2315,9082,0,2,0,129
LittleRiver,10/26/20,38,81,81,447,2235,387,2676,22,12417,411,36,2172,63,360,27,33,5,18,4,2583,93,411,2172,30,63,441,2235,0,0,0,3
Logan,10/26/20,3,83,83,592,9557,529,10156,60,21757,575,17,9246,311,519,10,3,0,53,7,9821,335,575,9246,24,311,599,9557,7,7,0,51
Lonoke,10/26/20,26,85,85,1723,27437,1466,29237,231,72206,1431,292,24554,2883,1249,217,24,2,158,73,25985,3252,1431,24554,369,2883,1800,27437,21,18,0,189
Madison,10/26/20,6,87,87,426,5290,398,5718,22,16076,396,30,5144,146,370,28,6,0,20,2,5540,178,396,5144,32,146,428,5290,0,3,0,54
Marion,10/26/20,2,89,89,151,3413,129,3564,20,16438,136,15,3214,199,120,9,1,1,15,5,3350,214,136,3214,15,199,151,3413,2,3,0,21
Miller,10/26/20,16,91,91,1419,8142,1127,9565,276,43759,1202,217,7980,162,973,154,14,2,215,61,9182,383,1202,7980,221,162,1423,8142,31,21,1,66
MissingCountyInfo,10/26/20,0,5,5,2205,59204,1566,61397,639,NA,1883,322,59200,4,1406,160,0,0,477,162,61083,314,1883,59200,310,4,2193,59204,13,18,0,-2612
Mississippi,10/26/20,68,93,93,2267,14220,1913,16478,286,42831,2164,103,14022,198,1848,65,55,13,261,25,16186,292,2164,14022,94,198,2258,14220,42,17,0,203
Monroe,10/26/20,1,95,95,212,3008,192,3220,19,7249,201,11,2945,63,184,8,1,0,16,3,3146,74,201,2945,11,63,212,3008,1,0,0,16
Montgomery,10/26/20,8,97,97,182,2852,168,3033,6,8993,179,3,2641,211,165,3,8,0,6,0,2820,213,179,2641,2,211,181,2852,0,0,0,11
Nevada,10/26/20,14,99,99,299,4459,251,4756,34,8440,274,25,4380,79,234,17,13,1,27,7,4654,102,274,4380,23,79,297,4459,6,2,0,45
Newton,10/26/20,20,101,101,306,2403,266,2704,20,7848,284,22,2081,322,250,16,17,3,17,3,2365,339,284,2081,17,322,301,2403,1,2,0,20
Ouachita,10/26/20,9,103,103,377,7369,316,7756,51,24106,356,21,7169,200,303,13,9,0,43,8,7525,231,356,7169,31,200,387,7369,3,2,0,70
Perry,10/26/20,0,105,105,137,4371,125,4510,12,10322,128,9,4249,122,119,6,0,0,9,3,4377,133,128,4249,11,122,139,4371,1,2,0,15
Phillips,10/26/20,16,107,107,741,8571,657,9324,68,19034,720,21,8453,118,644,13,16,0,60,8,9173,151,720,8453,33,118,753,8571,0,7,0,58
Pike,10/26/20,1,109,109,266,2836,253,3099,12,10808,254,12,2720,116,245,8,0,1,9,3,2974,125,254,2720,9,116,263,2836,3,2,0,20
Poinsett,10/26/20,18,111,111,1039,11339,860,12390,161,24054,974,65,11187,152,810,50,17,1,147,14,12161,229,974,11187,77,152,1051,11339,8,11,0,180
Polk,10/26/20,5,113,113,354,5665,328,6021,21,20163,347,7,5584,81,321,7,5,0,21,0,5931,90,347,5584,9,81,356,5665,0,9,0,37
Pope,10/26/20,37,115,115,2707,28738,2494,31448,176,63644,2571,136,28215,523,2392,102,33,4,146,30,30786,662,2571,28215,139,523,2710,28738,3,32,0,133
Prairie,10/26/20,4,117,117,207,3009,183,3220,20,8244,187,20,2724,285,169,14,4,0,14,6,2911,309,187,2724,24,285,211,3009,2,1,0,20
Pulaski,10/26/20,209,119,119,11830,169467,10660,181405,960,393463,11234,596,164453,5014,10176,484,195,14,862,98,175687,5718,11234,164453,704,5014,11938,169467,53,85,2,892
Randolph,10/26/20,24,121,121,640,6546,550,7197,66,17603,510,130,6176,370,458,92,19,5,33,33,6686,511,510,6176,141,370,651,6546,1,12,0,49
Saline,10/26/20,29,125,125,2790,40327,2534,43145,226,118009,2573,217,38313,2014,2362,172,27,2,183,43,40886,2259,2573,38313,245,2014,2818,40327,11,23,0,255
Scott,10/26/20,1,127,127,213,4132,140,4345,72,10442,204,9,4082,50,136,4,1,0,67,5,4286,59,204,4082,9,50,213,4132,4,2,0,168
Searcy,10/26/20,1,129,129,198,3089,174,3286,23,7923,188,10,2998,91,165,9,1,0,22,1,3186,100,188,2998,9,91,197,3089,0,0,0,14
Sebastian,10/26/20,92,131,131,4820,61289,4384,66119,343,127461,4638,182,60799,490,4239,145,85,7,313,30,65437,682,4638,60799,192,490,4830,61289,36,27,2,719
Sevier,10/26/20,16,133,133,1341,7308,1258,8646,67,17193,1237,104,7077,231,1194,64,16,0,27,40,8314,332,1237,7077,101,231,1338,7308,6,8,0,15
Sharp,10/26/20,10,135,135,358,5694,285,6052,63,17043,307,51,5444,250,249,36,10,0,48,15,5751,301,307,5444,51,250,358,5694,0,1,0,98
St.Francis,10/26/20,10,123,123,1750,14184,1637,15938,103,26294,1732,18,14102,82,1621,16,10,0,101,2,15834,104,1732,14102,22,82,1754,14184,46,4,0,192
Stone,10/26/20,21,137,137,398,4176,367,4577,10,12446,384,14,4064,112,355,12,21,0,8,2,4448,129,384,4064,17,112,401,4176,0,0,0,39
Union,10/26/20,49,139,139,1120,11608,1025,12737,46,39732,1004,116,10749,859,932,93,43,6,29,17,11753,984,1004,10749,125,859,1129,11608,2,11,0,82
VanBuren,10/26/20,3,141,141,209,5615,190,5832,16,16684,201,8,5408,207,185,5,3,0,13,3,5609,223,201,5408,16,207,217,5615,2,0,0,20
Washington,10/26/20,150,143,143,11392,97559,10654,109031,588,228529,10326,1066,92752,4807,9732,922,132,18,462,126,103078,5953,10326,92752,1146,4807,11472,97559,47,53,1,1419
White,10/26/20,32,145,145,1452,22131,1222,23604,198,78804,1223,229,20244,1887,1045,177,27,5,151,47,21467,2137,1223,20244,250,1887,1473,22131,5,14,0,139
Woodruff,10/26/20,0,147,147,116,2260,82,2378,34,6660,103,13,2200,60,71,11,0,0,32,2,2303,75,103,2200,15,60,118,2260,2,1,0,33
Yell,10/26/20,31,149,149,1339,12938,1282,14275,26,21573,1326,13,12775,163,1273,9,28,3,25,1,14101,174,1326,12775,11,163,1337,12938,0,1,0,60
Arkansas_all_counties,10/25/20,1812,5630,5630,106115,1227861,94528,1334772,9766,2990671,98880,7235,1189120,38741,89103,5425,1655,157,8113,1653,1288000,46772,98880,1189120,8031,38741,106911,1227861,797,551,15,8239
Arkansas_county,10/25/20,15,1,1,662,8741,551,9428,96,18124,582,80,7487,1254,497,54,15,0,70,26,8069,1359,582,7487,105,1254,687,8741,7,5,0,73
Ashley,10/25/20,11,3,3,536,6374,477,6914,48,20537,510,26,6183,191,462,15,11,0,37,11,6693,221,510,6183,30,191,540,6374,5,3,0,30
Baxter,10/25/20,9,5,5,649,6271,519,6923,121,41219,545,104,5888,383,435,84,9,0,101,20,6433,490,545,5888,107,383,652,6271,6,12,0,35
Benton,10/25/20,117,7,7,8065,87035,7420,95157,527,258980,7444,621,85369,1666,6946,474,101,16,396,131,92813,2344,7444,85369,678,1666,8122,87035,32,28,1,240
Boone,10/25/20,31,9,9,1025,13969,891,15005,103,37288,927,98,13768,201,801,90,29,2,97,6,14695,310,927,13768,109,201,1036,13969,5,6,1,52
Bradley,10/25/20,8,11,11,369,4157,345,4526,16,10948,363,6,3965,192,341,4,7,1,15,1,4328,198,363,3965,6,192,369,4157,0,1,0,30
Calhoun,10/25/20,0,13,13,48,1952,42,2000,6,5202,46,2,1920,32,41,1,0,0,5,1,1966,34,46,1920,2,32,48,1952,0,0,0,-1
Carroll,10/25/20,13,15,15,987,8806,890,9802,84,27887,951,36,8723,83,857,33,13,0,81,3,9674,128,951,8723,45,83,996,8806,3,5,0,34
Chicot,10/25/20,22,17,17,1049,5838,1000,6891,27,10826,1032,17,5667,171,991,9,21,1,20,7,6699,192,1032,5667,21,171,1053,5838,0,0,0,35
Clark,10/25/20,5,19,19,493,8746,440,9248,48,22385,451,42,8208,538,403,37,5,0,43,5,8659,589,451,8208,51,538,502,8746,2,1,0,41
Clay,10/25/20,13,21,21,480,6142,399,6627,67,15061,445,35,5461,681,375,24,11,2,58,9,5906,721,445,5461,40,681,485,6142,9,1,1,22
Cleburne,10/25/20,15,23,23,454,8731,404,9188,35,25230,406,48,8176,555,363,41,15,0,28,7,8582,606,406,8176,51,555,457,8731,0,4,0,53
Cleveland,10/25/20,13,25,25,231,3613,189,3844,29,8226,215,16,3509,104,183,6,12,1,20,9,3724,120,215,3509,16,104,231,3613,5,0,0,53
Columbia,10/25/20,19,27,27,690,6844,627,7549,44,23892,598,92,6565,279,552,75,19,0,27,17,7163,386,598,6565,107,279,705,6844,3,4,0,37
Conway,10/25/20,3,29,29,342,7933,318,8274,21,20906,322,20,7693,240,300,18,3,0,19,2,8015,259,322,7693,19,240,341,7933,1,1,0,30
Craighead,10/25/20,40,31,31,4432,46085,3833,50555,558,105701,4199,233,44608,1477,3670,163,36,4,492,66,48807,1748,4199,44608,271,1477,4470,46085,60,41,1,420
Crawford,10/25/20,25,33,33,2007,27500,1789,29509,193,62472,1919,88,27188,312,1718,71,23,2,178,15,29107,402,1919,27188,90,312,2009,27500,11,14,1,242
Crittenden,10/25/20,51,35,35,2349,16635,2099,18980,199,49013,2285,64,16464,171,2062,37,44,7,179,20,18749,231,2285,16464,60,171,2345,16635,13,16,0,100
Cross,10/25/20,22,37,37,577,6220,504,6797,51,16998,528,49,6073,147,470,34,20,2,38,13,6601,196,528,6073,49,147,577,6220,8,4,0,45
Dallas,10/25/20,5,39,39,179,2681,168,2860,6,7432,176,3,2633,48,166,2,5,0,5,1,2809,51,176,2633,3,48,179,2681,0,0,0,1
Desha,10/25/20,7,41,41,408,4918,352,5331,49,11887,387,21,4762,156,342,10,7,0,38,11,5149,182,387,4762,26,156,413,4918,10,5,0,32
Drew,10/25/20,7,43,43,429,7275,379,7709,43,18502,406,23,6803,472,364,15,6,1,36,7,7209,500,406,6803,28,472,434,7275,3,5,0,32
Faulkner,10/25/20,31,45,45,3310,49265,3019,52596,260,122416,3098,212,47475,1790,2853,166,26,5,219,41,50573,2023,3098,47475,233,1790,3331,49265,14,11,0,331
Franklin,10/25/20,2,47,47,521,8389,424,8925,95,17780,485,36,8248,141,405,19,2,0,78,17,8733,192,485,8248,51,141,536,8389,5,8,0,43
Fulton,10/25/20,9,49,49,315,2556,252,2881,54,12139,272,43,2243,313,218,34,8,1,46,8,2515,366,272,2243,53,313,325,2556,3,6,0,15
Garland,10/25/20,63,51,51,2441,39296,2131,41744,247,98296,2347,94,38454,842,2081,50,58,5,208,39,40801,943,2347,38454,101,842,2448,39296,13,8,1,120
Grant,10/25/20,4,53,53,359,6742,317,7107,38,18086,330,29,6383,359,294,23,4,0,32,6,6713,394,330,6383,35,359,365,6742,3,1,0,25
Greene,10/25/20,16,55,55,1447,18805,1179,20271,252,44623,1335,112,17891,914,1111,68,16,0,208,44,19226,1045,1335,17891,131,914,1466,18805,24,21,0,99
Hempstead,10/25/20,5,57,57,542,6463,489,7016,48,22018,495,47,6313,150,449,40,5,0,41,7,6808,208,495,6313,58,150,553,6463,2,6,0,26
HotSpring,10/25/20,34,59,59,2190,17168,2036,19364,120,33520,2163,27,16802,366,2020,16,32,2,111,9,18965,399,2163,16802,33,366,2196,17168,2,1,0,90
Howard,10/25/20,14,61,61,577,4332,522,4914,41,13389,523,54,4119,213,477,45,14,0,32,9,4642,272,523,4119,59,213,582,4332,9,4,0,19
Independence,10/25/20,46,63,63,1451,14203,1333,15667,72,37264,1201,250,13896,307,1112,221,42,4,47,25,15097,570,1201,13896,263,307,1464,14203,5,1,1,48
Izard,10/25/20,2,65,65,556,5308,366,5874,188,13559,519,37,4945,363,340,26,2,0,177,11,5464,410,519,4945,47,363,566,5308,3,2,0,13
Jackson,10/25/20,6,67,67,747,9109,552,9887,189,17225,565,182,9058,51,404,148,5,1,156,33,9623,264,565,9058,213,51,778,9109,55,13,0,207
Jefferson,10/25/20,102,69,69,4136,38901,3710,43094,322,70424,4027,109,38377,524,3639,71,97,5,289,33,42404,690,4027,38377,166,524,4193,38901,15,24,0,270
Johnson,10/25/20,8,71,71,1012,9605,924,10623,80,26291,984,28,9411,194,912,12,8,0,64,16,10395,228,984,9411,34,194,1018,9605,8,1,1,73
Lafayette,10/25/20,3,73,73,168,1393,143,1563,22,6915,150,18,1369,24,129,14,3,0,18,4,1519,44,150,1369,20,24,170,1393,1,0,0,10
Lawrence,10/25/20,17,75,75,804,5902,627,6713,160,16669,717,87,5759,143,560,67,17,0,140,20,6476,237,717,5759,94,143,811,5902,9,9,0,38
Lee,10/25/20,18,77,77,1108,4999,1075,6110,15,9398,1103,5,4969,30,1072,3,17,1,14,1,6072,38,1103,4969,8,30,1111,4999,1,0,0,12
Lincoln,10/25/20,17,79,79,2306,8953,2140,11268,149,13695,2283,23,8844,109,2125,15,16,1,142,7,11127,141,2283,8844,32,109,2315,8953,2,2,0,35
LittleRiver,10/25/20,38,81,81,447,2232,387,2673,22,12417,411,36,2169,63,360,27,33,5,18,4,2580,93,411,2169,30,63,441,2232,1,4,0,2
Logan,10/25/20,3,83,83,585,9513,522,10105,60,21757,568,17,9204,309,513,9,3,0,52,8,9772,333,568,9204,24,309,592,9513,1,3,0,58
Lonoke,10/25/20,26,85,85,1702,27269,1448,29047,228,72206,1414,288,24421,2848,1238,210,24,2,152,76,25835,3212,1414,24421,364,2848,1778,27269,16,6,1,152
Madison,10/25/20,6,87,87,426,5236,395,5664,25,16076,396,30,5091,145,369,26,6,0,21,4,5487,177,396,5091,32,145,428,5236,1,1,0,15
Marion,10/25/20,2,89,89,149,3394,126,3543,21,16438,134,15,3195,199,117,9,1,1,16,5,3329,214,134,3195,15,199,149,3394,2,0,0,12
Miller,10/25/20,15,91,91,1388,8107,1106,9498,267,43759,1187,201,7951,156,965,141,13,2,209,58,9138,360,1187,7951,204,156,1391,8107,16,15,0,36
MissingCountyInfo,10/25/20,0,5,5,2192,61829,1548,64010,644,NA,1866,326,61825,4,1392,156,0,0,474,170,63691,319,1866,61825,315,4,2181,61829,121,1,0,1873
Mississippi,10/25/20,68,93,93,2225,14059,1896,16274,261,42831,2127,98,13869,190,1834,62,55,13,238,23,15996,278,2127,13869,88,190,2215,14059,21,16,0,96
Monroe,10/25/20,1,95,95,211,2993,192,3204,18,7249,200,11,2930,63,184,8,1,0,15,3,3130,74,200,2930,11,63,211,2993,1,1,0,16
Montgomery,10/25/20,8,97,97,182,2841,168,3022,6,8993,179,3,2633,208,165,3,8,0,6,0,2812,210,179,2633,2,208,181,2841,0,0,0,5
Nevada,10/25/20,14,99,99,293,4420,249,4711,30,8440,273,20,4346,74,233,16,13,1,27,3,4619,92,273,4346,18,74,291,4420,1,4,0,12
Newton,10/25/20,20,101,101,305,2384,264,2684,21,7848,283,22,2062,322,248,16,17,3,18,3,2345,339,283,2062,17,322,300,2384,6,1,0,11
Ouachita,10/25/20,9,103,103,374,7302,314,7686,50,24106,354,20,7107,195,301,13,9,0,43,7,7461,225,354,7107,30,195,384,7302,4,3,0,14
Perry,10/25/20,0,105,105,136,4357,123,4495,13,10322,127,9,4237,120,117,6,0,0,10,3,4364,131,127,4237,11,120,138,4357,0,1,0,15
Phillips,10/25/20,16,107,107,741,8513,650,9266,75,19034,720,21,8395,118,638,12,16,0,66,9,9115,151,720,8395,33,118,753,8513,15,5,0,56
Pike,10/25/20,1,109,109,263,2819,251,3080,11,10808,253,10,2704,115,244,7,0,1,9,2,2957,123,253,2704,8,115,261,2819,1,1,0,13
Poinsett,10/25/20,18,111,111,1031,11167,849,12210,164,24054,966,65,11016,151,799,50,17,1,150,14,11982,228,966,11016,77,151,1043,11167,14,12,0,74
Polk,10/25/20,5,113,113,354,5628,319,5984,30,20163,347,7,5552,76,312,7,5,0,30,0,5899,85,347,5552,9,76,356,5628,4,3,0,17
Pope,10/25/20,37,115,115,2704,28608,2462,31315,205,63644,2568,136,28109,499,2364,98,33,4,171,34,30677,638,2568,28109,139,499,2707,28608,10,19,0,163
Prairie,10/25/20,4,117,117,205,2991,182,3200,19,8244,185,20,2707,284,168,14,4,0,13,6,2892,308,185,2707,24,284,209,2991,1,0,0,13
Pulaski,10/25/20,207,119,119,11777,168628,10575,180510,994,393463,11183,594,163670,4958,10107,468,193,14,882,112,174853,5657,11183,163670,699,4958,11882,168628,56,74,3,888
Randolph,10/25/20,24,121,121,639,6498,538,7148,77,17603,509,130,6130,368,450,88,19,5,40,37,6639,509,509,6130,141,368,650,6498,2,3,0,19
Saline,10/25/20,29,125,125,2779,40083,2511,42890,238,118009,2564,215,38141,1942,2345,166,27,2,191,47,40705,2185,2564,38141,243,1942,2807,40083,9,15,0,165
Scott,10/25/20,1,127,127,209,3968,138,4177,70,10442,200,9,3918,50,134,4,1,0,65,5,4118,59,200,3918,9,50,209,3968,1,1,0,7
Searcy,10/25/20,1,129,129,198,3075,174,3272,23,7923,188,10,2985,90,165,9,1,0,22,1,3173,99,188,2985,9,90,197,3075,1,0,0,5
Sebastian,10/25/20,90,131,131,4784,60606,4357,65399,336,127461,4603,181,60116,490,4214,143,83,7,305,31,64719,680,4603,60116,190,490,4793,60606,31,31,1,486
Sevier,10/25/20,16,133,133,1335,7299,1250,8631,69,17193,1233,102,7070,229,1192,58,16,0,25,44,8303,328,1233,7070,99,229,1332,7299,8,1,0,22
Sharp,10/25/20,10,135,135,358,5596,284,5953,64,17043,306,52,5347,249,248,36,10,0,48,16,5653,300,306,5347,51,249,357,5596,18,0,0,63
St.Francis,10/25/20,10,123,123,1704,14038,1633,15746,61,26294,1686,18,13960,78,1617,16,10,0,59,2,15646,100,1686,13960,22,78,1708,14038,12,6,0,69
Stone,10/25/20,21,137,137,398,4137,367,4538,10,12446,384,14,4027,110,355,12,21,0,8,2,4411,127,384,4027,17,110,401,4137,2,0,0,13
Union,10/25/20,49,139,139,1118,11528,1014,12655,55,39732,1002,116,10731,797,925,89,43,6,34,21,11733,922,1002,10731,125,797,1127,11528,2,3,0,21
VanBuren,10/25/20,3,141,141,207,5597,190,5812,14,16684,199,8,5391,206,185,5,3,0,11,3,5590,222,199,5391,16,206,215,5597,2,1,0,15
Washington,10/25/20,149,143,143,11345,96187,10601,107611,595,228529,10284,1061,91413,4774,9690,911,131,18,463,132,101697,5914,10284,91413,1140,4774,11424,96187,47,28,2,486
White,10/25/20,32,145,145,1447,21997,1208,23465,207,78804,1220,227,20127,1870,1033,175,27,5,160,47,21347,2118,1220,20127,248,1870,1468,21997,9,11,0,120
Woodruff,10/25/20,0,147,147,114,2229,81,2345,33,6660,101,13,2170,59,70,11,0,0,31,2,2271,74,101,2170,15,59,116,2229,2,1,0,20
Yell,10/25/20,31,149,149,1339,12878,1281,14215,27,21573,1326,13,12732,146,1272,9,28,3,26,1,14058,157,1326,12732,11,146,1337,12878,2,6,0,77
Arkansas_all_counties,10/24/20,1797,5630,5630,105318,1220419,93977,1326523,9535,2990671,98213,7105,1181805,38614,88652,5325,1640,157,7912,1623,1280018,46505,98213,1181805,7891,38614,106104,1220419,1183,762,15,14320
Arkansas_county,10/24/20,15,1,1,655,8675,546,9355,94,18124,575,80,7420,1255,492,54,15,0,68,26,7995,1360,575,7420,105,1255,680,8675,6,1,2,252
Ashley,10/24/20,11,3,3,531,6349,474,6884,46,20537,505,26,6159,190,459,15,11,0,35,11,6664,220,505,6159,30,190,535,6349,8,3,0,72
Baxter,10/24/20,9,5,5,643,6242,507,6888,127,41219,539,104,5859,383,429,78,9,0,101,26,6398,490,539,5859,107,383,646,6242,24,9,0,79
Benton,10/24/20,116,7,7,8033,86827,7392,94916,524,258980,7422,611,85165,1662,6922,470,100,16,399,125,92587,2329,7422,85165,667,1662,8089,86827,107,47,2,999
Boone,10/24/20,30,9,9,1020,13922,885,14953,105,37288,922,98,13724,198,796,89,28,2,98,7,14646,307,922,13724,109,198,1031,13922,23,9,0,146
Bradley,10/24/20,8,11,11,369,4127,344,4496,17,10948,363,6,3935,192,341,3,7,1,15,2,4298,198,363,3935,6,192,369,4127,2,0,0,16
Calhoun,10/24/20,0,13,13,48,1953,42,2001,6,5202,46,2,1921,32,41,1,0,0,5,1,1967,34,46,1921,2,32,48,1953,0,1,0,9
Carroll,10/24/20,13,15,15,984,8775,885,9768,86,27887,948,36,8692,83,852,33,13,0,83,3,9640,128,948,8692,45,83,993,8775,7,9,0,50
Chicot,10/24/20,22,17,17,1049,5803,1000,6856,27,10826,1032,17,5632,171,991,9,21,1,20,7,6664,192,1032,5632,21,171,1053,5803,6,0,0,46
Clark,10/24/20,5,19,19,491,8707,439,9207,47,22385,449,42,8169,538,402,37,5,0,42,5,8618,589,449,8169,51,538,500,8707,7,3,1,148
Clay,10/24/20,12,21,21,471,6129,398,6605,60,15061,437,34,5448,681,374,24,10,2,52,8,5885,720,437,5448,39,681,476,6129,11,11,0,85
Cleburne,10/24/20,15,23,23,454,8678,400,9135,39,25230,406,48,8125,553,360,40,15,0,31,8,8531,604,406,8125,51,553,457,8678,6,3,0,117
Cleveland,10/24/20,13,25,25,226,3565,189,3791,24,8226,210,16,3461,104,184,5,12,1,14,10,3671,120,210,3461,16,104,226,3565,0,0,0,21
Columbia,10/24/20,19,27,27,687,6810,623,7512,45,23892,596,91,6555,255,551,72,19,0,26,19,7151,361,596,6555,106,255,702,6810,10,5,0,38
Conway,10/24/20,3,29,29,341,7904,317,8244,21,20906,322,19,7669,235,299,18,3,0,20,1,7991,253,322,7669,18,235,340,7904,0,0,0,61
Craighead,10/24/20,39,31,31,4372,45725,3792,50134,540,105701,4140,232,44248,1477,3633,159,35,4,471,69,48388,1746,4140,44248,269,1477,4409,45725,51,40,1,516
Crawford,10/24/20,24,33,33,1996,27269,1775,29267,197,62472,1908,88,26964,305,1705,70,22,2,181,16,28872,395,1908,26964,90,305,1998,27269,16,18,-1,190
Crittenden,10/24/20,51,35,35,2336,16548,2083,18880,202,49013,2273,63,16377,171,2048,35,44,7,181,21,18650,230,2273,16377,59,171,2332,16548,34,16,0,187
Cross,10/24/20,22,37,37,569,6183,500,6752,47,16998,520,49,6036,147,468,32,20,2,32,15,6556,196,520,6036,49,147,569,6183,7,7,0,65
Dallas,10/24/20,5,39,39,179,2680,168,2859,6,7432,176,3,2632,48,166,2,5,0,5,1,2808,51,176,2632,3,48,179,2680,0,0,0,13
Desha,10/24/20,7,41,41,398,4896,347,5299,44,11887,380,18,4741,155,337,10,7,0,36,8,5121,178,380,4741,23,155,403,4896,9,3,0,86
Drew,10/24/20,7,43,43,426,7246,374,7677,45,18502,403,23,6774,472,359,15,6,1,38,7,7177,500,403,6774,28,472,431,7246,6,2,0,58
Faulkner,10/24/20,31,45,45,3296,48948,3008,52264,257,122416,3087,209,47157,1791,2843,165,26,5,218,39,50244,2020,3087,47157,229,1791,3316,48948,50,26,1,573
Franklin,10/24/20,2,47,47,516,8351,416,8882,98,17780,481,35,8213,138,398,18,2,0,81,17,8694,188,481,8213,50,138,531,8351,13,5,0,116
Fulton,10/24/20,9,49,49,312,2544,246,2867,57,12139,272,40,2231,313,214,32,8,1,50,7,2503,364,272,2231,51,313,323,2544,8,4,0,33
Garland,10/24/20,62,51,51,2428,39189,2123,41622,243,98296,2335,93,38349,840,2073,50,57,5,205,38,40684,938,2335,38349,98,840,2433,39189,27,15,0,162
Grant,10/24/20,4,53,53,356,6720,316,7082,36,18086,327,29,6362,358,293,23,4,0,30,6,6689,393,327,6362,35,358,362,6720,4,6,0,58
Greene,10/24/20,16,55,55,1423,18730,1158,20171,249,44623,1313,110,17816,914,1091,67,16,0,206,43,19129,1042,1313,17816,128,914,1441,18730,38,22,0,340
Hempstead,10/24/20,5,57,57,540,6439,483,6990,52,22018,493,47,6290,149,443,40,5,0,45,7,6783,207,493,6290,58,149,551,6439,10,3,0,140
HotSpring,10/24/20,34,59,59,2188,17080,2035,19274,119,33520,2162,26,16716,364,2019,16,32,2,111,8,18878,396,2162,16716,32,364,2194,17080,12,6,1,114
Howard,10/24/20,14,61,61,568,4322,518,4895,36,13389,515,53,4109,213,475,43,14,0,26,10,4624,271,515,4109,58,213,573,4322,4,3,0,20
Independence,10/24/20,45,63,63,1446,14160,1332,15619,69,37264,1197,249,13855,305,1113,219,41,4,43,26,15052,567,1197,13855,262,305,1459,14160,6,5,1,62
Izard,10/24/20,2,65,65,553,5298,364,5861,187,13559,517,36,4935,363,338,26,2,0,177,10,5452,409,517,4935,46,363,563,5298,1,2,1,78
Jackson,10/24/20,6,67,67,692,8957,539,9680,147,17225,513,179,8906,51,391,148,5,1,117,30,9419,261,513,8906,210,51,723,8957,25,34,0,127
Jefferson,10/24/20,102,69,69,4121,38646,3686,42824,331,70424,4014,107,38124,522,3616,70,97,5,299,32,42138,686,4014,38124,164,522,4178,38646,31,19,0,344
Johnson,10/24/20,7,71,71,1004,9540,923,10550,74,26291,977,27,9346,194,911,12,7,0,59,15,10323,227,977,9346,33,194,1010,9540,12,1,0,116
Lafayette,10/24/20,3,73,73,167,1384,143,1554,21,6915,150,17,1362,22,129,14,3,0,18,3,1512,42,150,1362,20,22,170,1384,4,2,0,14
Lawrence,10/24/20,17,75,75,795,5873,618,6675,160,16669,709,86,5730,143,552,66,17,0,140,20,6439,236,709,5730,93,143,802,5873,13,17,0,85
Lee,10/24/20,18,77,77,1107,4988,1075,6098,14,9398,1102,5,4958,30,1072,3,17,1,13,1,6060,38,1102,4958,8,30,1110,4988,2,0,0,36
Lincoln,10/24/20,17,79,79,2304,8920,2138,11233,149,13695,2281,23,8811,109,2123,15,16,1,142,7,11092,141,2281,8811,32,109,2313,8920,4,5,0,32
LittleRiver,10/24/20,38,81,81,446,2231,383,2671,25,12417,411,35,2168,63,356,27,33,5,22,3,2579,92,411,2168,29,63,440,2231,10,3,0,62
Logan,10/24/20,3,83,83,584,9456,519,10047,62,21757,567,17,9150,306,511,8,3,0,53,9,9717,330,567,9150,24,306,591,9456,6,5,0,62
Lonoke,10/24/20,25,85,85,1686,27133,1442,28893,219,72206,1400,286,24289,2844,1235,207,23,2,142,77,25689,3204,1400,24289,360,2844,1760,27133,44,17,0,206
Madison,10/24/20,6,87,87,425,5222,394,5649,25,16076,395,30,5077,145,368,26,6,0,21,4,5472,177,395,5077,32,145,427,5222,4,3,0,139
Marion,10/24/20,2,89,89,147,3384,126,3531,19,16438,133,14,3185,199,117,9,1,1,15,4,3318,213,133,3185,14,199,147,3384,4,3,0,39
Miller,10/24/20,15,91,91,1372,8087,1091,9462,266,43759,1175,197,7931,156,958,133,13,2,204,62,9106,356,1175,7931,200,156,1375,8087,40,14,0,159
MissingCountyInfo,10/24/20,0,5,5,2071,60077,1547,62138,524,NA,1797,274,60073,4,1390,157,0,0,407,117,61870,268,1797,60073,264,4,2061,60077,-71,-16,0,1880
Mississippi,10/24/20,68,93,93,2204,13984,1880,16179,256,42831,2107,97,13794,190,1825,55,55,13,227,29,15901,278,2107,13794,88,190,2195,13984,30,18,2,213
Monroe,10/24/20,1,95,95,210,2978,191,3188,18,7249,200,10,2915,63,183,8,1,0,16,2,3115,73,200,2915,10,63,210,2978,4,3,0,53
Montgomery,10/24/20,8,97,97,182,2836,168,3017,6,8993,179,3,2628,208,165,3,8,0,6,0,2807,210,179,2628,2,208,181,2836,0,0,0,7
Nevada,10/24/20,14,99,99,292,4409,245,4699,33,8440,272,20,4337,72,229,16,13,1,30,3,4609,90,272,4337,18,72,290,4409,2,1,0,38
Newton,10/24/20,20,101,101,299,2379,263,2673,16,7848,277,22,2057,322,247,16,17,3,13,3,2334,339,277,2057,17,322,294,2379,6,3,0,72
Ouachita,10/24/20,9,103,103,370,7292,311,7671,49,24106,349,21,7100,192,299,12,9,0,40,9,7449,222,349,7100,30,192,379,7292,11,5,0,67
Perry,10/24/20,0,105,105,136,4342,122,4480,14,10322,127,9,4218,124,116,6,0,0,11,3,4345,135,127,4218,11,124,138,4342,1,1,0,32
Phillips,10/24/20,16,107,107,726,8472,645,9210,65,19034,706,20,8354,118,633,12,16,0,57,8,9060,150,706,8354,32,118,738,8472,8,5,0,60
Pike,10/24/20,1,109,109,262,2807,250,3067,11,10808,252,10,2692,115,244,6,0,1,8,3,2944,123,252,2692,8,115,260,2807,0,0,0,23
Poinsett,10/24/20,18,111,111,1017,11107,837,12134,162,24054,952,65,10956,151,790,47,17,1,145,17,11908,226,952,10956,75,151,1027,11107,21,17,0,142
Polk,10/24/20,5,113,113,350,5615,316,5967,29,20163,343,7,5539,76,309,7,5,0,29,0,5882,85,343,5539,9,76,352,5615,4,5,0,26
Pope,10/24/20,37,115,115,2694,28455,2443,31152,214,63644,2561,133,27958,497,2351,92,33,4,177,37,30519,633,2561,27958,136,497,2697,28455,34,17,0,167
Prairie,10/24/20,4,117,117,204,2979,182,3187,18,8244,185,19,2695,284,168,14,4,0,13,5,2880,307,185,2695,23,284,208,2979,2,1,0,42
Pulaski,10/24/20,204,119,119,11721,167796,10501,179621,1015,393463,11135,586,162851,4945,10040,461,190,14,904,111,173986,5635,11135,162851,690,4945,11825,167796,120,110,3,1948
Randolph,10/24/20,24,121,121,637,6481,535,7128,78,17603,507,130,6113,368,448,87,19,5,40,38,6620,508,507,6113,140,368,647,6481,11,3,0,76
Saline,10/24/20,29,125,125,2770,39927,2496,42724,244,118009,2555,215,37985,1942,2330,166,27,2,197,47,40540,2184,2555,37985,242,1942,2797,39927,29,23,0,371
Scott,10/24/20,1,127,127,208,3962,137,4170,70,10442,199,9,3912,50,133,4,1,0,65,5,4111,59,199,3912,9,50,208,3962,11,7,0,63
Searcy,10/24/20,1,129,129,197,3071,174,3267,22,7923,187,10,2982,89,165,9,1,0,21,1,3169,98,187,2982,9,89,196,3071,1,2,0,17
Sebastian,10/24/20,89,131,131,4753,60151,4326,64913,337,127461,4574,179,59699,452,4189,137,82,7,302,35,64273,640,4574,59699,188,452,4762,60151,49,49,-1,419
Sevier,10/24/20,16,133,133,1327,7285,1249,8609,62,17193,1229,98,7056,229,1192,57,16,0,21,41,8285,324,1229,7056,95,229,1324,7285,16,15,0,67
Sharp,10/24/20,10,135,135,340,5551,284,5890,46,17043,290,50,5302,249,248,36,10,0,32,14,5592,298,290,5302,49,249,339,5551,7,2,0,59
St.Francis,10/24/20,10,123,123,1692,13981,1627,15677,55,26294,1674,18,13903,78,1612,15,10,0,52,3,15577,100,1674,13903,22,78,1696,13981,10,5,0,231
Stone,10/24/20,21,137,137,396,4126,367,4525,8,12446,382,14,4020,106,355,12,21,0,6,2,4402,123,382,4020,17,106,399,4126,2,1,0,21
Union,10/24/20,49,139,139,1116,11509,1011,12634,56,39732,1001,115,10711,798,924,87,43,6,34,22,11712,922,1001,10711,124,798,1125,11509,9,2,0,40
VanBuren,10/24/20,3,141,141,205,5584,189,5797,13,16684,197,8,5377,207,184,5,3,0,10,3,5574,223,197,5377,16,207,213,5584,0,3,0,45
Washington,10/24/20,147,143,143,11298,95748,10573,107126,578,228529,10244,1054,90975,4773,9672,901,129,18,443,135,101219,5907,10244,90975,1134,4773,11378,95748,110,53,1,1356
White,10/24/20,32,145,145,1438,21886,1197,23344,209,78804,1211,227,20017,1869,1026,171,27,5,158,51,21228,2116,1211,20017,247,1869,1458,21886,31,17,0,314
Woodruff,10/24/20,0,147,147,112,2211,80,2325,32,6660,99,13,2152,59,70,10,0,0,29,3,2251,74,99,2152,15,59,114,2211,9,0,0,46
Yell,10/24/20,31,149,149,1337,12803,1275,14138,31,21573,1324,13,12658,145,1267,8,28,3,29,2,13982,156,1324,12658,11,145,1335,12803,4,3,1,54
Arkansas_all_counties,10/23/20,1782,5630,5630,104135,1207282,93215,1312167,9129,2990671,97339,6796,1170162,37120,88037,5178,1626,156,7667,1462,1267501,44666,97339,1170162,7546,37120,104885,1207282,1337,927,10,13984
Arkansas_county,10/23/20,13,1,1,649,8429,545,9103,91,18124,571,78,7360,1069,490,55,13,0,68,23,7931,1172,571,7360,103,1069,674,8429,15,11,1,169
Ashley,10/23/20,11,3,3,523,6285,471,6812,41,20537,499,24,6101,184,456,15,11,0,32,9,6600,212,499,6101,28,184,527,6285,8,4,0,91
Baxter,10/23/20,9,5,5,619,6187,498,6808,112,41219,518,101,5805,382,419,79,9,0,90,22,6323,485,518,5805,103,382,621,6187,20,9,2,308
Benton,10/23/20,114,7,7,7926,85935,7345,93914,466,258980,7353,573,84346,1589,6886,459,98,16,368,98,91699,2215,7353,84346,626,1589,7979,85935,75,67,0,698
Boone,10/23/20,30,9,9,997,13799,876,14806,91,37288,899,98,13612,187,787,89,28,2,84,7,14511,295,899,13612,108,187,1007,13799,18,12,1,142
Bradley,10/23/20,8,11,11,367,4113,344,4480,15,10948,361,6,3921,192,341,3,7,1,13,2,4282,198,361,3921,6,192,367,4113,2,3,0,19
Calhoun,10/23/20,0,13,13,48,1944,41,1992,7,5202,46,2,1912,32,40,1,0,0,6,1,1958,34,46,1912,2,32,48,1944,1,0,0,8
Carroll,10/23/20,13,15,15,977,8732,876,9718,88,27887,941,36,8650,82,847,29,13,0,81,7,9591,127,941,8650,45,82,986,8732,7,27,1,104
Chicot,10/23/20,22,17,17,1043,5763,1000,6810,21,10826,1029,14,5599,164,991,9,21,1,17,4,6628,182,1029,5599,18,164,1047,5763,2,1,0,16
Clark,10/23/20,4,19,19,484,8566,436,9058,44,22385,442,42,8058,508,399,37,4,0,39,5,8500,558,442,8058,50,508,492,8566,4,7,0,57
Clay,10/23/20,12,21,21,460,6055,387,6519,60,15061,428,32,5376,679,365,22,10,2,52,8,5804,715,428,5376,36,679,464,6055,8,5,0,106
Cleburne,10/23/20,15,23,23,448,8567,397,9017,36,25230,400,48,8064,503,360,37,15,0,25,11,8464,553,400,8064,50,503,450,8567,6,4,0,126
Cleveland,10/23/20,13,25,25,226,3544,189,3770,24,8226,210,16,3440,104,184,5,12,1,14,10,3650,120,210,3440,16,104,226,3544,13,4,0,73
Columbia,10/23/20,19,27,27,677,6782,618,7474,40,23892,592,85,6534,248,547,71,19,0,26,14,7126,348,592,6534,100,248,692,6782,10,3,0,111
Conway,10/23/20,3,29,29,341,7843,317,8183,21,20906,322,19,7619,224,299,18,3,0,20,1,7941,242,322,7619,18,224,340,7843,3,5,0,49
Craighead,10/23/20,38,31,31,4321,45260,3752,49619,530,105701,4101,220,43859,1401,3595,157,34,4,471,59,47960,1659,4101,43859,258,1401,4359,45260,72,75,0,531
Crawford,10/23/20,25,33,33,1980,27095,1757,29076,198,62472,1892,88,26796,299,1691,66,22,3,179,19,28688,388,1892,26796,89,299,1981,27095,44,23,0,367
Crittenden,10/23/20,51,35,35,2302,16395,2067,18693,184,49013,2245,57,16240,155,2038,29,44,7,163,21,18485,208,2245,16240,53,155,2298,16395,41,20,0,185
Cross,10/23/20,22,37,37,562,6125,493,6687,47,16998,515,47,5979,146,463,30,20,2,32,15,6494,193,515,5979,47,146,562,6125,5,2,0,50
Dallas,10/23/20,5,39,39,179,2667,168,2846,6,7432,176,3,2620,47,166,2,5,0,5,1,2796,50,176,2620,3,47,179,2667,1,1,0,31
Desha,10/23/20,7,41,41,389,4819,344,5212,38,11887,374,15,4668,151,334,10,7,0,33,5,5042,170,374,4668,19,151,393,4819,3,4,0,22
Drew,10/23/20,7,43,43,420,7194,372,7618,41,18502,396,24,6724,470,357,15,6,1,33,8,7120,498,396,6724,28,470,424,7194,3,1,0,40
Faulkner,10/23/20,30,45,45,3246,48425,2982,51691,234,122416,3048,198,46744,1681,2821,161,26,4,201,33,49792,1899,3048,46744,218,1681,3266,48425,30,29,0,331
Franklin,10/23/20,2,47,47,503,8248,411,8758,90,17780,471,32,8114,134,395,16,2,0,74,16,8585,173,471,8114,39,134,510,8248,18,18,0,198
Fulton,10/23/20,9,49,49,304,2519,242,2832,53,12139,264,40,2206,313,209,33,8,1,47,6,2470,362,264,2206,49,313,313,2519,5,4,0,26
Garland,10/23/20,62,51,51,2401,39054,2108,41459,231,98296,2318,83,38275,779,2061,47,57,5,200,31,40593,866,2318,38275,87,779,2405,39054,61,18,0,463
Grant,10/23/20,4,53,53,352,6666,310,7024,38,18086,323,29,6316,350,290,20,4,0,29,9,6639,385,323,6316,35,350,358,6666,3,2,0,67
Greene,10/23/20,16,55,55,1385,18428,1136,19830,233,44623,1280,105,17661,767,1072,64,16,0,192,41,18941,889,1280,17661,122,767,1402,18428,54,24,0,313
Hempstead,10/23/20,5,57,57,530,6309,480,6850,45,22018,484,46,6172,137,441,39,5,0,38,7,6656,194,484,6172,57,137,541,6309,4,15,0,60
HotSpring,10/23/20,33,59,59,2176,16978,2029,19160,114,33520,2152,24,16635,343,2014,15,31,2,107,7,18787,373,2152,16635,30,343,2182,16978,16,12,1,240
Howard,10/23/20,14,61,61,564,4306,515,4875,35,13389,513,51,4095,211,474,41,14,0,25,10,4608,267,513,4095,56,211,569,4306,8,2,0,33
Independence,10/23/20,44,63,63,1440,14104,1327,15556,69,37264,1194,246,13805,299,1111,216,40,4,43,26,14999,557,1194,13805,258,299,1452,14104,13,16,2,207
Izard,10/23/20,1,65,65,552,5221,362,5783,189,13559,516,36,4858,363,336,26,1,0,179,10,5374,409,516,4858,46,363,562,5221,2,1,0,104
Jackson,10/23/20,6,67,67,667,8855,505,9554,156,17225,498,169,8804,51,363,142,5,1,130,26,9302,252,498,8804,201,51,699,8855,9,3,0,121
Jefferson,10/23/20,102,69,69,4090,38333,3667,42480,319,70424,3994,96,37817,516,3598,69,97,5,297,22,41811,669,3994,37817,153,516,4147,38333,26,22,1,297
Johnson,10/23/20,7,71,71,992,9436,922,10434,63,26291,967,25,9252,184,910,12,7,0,50,13,10219,215,967,9252,31,184,998,9436,16,9,0,136
Lafayette,10/23/20,3,73,73,163,1374,141,1540,19,6915,148,15,1352,22,128,13,3,0,17,2,1500,40,148,1352,18,22,166,1374,4,5,0,21
Lawrence,10/23/20,17,75,75,782,5801,601,6590,164,16669,701,81,5663,138,537,64,17,0,147,17,6364,226,701,5663,88,138,789,5801,16,13,0,66
Lee,10/23/20,18,77,77,1105,4954,1075,6062,12,9398,1100,5,4927,27,1072,3,17,1,11,1,6027,35,1100,4927,8,27,1108,4954,3,2,0,14
Lincoln,10/23/20,17,79,79,2300,8892,2133,11201,150,13695,2278,22,8785,107,2118,15,16,1,144,6,11063,138,2278,8785,31,107,2309,8892,10,6,0,79
LittleRiver,10/23/20,38,81,81,436,2179,380,2609,18,12417,406,30,2117,62,356,24,33,5,17,1,2523,86,406,2117,24,62,430,2179,4,5,0,24
Logan,10/23/20,3,83,83,578,9400,514,9983,61,21757,563,15,9099,301,506,8,3,0,54,7,9662,321,563,9099,20,301,583,9400,11,9,0,307
Lonoke,10/23/20,25,85,85,1642,26971,1425,28686,192,72206,1377,265,24147,2824,1225,200,23,2,129,63,25524,3162,1377,24147,338,2824,1715,26971,20,8,-1,289
Madison,10/23/20,6,87,87,421,5087,391,5510,24,16076,392,29,4945,142,365,26,6,0,21,3,5337,173,392,4945,31,142,423,5087,3,2,0,68
Marion,10/23/20,2,89,89,143,3349,123,3492,18,16438,129,14,3151,198,114,9,1,1,14,4,3280,212,129,3151,14,198,143,3349,2,3,0,85
Miller,10/23/20,15,91,91,1332,7968,1077,9302,240,43759,1143,189,7813,155,950,127,13,2,180,60,8956,346,1143,7813,191,155,1334,7968,61,14,0,156
MissingCountyInfo,10/23/20,0,5,5,2142,58126,1563,60256,579,NA,1843,299,58122,4,1388,175,0,0,455,124,59965,291,1843,58122,287,4,2130,58126,82,8,0,1235
Mississippi,10/23/20,66,93,93,2174,13801,1862,15967,246,42831,2086,88,13625,176,1809,53,55,11,222,24,15711,256,2086,13625,80,176,2166,13801,30,22,0,125
Monroe,10/23/20,1,95,95,206,2929,188,3135,17,7249,196,10,2868,61,180,8,1,0,15,2,3064,71,196,2868,10,61,206,2929,0,9,0,30
Montgomery,10/23/20,8,97,97,182,2829,168,3010,6,8993,179,3,2622,207,165,3,8,0,6,0,2801,209,179,2622,2,207,181,2829,1,2,0,10
Nevada,10/23/20,14,99,99,290,4373,244,4661,32,8440,270,20,4304,69,228,16,13,1,29,3,4574,87,270,4304,18,69,288,4373,4,0,0,75
Newton,10/23/20,20,101,101,293,2313,260,2601,13,7848,272,21,2045,268,244,16,17,3,11,2,2317,284,272,2045,16,268,288,2313,1,1,0,6
Ouachita,10/23/20,9,103,103,359,7236,306,7603,43,24106,342,17,7047,189,296,10,9,0,36,7,7389,214,342,7047,25,189,367,7236,8,2,0,54
Perry,10/23/20,0,105,105,135,4311,121,4447,14,10322,125,10,4191,120,115,6,0,0,10,4,4316,131,125,4191,11,120,136,4311,3,0,0,37
Phillips,10/23/20,16,107,107,718,8420,640,9150,62,19034,699,19,8305,115,627,13,16,0,56,6,9004,146,699,8305,31,115,730,8420,8,6,0,114
Pike,10/23/20,1,109,109,262,2784,250,3044,11,10808,252,10,2672,112,244,6,0,1,8,3,2924,120,252,2672,8,112,260,2784,2,2,0,16
Poinsett,10/23/20,18,111,111,996,10986,820,11991,158,24054,933,63,10847,139,778,42,17,1,138,20,11780,211,933,10847,72,139,1005,10986,13,12,1,110
Polk,10/23/20,5,113,113,346,5593,311,5941,30,20163,339,7,5518,75,305,6,5,0,29,1,5857,84,339,5518,9,75,348,5593,4,3,0,88
Pope,10/23/20,37,115,115,2660,28322,2426,30985,197,63644,2533,127,27830,492,2335,91,33,4,165,32,30363,622,2533,27830,130,492,2663,28322,15,21,0,266
Prairie,10/23/20,4,117,117,202,2939,181,3144,17,8244,182,20,2661,278,167,14,4,0,11,6,2843,301,182,2661,23,278,205,2939,2,2,0,30
Pulaski,10/23/20,201,119,119,11601,165968,10391,177670,1008,393463,11040,561,161203,4765,9946,445,187,14,906,102,172243,5427,11040,161203,662,4765,11702,165968,116,88,1,1593
Randolph,10/23/20,24,121,121,626,6416,532,7052,70,17603,504,122,6066,350,448,84,19,5,37,33,6570,482,504,6066,132,350,636,6416,5,10,0,49
Saline,10/23/20,29,125,125,2741,39585,2473,42353,238,118009,2536,205,37750,1835,2316,157,27,2,192,46,40286,2067,2536,37750,232,1835,2768,39585,48,30,0,457
Scott,10/23/20,1,127,127,197,3910,130,4107,66,10442,188,9,3865,45,127,3,1,0,60,6,4053,54,188,3865,9,45,197,3910,12,2,0,88
Searcy,10/23/20,1,129,129,196,3055,172,3251,23,7923,187,9,2969,86,163,9,1,0,23,0,3156,95,187,2969,9,86,196,3055,13,3,0,99
Sebastian,10/23/20,90,131,131,4704,59781,4277,64494,336,127461,4538,166,59340,441,4156,121,82,8,299,37,63878,616,4538,59340,175,441,4713,59781,38,36,0,545
Sevier,10/23/20,16,133,133,1311,7234,1234,8542,61,17193,1222,89,7013,221,1188,46,16,0,18,43,8235,307,1222,7013,86,221,1308,7234,10,2,0,47
Sharp,10/23/20,10,135,135,333,5499,282,5831,41,17043,286,47,5255,244,247,35,10,0,29,12,5541,290,286,5255,46,244,332,5499,9,8,0,51
St.Francis,10/23/20,10,123,123,1682,13760,1622,15446,50,26294,1664,18,13683,77,1608,14,10,0,46,4,15347,99,1664,13683,22,77,1686,13760,4,26,0,57
Stone,10/23/20,21,137,137,394,4107,366,4504,7,12446,381,13,4007,100,354,12,21,0,6,1,4388,116,381,4007,16,100,397,4107,2,1,0,63
Union,10/23/20,49,139,139,1107,11478,1009,12594,49,39732,996,111,10684,794,923,86,43,6,30,19,11680,914,996,10684,120,794,1116,11478,7,5,0,161
VanBuren,10/23/20,3,141,141,205,5539,186,5752,16,16684,197,8,5336,203,180,6,3,0,14,2,5533,219,197,5336,16,203,213,5539,1,0,0,42
Washington,10/23/20,146,143,143,11188,94502,10520,105767,522,228529,10182,1006,89793,4709,9633,887,128,18,421,101,99975,5792,10182,89793,1083,4709,11265,94502,89,74,0,1060
White,10/23/20,32,145,145,1407,21603,1180,23030,195,78804,1186,221,19778,1825,1012,168,27,5,147,48,20964,2066,1186,19778,241,1825,1427,21603,45,17,0,381
Woodruff,10/23/20,0,147,147,103,2174,80,2279,23,6660,91,12,2116,58,70,10,0,0,21,2,2207,72,91,2116,14,58,105,2174,2,0,0,21
Yell,10/23/20,30,149,149,1333,12753,1272,14084,31,21573,1321,12,12611,142,1264,8,27,3,30,1,13932,152,1321,12611,10,142,1331,12753,3,5,0,66
Arkansas_all_counties,10/22/20,1772,5630,5630,102798,1194635,92288,1298158,8730,2990671,96292,6506,1159242,35393,87311,4977,1616,156,7357,1373,1255534,42624,96292,1159242,7231,35393,103523,1194635,1202,971,21,15473
Arkansas_county,10/22/20,12,1,1,634,8275,534,8933,88,18124,557,77,7280,995,482,52,12,0,63,25,7837,1096,557,7280,101,995,658,8275,15,12,0,171
Ashley,10/22/20,11,3,3,515,6202,467,6721,37,20537,494,21,6025,177,452,15,11,0,31,6,6519,202,494,6025,25,177,519,6202,8,3,0,68
Baxter,10/22/20,7,5,5,599,5899,489,6501,103,41219,504,95,5608,291,414,75,7,0,83,20,6112,389,504,5608,98,291,602,5899,11,13,0,208
Benton,10/22/20,114,7,7,7851,85312,7278,93217,458,258980,7303,548,83753,1559,6840,438,98,16,364,94,91056,2161,7303,83753,602,1559,7905,85312,94,56,2,806
Boone,10/22/20,29,9,9,979,13675,864,14664,86,37288,883,96,13493,182,777,87,27,2,79,7,14376,288,883,13493,106,182,989,13675,7,14,0,257
Bradley,10/22/20,8,11,11,365,4096,341,4460,16,10948,358,7,3912,184,339,2,7,1,12,4,4270,190,358,3912,6,184,364,4096,0,1,0,159
Calhoun,10/22/20,0,13,13,47,1937,41,1984,6,5202,46,1,1907,30,40,1,0,0,6,0,1953,31,46,1907,1,30,47,1937,1,2,0,8
Carroll,10/22/20,12,15,15,970,8635,849,9614,109,27887,935,35,8557,78,820,29,12,0,103,6,9492,122,935,8557,44,78,979,8635,15,10,0,70
Chicot,10/22/20,22,17,17,1041,5749,999,6793,20,10826,1027,14,5586,163,990,9,21,1,16,4,6613,180,1027,5586,17,163,1044,5749,3,3,0,36
Clark,10/22/20,4,19,19,480,8513,429,9002,47,22385,440,40,8011,502,393,36,4,0,43,4,8451,551,440,8011,49,502,489,8513,5,6,0,91
Clay,10/22/20,12,21,21,452,5957,382,6412,57,15061,421,31,5342,615,362,20,10,2,48,9,5763,649,421,5342,34,615,455,5957,7,9,0,76
Cleburne,10/22/20,15,23,23,442,8447,393,8891,34,25230,395,47,7949,498,360,33,15,0,20,14,8344,547,395,7949,49,498,444,8447,3,4,1,75
Cleveland,10/22/20,13,25,25,213,3484,185,3697,15,8226,200,13,3385,99,180,5,12,1,8,7,3585,112,200,3385,13,99,213,3484,2,0,0,27
Columbia,10/22/20,19,27,27,667,6681,615,7362,33,23892,582,85,6453,228,544,71,19,0,19,14,7035,327,582,6453,99,228,681,6681,5,8,0,133
Conway,10/22/20,3,29,29,338,7797,312,8134,23,20906,320,18,7578,219,295,17,3,0,22,1,7898,236,320,7578,17,219,337,7797,4,3,0,62
Craighead,10/22/20,38,31,31,4249,44801,3677,49090,533,105701,4037,212,43514,1287,3528,149,34,4,474,59,47551,1539,4037,43514,252,1287,4289,44801,81,69,0,637
Crawford,10/22/20,25,33,33,1936,26772,1734,28708,177,62472,1852,84,26483,289,1672,62,22,3,158,19,28335,373,1852,26483,84,289,1936,26772,16,15,0,455
Crittenden,10/22/20,51,35,35,2261,16251,2047,18510,163,49013,2211,50,16133,118,2023,24,44,7,144,19,18344,166,2211,16133,48,118,2259,16251,16,14,0,154
Cross,10/22/20,22,37,37,557,6080,491,6637,44,16998,512,45,5937,143,462,29,20,2,30,14,6449,188,512,5937,45,143,557,6080,3,3,0,50
Dallas,10/22/20,5,39,39,178,2637,167,2815,6,7432,176,2,2592,45,165,2,5,0,6,0,2768,47,176,2592,2,45,178,2637,0,0,0,54
Desha,10/22/20,7,41,41,386,4800,340,5188,39,11887,371,15,4652,148,330,10,7,0,34,5,5023,165,371,4652,17,148,388,4800,2,4,0,44
Drew,10/22/20,7,43,43,417,7157,371,7578,39,18502,396,21,6688,469,356,15,6,1,34,5,7084,494,396,6688,25,469,421,7157,5,4,0,171
Faulkner,10/22/20,30,45,45,3216,48124,2953,51361,233,122416,3024,192,46486,1638,2797,156,26,4,201,32,49510,1851,3024,46486,213,1638,3237,48124,25,34,1,605
Franklin,10/22/20,2,47,47,485,8068,393,8558,90,17780,459,26,7952,116,378,15,2,0,79,11,8411,147,459,7952,31,116,490,8068,11,2,0,72
Fulton,10/22/20,9,49,49,299,2498,238,2806,52,12139,261,38,2188,310,207,31,8,1,46,6,2449,357,261,2188,47,310,308,2498,3,8,0,55
Garland,10/22/20,62,51,51,2340,38652,2090,40996,188,98296,2266,74,37898,754,2046,44,57,5,163,25,40164,832,2266,37898,78,754,2344,38652,38,22,0,733
Grant,10/22/20,4,53,53,349,6602,308,6958,37,18086,322,27,6275,327,288,20,4,0,30,7,6597,361,322,6275,34,327,356,6602,6,5,0,124
Greene,10/22/20,16,55,55,1331,18169,1112,19518,203,44623,1251,80,17436,733,1049,63,16,0,186,17,18687,831,1251,17436,98,733,1349,18169,20,20,0,223
Hempstead,10/22/20,5,57,57,526,6253,465,6790,56,22018,481,45,6125,128,428,37,5,0,48,8,6606,184,481,6125,56,128,537,6253,9,8,0,46
HotSpring,10/22/20,32,59,59,2160,16754,2017,18919,111,33520,2135,25,16435,319,2003,14,30,2,102,9,18570,349,2135,16435,30,319,2165,16754,37,28,0,280
Howard,10/22/20,14,61,61,556,4281,513,4842,29,13389,510,46,4074,207,474,39,14,0,22,7,4584,258,510,4074,51,207,561,4281,10,5,0,32
Independence,10/22/20,42,63,63,1427,13910,1311,15348,74,37264,1188,239,13634,276,1103,208,38,4,47,27,14822,526,1188,13634,250,276,1438,13910,19,8,1,122
Izard,10/22/20,1,65,65,550,5119,361,5679,188,13559,516,34,4756,363,335,26,1,0,180,8,5272,407,516,4756,44,363,560,5119,3,35,0,300
Jackson,10/22/20,6,67,67,658,8743,502,9432,150,17225,494,164,8695,48,362,140,5,1,127,23,9189,243,494,8695,195,48,689,8743,6,4,0,31
Jefferson,10/22/20,101,69,69,4064,38062,3645,42176,316,70424,3971,93,37585,477,3578,67,96,5,295,21,41556,620,3971,37585,143,477,4114,38062,25,24,1,197
Johnson,10/22/20,7,71,71,976,9316,913,10298,56,26291,954,22,9144,172,902,11,7,0,45,11,10098,200,954,9144,28,172,982,9316,14,2,0,85
Lafayette,10/22/20,3,73,73,159,1357,136,1519,20,6915,144,15,1337,20,124,12,3,0,17,3,1481,38,144,1337,18,20,162,1357,4,2,0,17
Lawrence,10/22/20,17,75,75,766,5751,588,6524,161,16669,692,74,5617,134,526,62,17,0,149,12,6309,215,692,5617,81,134,773,5751,8,10,0,79
Lee,10/22/20,18,77,77,1102,4943,1073,6046,11,9398,1097,5,4917,26,1070,3,17,1,10,1,6014,32,1097,4917,6,26,1103,4943,0,1,0,63
Lincoln,10/22/20,17,79,79,2290,8823,2127,11122,146,13695,2268,22,8717,106,2111,16,16,1,141,5,10985,137,2268,8717,31,106,2299,8823,66,34,0,151
LittleRiver,10/22/20,38,81,81,432,2159,375,2584,19,12417,402,30,2105,54,353,22,33,5,16,3,2507,77,402,2105,23,54,425,2159,6,4,0,13
Logan,10/22/20,3,83,83,567,9104,505,9676,59,21757,552,15,9015,89,499,6,3,0,50,9,9567,109,552,9015,20,89,572,9104,5,6,1,134
Lonoke,10/22/20,26,85,85,1622,26702,1417,28395,179,72206,1364,258,23904,2798,1219,198,24,2,121,58,25268,3127,1364,23904,329,2798,1693,26702,28,18,0,269
Madison,10/22/20,6,87,87,418,5022,389,5442,23,16076,390,28,4884,138,363,26,6,0,21,2,5274,168,390,4884,30,138,420,5022,1,-1,1,63
Marion,10/22/20,2,89,89,141,3266,120,3407,19,16438,129,12,3074,192,112,8,1,1,16,3,3203,204,129,3074,12,192,141,3266,3,2,0,59
Miller,10/22/20,15,91,91,1271,7873,1063,9147,193,43759,1109,162,7719,154,943,120,13,2,153,40,8828,319,1109,7719,165,154,1274,7873,36,17,0,202
MissingCountyInfo,10/22/20,0,5,5,2060,56973,1555,59022,505,NA,1782,278,56970,3,1373,182,0,0,409,96,58752,270,1782,56970,267,3,2049,56973,61,21,0,1477
Mississippi,10/22/20,66,93,93,2144,13706,1840,15845,238,42831,2061,83,13539,167,1793,47,55,11,213,25,15600,245,2061,13539,78,167,2139,13706,16,17,2,143
Monroe,10/22/20,1,95,95,206,2899,179,3105,26,7249,196,10,2844,55,174,5,1,0,21,5,3040,65,196,2844,10,55,206,2899,5,2,0,44
Montgomery,10/22/20,8,97,97,181,2820,166,3000,7,8993,178,3,2615,205,163,3,8,0,7,0,2793,207,178,2615,2,205,180,2820,0,0,0,18
Nevada,10/22/20,14,99,99,286,4302,244,4586,28,8440,265,21,4235,67,228,16,13,1,24,4,4500,86,265,4235,19,67,284,4302,3,6,0,45
Newton,10/22/20,20,101,101,292,2308,259,2595,13,7848,271,21,2041,267,244,15,17,3,10,3,2312,283,271,2041,16,267,287,2308,2,3,1,22
Ouachita,10/22/20,9,103,103,351,7190,304,7549,38,24106,335,16,7007,183,295,9,9,0,31,7,7342,207,335,7007,24,183,359,7190,5,7,1,47
Perry,10/22/20,0,105,105,132,4277,121,4410,11,10322,125,7,4163,114,115,6,0,0,10,1,4288,122,125,4163,8,114,133,4277,2,5,0,167
Phillips,10/22/20,16,107,107,710,8314,634,9032,60,19034,692,18,8218,96,623,11,16,0,53,7,8910,122,692,8218,26,96,718,8314,11,9,1,94
Pike,10/22/20,1,109,109,260,2770,248,3028,11,10808,251,9,2659,111,243,5,0,1,8,3,2910,118,251,2659,7,111,258,2770,2,0,0,21
Poinsett,10/22/20,17,111,111,983,10889,808,11879,158,24054,919,64,10765,124,766,42,16,1,137,21,11684,195,919,10765,71,124,990,10889,18,20,0,113
Polk,10/22/20,5,113,113,342,5509,308,5853,29,20163,335,7,5436,73,302,6,5,0,28,1,5771,82,335,5436,9,73,344,5509,1,2,1,36
Pope,10/22/20,37,115,115,2645,28071,2405,30718,203,63644,2522,123,27593,478,2323,82,33,4,166,37,30115,603,2522,27593,125,478,2647,28071,29,23,0,393
Prairie,10/22/20,4,117,117,200,2911,179,3114,17,8244,180,20,2637,274,165,14,4,0,11,6,2817,297,180,2637,23,274,203,2911,5,0,0,60
Pulaski,10/22/20,200,119,119,11485,164491,10303,176074,981,393463,10932,553,159864,4627,9876,427,186,14,869,112,170796,5278,10932,159864,651,4627,11583,164491,130,73,1,1354
Randolph,10/22/20,24,121,121,621,6372,522,7003,75,17603,503,118,6040,332,444,78,19,5,40,35,6543,460,503,6040,128,332,631,6372,14,11,0,63
Saline,10/22/20,29,125,125,2693,39176,2443,41896,220,118009,2498,195,37469,1707,2296,147,27,2,174,46,39967,1929,2498,37469,222,1707,2720,39176,24,48,1,297
Scott,10/22/20,1,127,127,185,3834,128,4019,56,10442,179,6,3797,37,125,3,1,0,53,3,3976,43,179,3797,6,37,185,3834,27,2,0,64
Searcy,10/22/20,1,129,129,183,2969,169,3152,13,7923,174,9,2894,75,161,8,1,0,12,1,3068,84,174,2894,9,75,183,2969,4,3,0,26
Sebastian,10/22/20,90,131,131,4666,59274,4241,63950,334,127461,4504,162,58854,420,4129,112,82,8,292,42,63358,592,4504,58854,172,420,4676,59274,34,28,0,985
Sevier,10/22/20,16,133,133,1301,7197,1232,8495,53,17193,1221,80,6985,212,1187,45,16,0,18,35,8206,289,1221,6985,77,212,1298,7197,10,6,0,32
Sharp,10/22/20,10,135,135,324,5457,274,5780,40,17043,280,44,5222,235,243,31,10,0,27,13,5502,278,280,5222,43,235,323,5457,7,2,0,116
St.Francis,10/22/20,10,123,123,1678,13707,1596,15389,72,26294,1660,18,13634,73,1586,10,10,0,64,8,15294,95,1660,13634,22,73,1682,13707,10,6,0,154
Stone,10/22/20,21,137,137,392,4046,365,4441,6,12446,379,13,3957,89,354,11,21,0,4,2,4336,105,379,3957,16,89,395,4046,2,1,0,22
Union,10/22/20,49,139,139,1100,11324,1004,12433,47,39732,990,110,10632,692,922,82,43,6,25,22,11622,811,990,10632,119,692,1109,11324,11,3,2,197
VanBuren,10/22/20,3,141,141,204,5498,186,5710,15,16684,195,9,5299,199,180,6,3,0,12,3,5494,216,195,5299,17,199,212,5498,3,1,0,98
Washington,10/22/20,146,143,143,11099,93531,10446,104706,507,228529,10113,986,88947,4584,9579,867,128,18,406,101,99060,5646,10113,88947,1062,4584,11175,93531,57,92,3,775
White,10/22/20,32,145,145,1362,21267,1163,22645,167,78804,1148,214,19461,1806,998,165,27,5,123,44,20609,2036,1148,19461,230,1806,1378,21267,15,24,0,467
Woodruff,10/22/20,0,147,147,101,2155,80,2257,21,6660,87,14,2098,57,69,11,0,0,18,3,2185,72,87,2098,15,57,102,2155,5,5,0,86
Yell,10/22/20,30,149,149,1330,12690,1267,14018,33,21573,1318,12,12557,133,1261,6,27,3,30,3,13875,143,1318,12557,10,133,1328,12690,3,0,0,290
Arkansas_all_counties,10/21/20,1751,5630,5630,101596,1180364,91317,1282654,8520,2990671,95399,6197,1147353,33011,86520,4797,1599,152,7272,1248,1242752,39902,95399,1147353,6891,33011,102290,1180364,1155,1034,23,13419
Arkansas_county,10/21/20,12,1,1,619,8119,522,8762,85,18124,552,67,7153,966,473,49,12,0,67,18,7705,1057,552,7153,91,966,643,8119,13,17,1,57
Ashley,10/21/20,11,3,3,507,6142,464,6652,32,20537,487,20,5989,153,451,13,11,0,25,7,6476,176,487,5989,23,153,510,6142,4,9,-1,40
Baxter,10/21/20,7,5,5,588,5702,476,6293,105,41219,494,94,5459,243,406,70,7,0,81,24,5953,340,494,5459,97,243,591,5702,22,13,0,113
Benton,10/21/20,112,7,7,7757,84600,7222,92410,422,258980,7223,534,83079,1521,6796,426,96,16,330,92,90302,2108,7223,83079,587,1521,7810,84600,59,54,0,496
Boone,10/21/20,29,9,9,972,13425,850,14407,93,37288,878,94,13245,180,764,86,27,2,87,6,14123,284,878,13245,104,180,982,13425,13,9,0,86
Bradley,10/21/20,8,11,11,365,3937,340,4301,17,10948,358,7,3897,40,338,2,7,1,13,4,4255,46,358,3897,6,40,364,3937,5,0,0,24
Calhoun,10/21/20,0,13,13,46,1930,39,1976,7,5202,45,1,1902,28,38,1,0,0,7,0,1947,29,45,1902,1,28,46,1930,2,1,0,15
Carroll,10/21/20,12,15,15,955,8580,839,9544,104,27887,921,34,8504,76,811,28,12,0,98,6,9425,119,921,8504,43,76,964,8580,11,15,0,62
Chicot,10/21/20,22,17,17,1038,5716,996,6757,20,10826,1025,13,5577,139,987,9,21,1,17,3,6602,155,1025,5577,16,139,1041,5716,6,1,0,47
Clark,10/21/20,4,19,19,475,8427,423,8911,48,22385,437,38,7945,482,388,35,4,0,45,3,8382,529,437,7945,47,482,484,8427,4,3,0,147
Clay,10/21/20,12,21,21,445,5888,373,6336,59,15061,417,28,5321,567,354,19,10,2,52,7,5738,598,417,5321,31,567,448,5888,2,8,1,94
Cleburne,10/21/20,14,23,23,439,8375,389,8816,36,25230,392,47,7890,485,357,32,14,0,21,15,8282,534,392,7890,49,485,441,8375,3,4,0,143
Cleveland,10/21/20,13,25,25,211,3459,185,3670,13,8226,198,13,3365,94,180,5,12,1,6,7,3563,107,198,3365,13,94,211,3459,3,0,1,122
Columbia,10/21/20,19,27,27,662,6553,607,7229,36,23892,582,80,6355,198,539,68,19,0,24,12,6937,292,582,6355,94,198,676,6553,2,10,0,33
Conway,10/21/20,3,29,29,334,7739,309,8072,22,20906,316,18,7517,222,293,16,3,0,20,2,7833,239,316,7517,17,222,333,7739,4,2,0,48
Craighead,10/21/20,38,31,31,4168,44245,3608,48451,521,105701,3972,196,43179,1066,3466,142,34,4,471,50,47151,1300,3972,43179,234,1066,4206,44245,54,57,2,587
Crawford,10/21/20,25,33,33,1920,26333,1719,28253,176,62472,1837,83,26054,279,1658,61,22,3,157,19,27891,362,1837,26054,83,279,1920,26333,16,19,1,143
Crittenden,10/21/20,51,35,35,2245,16113,2033,18357,161,49013,2197,48,16015,98,2012,21,44,7,141,20,18212,145,2197,16015,47,98,2244,16113,28,20,0,283
Cross,10/21/20,22,37,37,554,6033,488,6586,44,16998,508,46,5901,132,459,29,20,2,29,15,6409,177,508,5901,45,132,553,6033,3,2,0,180
Dallas,10/21/20,5,39,39,178,2583,167,2761,6,7432,176,2,2542,41,165,2,5,0,6,0,2718,43,176,2542,2,41,178,2583,1,0,0,22
Desha,10/21/20,7,41,41,384,4758,336,5144,41,11887,369,15,4621,137,326,10,7,0,36,5,4990,154,369,4621,17,137,386,4758,5,1,0,23
Drew,10/21/20,7,43,43,412,6991,367,7407,38,18502,392,20,6645,346,353,14,6,1,33,5,7037,370,392,6645,24,346,416,6991,6,1,0,52
Faulkner,10/21/20,29,45,45,3191,47544,2919,50756,243,122416,3001,190,46062,1482,2765,154,25,4,211,32,49063,1693,3001,46062,211,1482,3212,47544,33,31,0,266
Franklin,10/21/20,2,47,47,474,8007,391,8486,81,17780,447,27,7894,113,375,16,2,0,70,11,8341,145,447,7894,32,113,479,8007,6,17,0,45
Fulton,10/21/20,9,49,49,296,2446,230,2751,57,12139,259,37,2150,296,202,28,8,1,49,8,2409,342,259,2150,46,296,305,2446,16,10,0,68
Garland,10/21/20,62,51,51,2302,37957,2068,40264,172,98296,2233,69,37246,711,2024,44,57,5,152,20,39479,785,2233,37246,74,711,2307,37957,27,16,0,196
Grant,10/21/20,4,53,53,343,6484,303,6834,36,18086,318,25,6164,320,284,19,4,0,30,6,6482,352,318,6164,32,320,350,6484,6,1,0,61
Greene,10/21/20,16,55,55,1311,17966,1092,19289,203,44623,1233,78,17372,594,1029,63,16,0,188,15,18605,684,1233,17372,90,594,1323,17966,35,31,0,424
Hempstead,10/21/20,5,57,57,517,6216,457,6744,55,22018,475,42,6096,120,421,36,5,0,49,6,6571,173,475,6096,53,120,528,6216,4,6,0,122
HotSpring,10/21/20,32,59,59,2123,16511,1989,18639,102,33520,2100,23,16219,292,1976,13,30,2,94,8,18319,320,2100,16219,28,292,2128,16511,11,20,0,245
Howard,10/21/20,14,61,61,546,4259,508,4809,24,13389,503,43,4057,202,471,37,14,0,18,6,4560,249,503,4057,47,202,550,4259,2,3,1,59
Independence,10/21/20,41,63,63,1408,13807,1303,15226,64,37264,1179,229,13557,250,1097,206,38,3,44,20,14736,490,1179,13557,240,250,1419,13807,13,35,2,93
Izard,10/21/20,1,65,65,547,4822,326,5379,220,13559,517,30,4647,175,301,25,1,0,215,5,5164,215,517,4647,40,175,557,4822,65,27,0,444
Jackson,10/21/20,6,67,67,652,8718,498,9400,148,17225,490,162,8676,42,361,137,5,1,124,24,9166,234,490,8676,192,42,682,8718,10,12,1,36
Jefferson,10/21/20,100,69,69,4039,37890,3621,41976,316,70424,3949,90,37442,448,3557,64,95,5,295,21,41391,585,3949,37442,137,448,4086,37890,52,29,0,1102
Johnson,10/21/20,7,71,71,962,9245,911,10213,44,26291,945,17,9079,166,900,11,7,0,38,6,10024,189,945,9079,23,166,968,9245,14,10,0,48
Lafayette,10/21/20,3,73,73,155,1344,134,1502,18,6915,140,15,1326,18,122,12,3,0,15,3,1466,36,140,1326,18,18,158,1344,1,3,0,22
Lawrence,10/21/20,17,75,75,758,5680,578,6445,163,16669,685,73,5553,127,518,60,17,0,150,13,6238,207,685,5553,80,127,765,5680,11,6,2,58
Lee,10/21/20,18,77,77,1102,4880,1072,5983,12,9398,1097,5,4855,25,1069,3,17,1,11,1,5952,31,1097,4855,6,25,1103,4880,0,1,0,15
Lincoln,10/21/20,17,79,79,2224,8738,2093,10971,114,13695,2203,21,8640,98,2077,16,16,1,110,4,10843,128,2203,8640,30,98,2233,8738,2,1,0,101
LittleRiver,10/21/20,38,81,81,426,2152,371,2571,17,12417,396,30,2098,54,349,22,33,5,14,3,2494,77,396,2098,23,54,419,2152,6,7,1,22
Logan,10/21/20,2,83,83,562,8975,499,9541,61,21757,546,16,8890,85,492,7,2,0,52,9,9436,105,546,8890,20,85,566,8975,6,17,0,49
Lonoke,10/21/20,26,85,85,1594,26461,1399,28126,169,72206,1349,245,23742,2719,1208,191,24,2,117,52,25091,3035,1349,23742,316,2719,1665,26461,48,11,3,631
Madison,10/21/20,5,87,87,417,4960,390,5378,22,16076,388,29,4826,134,364,26,5,0,19,3,5214,164,388,4826,30,134,418,4960,1,0,0,29
Marion,10/21/20,2,89,89,138,3210,118,3348,18,16438,127,11,3034,176,110,8,1,1,16,2,3161,187,127,3034,11,176,138,3210,1,0,0,32
Miller,10/21/20,15,91,91,1235,7707,1046,8945,174,43759,1086,149,7555,152,931,115,13,2,142,32,8641,304,1086,7555,152,152,1238,7707,29,24,0,212
MissingCountyInfo,10/21/20,0,5,5,1999,55557,1534,57546,465,NA,1781,218,55554,3,1372,162,0,0,409,56,57335,211,1781,55554,208,3,1989,55557,38,30,0,1022
Mississippi,10/21/20,64,93,93,2128,13579,1823,15701,241,42831,2048,80,13428,151,1777,46,53,11,218,23,15476,225,2048,13428,74,151,2122,13579,34,17,0,145
Monroe,10/21/20,1,95,95,201,2860,177,3061,23,7249,191,10,2806,54,172,5,1,0,18,5,2997,64,191,2806,10,54,201,2860,0,7,1,15
Montgomery,10/21/20,8,97,97,181,2802,166,2982,7,8993,178,3,2599,203,163,3,8,0,7,0,2777,205,178,2599,2,203,180,2802,0,1,0,96
Nevada,10/21/20,14,99,99,283,4260,238,4541,31,8440,263,20,4198,62,223,15,13,1,27,4,4461,80,263,4198,18,62,281,4260,9,5,0,36
Newton,10/21/20,19,101,101,290,2288,256,2573,15,7848,270,20,2022,266,241,15,16,3,13,2,2292,281,270,2022,15,266,285,2288,1,1,0,61
Ouachita,10/21/20,8,103,103,346,7148,297,7501,41,24106,331,15,6977,171,288,9,8,0,35,6,7308,193,331,6977,22,171,353,7148,4,3,0,46
Perry,10/21/20,0,105,105,130,4112,116,4243,14,10322,123,7,4006,106,111,5,0,0,12,2,4129,114,123,4006,8,106,131,4112,3,4,0,20
Phillips,10/21/20,15,107,107,699,8231,625,8936,59,19034,684,15,8139,92,615,10,15,0,54,5,8823,113,684,8139,21,92,705,8231,9,7,0,119
Pike,10/21/20,1,109,109,258,2751,248,3007,9,10808,249,9,2646,105,243,5,0,1,6,3,2895,112,249,2646,7,105,256,2751,4,4,0,35
Poinsett,10/21/20,17,111,111,965,10794,788,11767,160,24054,906,59,10683,111,749,39,16,1,141,19,11589,178,906,10683,67,111,973,10794,28,16,0,324
Polk,10/21/20,4,113,113,341,5474,306,5817,31,20163,334,7,5403,71,300,6,4,0,30,1,5737,80,334,5403,9,71,343,5474,1,6,0,38
Pope,10/21/20,37,115,115,2616,27707,2382,30321,197,63644,2496,120,27249,458,2304,78,33,4,159,38,29745,576,2496,27249,118,458,2614,27707,32,32,1,227
Prairie,10/21/20,4,117,117,195,2856,179,3054,12,8244,180,15,2619,237,165,14,4,0,11,1,2799,255,180,2619,18,237,198,2856,1,4,0,51
Pulaski,10/21/20,199,119,119,11355,163267,10230,174718,925,393463,10830,525,158791,4476,9812,418,185,14,832,93,169621,5097,10830,158791,621,4476,11451,163267,95,109,4,1447
Randolph,10/21/20,24,121,121,607,6323,511,6940,72,17603,499,108,6013,310,438,73,19,5,42,30,6512,428,499,6013,118,310,617,6323,13,16,0,75
Saline,10/21/20,28,125,125,2669,38903,2395,41596,245,118009,2481,188,37275,1628,2259,136,26,2,195,50,39756,1840,2481,37275,212,1628,2693,38903,40,33,0,423
Scott,10/21/20,1,127,127,158,3797,126,3955,31,10442,154,4,3767,30,123,3,1,0,30,1,3921,34,154,3767,4,30,158,3797,8,0,0,145
Searcy,10/21/20,1,129,129,179,2947,166,3126,12,7923,170,9,2873,74,158,8,1,0,11,1,3043,83,170,2873,9,74,179,2947,1,2,0,4
Sebastian,10/21/20,90,131,131,4632,58323,4213,62965,328,127461,4472,160,57913,410,4107,106,82,8,282,46,62385,580,4472,57913,170,410,4642,58323,34,35,0,400
Sevier,10/21/20,16,133,133,1291,7175,1226,8463,49,17193,1221,70,6974,201,1186,40,16,0,19,30,8195,268,1221,6974,67,201,1288,7175,11,7,0,67
Sharp,10/21/20,10,135,135,317,5348,272,5664,35,17043,275,42,5188,160,244,28,10,0,21,14,5463,201,275,5188,41,160,316,5348,7,0,0,129
St.Francis,10/21/20,10,123,123,1668,13563,1590,15234,68,26294,1649,19,13489,74,1580,10,10,0,59,9,15138,96,1649,13489,22,74,1671,13563,5,9,0,92
Stone,10/21/20,21,137,137,390,4026,364,4419,5,12446,378,12,3946,80,354,10,21,0,3,2,4324,95,378,3946,15,80,393,4026,1,3,0,38
Union,10/21/20,47,139,139,1089,11138,1001,12233,41,39732,982,107,10460,678,921,80,42,5,19,22,11442,791,982,10460,113,678,1095,11138,8,3,0,199
VanBuren,10/21/20,3,141,141,201,5403,185,5612,13,16684,194,7,5217,186,180,5,3,0,11,2,5411,201,194,5217,15,186,209,5403,1,0,0,28
Washington,10/21/20,143,143,143,11042,92813,10354,103932,545,228529,10080,962,88317,4496,9512,842,127,16,441,104,98397,5535,10080,88317,1039,4496,11119,92813,57,85,2,535
White,10/21/20,32,145,145,1347,20815,1139,22177,176,78804,1141,206,19167,1648,980,159,27,5,134,42,20308,1869,1141,19167,221,1648,1362,20815,39,26,0,274
Woodruff,10/21/20,0,147,147,96,2074,75,2171,21,6660,83,13,2023,51,65,10,0,0,18,3,2106,65,83,2023,14,51,97,2074,4,1,0,22
Yell,10/21/20,30,149,149,1327,12403,1267,13728,30,21573,1314,13,12276,127,1261,6,27,3,26,4,13590,138,1314,12276,11,127,1325,12403,2,4,0,109
Arkansas_all_counties,10/20/20,1728,5630,5630,100441,1168100,90283,1269190,8422,2990671,94418,6023,1137234,30866,85675,4608,1576,152,7159,1263,1231652,37538,94418,1137234,6672,30866,101090,1168100,844,1066,14,9021
Arkansas_county,10/20/20,11,1,1,606,8075,505,8705,90,18124,543,63,7117,958,458,47,11,0,74,16,7660,1045,543,7117,87,958,630,8075,103,50,-1,2072
Ashley,10/20/20,12,3,3,503,6106,455,6612,36,20537,485,18,5955,151,445,10,12,0,28,8,6440,172,485,5955,21,151,506,6106,2,2,0,18
Baxter,10/20/20,7,5,5,566,5611,463,6180,96,41219,477,89,5381,230,395,68,7,0,75,21,5858,322,477,5381,92,230,569,5611,14,10,0,97
Benton,10/20/20,112,7,7,7698,84163,7168,91905,417,258980,7174,524,82713,1450,6758,410,96,16,319,98,89887,2018,7174,82713,568,1450,7742,84163,66,71,2,612
Boone,10/20/20,29,9,9,959,13352,841,14321,89,37288,866,93,13191,161,758,83,27,2,81,8,14057,264,866,13191,103,161,969,13352,8,12,0,83
Bradley,10/20/20,8,11,11,360,3918,340,4277,12,10948,353,7,3879,39,338,2,7,1,8,4,4232,45,353,3879,6,39,359,3918,2,0,0,17
Calhoun,10/20/20,0,13,13,44,1917,38,1961,6,5202,43,1,1892,25,37,1,0,0,6,0,1935,26,43,1892,1,25,44,1917,2,0,0,7
Carroll,10/20/20,12,15,15,944,8529,824,9481,108,27887,912,32,8455,74,801,23,12,0,99,9,9367,114,912,8455,40,74,952,8529,7,31,0,91
Chicot,10/20/20,22,17,17,1032,5675,995,6710,15,10826,1019,13,5559,116,986,9,21,1,12,3,6578,132,1019,5559,16,116,1035,5675,1,0,0,22
Clark,10/20/20,4,19,19,471,8284,420,8764,47,22385,434,37,7860,424,385,35,4,0,45,2,8294,470,434,7860,46,424,480,8284,4,10,0,27
Clay,10/20/20,11,21,21,443,5796,365,6242,66,15061,416,27,5285,511,346,19,9,2,60,6,5701,541,416,5285,30,511,446,5796,13,3,0,121
Cleburne,10/20/20,14,23,23,436,8235,385,8673,37,25230,390,46,7835,400,354,31,14,0,22,15,8225,448,390,7835,48,400,438,8235,3,5,0,38
Cleveland,10/20/20,12,25,25,208,3340,185,3548,11,8226,197,11,3252,88,180,5,11,1,6,5,3449,99,197,3252,11,88,208,3340,2,-1,0,26
Columbia,10/20/20,19,27,27,660,6522,597,7196,44,23892,581,79,6329,193,530,67,19,0,32,12,6910,286,581,6329,93,193,674,6522,2,13,0,55
Conway,10/20/20,3,29,29,330,7695,307,8024,20,20906,312,18,7485,210,291,16,3,0,18,2,7797,227,312,7485,17,210,329,7695,1,0,0,48
Craighead,10/20/20,36,31,31,4114,43712,3551,47861,526,105701,3921,193,42696,1016,3413,138,32,4,475,51,46617,1244,3921,42696,228,1016,4149,43712,42,66,0,440
Crawford,10/20/20,24,33,33,1904,26206,1700,28110,180,62472,1825,79,25936,270,1643,57,21,3,161,19,27761,349,1825,25936,79,270,1904,26206,27,36,-1,321
Crittenden,10/20/20,51,35,35,2217,15858,2013,18071,153,49013,2170,47,15776,82,1995,18,44,7,131,22,17946,125,2170,15776,43,82,2213,15858,27,9,0,84
Cross,10/20/20,22,37,37,551,5856,486,6405,43,16998,506,45,5737,119,457,29,20,2,29,14,6243,162,506,5737,43,119,549,5856,7,2,1,45
Dallas,10/20/20,5,39,39,177,2562,167,2739,5,7432,175,2,2525,37,165,2,5,0,5,0,2700,39,175,2525,2,37,177,2562,0,0,0,10
Desha,10/20/20,7,41,41,379,4740,335,5121,37,11887,366,13,4607,133,325,10,7,0,34,3,4973,148,366,4607,15,133,381,4740,2,4,0,26
Drew,10/20/20,7,43,43,406,6945,366,7355,33,18502,388,18,6610,335,352,14,6,1,30,3,6998,357,388,6610,22,335,410,6945,3,1,0,106
Faulkner,10/20/20,29,45,45,3158,47311,2888,50488,241,122416,2971,187,45885,1426,2738,150,25,4,208,33,48856,1632,2971,45885,206,1426,3177,47311,18,37,0,245
Franklin,10/20/20,2,47,47,468,7968,374,8441,92,17780,442,26,7859,109,359,15,2,0,81,11,8301,140,442,7859,31,109,473,7968,3,9,0,51
Fulton,10/20/20,9,49,49,280,2394,220,2683,51,12139,245,35,2108,286,197,23,8,1,40,11,2353,330,245,2108,44,286,289,2394,5,7,0,24
Garland,10/20/20,62,51,51,2275,37788,2052,40063,161,98296,2203,72,37112,676,2009,43,57,5,137,24,39315,748,2203,37112,72,676,2275,37788,16,20,0,184
Grant,10/20/20,4,53,53,337,6429,302,6773,31,18086,313,24,6131,298,283,19,4,0,26,5,6444,329,313,6131,31,298,344,6429,2,5,0,31
Greene,10/20/20,16,55,55,1276,17577,1061,18864,199,44623,1203,73,17147,430,1003,58,16,0,184,15,18350,514,1203,17147,84,430,1287,17577,17,14,0,101
Hempstead,10/20/20,5,57,57,513,6098,451,6622,57,22018,472,41,5985,113,416,35,5,0,51,6,6457,165,472,5985,52,113,524,6098,8,6,0,37
HotSpring,10/20/20,32,59,59,2112,16277,1969,18394,111,33520,2090,22,16037,240,1958,11,30,2,102,9,18127,267,2090,16037,27,240,2117,16277,3,22,0,71
Howard,10/20/20,13,61,61,544,4202,505,4750,26,13389,501,43,4035,167,468,37,13,0,20,6,4536,214,501,4035,47,167,548,4202,0,1,0,6
Independence,10/20/20,39,63,63,1395,13727,1268,15133,88,37264,1172,223,13506,221,1069,199,36,3,67,21,14678,455,1172,13506,234,221,1406,13727,14,12,0,52
Izard,10/20/20,1,65,65,482,4443,299,4934,182,13559,454,28,4388,55,274,25,1,0,179,3,4842,92,454,4388,37,55,491,4443,59,4,0,217
Jackson,10/20/20,5,67,67,642,8692,486,9365,151,17225,482,160,8658,34,354,132,4,1,124,27,9140,225,482,8658,191,34,673,8692,23,11,0,54
Jefferson,10/20/20,100,69,69,3987,36840,3592,40873,293,70424,3898,89,36409,431,3531,61,95,5,270,23,40307,566,3898,36409,135,431,4033,36840,20,48,0,236
Johnson,10/20/20,7,71,71,948,9211,901,10165,40,26291,932,16,9051,160,892,9,7,0,33,7,9983,182,932,9051,22,160,954,9211,6,5,0,37
Lafayette,10/20/20,3,73,73,154,1323,131,1479,20,6915,139,15,1306,17,120,11,3,0,16,4,1445,34,139,1306,17,17,156,1323,1,1,0,11
Lawrence,10/20/20,15,75,75,747,5633,572,6387,160,16669,676,71,5516,117,513,59,15,0,148,12,6192,195,676,5516,78,117,754,5633,16,36,1,57
Lee,10/20/20,18,77,77,1102,4865,1071,5968,13,9398,1097,5,4844,21,1068,3,17,1,12,1,5941,27,1097,4844,6,21,1103,4865,0,2,0,12
Lincoln,10/20/20,17,79,79,2222,8639,2092,10870,113,13695,2202,20,8543,96,2077,15,16,1,109,4,10745,125,2202,8543,29,96,2231,8639,3,2,0,33
LittleRiver,10/20/20,37,81,81,420,2136,364,2548,19,12417,390,30,2083,53,343,21,32,5,15,4,2473,75,390,2083,22,53,412,2136,3,1,2,13
Logan,10/20/20,2,83,83,556,8932,482,9492,72,21757,541,15,8849,83,476,6,2,0,63,9,9390,102,541,8849,19,83,560,8932,7,8,0,162
Lonoke,10/20/20,23,85,85,1546,25878,1388,27495,135,72206,1313,233,23282,2596,1201,187,21,2,91,44,24595,2900,1313,23282,304,2596,1617,25878,16,26,0,113
Madison,10/20/20,5,87,87,416,4932,390,5349,21,16076,387,29,4803,129,364,26,5,0,18,3,5190,159,387,4803,30,129,417,4932,5,3,0,36
Marion,10/20/20,2,89,89,137,3179,118,3316,17,16438,126,11,3004,175,110,8,1,1,15,2,3130,186,126,3004,11,175,137,3179,4,2,0,73
Miller,10/20/20,15,91,91,1206,7524,1022,8732,169,43759,1073,133,7372,152,915,107,13,2,145,24,8445,287,1073,7372,135,152,1208,7524,13,31,0,43
MissingCountyInfo,10/20/20,0,5,5,1961,54573,1504,56524,457,NA,1751,210,54572,1,1350,154,0,0,401,56,56323,201,1751,54572,200,1,1951,54573,-29,-17,0,410
Mississippi,10/20/20,64,93,93,2094,13468,1806,15556,224,42831,2017,77,13337,131,1761,45,53,11,203,21,15354,202,2017,13337,71,131,2088,13468,16,15,1,91
Monroe,10/20/20,0,95,95,201,2845,170,3046,31,7249,192,9,2793,52,165,5,0,0,27,4,2985,61,192,2793,9,52,201,2845,2,4,0,21
Montgomery,10/20/20,8,97,97,181,2706,165,2886,8,8993,178,3,2592,114,162,3,8,0,8,0,2770,116,178,2592,2,114,180,2706,1,1,0,6
Nevada,10/20/20,14,99,99,274,4233,233,4504,27,8440,254,20,4174,59,219,14,13,1,22,5,4428,76,254,4174,17,59,271,4233,5,4,0,53
Newton,10/20/20,19,101,101,289,2228,255,2512,15,7848,269,20,2008,220,240,15,16,3,13,2,2277,235,269,2008,15,220,284,2228,2,0,0,13
Ouachita,10/20/20,8,103,103,342,7106,294,7455,40,24106,328,14,6950,156,285,9,8,0,35,5,7278,177,328,6950,21,156,349,7106,6,5,1,81
Perry,10/20/20,0,105,105,127,4095,112,4223,15,10322,120,7,3992,103,107,5,0,0,13,2,4112,111,120,3992,8,103,128,4095,2,2,0,26
Phillips,10/20/20,15,107,107,690,8121,618,8817,57,19034,677,13,8029,92,608,10,15,0,54,3,8706,111,677,8029,19,92,696,8121,4,14,0,23
Pike,10/20/20,1,109,109,254,2720,244,2972,9,10808,245,9,2625,95,239,5,0,1,6,3,2870,102,245,2625,7,95,252,2720,0,1,0,4
Poinsett,10/20/20,17,111,111,937,10498,772,11443,148,24054,884,53,10390,108,735,37,16,1,133,15,11274,169,884,10390,61,108,945,10498,11,14,0,64
Polk,10/20/20,4,113,113,340,5437,300,5779,36,20163,333,7,5375,62,297,3,4,0,32,4,5708,71,333,5375,9,62,342,5437,-2,2,0,16
Pope,10/20/20,36,115,115,2584,27512,2350,30094,198,63644,2477,107,27073,439,2283,67,32,4,162,36,29550,544,2477,27073,105,439,2582,27512,27,40,0,201
Prairie,10/20/20,4,117,117,194,2806,175,3003,15,8244,180,14,2576,230,162,13,4,0,14,1,2756,247,180,2576,17,230,197,2806,1,2,0,16
Pulaski,10/20/20,195,119,119,11260,161915,10121,173269,943,393463,10739,521,157586,4329,9715,406,181,14,842,101,168325,4944,10739,157586,615,4329,11354,161915,85,109,2,1595
Randolph,10/20/20,24,121,121,594,6261,495,6864,75,17603,491,103,5970,291,430,65,19,5,42,33,6461,403,491,5970,112,291,603,6261,1,5,1,39
Saline,10/20/20,28,125,125,2629,38520,2362,41168,238,118009,2446,183,37078,1442,2230,132,26,2,189,49,39524,1644,2446,37078,202,1442,2648,38520,30,30,0,615
Scott,10/20/20,1,127,127,150,3660,126,3810,23,10442,146,4,3631,29,123,3,1,0,22,1,3777,33,146,3631,4,29,150,3660,2,2,0,53
Searcy,10/20/20,1,129,129,178,2944,164,3121,13,7923,169,9,2869,75,157,7,1,0,11,2,3038,83,169,2869,8,75,177,2944,0,4,0,12
Sebastian,10/20/20,90,131,131,4598,57957,4178,62564,329,127461,4440,158,57555,402,4076,102,82,8,281,48,61995,569,4440,57555,167,402,4607,57957,35,53,2,509
Sevier,10/20/20,16,133,133,1280,7119,1219,8396,45,17193,1217,63,6945,174,1184,35,16,0,17,28,8162,234,1217,6945,60,174,1277,7119,6,4,0,25
Sharp,10/20/20,10,135,135,310,5226,272,5534,28,17043,270,40,5082,144,242,30,10,0,18,10,5352,182,270,5082,38,144,308,5226,4,7,1,11
St.Francis,10/20/20,10,123,123,1663,13476,1581,15142,72,26294,1645,18,13412,64,1572,9,10,0,63,9,15057,85,1645,13412,21,64,1666,13476,6,10,0,34
Stone,10/20/20,21,137,137,389,3989,361,4381,7,12446,377,12,3931,58,352,9,21,0,4,3,4308,73,377,3931,15,58,392,3989,0,1,0,10
Union,10/20/20,47,139,139,1081,10947,998,12034,36,39732,980,101,10446,501,919,79,42,5,19,17,11426,608,980,10446,107,501,1087,10947,8,4,0,113
VanBuren,10/20/20,3,141,141,200,5376,185,5584,12,16684,193,7,5194,182,180,5,3,0,10,2,5387,197,193,5194,15,182,208,5376,0,1,0,17
Washington,10/20/20,141,143,143,10985,92335,10269,103395,575,228529,10030,955,87889,4446,9452,817,125,16,453,122,97919,5476,10030,87889,1030,4446,11060,92335,96,112,1,552
White,10/20/20,32,145,145,1308,20580,1113,21901,163,78804,1104,204,18995,1585,959,154,27,5,118,45,20099,1802,1104,18995,217,1585,1321,20580,21,37,0,138
Woodruff,10/20/20,0,147,147,92,2056,74,2149,18,6660,79,13,2006,50,64,10,0,0,15,3,2085,64,79,2006,14,50,93,2056,2,1,0,18
Yell,10/20/20,30,149,149,1325,12296,1263,13619,32,21573,1312,13,12171,125,1257,6,27,3,28,4,13483,136,1312,12171,11,125,1323,12296,5,6,0,40
Arkansas,10/19/20,11,1,1,606,8053,499,8683,96,18124,543,63,7104,949,454,45,11,0,78,18,7647,1036,543,7104,87,949,630,8053,-98991,-88718,-1703,-1250861
Arkansas_all_counties,10/19/20,1714,5630,5630,99597,1159923,89217,1260126,8658,2990671,93790,5807,1130124,29799,84770,4447,1562,152,7450,1208,1223914,36212,93790,1130124,6413,29799,100203,1159923,531,767,10,8540
Ashley,10/19/20,12,3,3,501,6090,453,6594,36,20537,485,16,5944,146,444,9,12,0,29,7,6429,165,485,5944,19,146,504,6090,3,3,0,48
Baxter,10/19/20,7,5,5,552,5528,453,6083,92,41219,473,79,5317,211,388,65,7,0,78,14,5790,293,473,5317,82,211,555,5528,2,5,0,134
Benton,10/19/20,110,7,7,7632,83617,7097,91293,424,258980,7133,499,82195,1422,6712,385,94,16,326,98,89328,1965,7133,82195,543,1422,7676,83617,33,40,0,801
Boone,10/19/20,29,9,9,951,13277,829,14238,93,37288,858,93,13127,150,747,82,27,2,84,9,13985,253,858,13127,103,150,961,13277,0,6,0,137
Bradley,10/19/20,8,11,11,358,3903,340,4260,10,10948,353,5,3869,34,338,2,7,1,8,2,4222,38,353,3869,4,34,357,3903,2,0,0,20
Calhoun,10/19/20,0,13,13,42,1912,38,1954,4,5202,41,1,1888,24,37,1,0,0,4,0,1929,25,41,1888,1,24,42,1912,0,0,0,24
Carroll,10/19/20,12,15,15,937,8445,793,9390,132,27887,908,29,8374,71,772,21,12,0,124,8,9282,108,908,8374,37,71,945,8445,10,5,0,89
Chicot,10/19/20,22,17,17,1031,5654,995,6688,14,10826,1018,13,5545,109,986,9,21,1,11,3,6563,125,1018,5545,16,109,1034,5654,1,3,0,48
Clark,10/19/20,4,19,19,467,8261,410,8737,53,22385,430,37,7838,423,378,32,4,0,48,5,8268,469,430,7838,46,423,476,8261,4,5,0,161
Clay,10/19/20,11,21,21,430,5688,362,6120,56,15061,403,27,5232,456,344,18,9,2,49,7,5635,485,403,5232,29,456,432,5688,1,5,0,84
Cleburne,10/19/20,14,23,23,433,8200,380,8635,39,25230,387,46,7805,395,349,31,14,0,24,15,8192,443,387,7805,48,395,435,8200,2,5,0,64
Cleveland,10/19/20,12,25,25,206,3316,186,3522,8,8226,196,10,3233,83,180,6,11,1,5,3,3429,93,196,3233,10,83,206,3316,2,-1,0,18
Columbia,10/19/20,19,27,27,658,6469,584,7140,55,23892,580,78,6309,160,522,62,19,0,39,16,6889,251,580,6309,91,160,671,6469,4,4,0,44
Conway,10/19/20,3,29,29,329,7648,307,7975,19,20906,311,18,7444,204,291,16,3,0,17,2,7755,220,311,7444,16,204,327,7648,0,5,0,38
Craighead,10/19/20,36,31,31,4072,43314,3485,47419,550,105701,3885,187,42353,961,3360,125,32,4,492,58,46238,1181,3885,42353,220,961,4105,43314,46,60,0,452
Crawford,10/19/20,25,33,33,1877,25912,1664,27789,188,62472,1805,72,25656,256,1611,53,22,3,172,16,27461,328,1805,25656,72,256,1877,25912,10,14,0,388
Crittenden,10/19/20,51,35,35,2190,15801,2004,17984,135,49013,2143,47,15719,82,1987,17,44,7,112,23,17862,122,2143,15719,40,82,2183,15801,6,5,0,121
Cross,10/19/20,21,37,37,544,5818,484,6360,39,16998,504,40,5719,99,455,29,19,2,30,9,6223,137,504,5719,38,99,542,5818,6,4,1,47
Dallas,10/19/20,5,39,39,177,2552,167,2729,5,7432,175,2,2515,37,165,2,5,0,5,0,2690,39,175,2515,2,37,177,2552,0,1,0,17
Desha,10/19/20,7,41,41,377,4716,331,5095,39,11887,364,13,4588,128,321,10,7,0,36,3,4952,143,364,4588,15,128,379,4716,3,2,0,38
Drew,10/19/20,7,43,43,403,6842,365,7249,31,18502,387,16,6582,260,351,14,6,1,30,1,6969,280,387,6582,20,260,407,6842,0,2,0,50
Faulkner,10/19/20,29,45,45,3140,47084,2851,50240,260,122416,2954,186,45686,1398,2708,143,25,4,221,39,48640,1600,2954,45686,202,1398,3156,47084,8,32,0,378
Franklin,10/19/20,2,47,47,465,7920,365,8390,98,17780,440,25,7813,107,350,15,2,0,88,10,8253,137,440,7813,30,107,470,7920,7,8,0,90
Fulton,10/19/20,9,49,49,275,2375,213,2658,53,12139,241,34,2099,276,190,23,8,1,43,10,2340,318,241,2099,42,276,283,2375,1,7,1,54
Garland,10/19/20,62,51,51,2259,37620,2032,39878,165,98296,2195,64,36987,633,1995,37,57,5,143,22,39182,696,2195,36987,63,633,2258,37620,13,12,0,556
Grant,10/19/20,4,53,53,335,6400,297,6742,34,18086,312,23,6113,287,281,16,4,0,27,7,6425,317,312,6113,30,287,342,6400,1,5,0,52
Greene,10/19/20,16,55,55,1259,17493,1047,18760,196,44623,1183,76,17070,423,990,57,16,0,177,19,18253,507,1183,17070,84,423,1267,17493,13,17,0,320
Hempstead,10/19/20,5,57,57,505,6069,445,6585,55,22018,465,40,5958,111,410,35,5,0,50,5,6423,162,465,5958,51,111,516,6069,4,7,0,52
HotSpring,10/19/20,32,59,59,2109,16209,1947,18322,130,33520,2087,22,15987,222,1936,11,30,2,121,9,18074,248,2087,15987,26,222,2113,16209,4,10,0,123
Howard,10/19/20,13,61,61,544,4196,504,4744,27,13389,501,43,4032,164,467,37,13,0,21,6,4533,211,501,4032,47,164,548,4196,5,4,0,12
Independence,10/19/20,39,63,63,1381,13689,1256,15080,86,37264,1163,218,13475,214,1059,197,36,3,68,18,14638,442,1163,13475,228,214,1391,13689,13,10,1,249
Izard,10/19/20,1,65,65,423,4285,295,4717,127,13559,395,28,4231,54,271,24,1,0,123,4,4626,91,395,4231,37,54,432,4285,15,4,0,64
Jackson,10/19/20,5,67,67,619,8661,475,9311,139,17225,462,157,8631,30,348,127,4,1,110,29,9093,218,462,8631,188,30,650,8661,5,8,0,154
Jefferson,10/19/20,100,69,69,3967,36624,3544,40636,321,70424,3889,78,36200,424,3488,56,95,5,304,17,40089,547,3889,36200,123,424,4012,36624,34,12,2,492
Johnson,10/19/20,7,71,71,942,9180,896,10128,39,26291,927,15,9023,157,887,9,7,0,33,6,9950,178,927,9023,21,157,948,9180,1,4,0,44
Lafayette,10/19/20,3,73,73,153,1313,130,1468,20,6915,139,14,1299,14,121,9,3,0,15,5,1438,30,139,1299,16,14,155,1313,2,1,0,12
Lawrence,10/19/20,14,75,75,731,5592,536,6330,181,16669,661,70,5477,115,481,55,14,0,166,15,6138,192,661,5477,77,115,738,5592,9,10,0,87
Lee,10/19/20,18,77,77,1102,4853,1069,5956,15,9398,1097,5,4833,20,1066,3,17,1,14,1,5930,26,1097,4833,6,20,1103,4853,2,1,0,23
Lincoln,10/19/20,17,79,79,2219,8609,2090,10837,112,13695,2202,17,8514,95,2076,14,16,1,110,2,10716,121,2202,8514,26,95,2228,8609,0,4,0,82
LittleRiver,10/19/20,35,81,81,417,2126,363,2535,19,12417,387,30,2073,53,342,21,30,5,15,4,2460,75,387,2073,22,53,409,2126,4,3,0,15
Logan,10/19/20,2,83,83,549,8777,474,9330,73,21757,537,12,8696,81,468,6,2,0,67,6,9233,97,537,8696,16,81,553,8777,7,9,0,104
Lonoke,10/19/20,23,85,85,1530,25781,1362,27380,145,72206,1304,226,23195,2586,1179,183,21,2,104,41,24499,2881,1304,23195,295,2586,1599,25781,13,9,0,258
Madison,10/19/20,5,87,87,411,4901,387,5313,19,16076,382,29,4775,126,362,25,5,0,15,4,5157,156,382,4775,30,126,412,4901,2,1,0,61
Marion,10/19/20,2,89,89,133,3110,116,3243,15,16438,122,11,2980,130,110,6,1,1,11,4,3102,141,122,2980,11,130,133,3110,2,2,0,57
Miller,10/19/20,15,91,91,1193,7494,991,8689,187,43759,1067,126,7349,145,890,101,13,2,164,23,8416,273,1067,7349,128,145,1195,7494,18,17,0,89
MissingCountyInfo,10/19/20,0,5,5,1990,54134,1521,56115,469,NA,1769,221,54133,1,1349,172,0,0,420,49,55902,213,1769,54133,212,1,1981,54134,-8,17,0,-3941
Mississippi,10/19/20,63,93,93,2078,13393,1791,15460,224,42831,1998,80,13273,120,1746,45,52,11,200,24,15271,189,1998,13273,69,120,2067,13393,19,16,1,250
Monroe,10/19/20,0,95,95,199,2826,166,3025,33,7249,190,9,2776,50,161,5,0,0,29,4,2966,59,190,2776,9,50,199,2826,1,3,0,14
Montgomery,10/19/20,8,97,97,180,2701,164,2880,8,8993,177,3,2587,114,161,3,8,0,8,0,2764,116,177,2587,2,114,179,2701,1,0,0,24
Nevada,10/19/20,14,99,99,269,4185,229,4451,26,8440,252,17,4128,57,216,13,13,1,23,3,4380,71,252,4128,14,57,266,4185,3,1,0,75
Newton,10/19/20,19,101,101,287,2217,255,2499,13,7848,268,19,1998,219,240,15,16,3,12,1,2266,233,268,1998,14,219,282,2217,0,3,0,11
Ouachita,10/19/20,7,103,103,336,7031,289,7374,40,24106,324,12,6879,152,280,9,7,0,37,3,7203,171,324,6879,19,152,343,7031,3,5,0,74
Perry,10/19/20,0,105,105,125,4071,110,4197,15,10322,119,6,3972,99,105,5,0,0,14,1,4091,106,119,3972,7,99,126,4071,1,1,0,25
Phillips,10/19/20,15,107,107,686,8102,604,8794,67,19034,673,13,8009,93,595,9,15,0,63,4,8682,112,673,8009,19,93,692,8102,4,17,0,67
Pike,10/19/20,1,109,109,254,2716,243,2968,10,10808,245,9,2621,95,238,5,0,1,7,3,2866,102,245,2621,7,95,252,2716,0,1,0,48
Poinsett,10/19/20,17,111,111,926,10445,758,11378,151,24054,872,54,10342,103,722,36,16,1,134,17,11214,164,872,10342,61,103,933,10445,12,12,1,94
Polk,10/19/20,4,113,113,342,5419,298,5763,40,20163,335,7,5361,58,295,3,4,0,36,4,5696,67,335,5361,9,58,344,5419,0,4,0,90
Pope,10/19/20,36,115,115,2557,27338,2310,29893,211,63644,2462,95,26943,395,2252,58,32,4,178,33,29405,488,2462,26943,93,395,2555,27338,6,13,0,238
Prairie,10/19/20,4,117,117,193,2791,173,2987,16,8244,179,14,2564,227,161,12,4,0,14,2,2743,244,179,2564,17,227,196,2791,1,2,0,36
Pulaski,10/19/20,193,119,119,11175,160405,10012,171668,969,393463,10675,500,156228,4177,9617,395,179,14,878,91,166903,4765,10675,156228,588,4177,11263,160405,65,99,0,1625
Randolph,10/19/20,23,121,121,593,6223,490,6825,80,17603,493,100,5938,285,427,63,18,5,48,32,6431,394,493,5938,109,285,602,6223,5,8,0,71
Saline,10/19/20,28,125,125,2599,37935,2332,40552,238,118009,2428,171,36589,1346,2201,131,26,2,200,38,39017,1535,2428,36589,189,1346,2617,37935,7,16,0,340
Scott,10/19/20,1,127,127,148,3609,124,3757,23,10442,144,4,3581,28,121,3,1,0,22,1,3725,32,144,3581,4,28,148,3609,1,0,0,135
Searcy,10/19/20,1,129,129,178,2932,160,3109,17,7923,169,9,2864,68,153,7,1,0,15,2,3033,76,169,2864,8,68,177,2932,1,3,0,67
Sebastian,10/19/20,88,131,131,4563,57483,4125,62055,349,127461,4418,145,57096,387,4026,99,80,8,311,38,61514,541,4418,57096,154,387,4572,57483,24,31,1,958
Sevier,10/19/20,16,133,133,1274,7100,1215,8371,43,17193,1216,58,6935,165,1184,31,16,0,16,27,8151,220,1216,6935,55,165,1271,7100,3,4,0,19
Sharp,10/19/20,9,135,135,306,5219,265,5523,32,17043,268,38,5077,142,237,28,9,0,22,10,5345,178,268,5077,36,142,304,5219,3,7,0,150
St.Francis,10/19/20,10,123,123,1657,13448,1571,15107,76,26294,1640,17,13389,59,1564,7,10,0,66,10,15029,78,1640,13389,19,59,1659,13448,5,5,0,78
Stone,10/19/20,21,137,137,389,3979,360,4371,8,12446,377,12,3924,55,351,9,21,0,5,3,4301,70,377,3924,15,55,392,3979,0,-1,1,45
Union,10/19/20,47,139,139,1073,10842,994,11919,32,39732,976,97,10404,438,916,78,42,5,18,14,11380,539,976,10404,101,438,1077,10842,1,7,0,50
VanBuren,10/19/20,3,141,141,200,5359,184,5567,13,16684,193,7,5175,184,180,4,3,0,10,3,5368,199,193,5175,15,184,208,5359,0,2,0,106
Washington,10/19/20,140,143,143,10889,91879,10157,102837,592,228529,9963,926,87455,4424,9365,792,124,16,474,118,97418,5419,9963,87455,995,4424,10958,91879,38,69,1,1017
White,10/19/20,32,145,145,1287,20463,1076,21762,179,78804,1088,199,18892,1571,927,149,27,5,134,45,19980,1782,1088,18892,211,1571,1299,20463,12,25,0,355
Woodruff,10/19/20,0,147,147,90,2040,73,2131,17,6660,77,13,1994,46,62,11,0,0,15,2,2071,60,77,1994,14,46,91,2040,2,4,0,43
Yell,10/19/20,30,149,149,1320,12261,1257,13579,33,21573,1308,12,12145,116,1251,6,27,3,30,3,13453,126,1308,12145,10,116,1318,12261,-1,4,0,53
Arkansas_all_counties,10/18/20,1704,5630,5630,99066,1151914,88450,1251578,8904,2990671,93356,5710,1122588,29326,84175,4275,1552,152,7621,1283,1215944,35634,93356,1122588,6308,29326,99664,1151914,644,530,20,8539
Arkansas_county,10/18/20,11,1,1,602,7985,480,8611,111,18124,539,63,7037,948,438,42,11,0,90,21,7576,1035,539,7037,87,948,626,7985,3,5,0,20
Ashley,10/18/20,12,3,3,498,6045,450,6546,36,20537,482,16,5898,147,442,8,12,0,28,8,6380,166,482,5898,19,147,501,6045,0,2,0,15
Baxter,10/18/20,7,5,5,550,5396,448,5949,95,41219,471,79,5244,152,386,62,7,0,78,17,5715,234,471,5244,82,152,553,5396,18,5,0,98
Benton,10/18/20,110,7,7,7599,82849,7057,90491,431,258980,7110,489,81432,1417,6690,367,94,16,325,106,88542,1949,7110,81432,532,1417,7642,82849,41,30,7,240
Boone,10/18/20,29,9,9,951,13140,823,14101,99,37288,858,93,12992,148,743,80,27,2,88,11,13850,251,858,12992,103,148,961,13140,4,3,1,39
Bradley,10/18/20,8,11,11,356,3885,340,4240,8,10948,351,5,3852,33,338,2,7,1,6,2,4203,37,351,3852,4,33,355,3885,1,1,0,7
Calhoun,10/18/20,0,13,13,42,1888,38,1930,4,5202,41,1,1866,22,37,1,0,0,4,0,1907,23,41,1866,1,22,42,1888,0,0,0,2
Carroll,10/18/20,12,15,15,927,8366,788,9301,127,27887,898,29,8295,71,768,20,12,0,118,9,9193,108,898,8295,37,71,935,8366,3,7,0,17
Chicot,10/18/20,22,17,17,1030,5607,992,6640,16,10826,1017,13,5498,109,983,9,21,1,13,3,6515,125,1017,5498,16,109,1033,5607,1,0,0,25
Clark,10/18/20,4,19,19,463,8104,405,8576,54,22385,426,37,7687,417,374,31,4,0,48,6,8113,463,426,7687,46,417,472,8104,0,5,0,36
Clay,10/18/20,11,21,21,429,5605,357,6036,60,15061,402,27,5155,450,339,18,9,2,53,7,5557,479,402,5155,29,450,431,5605,6,1,0,29
Cleburne,10/18/20,14,23,23,431,8138,375,8571,42,25230,388,43,7747,391,346,29,14,0,28,14,8135,436,388,7747,45,391,433,8138,3,4,0,41
Cleveland,10/18/20,12,25,25,204,3300,187,3504,5,8226,194,10,3223,77,181,6,11,1,2,3,3417,87,194,3223,10,77,204,3300,2,2,0,7
Columbia,10/18/20,19,27,27,654,6429,580,7095,55,23892,576,78,6269,160,519,61,19,0,38,17,6845,250,576,6269,90,160,666,6429,8,9,0,25
Conway,10/18/20,3,29,29,329,7610,302,7937,24,20906,311,18,7408,202,286,16,3,0,22,2,7719,218,311,7408,16,202,327,7610,1,2,0,64
Craighead,10/18/20,36,31,31,4026,42908,3425,46967,564,105701,3839,187,41947,961,3304,121,32,4,502,62,45786,1181,3839,41947,220,961,4059,42908,34,46,1,367
Crawford,10/18/20,25,33,33,1867,25534,1650,27401,192,62472,1797,70,25282,252,1601,49,22,3,174,18,27079,322,1797,25282,70,252,1867,25534,12,18,1,250
Crittenden,10/18/20,51,35,35,2184,15686,1999,17863,134,49013,2140,44,15604,82,1982,17,44,7,114,20,17744,119,2140,15604,37,82,2177,15686,8,4,0,39
Cross,10/18/20,20,37,37,538,5777,480,6313,38,16998,501,37,5678,99,454,26,18,2,29,9,6179,134,501,5678,35,99,536,5777,3,2,0,32
Dallas,10/18/20,5,39,39,177,2535,166,2712,6,7432,175,2,2501,34,164,2,5,0,6,0,2676,36,175,2501,2,34,177,2535,0,0,0,10
Desha,10/18/20,7,41,41,374,4681,329,5057,38,11887,361,13,4554,127,320,9,7,0,34,4,4915,142,361,4554,15,127,376,4681,6,2,0,23
Drew,10/18/20,7,43,43,403,6792,363,7199,33,18502,387,16,6533,259,350,13,6,1,31,2,6920,279,387,6533,20,259,407,6792,2,2,0,18
Faulkner,10/18/20,29,45,45,3132,46714,2819,49862,284,122416,2946,186,45350,1364,2677,142,25,4,244,40,48296,1566,2946,45350,202,1364,3148,46714,19,25,0,518
Franklin,10/18/20,2,47,47,458,7837,357,8299,99,17780,432,26,7733,104,342,15,2,0,88,11,8165,134,432,7733,30,104,462,7837,5,4,0,36
Fulton,10/18/20,8,49,49,274,2322,206,2604,60,12139,239,35,2054,268,185,21,7,1,47,13,2293,311,239,2054,43,268,282,2322,7,3,0,22
Garland,10/18/20,62,51,51,2246,37077,2020,39322,164,98296,2186,60,36462,615,1984,36,57,5,145,19,38648,674,2186,36462,59,615,2245,37077,14,8,1,116
Grant,10/18/20,4,53,53,334,6349,292,6690,38,18086,310,24,6065,284,279,13,4,0,27,11,6375,315,310,6065,31,284,341,6349,0,3,0,28
Greene,10/18/20,16,55,55,1246,17186,1030,18440,200,44623,1173,73,16764,422,976,54,16,0,181,19,17937,503,1173,16764,81,422,1254,17186,15,13,1,56
Hempstead,10/18/20,5,57,57,501,6021,438,6533,58,22018,463,38,5912,109,404,34,5,0,54,4,6375,158,463,5912,49,109,512,6021,5,7,0,36
HotSpring,10/18/20,32,59,59,2105,16090,1937,18199,136,33520,2085,20,15873,217,1926,11,30,2,129,7,17958,241,2085,15873,24,217,2109,16090,8,5,2,85
Howard,10/18/20,13,61,61,539,4189,500,4732,26,13389,497,42,4025,164,466,34,13,0,18,8,4522,210,497,4025,46,164,543,4189,2,0,0,12
Independence,10/18/20,38,63,63,1368,13453,1246,14831,84,37264,1151,217,13240,213,1052,194,35,3,64,20,14391,440,1151,13240,227,213,1378,13453,3,8,1,31
Izard,10/18/20,1,65,65,408,4236,291,4653,116,13559,381,27,4184,52,269,22,1,0,111,5,4565,88,381,4184,36,52,417,4236,10,4,0,21
Jackson,10/18/20,5,67,67,614,8512,467,9156,142,17225,460,154,8482,30,346,121,4,1,110,32,8942,214,460,8482,184,30,644,8512,5,6,0,282
Jefferson,10/18/20,98,69,69,3933,36166,3532,40143,301,70424,3855,78,35780,386,3479,53,93,5,281,20,39635,508,3855,35780,122,386,3977,36166,12,11,1,254
Johnson,10/18/20,7,71,71,941,9137,892,10084,42,26291,926,15,8980,157,884,8,7,0,35,7,9906,178,926,8980,21,157,947,9137,4,2,0,21
Lafayette,10/18/20,3,73,73,151,1303,129,1456,19,6915,137,14,1290,13,120,9,3,0,14,5,1427,29,137,1290,16,13,153,1303,2,2,0,2
Lawrence,10/18/20,14,75,75,722,5514,526,6243,182,16669,654,68,5400,114,475,51,14,0,165,17,6054,189,654,5400,75,114,729,5514,4,4,0,37
Lee,10/18/20,18,77,77,1100,4832,1068,5933,14,9398,1095,5,4812,20,1065,3,17,1,13,1,5907,26,1095,4812,6,20,1101,4832,3,1,0,17
Lincoln,10/18/20,17,79,79,2219,8527,2086,10755,116,13695,2202,17,8435,92,2075,11,16,1,111,5,10637,118,2202,8435,26,92,2228,8527,8,4,0,18
LittleRiver,10/18/20,35,81,81,413,2115,360,2520,18,12417,383,30,2062,53,340,20,30,5,13,5,2445,75,383,2062,22,53,405,2115,0,2,0,8
Logan,10/18/20,2,83,83,542,8680,465,9226,75,21757,531,11,8599,81,460,5,2,0,69,6,9130,96,531,8599,15,81,546,8680,3,2,0,46
Lonoke,10/18/20,23,85,85,1517,25536,1353,27120,141,72206,1297,220,23000,2536,1171,182,21,2,105,36,24297,2823,1297,23000,287,2536,1584,25536,4,9,1,119
Madison,10/18/20,5,87,87,409,4842,386,5252,18,16076,380,29,4719,123,362,24,5,0,13,5,5099,153,380,4719,30,123,410,4842,1,3,0,18
Marion,10/18/20,2,89,89,131,3055,114,3186,15,16438,121,10,2937,118,108,6,1,1,12,3,3058,128,121,2937,10,118,131,3055,2,3,0,12
Miller,10/18/20,15,91,91,1175,7423,974,8600,186,43759,1050,125,7278,145,877,97,13,2,160,26,8328,272,1050,7278,127,145,1177,7423,12,8,0,29
MissingCountyInfo,10/18/20,0,5,5,1998,58067,1504,60055,494,NA,1789,209,58066,1,1337,167,0,0,452,42,59855,200,1789,58066,199,1,1988,58067,13,3,0,1668
Mississippi,10/18/20,62,93,93,2059,13162,1775,15211,222,42831,1981,78,13042,120,1733,42,51,11,197,25,15023,188,1981,13042,68,120,2049,13162,37,7,1,122
Monroe,10/18/20,0,95,95,198,2813,163,3011,35,7249,189,9,2763,50,158,5,0,0,31,4,2952,59,189,2763,9,50,198,2813,0,4,0,24
Montgomery,10/18/20,8,97,97,179,2678,164,2856,7,8993,176,3,2564,114,161,3,8,0,7,0,2740,116,176,2564,2,114,178,2678,0,1,0,9
Nevada,10/18/20,14,99,99,266,4113,228,4376,24,8440,250,16,4056,57,215,13,13,1,22,2,4306,70,250,4056,13,57,263,4113,3,4,0,42
Newton,10/18/20,19,101,101,287,2206,252,2488,16,7848,268,19,1987,219,237,15,16,3,15,1,2255,233,268,1987,14,219,282,2206,2,0,0,7
Ouachita,10/18/20,7,103,103,333,6960,284,7300,42,24106,321,12,6812,148,275,9,7,0,39,3,7133,167,321,6812,19,148,340,6960,4,1,0,15
Perry,10/18/20,0,105,105,124,4047,109,4172,15,10322,119,5,3951,96,104,5,0,0,15,0,4070,102,119,3951,6,96,125,4047,0,1,0,16
Phillips,10/18/20,15,107,107,682,8039,587,8727,80,19034,670,12,7946,93,578,9,15,0,77,3,8616,111,670,7946,18,93,688,8039,1,6,0,27
Pike,10/18/20,1,109,109,254,2668,242,2920,11,10808,245,9,2574,94,237,5,0,1,8,3,2819,101,245,2574,7,94,252,2668,0,0,0,14
Poinsett,10/18/20,16,111,111,914,10363,746,11284,152,24054,860,54,10260,103,712,34,15,1,133,19,11120,164,860,10260,61,103,921,10363,14,8,0,76
Polk,10/18/20,4,113,113,342,5329,294,5673,44,20163,335,7,5271,58,292,2,4,0,39,5,5606,67,335,5271,9,58,344,5329,1,1,0,14
Pope,10/18/20,36,115,115,2551,27106,2297,29654,218,63644,2455,96,26711,395,2239,58,32,4,184,34,29166,488,2455,26711,93,395,2548,27106,22,15,0,212
Prairie,10/18/20,4,117,117,192,2756,171,2951,17,8244,178,14,2531,225,161,10,4,0,13,4,2709,242,178,2531,17,225,195,2756,0,1,0,13
Pulaski,10/18/20,193,119,119,11110,158845,9913,170043,1003,393463,10618,492,154694,4151,9531,382,179,14,907,96,165312,4731,10618,154694,580,4151,11198,158845,85,74,0,1471
Randolph,10/18/20,23,121,121,588,6157,482,6753,83,17603,490,98,5875,282,425,57,18,5,47,36,6365,388,490,5875,106,282,596,6157,10,1,0,28
Saline,10/18/20,28,125,125,2592,37602,2316,40212,247,118009,2423,169,36271,1331,2190,126,26,2,206,41,38694,1518,2423,36271,187,1331,2610,37602,20,13,0,234
Scott,10/18/20,1,127,127,147,3475,124,3622,22,10442,143,4,3447,28,121,3,1,0,21,1,3590,32,143,3447,4,28,147,3475,0,3,0,12
Searcy,10/18/20,1,129,129,177,2866,157,3042,19,7923,169,8,2799,67,151,6,1,0,17,2,2968,74,169,2799,7,67,176,2866,2,-1,0,9
Sebastian,10/18/20,87,131,131,4539,56549,4094,61097,357,127461,4394,145,56168,381,4000,94,79,8,314,43,60562,535,4394,56168,154,381,4548,56549,44,25,0,495
Sevier,10/18/20,16,133,133,1271,7084,1211,8350,44,17193,1214,57,6920,164,1183,28,16,0,15,29,8134,216,1214,6920,52,164,1266,7084,7,1,0,32
Sharp,10/18/20,9,135,135,303,5072,258,5373,36,17043,265,38,4930,142,232,26,9,0,24,12,5195,178,265,4930,36,142,301,5072,5,2,0,31
St.Francis,10/18/20,10,123,123,1652,13375,1566,15029,76,26294,1636,16,13317,58,1561,5,10,0,65,11,14953,76,1636,13317,18,58,1654,13375,3,3,0,45
Stone,10/18/20,20,137,137,389,3934,361,4326,8,12446,377,12,3879,55,352,9,20,0,5,3,4256,70,377,3879,15,55,392,3934,0,3,0,13
Union,10/18/20,47,139,139,1072,10793,987,11870,38,39732,976,96,10355,438,910,77,42,5,24,14,11331,539,976,10355,101,438,1077,10793,3,5,0,39
VanBuren,10/18/20,3,141,141,200,5253,182,5461,15,16684,193,7,5073,180,179,3,3,0,11,4,5266,195,193,5073,15,180,208,5253,1,0,0,24
Washington,10/18/20,139,143,143,10851,90900,10088,101819,624,228529,9939,912,86530,4370,9317,771,123,16,499,125,96469,5350,9939,86530,980,4370,10919,90900,46,41,2,418
White,10/18/20,32,145,145,1275,20120,1051,21409,192,78804,1079,196,18610,1510,911,140,27,5,141,51,19689,1720,1079,18610,210,1510,1289,20120,9,17,0,67
Woodruff,10/18/20,0,147,147,88,1999,69,2089,19,6660,77,11,1955,44,59,10,0,0,18,1,2032,57,77,1955,13,44,90,1999,3,0,0,36
Yell,10/18/20,30,149,149,1321,12207,1253,13526,38,21573,1309,12,12093,114,1247,6,27,3,35,3,13402,124,1309,12093,10,114,1319,12207,5,4,0,98
Arkansas_all_counties,10/17/20,1684,5630,5630,98422,1144019,87920,1243038,8810,2990671,92827,5595,1114815,29204,83731,4189,1533,151,7555,1255,1207642,35396,92827,1114815,6192,29204,99019,1144019,883,664,19,10786
Arkansas_county,10/17/20,11,1,1,599,7968,475,8591,113,18124,536,63,7021,947,434,41,11,0,91,22,7557,1034,536,7021,87,947,623,7968,5,6,0,49
Ashley,10/17/20,12,3,3,498,6030,448,6531,38,20537,482,16,5884,146,441,7,12,0,29,9,6366,165,482,5884,19,146,501,6030,3,3,0,82
Baxter,10/17/20,7,5,5,532,5316,443,5851,82,41219,454,78,5165,151,382,61,7,0,65,17,5619,232,454,5165,81,151,535,5316,14,9,0,70
Benton,10/17/20,103,7,7,7558,82650,7027,90251,427,258980,7082,476,81233,1417,6670,357,87,16,324,103,88315,1936,7082,81233,519,1417,7601,82650,46,42,1,391
Boone,10/17/20,28,9,9,947,13105,820,14062,99,37288,855,92,12957,148,742,78,26,2,87,12,13812,250,855,12957,102,148,957,13105,7,11,1,87
Bradley,10/17/20,8,11,11,355,3879,339,4233,8,10948,351,4,3846,33,337,2,7,1,7,1,4197,36,351,3846,3,33,354,3879,1,1,0,24
Calhoun,10/17/20,0,13,13,42,1886,38,1928,4,5202,41,1,1864,22,37,1,0,0,4,0,1905,23,41,1864,1,22,42,1886,1,1,0,5
Carroll,10/17/20,12,15,15,924,8352,781,9284,131,27887,895,29,8281,71,762,19,12,0,121,10,9176,108,895,8281,37,71,932,8352,3,11,0,63
Chicot,10/17/20,22,17,17,1029,5583,992,6615,15,10826,1016,13,5474,109,983,9,21,1,12,3,6490,125,1016,5474,16,109,1032,5583,2,0,0,23
Clark,10/17/20,4,19,19,463,8068,400,8540,59,22385,426,37,7650,418,371,29,4,0,51,8,8076,464,426,7650,46,418,472,8068,11,2,-1,123
Clay,10/17/20,11,21,21,423,5582,356,6006,55,15061,398,25,5138,444,338,18,9,2,50,5,5536,470,398,5138,26,444,424,5582,10,9,0,33
Cleburne,10/17/20,14,23,23,428,8100,371,8530,43,25230,386,42,7712,388,342,29,14,0,30,13,8098,432,386,7712,44,388,430,8100,18,14,0,137
Cleveland,10/17/20,12,25,25,202,3295,185,3497,5,8226,194,8,3218,77,181,4,11,1,2,3,3412,85,194,3218,8,77,202,3295,3,0,0,29
Columbia,10/17/20,19,27,27,646,6412,571,7071,56,23892,576,70,6252,160,512,59,19,0,45,11,6828,243,576,6252,83,160,659,6412,7,1,0,41
Conway,10/17/20,3,29,29,328,7547,300,7873,25,20906,310,18,7356,191,285,15,3,0,22,3,7666,207,310,7356,16,191,326,7547,2,4,0,52
Craighead,10/17/20,35,31,31,3992,42575,3379,46599,577,105701,3808,184,41632,943,3264,115,32,3,511,66,45440,1159,3808,41632,216,943,4024,42575,57,43,1,503
Crawford,10/17/20,24,33,33,1855,25296,1632,27151,199,62472,1785,70,25044,252,1583,49,21,3,181,18,26829,322,1785,25044,70,252,1855,25296,34,22,0,270
Crittenden,10/17/20,51,35,35,2176,15655,1995,17825,130,49013,2133,43,15573,82,1978,17,44,7,111,19,17706,119,2133,15573,37,82,2170,15655,24,2,0,97
Cross,10/17/20,20,37,37,535,5748,478,6280,37,16998,499,36,5657,91,452,26,18,2,29,8,6156,124,499,5657,33,91,532,5748,3,1,0,58
Dallas,10/17/20,5,39,39,177,2525,166,2702,6,7432,175,2,2491,34,164,2,5,0,6,0,2666,36,175,2491,2,34,177,2525,-1,0,0,10
Desha,10/17/20,7,41,41,368,4664,327,5033,34,11887,354,14,4537,127,319,8,7,0,28,6,4891,142,354,4537,15,127,369,4664,7,5,0,38
Drew,10/17/20,7,43,43,401,6776,361,7181,33,18502,384,17,6518,258,348,13,6,1,30,3,6902,279,384,6518,21,258,405,6776,13,1,0,47
Faulkner,10/17/20,29,45,45,3113,46215,2794,49343,290,122416,2932,181,44859,1356,2654,140,25,4,253,37,47791,1552,2932,44859,196,1356,3128,46215,42,35,2,631
Franklin,10/17/20,2,47,47,453,7806,353,8263,98,17780,427,26,7701,105,338,15,2,0,87,11,8128,135,427,7701,30,105,457,7806,7,6,0,96
Fulton,10/17/20,8,49,49,267,2307,203,2582,56,12139,232,35,2039,268,182,21,7,1,43,13,2271,311,232,2039,43,268,275,2307,3,1,0,28
Garland,10/17/20,61,51,51,2232,36975,2012,39207,159,98296,2176,56,36360,615,1976,36,56,5,144,15,38536,671,2176,36360,56,615,2232,36975,10,7,3,145
Grant,10/17/20,4,53,53,334,6321,289,6662,41,18086,310,24,6038,283,276,13,4,0,30,11,6348,314,310,6038,31,283,341,6321,3,7,0,38
Greene,10/17/20,15,55,55,1231,17145,1017,18384,199,44623,1162,69,16727,418,964,53,15,0,183,16,17889,495,1162,16727,77,418,1239,17145,19,19,0,115
Hempstead,10/17/20,5,57,57,496,5990,431,6497,60,22018,458,38,5887,103,399,32,5,0,54,6,6345,152,458,5887,49,103,507,5990,4,6,0,54
HotSpring,10/17/20,30,59,59,2097,16013,1932,18114,135,33520,2077,20,15799,214,1921,11,28,2,128,7,17876,238,2077,15799,24,214,2101,16013,6,10,0,127
Howard,10/17/20,13,61,61,537,4179,500,4720,24,13389,495,42,4015,164,466,34,13,0,16,8,4510,210,495,4015,46,164,541,4179,1,0,0,56
Independence,10/17/20,37,63,63,1365,13425,1238,14800,90,37264,1150,215,13212,213,1047,191,34,3,69,21,14362,438,1150,13212,225,213,1375,13425,11,5,1,43
Izard,10/17/20,1,65,65,398,4225,287,4632,110,13559,371,27,4173,52,267,20,1,0,103,7,4544,88,371,4173,36,52,407,4225,4,1,0,25
Jackson,10/17/20,5,67,67,609,8235,461,8874,143,17225,455,154,8205,30,341,120,4,1,110,33,8660,214,455,8205,184,30,639,8235,18,25,0,310
Jefferson,10/17/20,97,69,69,3921,35924,3521,39888,301,70424,3846,75,35539,385,3469,52,92,5,283,18,39385,503,3846,35539,118,385,3964,35924,17,32,0,398
Johnson,10/17/20,7,71,71,937,9120,890,10063,40,26291,922,15,8963,157,882,8,7,0,33,7,9885,178,922,8963,21,157,943,9120,4,2,-1,54
Lafayette,10/17/20,3,73,73,149,1303,127,1454,19,6915,136,13,1290,13,119,8,3,0,14,5,1426,28,136,1290,15,13,151,1303,3,0,0,10
Lawrence,10/17/20,14,75,75,718,5481,522,6206,182,16669,651,67,5367,114,473,49,14,0,164,18,6018,188,651,5367,74,114,725,5481,18,8,0,63
Lee,10/17/20,18,77,77,1097,4818,1067,5916,12,9398,1092,5,4799,19,1064,3,17,1,11,1,5891,25,1092,4799,6,19,1098,4818,1,0,0,10
Lincoln,10/17/20,17,79,79,2211,8517,2082,10738,112,13695,2199,12,8425,92,2072,10,16,1,111,1,10624,114,2199,8425,22,92,2221,8517,31,15,0,103
LittleRiver,10/17/20,35,81,81,413,2107,358,2512,20,12417,383,30,2054,53,338,20,30,5,15,5,2437,75,383,2054,22,53,405,2107,9,3,6,82
Logan,10/17/20,2,83,83,539,8637,463,9180,74,21757,528,11,8557,80,459,4,2,0,67,7,9085,95,528,8557,15,80,543,8637,8,8,0,47
Lonoke,10/17/20,22,85,85,1513,25421,1344,27000,147,72206,1294,219,22889,2532,1164,180,20,2,110,37,24183,2817,1294,22889,285,2532,1579,25421,8,14,1,156
Madison,10/17/20,5,87,87,408,4825,383,5234,20,16076,379,29,4702,123,360,23,5,0,14,6,5081,153,379,4702,30,123,409,4825,0,4,-1,58
Marion,10/17/20,2,89,89,129,3045,111,3174,16,16438,120,9,2927,118,105,6,1,1,14,2,3047,127,120,2927,9,118,129,3045,3,2,0,31
Miller,10/17/20,15,91,91,1163,7406,966,8571,182,43759,1038,125,7261,145,870,96,13,2,155,27,8299,272,1038,7261,127,145,1165,7406,17,7,0,56
MissingCountyInfo,10/17/20,0,5,5,1985,56412,1501,58387,484,NA,1778,207,56411,1,1333,168,0,0,445,39,58189,198,1778,56411,197,1,1975,56412,3,18,0,2252
Mississippi,10/17/20,61,93,93,2022,13077,1768,15089,193,42831,1945,77,12960,117,1728,40,50,11,167,26,14905,184,1945,12960,67,117,2012,13077,31,15,3,115
Monroe,10/17/20,0,95,95,198,2789,159,2987,39,7249,189,9,2738,51,154,5,0,0,35,4,2927,60,189,2738,9,51,198,2789,4,4,0,38
Montgomery,10/17/20,8,97,97,179,2669,163,2847,8,8993,176,3,2555,114,160,3,8,0,8,0,2731,116,176,2555,2,114,178,2669,1,0,0,49
Nevada,10/17/20,14,99,99,263,4074,224,4334,25,8440,247,16,4018,56,211,13,13,1,23,2,4265,69,247,4018,13,56,260,4074,3,1,0,49
Newton,10/17/20,19,101,101,285,2201,252,2481,14,7848,266,19,1982,219,237,15,16,3,13,1,2248,233,266,1982,14,219,280,2201,3,6,0,53
Ouachita,10/17/20,7,103,103,329,6949,283,7285,39,24106,319,10,6801,148,274,9,7,0,38,1,7120,165,319,6801,17,148,336,6949,3,2,0,38
Perry,10/17/20,0,105,105,124,4031,108,4156,16,10322,119,5,3933,98,103,5,0,0,16,0,4052,104,119,3933,6,98,125,4031,0,1,0,27
Phillips,10/17/20,15,107,107,681,8013,581,8700,85,19034,669,12,7921,92,572,9,15,0,82,3,8590,110,669,7921,18,92,687,8013,10,7,0,119
Pike,10/17/20,1,109,109,254,2654,242,2906,11,10808,245,9,2561,93,237,5,0,1,8,3,2806,100,245,2561,7,93,252,2654,1,1,-1,23
Poinsett,10/17/20,16,111,111,900,10301,738,11208,146,24054,847,53,10202,99,704,34,15,1,128,18,11049,159,847,10202,60,99,907,10301,17,4,0,102
Polk,10/17/20,4,113,113,341,5316,293,5659,44,20163,334,7,5258,58,291,2,4,0,39,5,5592,67,334,5258,9,58,343,5316,9,5,0,42
Pope,10/17/20,36,115,115,2529,26916,2282,29442,211,63644,2436,93,26520,396,2226,56,32,4,178,33,28956,486,2436,26520,90,396,2526,26916,18,15,0,139
Prairie,10/17/20,4,117,117,192,2743,170,2938,18,8244,178,14,2518,225,160,10,4,0,14,4,2696,242,178,2518,17,225,195,2743,1,2,0,42
Pulaski,10/17/20,193,119,119,11025,157459,9839,168573,992,393463,10537,488,153331,4128,9465,374,179,14,892,100,163868,4705,10537,153331,577,4128,11114,157459,71,42,0,1004
Randolph,10/17/20,23,121,121,578,6139,481,6725,74,17603,483,95,5858,281,424,57,18,5,41,33,6341,384,483,5858,103,281,586,6139,6,5,0,26
Saline,10/17/20,28,125,125,2572,37388,2303,39978,240,118009,2411,161,36058,1330,2181,122,26,2,203,37,38469,1509,2411,36058,179,1330,2590,37388,28,14,0,207
Scott,10/17/20,1,127,127,147,3463,121,3610,25,10442,143,4,3435,28,119,2,1,0,23,2,3578,32,143,3435,4,28,147,3463,1,4,0,21
Searcy,10/17/20,1,129,129,175,2859,158,3033,16,7923,167,8,2795,64,152,6,1,0,14,2,2962,71,167,2795,7,64,174,2859,2,1,0,13
Sebastian,10/17/20,87,131,131,4495,56098,4069,60600,338,127461,4357,138,55717,381,3978,91,79,8,299,39,60074,526,4357,55717,145,381,4502,56098,38,25,0,378
Sevier,10/17/20,16,133,133,1264,7059,1210,8318,38,17193,1213,51,6895,164,1184,26,16,0,13,25,8108,210,1213,6895,46,164,1259,7059,8,1,-3,54
Sharp,10/17/20,9,135,135,298,5046,256,5342,33,17043,262,36,4904,142,231,25,9,0,22,11,5166,176,262,4904,34,142,296,5046,5,4,0,32
St.Francis,10/17/20,10,123,123,1649,13333,1563,14984,76,26294,1634,15,13279,54,1557,6,10,0,67,9,14913,71,1634,13279,17,54,1651,13333,6,0,1,43
Stone,10/17/20,20,137,137,389,3921,358,4313,11,12446,377,12,3865,56,349,9,20,0,8,3,4242,71,377,3865,15,56,392,3921,0,1,0,13
Union,10/17/20,47,139,139,1069,10757,982,11832,40,39732,975,94,10319,438,906,76,42,5,27,13,11294,538,975,10319,100,438,1075,10757,12,6,0,32
VanBuren,10/17/20,3,141,141,199,5230,182,5437,14,16684,193,6,5050,180,179,3,3,0,11,3,5243,194,193,5050,14,180,207,5230,1,3,0,40
Washington,10/17/20,137,143,143,10805,90528,10047,101400,621,228529,9899,906,86157,4371,9288,759,121,16,490,131,96056,5344,9899,86157,973,4371,10872,90528,57,42,6,660
White,10/17/20,32,145,145,1266,20062,1034,21345,200,78804,1077,189,18561,1501,895,139,27,5,155,45,19638,1707,1077,18561,206,1501,1283,20062,18,27,0,154
Woodruff,10/17/20,0,147,147,85,1966,69,2053,16,6660,74,11,1922,44,59,10,0,0,15,1,1996,57,74,1922,13,44,87,1966,3,1,0,30
Yell,10/17/20,30,149,149,1316,12114,1249,13428,37,21573,1304,12,12000,114,1243,6,27,3,34,3,13304,124,1304,12000,10,114,1314,12114,6,2,0,23
Arkansas_all_counties,10/16/20,1665,5630,5630,97539,1134116,87256,1232241,8609,2990671,92117,5422,1105781,28335,83174,4082,1514,151,7420,1189,1197898,34343,92117,1105781,6008,28335,98125,1134116,1015,809,20,13480
Arkansas_county,10/16/20,11,1,1,594,7924,469,8540,114,18124,532,62,6979,945,430,39,11,0,91,23,7511,1029,532,6979,84,945,616,7924,12,14,0,189
Ashley,10/16/20,12,3,3,495,5951,445,6449,38,20537,480,15,5807,144,438,7,12,0,30,8,6287,162,480,5807,18,144,498,5951,4,2,0,116
Baxter,10/16/20,7,5,5,518,5260,434,5781,77,41219,445,73,5109,151,375,59,7,0,63,14,5554,227,445,5109,76,151,521,5260,12,8,2,57
Benton,10/16/20,102,7,7,7512,82305,6985,89864,424,258980,7057,455,80976,1329,6636,349,86,16,334,90,88033,1831,7057,80976,502,1329,7559,82305,67,52,0,628
Boone,10/16/20,27,9,9,940,13025,809,13975,104,37288,851,89,12887,138,736,73,25,2,90,14,13738,237,851,12887,99,138,950,13025,28,9,0,216
Bradley,10/16/20,8,11,11,354,3856,338,4209,8,10948,350,4,3825,31,336,2,7,1,7,1,4175,34,350,3825,3,31,353,3856,4,2,0,32
Calhoun,10/16/20,0,13,13,41,1882,37,1923,4,5202,40,1,1860,22,36,1,0,0,4,0,1900,23,40,1860,1,22,41,1882,1,1,0,11
Carroll,10/16/20,12,15,15,921,8292,770,9221,139,27887,892,29,8223,69,754,16,12,0,126,13,9115,106,892,8223,37,69,929,8292,14,11,0,119
Chicot,10/16/20,22,17,17,1027,5562,992,6592,13,10826,1014,13,5454,108,983,9,21,1,10,3,6468,124,1014,5454,16,108,1030,5562,2,0,0,40
Clark,10/16/20,5,19,19,452,7956,398,8412,49,22385,412,40,7599,357,369,29,5,0,38,11,8011,401,412,7599,44,357,456,7956,4,7,0,58
Clay,10/16/20,11,21,21,413,5559,347,5973,54,15061,388,25,5122,437,330,17,9,2,48,6,5510,463,388,5122,26,437,414,5559,8,2,0,141
Cleburne,10/16/20,14,23,23,410,7981,357,8394,39,25230,371,39,7638,343,333,24,14,0,24,15,8009,385,371,7638,42,343,413,7981,4,5,0,105
Cleveland,10/16/20,12,25,25,199,3269,185,3468,2,8226,193,6,3199,70,181,4,11,1,1,1,3392,76,193,3199,6,70,199,3269,1,0,0,34
Columbia,10/16/20,19,27,27,639,6378,570,7030,50,23892,574,65,6226,152,511,59,19,0,44,6,6800,230,574,6226,78,152,652,6378,5,8,0,95
Conway,10/16/20,3,29,29,326,7497,296,7821,27,20906,308,18,7301,196,281,15,3,0,24,3,7609,212,308,7301,16,196,324,7497,2,4,0,24
Craighead,10/16/20,34,31,31,3935,42129,3336,46096,564,105701,3761,174,41219,910,3227,109,31,3,502,62,44980,1116,3761,41219,206,910,3967,42129,72,36,2,430
Crawford,10/16/20,24,33,33,1821,25060,1610,26881,187,62472,1753,68,24811,249,1560,50,21,3,172,15,26564,317,1753,24811,68,249,1821,25060,18,24,2,337
Crittenden,10/16/20,51,35,35,2152,15582,1993,17727,108,49013,2117,35,15500,82,1977,16,44,7,96,12,17617,110,2117,15500,28,82,2145,15582,21,7,0,98
Cross,10/16/20,20,37,37,532,5693,477,6222,35,16998,496,36,5608,85,450,27,18,2,28,7,6104,118,496,5608,33,85,529,5693,11,1,1,126
Dallas,10/16/20,5,39,39,178,2514,166,2692,7,7432,176,2,2480,34,164,2,5,0,7,0,2656,36,176,2480,2,34,178,2514,1,0,0,22
Desha,10/16/20,7,41,41,361,4633,322,4995,32,11887,347,14,4512,121,315,7,7,0,25,7,4859,136,347,4512,15,121,362,4633,4,3,0,32
Drew,10/16/20,7,43,43,388,6742,360,7135,21,18502,373,15,6485,257,347,13,6,1,20,1,6858,277,373,6485,20,257,393,6742,1,2,0,47
Faulkner,10/16/20,27,45,45,3071,45626,2759,48713,285,122416,2898,173,44326,1300,2623,136,23,4,252,33,47224,1489,2898,44326,189,1300,3087,45626,33,33,0,281
Franklin,10/16/20,2,47,47,446,7717,347,8166,97,17780,420,26,7614,103,332,15,2,0,86,11,8034,132,420,7614,29,103,449,7717,7,6,0,70
Fulton,10/16/20,8,49,49,264,2282,202,2554,54,12139,229,35,2023,259,181,21,7,1,41,13,2252,302,229,2023,43,259,272,2282,7,5,0,31
Garland,10/16/20,58,51,51,2222,36840,2005,39062,159,98296,2168,54,36248,592,1968,37,53,5,147,12,38416,646,2168,36248,54,592,2222,36840,16,9,1,166
Grant,10/16/20,4,53,53,331,6286,282,6624,45,18086,309,22,6004,282,270,12,4,0,35,10,6313,311,309,6004,29,282,338,6286,2,6,0,42
Greene,10/16/20,15,55,55,1212,17049,998,18269,199,44623,1144,68,16632,417,948,50,15,0,181,18,17776,493,1144,16632,76,417,1220,17049,17,23,0,282
Hempstead,10/16/20,5,57,57,492,5940,425,6443,62,22018,455,37,5844,96,395,30,5,0,55,7,6299,144,455,5844,48,96,503,5940,5,8,0,41
HotSpring,10/16/20,30,59,59,2091,15892,1922,17987,139,33520,2075,16,15688,204,1913,9,28,2,134,5,17763,224,2075,15688,20,204,2095,15892,5,0,0,123
Howard,10/16/20,13,61,61,536,4124,500,4663,23,13389,493,43,3994,130,466,34,13,0,14,9,4487,176,493,3994,46,130,539,4124,4,1,1,16
Independence,10/16/20,36,63,63,1354,13393,1233,14758,85,37264,1140,214,13183,210,1046,187,33,3,61,24,14323,435,1140,13183,225,210,1365,13393,2,10,1,70
Izard,10/16/20,1,65,65,394,4204,286,4607,107,13559,367,27,4154,50,266,20,1,0,100,7,4521,86,367,4154,36,50,403,4204,3,8,0,33
Jackson,10/16/20,5,67,67,591,7943,436,8564,150,17225,441,150,7913,30,320,116,4,1,117,33,8354,210,441,7913,180,30,621,7943,6,12,0,267
Jefferson,10/16/20,97,69,69,3904,35543,3489,39490,316,70424,3831,73,35160,383,3440,49,92,5,297,19,38991,499,3831,35160,116,383,3947,35543,8,48,0,167
Johnson,10/16/20,8,71,71,933,9070,888,10008,37,26291,919,14,8920,150,880,8,8,0,31,6,9839,169,919,8920,19,150,938,9070,4,1,0,47
Lafayette,10/16/20,3,73,73,146,1296,127,1444,16,6915,133,13,1284,12,119,8,3,0,11,5,1417,27,133,1284,15,12,148,1296,1,0,0,11
Lawrence,10/16/20,14,75,75,700,5436,514,6143,172,16669,634,66,5321,115,465,49,14,0,155,17,5955,188,634,5321,73,115,707,5436,7,4,0,41
Lee,10/16/20,18,77,77,1096,4809,1067,5906,11,9398,1092,4,4790,19,1064,3,17,1,11,0,5882,24,1092,4790,5,19,1097,4809,2,4,0,24
Lincoln,10/16/20,17,79,79,2180,8445,2067,10635,96,13695,2168,12,8354,91,2057,10,16,1,95,1,10522,113,2168,8354,22,91,2190,8445,18,39,0,87
LittleRiver,10/16/20,29,81,81,404,2034,355,2431,20,12417,376,28,1986,48,338,17,24,5,14,6,2362,69,376,1986,21,48,397,2034,0,2,0,33
Logan,10/16/20,2,83,83,531,8598,455,9132,74,21757,520,11,8526,72,452,3,2,0,66,8,9046,86,520,8526,14,72,534,8598,11,4,0,105
Lonoke,10/16/20,21,85,85,1505,25273,1330,26843,154,72206,1289,216,22757,2516,1153,177,19,2,117,37,24046,2797,1289,22757,281,2516,1570,25273,17,11,1,207
Madison,10/16/20,6,87,87,408,4767,379,5176,23,16076,379,29,4647,120,358,21,6,0,15,8,5026,150,379,4647,30,120,409,4767,0,4,0,51
Marion,10/16/20,2,89,89,126,3017,109,3143,15,16438,118,8,2899,118,103,6,1,1,14,1,3017,126,118,2899,8,118,126,3017,4,1,0,52
Miller,10/16/20,15,91,91,1146,7367,959,8514,172,43759,1028,118,7235,132,863,96,13,2,152,20,8263,251,1028,7235,119,132,1147,7367,19,16,1,66
MissingCountyInfo,10/16/20,0,5,5,1982,54163,1483,56134,498,NA,1770,212,54162,1,1314,169,0,0,455,43,55932,202,1770,54162,201,1,1971,54163,74,33,0,2939
Mississippi,10/16/20,58,93,93,1991,12993,1753,14974,180,42831,1924,67,12883,110,1714,39,47,11,163,17,14807,167,1924,12883,57,110,1981,12993,47,20,1,114
Monroe,10/16/20,0,95,95,194,2755,155,2949,39,7249,185,9,2705,50,150,5,0,0,35,4,2890,59,185,2705,9,50,194,2755,4,5,0,50
Montgomery,10/16/20,8,97,97,178,2621,163,2798,7,8993,175,3,2507,114,160,3,8,0,7,0,2682,116,175,2507,2,114,177,2621,1,2,0,91
Nevada,10/16/20,14,99,99,260,4028,223,4285,23,8440,244,16,3974,54,210,13,13,1,21,2,4218,67,244,3974,13,54,257,4028,1,5,0,34
Newton,10/16/20,19,101,101,282,2151,246,2428,17,7848,263,19,1965,186,231,15,16,3,16,1,2228,200,263,1965,14,186,277,2151,3,3,0,47
Ouachita,10/16/20,7,103,103,326,6914,281,7247,38,24106,317,9,6768,146,272,9,7,0,38,0,7085,162,317,6768,16,146,333,6914,12,2,0,54
Perry,10/16/20,0,105,105,124,4004,107,4129,17,10322,119,5,3907,97,102,5,0,0,17,0,4026,103,119,3907,6,97,125,4004,2,2,0,19
Phillips,10/16/20,15,107,107,671,7904,574,8581,82,19034,660,11,7814,90,565,9,15,0,80,2,8474,107,660,7814,17,90,677,7904,10,15,0,47
Pike,10/16/20,2,109,109,253,2632,241,2883,10,10808,245,8,2553,79,236,5,1,1,8,2,2798,85,245,2553,6,79,251,2632,0,1,-1,12
Poinsett,10/16/20,16,111,111,883,10216,734,11106,133,24054,835,48,10128,88,700,34,15,1,120,13,10963,143,835,10128,55,88,890,10216,15,6,1,71
Polk,10/16/20,4,113,113,332,5283,288,5617,40,20163,325,7,5226,57,286,2,4,0,35,5,5551,66,325,5226,9,57,334,5283,7,5,0,52
Pope,10/16/20,36,115,115,2511,26795,2267,29302,208,63644,2422,89,26415,380,2215,52,32,4,175,33,28837,465,2422,26415,85,380,2507,26795,41,15,0,244
Prairie,10/16/20,4,117,117,191,2702,168,2896,19,8244,177,14,2478,224,158,10,4,0,15,4,2655,241,177,2478,17,224,194,2702,5,1,0,46
Pulaski,10/16/20,193,119,119,10954,156526,9797,167566,963,393463,10473,481,152458,4068,9432,365,179,14,861,102,162931,4635,10473,152458,567,4068,11040,156526,92,72,4,1328
Randolph,10/16/20,23,121,121,572,6119,476,6700,73,17603,479,93,5843,276,421,55,18,5,40,33,6322,378,479,5843,102,276,581,6119,6,7,0,171
Saline,10/16/20,28,125,125,2544,37209,2289,39771,226,118009,2391,153,35885,1324,2170,119,26,2,194,32,38276,1495,2391,35885,171,1324,2562,37209,23,17,0,297
Scott,10/16/20,1,127,127,146,3443,117,3589,28,10442,142,4,3415,28,115,2,1,0,26,2,3557,32,142,3415,4,28,146,3443,5,1,0,58
Searcy,10/16/20,1,129,129,173,2848,157,3020,15,7923,165,8,2785,63,151,6,1,0,13,2,2950,70,165,2785,7,63,172,2848,2,3,0,81
Sebastian,10/16/20,87,131,131,4457,55758,4044,60220,325,127461,4326,131,55382,376,3956,88,79,8,290,35,59708,512,4326,55382,136,376,4462,55758,30,37,0,543
Sevier,10/16/20,19,133,133,1256,7013,1209,8266,28,17193,1212,44,6868,145,1184,25,19,0,9,19,8080,186,1212,6868,41,145,1253,7013,10,4,0,33
Sharp,10/16/20,9,135,135,293,5019,252,5310,32,17043,257,36,4878,141,228,24,9,0,20,12,5135,175,257,4878,34,141,291,5019,3,4,0,37
St.Francis,10/16/20,9,123,123,1643,13296,1563,14941,71,26294,1630,13,13244,52,1557,6,9,0,64,7,14874,67,1630,13244,15,52,1645,13296,7,4,0,83
Stone,10/16/20,20,137,137,389,3908,357,4300,12,12446,377,12,3855,53,348,9,20,0,9,3,4232,68,377,3855,15,53,392,3908,-1,0,1,45
Union,10/16/20,47,139,139,1057,10737,976,11800,34,39732,967,90,10303,434,901,75,42,5,24,10,11270,530,967,10303,96,434,1063,10737,8,13,0,111
VanBuren,10/16/20,3,141,141,198,5191,179,5397,16,16684,192,6,5021,170,176,3,3,0,13,3,5213,184,192,5021,14,170,206,5191,1,1,0,164
Washington,10/16/20,131,143,143,10748,89925,10005,100740,612,228529,9858,890,85705,4220,9258,747,115,16,485,127,95563,5177,9858,85705,957,4220,10815,89925,85,54,2,936
White,10/16/20,32,145,145,1248,19926,1007,21190,209,78804,1061,187,18455,1471,875,132,27,5,159,50,19516,1674,1061,18455,203,1471,1264,19926,18,21,0,408
Woodruff,10/16/20,0,147,147,82,1939,68,2022,14,6660,72,10,1895,44,59,9,0,0,13,1,1967,55,72,1895,11,44,83,1939,3,2,0,37
Yell,10/16/20,30,149,149,1310,12097,1247,13405,33,21573,1298,12,11982,115,1241,6,27,3,30,3,13280,125,1298,11982,10,115,1308,12097,7,1,0,58
Arkansas_all_counties,10/15/20,1645,5630,5630,96524,1121651,86447,1218743,8424,2990671,91303,5221,1094699,26952,82529,3918,1494,151,7272,1152,1186002,32741,91303,1094699,5789,26952,97092,1121651,1278,850,11,14065
Arkansas_county,10/15/20,11,1,1,582,7747,455,8348,116,18124,521,61,6857,890,420,35,11,0,90,26,7378,970,521,6857,80,890,601,7747,4,11,0,157
Ashley,10/15/20,12,3,3,491,5839,443,6333,36,20537,476,15,5714,125,437,6,12,0,27,9,6190,143,476,5714,18,125,494,5839,3,1,0,41
Baxter,10/15/20,5,5,5,506,5215,426,5724,75,41219,436,70,5066,149,368,58,5,0,63,12,5502,222,436,5066,73,149,509,5215,16,14,0,98
Benton,10/15/20,102,7,7,7445,81744,6933,89236,409,258980,7024,421,80464,1280,6604,329,86,16,333,76,87488,1748,7024,80464,468,1280,7492,81744,97,69,0,766
Boone,10/15/20,27,9,9,912,12837,800,13754,85,37288,825,87,12708,129,727,73,25,2,73,12,13533,221,825,12708,92,129,917,12837,13,14,0,250
Bradley,10/15/20,8,11,11,350,3828,336,4177,6,10948,348,2,3797,31,335,1,7,1,6,0,4145,32,348,3797,1,31,349,3828,0,1,0,12
Calhoun,10/15/20,0,13,13,40,1872,36,1912,4,5202,39,1,1853,19,35,1,0,0,4,0,1892,20,39,1853,1,19,40,1872,1,0,0,19
Carroll,10/15/20,12,15,15,907,8187,759,9102,136,27887,882,25,8123,64,744,15,12,0,126,10,9005,97,882,8123,33,64,915,8187,14,9,0,67
Chicot,10/15/20,22,17,17,1025,5524,992,6552,11,10826,1013,12,5418,106,983,9,21,1,9,2,6431,121,1013,5418,15,106,1028,5524,3,0,0,18
Clark,10/15/20,5,19,19,448,7902,391,8354,52,22385,408,40,7553,349,362,29,5,0,41,11,7961,393,408,7553,44,349,452,7902,11,3,0,109
Clay,10/15/20,11,21,21,405,5426,345,5832,48,15061,380,25,5038,388,328,17,9,2,42,6,5418,414,380,5038,26,388,406,5426,9,7,0,91
Cleburne,10/15/20,14,23,23,406,7880,352,8291,40,25230,368,38,7543,337,329,23,14,0,25,15,7911,380,368,7543,43,337,411,7880,7,3,0,68
Cleveland,10/15/20,12,25,25,198,3236,185,3434,1,8226,193,5,3176,60,181,4,11,1,1,0,3369,65,193,3176,5,60,198,3236,0,3,0,16
Columbia,10/15/20,19,27,27,634,6288,562,6935,53,23892,569,65,6167,121,504,58,19,0,46,7,6736,199,569,6167,78,121,647,6288,12,12,0,175
Conway,10/15/20,3,29,29,324,7475,292,7797,29,20906,306,18,7281,194,278,14,3,0,25,4,7587,210,306,7281,16,194,322,7475,6,5,0,43
Craighead,10/15/20,32,31,31,3863,41771,3300,45662,530,105701,3710,153,40928,843,3193,107,29,3,487,43,44638,1024,3710,40928,181,843,3891,41771,89,47,0,683
Crawford,10/15/20,22,33,33,1803,24741,1586,26545,195,62472,1739,64,24506,235,1538,48,19,3,182,13,26245,300,1739,24506,65,235,1804,24741,25,17,0,426
Crittenden,10/15/20,51,35,35,2131,15505,1986,17629,94,49013,2101,30,15423,82,1970,16,44,7,87,7,17524,105,2101,15423,23,82,2124,15505,33,11,0,231
Cross,10/15/20,19,37,37,521,5578,476,6096,26,16998,488,33,5493,85,449,27,17,2,22,4,5981,115,488,5493,30,85,518,5578,3,9,0,28
Dallas,10/15/20,5,39,39,177,2493,166,2670,6,7432,175,2,2459,34,164,2,5,0,6,0,2634,36,175,2459,2,34,177,2493,-1,1,0,63
Desha,10/15/20,7,41,41,357,4605,319,4963,31,11887,345,12,4489,116,312,7,7,0,26,5,4834,129,345,4489,13,116,358,4605,6,5,0,41
Drew,10/15/20,7,43,43,387,6696,358,7088,22,18502,372,15,6443,253,345,13,6,1,21,1,6815,273,372,6443,20,253,392,6696,6,2,0,35
Faulkner,10/15/20,27,45,45,3038,45378,2726,48432,285,122416,2877,161,44100,1278,2594,132,23,4,260,25,46977,1455,2877,44100,177,1278,3054,45378,47,30,0,511
Franklin,10/15/20,2,47,47,439,7654,341,8096,96,17780,414,25,7560,94,327,14,2,0,85,11,7974,122,414,7560,28,94,442,7654,13,12,0,114
Fulton,10/15/20,8,49,49,257,2258,197,2523,52,12139,223,34,2000,258,177,20,7,1,39,13,2223,300,223,2000,42,258,265,2258,15,1,0,37
Garland,10/15/20,57,51,51,2206,36690,1996,38897,153,98296,2153,53,36141,549,1961,35,52,5,140,13,38294,603,2153,36141,54,549,2207,36690,39,20,0,877
Grant,10/15/20,4,53,53,329,6246,276,6582,49,18086,307,22,5971,275,265,11,4,0,38,11,6278,304,307,5971,29,275,336,6246,5,3,0,144
Greene,10/15/20,15,55,55,1195,16784,975,17987,205,44623,1128,67,16493,291,927,48,15,0,186,19,17621,366,1128,16493,75,291,1203,16784,46,17,0,257
Hempstead,10/15/20,5,57,57,487,5904,417,6402,65,22018,449,38,5812,92,390,27,5,0,54,11,6261,141,449,5812,49,92,498,5904,7,7,0,61
HotSpring,10/15/20,30,59,59,2086,15774,1922,17864,134,33520,2070,16,15581,193,1913,9,28,2,129,5,17651,213,2070,15581,20,193,2090,15774,20,2,0,309
Howard,10/15/20,12,61,61,532,4112,499,4647,21,13389,489,43,3984,128,466,33,12,0,11,10,4473,174,489,3984,46,128,535,4112,5,11,0,25
Independence,10/15/20,35,63,63,1352,13325,1223,14688,94,37264,1138,214,13132,193,1043,180,32,3,63,31,14270,418,1138,13132,225,193,1363,13325,33,17,2,150
Izard,10/15/20,1,65,65,391,4174,278,4573,112,13559,365,26,4126,48,259,19,1,0,105,7,4491,82,365,4126,34,48,399,4174,35,2,0,88
Jackson,10/15/20,5,67,67,585,7682,424,8297,156,17225,436,149,7652,30,313,111,4,1,119,37,8088,209,436,7652,179,30,615,7682,13,10,0,76
Jefferson,10/15/20,97,69,69,3896,35384,3441,39323,356,70424,3823,73,35008,376,3394,47,92,5,335,21,38831,492,3823,35008,116,376,3939,35384,33,49,0,272
Johnson,10/15/20,8,71,71,929,9027,887,9960,34,26291,917,12,8882,145,879,8,8,0,30,4,9799,161,917,8882,16,145,933,9027,4,6,-1,77
Lafayette,10/15/20,3,73,73,145,1286,127,1433,15,6915,133,12,1276,10,119,8,3,0,11,4,1409,24,133,1276,14,10,147,1286,4,5,0,26
Lawrence,10/15/20,14,75,75,693,5402,510,6102,169,16669,628,65,5292,110,461,49,14,0,153,16,5920,182,628,5292,72,110,700,5402,53,10,1,119
Lee,10/15/20,18,77,77,1094,4787,1063,5882,13,9398,1090,4,4768,19,1060,3,17,1,13,0,5858,24,1090,4768,5,19,1095,4787,1,5,0,43
Lincoln,10/15/20,17,79,79,2162,8376,2028,10548,117,13695,2150,12,8286,90,2018,10,16,1,116,1,10436,112,2150,8286,22,90,2172,8376,5,5,0,97
LittleRiver,10/15/20,29,81,81,404,2001,353,2398,22,12417,376,28,1953,48,336,17,24,5,16,6,2329,69,376,1953,21,48,397,2001,2,3,0,21
Logan,10/15/20,2,83,83,520,8504,451,9025,67,21757,513,7,8441,63,448,3,2,0,63,4,8954,71,513,8441,8,63,521,8504,4,6,0,69
Lonoke,10/15/20,20,85,85,1488,25083,1319,26637,149,72206,1279,209,22608,2475,1144,175,18,2,117,32,23887,2750,1279,22608,275,2475,1554,25083,21,19,0,331
Madison,10/15/20,6,87,87,408,4716,375,5125,27,16076,379,29,4611,105,358,17,6,0,15,12,4990,135,379,4611,30,105,409,4716,4,3,0,38
Marion,10/15/20,2,89,89,122,2969,108,3091,12,16438,114,8,2852,117,102,6,1,1,11,1,2966,125,114,2852,8,117,122,2969,1,0,0,84
Miller,10/15/20,14,91,91,1127,7320,943,8448,170,43759,1013,114,7190,130,853,90,12,2,148,22,8203,245,1013,7190,115,130,1128,7320,60,13,1,183
MissingCountyInfo,10/15/20,0,5,5,1908,51298,1450,53195,458,NA,1706,202,51297,1,1292,158,0,0,414,44,53003,192,1706,51297,191,1,1897,51298,-120,-13,0,820
Mississippi,10/15/20,57,93,93,1944,12926,1733,14860,154,42831,1881,63,12829,97,1698,35,46,11,137,17,14710,150,1881,12829,53,97,1934,12926,26,11,0,119
Monroe,10/15/20,0,95,95,190,2709,150,2899,40,7249,182,8,2661,48,146,4,0,0,36,4,2843,56,182,2661,8,48,190,2709,3,5,0,40
Montgomery,10/15/20,8,97,97,177,2531,161,2707,8,8993,174,3,2497,34,158,3,8,0,8,0,2671,36,174,2497,2,34,176,2531,2,2,0,39
Nevada,10/15/20,14,99,99,259,3995,218,4251,27,8440,243,16,3942,53,206,12,13,1,24,3,4185,66,243,3942,13,53,256,3995,2,1,0,23
Newton,10/15/20,19,101,101,279,2107,243,2381,17,7848,260,19,1957,150,229,14,16,3,15,2,2217,164,260,1957,14,150,274,2107,1,4,0,22
Ouachita,10/15/20,7,103,103,314,6872,279,7193,28,24106,305,9,6732,140,270,9,7,0,28,0,7037,156,305,6732,16,140,321,6872,7,6,0,101
Perry,10/15/20,0,105,105,122,3987,105,4110,17,10322,117,5,3893,94,100,5,0,0,17,0,4010,100,117,3893,6,94,123,3987,2,4,0,110
Phillips,10/15/20,15,107,107,661,7867,559,8534,87,19034,650,11,7780,87,551,8,15,0,84,3,8430,104,650,7780,17,87,667,7867,23,8,0,94
Pike,10/15/20,3,109,109,253,2620,240,2871,10,10808,246,7,2542,78,235,5,2,1,9,1,2788,83,246,2542,5,78,251,2620,2,2,0,42
Poinsett,10/15/20,15,111,111,868,10160,728,11035,125,24054,821,47,10077,83,694,34,14,1,113,12,10898,137,821,10077,54,83,875,10160,18,6,0,204
Polk,10/15/20,4,113,113,325,5238,283,5565,38,20163,318,7,5182,56,281,2,4,0,33,5,5500,65,318,5182,9,56,327,5238,6,5,0,52
Pope,10/15/20,36,115,115,2470,26592,2252,29058,182,63644,2385,85,26236,356,2205,47,32,4,148,34,28621,437,2385,26236,81,356,2466,26592,20,25,0,362
Prairie,10/15/20,4,117,117,186,2661,167,2850,15,8244,172,14,2438,223,157,10,4,0,11,4,2610,240,172,2438,17,223,189,2661,1,3,0,20
Pulaski,10/15/20,189,119,119,10862,155290,9725,166235,947,393463,10386,476,151349,3941,9372,353,175,14,838,109,161735,4500,10386,151349,559,3941,10945,155290,135,71,1,1380
Randolph,10/15/20,23,121,121,566,5954,469,6528,74,17603,474,92,5712,242,417,52,18,5,39,35,6186,342,474,5712,100,242,574,5954,11,8,0,107
Saline,10/15/20,28,125,125,2521,36935,2272,39475,220,118009,2373,148,35690,1245,2156,116,26,2,190,30,38063,1412,2373,35690,167,1245,2540,36935,34,47,1,369
Scott,10/15/20,1,127,127,141,3390,116,3531,24,10442,138,3,3362,28,114,2,1,0,23,1,3500,31,138,3362,3,28,141,3390,9,2,0,30
Searcy,10/15/20,1,129,129,171,2769,154,2939,16,7923,163,8,2709,60,148,6,1,0,14,2,2872,67,163,2709,7,60,170,2769,2,0,0,48
Sebastian,10/15/20,87,131,131,4427,55245,4007,59677,332,127461,4303,124,54881,364,3924,83,79,8,299,33,59184,493,4303,54881,129,364,4432,55245,61,30,6,858
Sevier,10/15/20,19,133,133,1246,6990,1205,8233,22,17193,1208,38,6858,132,1181,24,19,0,8,14,8066,167,1208,6858,35,132,1243,6990,6,5,0,24
Sharp,10/15/20,9,135,135,290,4985,248,5273,33,17043,256,34,4847,138,226,22,9,0,21,12,5103,170,256,4847,32,138,288,4985,4,3,0,66
St.Francis,10/15/20,9,123,123,1636,13220,1559,14858,68,26294,1623,13,13169,51,1553,6,9,0,61,7,14792,66,1623,13169,15,51,1638,13220,2,6,0,26
Stone,10/15/20,19,137,137,390,3862,357,4255,14,12446,378,12,3810,52,349,8,19,0,10,4,4188,67,378,3810,15,52,393,3862,2,1,0,20
Union,10/15/20,47,139,139,1049,10634,963,11688,39,39732,962,87,10259,375,897,66,42,5,23,16,11221,467,962,10259,92,375,1054,10634,21,19,0,174
VanBuren,10/15/20,3,141,141,197,5028,178,5233,16,16684,191,6,4862,166,175,3,3,0,13,3,5053,180,191,4862,14,166,205,5028,6,0,0,34
Washington,10/15/20,129,143,143,10663,89074,9951,99803,583,228529,9791,872,85020,4054,9221,730,113,16,457,126,94811,4992,9791,85020,938,4054,10729,89074,111,71,0,898
White,10/15/20,32,145,145,1230,19536,986,20780,212,78804,1052,178,18086,1450,863,123,27,5,162,50,19138,1642,1052,18086,192,1450,1244,19536,45,15,0,269
Woodruff,10/15/20,0,147,147,79,1905,66,1985,13,6660,71,8,1866,39,58,8,0,0,13,0,1937,48,71,1866,9,39,80,1905,5,0,0,15
Yell,10/15/20,30,149,149,1303,12046,1246,13347,27,21573,1292,11,11938,108,1240,6,27,3,25,2,13230,117,1292,11938,9,108,1301,12046,4,3,0,253
Arkansas_all_counties,10/14/20,1634,5630,5630,95246,1108864,85597,1204636,8007,2990671,90235,5011,1083107,25757,81819,3778,1484,150,6924,1083,1173342,31294,90235,1083107,5537,25757,95772,1108864,1079,793,23,11910
Arkansas_county,10/14/20,11,1,1,578,7594,444,8191,123,18124,519,59,6785,809,409,35,11,0,99,24,7304,887,519,6785,78,809,597,7594,9,7,0,60
Ashley,10/14/20,12,3,3,488,5801,442,6292,34,20537,474,14,5683,118,436,6,12,0,26,8,6157,135,474,5683,17,118,491,5801,4,5,0,37
Baxter,10/14/20,5,5,5,490,5133,412,5626,73,41219,428,62,5004,129,356,56,5,0,67,6,5432,194,428,5004,65,129,493,5133,15,11,0,134
Benton,10/14/20,102,7,7,7348,81075,6864,88470,381,258980,6940,408,79807,1268,6546,318,86,16,307,74,86747,1723,6940,79807,455,1268,7395,81075,60,41,0,605
Boone,10/14/20,27,9,9,899,12600,786,13503,86,37288,812,87,12481,119,715,71,25,2,72,14,13293,210,812,12481,91,119,903,12600,12,12,1,132
Bradley,10/14/20,8,11,11,350,3816,335,4165,7,10948,348,2,3788,28,334,1,7,1,7,0,4136,29,348,3788,1,28,349,3816,0,0,0,19
Calhoun,10/14/20,0,13,13,39,1854,36,1893,3,5202,38,1,1835,19,35,1,0,0,3,0,1873,20,38,1835,1,19,39,1854,0,0,0,7
Carroll,10/14/20,12,15,15,893,8134,750,9034,131,27887,868,25,8070,64,736,14,12,0,120,11,8938,96,868,8070,32,64,900,8134,14,15,0,65
Chicot,10/14/20,22,17,17,1022,5509,992,6534,8,10826,1012,10,5405,104,983,9,21,1,8,0,6417,117,1012,5405,13,104,1025,5509,4,0,0,23
Clark,10/14/20,5,19,19,437,7804,388,8245,44,22385,401,36,7466,338,361,27,5,0,35,9,7867,378,401,7466,40,338,441,7804,8,7,0,71
Clay,10/14/20,11,21,21,396,5344,338,5741,46,15061,374,22,5003,341,323,15,9,2,41,5,5377,364,374,5003,23,341,397,5344,12,11,0,188
Cleburne,10/14/20,14,23,23,399,7819,349,8224,36,25230,364,35,7483,336,327,22,14,0,23,13,7847,377,364,7483,41,336,405,7819,4,5,0,64
Cleveland,10/14/20,12,25,25,198,3220,182,3418,4,8226,193,5,3161,59,178,4,11,1,4,0,3354,64,193,3161,5,59,198,3220,2,2,0,57
Columbia,10/14/20,19,27,27,622,6125,550,6760,53,23892,559,63,6015,110,495,55,19,0,45,8,6574,186,559,6015,76,110,635,6125,3,15,0,32
Conway,10/14/20,3,29,29,318,7438,287,7754,28,20906,300,18,7236,202,275,12,3,0,22,6,7536,218,300,7236,16,202,316,7438,4,2,0,53
Craighead,10/14/20,32,31,31,3774,41177,3253,44975,488,105701,3626,148,40483,694,3151,102,29,3,445,43,44109,866,3626,40483,172,694,3798,41177,74,46,0,747
Crawford,10/14/20,22,33,33,1778,24340,1569,26119,187,62472,1716,62,24108,232,1522,47,19,3,175,12,25824,295,1716,24108,63,232,1779,24340,20,32,0,157
Crittenden,10/14/20,51,35,35,2098,15307,1975,17397,72,49013,2069,29,15241,66,1958,17,44,7,67,5,17310,87,2069,15241,21,66,2090,15307,21,4,0,157
Cross,10/14/20,19,37,37,518,5553,467,6068,32,16998,486,32,5470,83,442,25,17,2,27,5,5956,112,486,5470,29,83,515,5553,3,4,0,19
Dallas,10/14/20,5,39,39,178,2429,165,2607,8,7432,176,2,2400,29,163,2,5,0,8,0,2576,31,176,2400,2,29,178,2429,1,1,0,25
Desha,10/14/20,7,41,41,351,4570,314,4921,30,11887,341,10,4459,111,308,6,7,0,26,4,4800,121,341,4459,10,111,351,4570,3,3,0,19
Drew,10/14/20,7,43,43,381,6667,356,7052,18,18502,366,15,6416,251,344,12,6,1,16,2,6782,270,366,6416,19,251,385,6667,1,0,0,49
Faulkner,10/14/20,27,45,45,2991,44914,2696,47921,268,122416,2838,153,43673,1241,2571,125,23,4,244,24,46511,1410,2838,43673,169,1241,3007,44914,28,28,0,301
Franklin,10/14/20,2,47,47,426,7553,329,7981,95,17780,405,21,7463,90,315,14,2,0,88,7,7868,113,405,7463,23,90,428,7553,8,10,0,51
Fulton,10/14/20,8,49,49,242,2236,196,2482,38,12139,211,31,1983,253,175,21,7,1,29,9,2194,288,211,1983,35,253,246,2236,13,7,0,63
Garland,10/14/20,57,51,51,2167,35852,1976,38021,134,98296,2121,46,35322,530,1946,30,52,5,123,11,37443,578,2121,35322,48,530,2169,35852,25,15,0,391
Grant,10/14/20,4,53,53,324,6107,273,6437,47,18086,301,23,5835,272,262,11,4,0,35,12,6136,301,301,5835,29,272,330,6107,11,0,0,65
Greene,10/14/20,15,55,55,1149,16573,958,17728,176,44623,1086,63,16328,245,913,45,15,0,158,18,17414,314,1086,16328,69,245,1155,16573,27,8,0,337
Hempstead,10/14/20,5,57,57,480,5850,410,6340,65,22018,444,36,5759,91,387,23,5,0,52,13,6203,137,444,5759,46,91,490,5850,11,2,0,122
HotSpring,10/14/20,30,59,59,2066,15485,1920,17554,116,33520,2050,16,15296,189,1911,9,28,2,111,5,17346,208,2050,15296,19,189,2069,15485,9,6,0,142
Howard,10/14/20,12,61,61,527,4092,488,4622,27,13389,488,39,3969,123,458,30,12,0,18,9,4457,165,488,3969,42,123,530,4092,3,1,0,26
Independence,10/14/20,33,63,63,1319,13208,1206,14538,80,37264,1109,210,13020,188,1027,179,31,2,51,29,14129,409,1109,13020,221,188,1330,13208,8,6,7,73
Izard,10/14/20,1,65,65,356,4121,276,4485,79,13559,329,27,4075,46,258,18,1,0,70,9,4404,81,329,4075,35,46,364,4121,4,6,0,86
Jackson,10/14/20,5,67,67,572,7619,414,8221,153,17225,428,144,7588,31,309,105,4,1,115,38,8016,205,428,7588,174,31,602,7619,24,7,0,165
Jefferson,10/14/20,97,69,69,3863,35145,3392,39039,372,70424,3794,69,34779,366,3349,43,92,5,351,21,38573,466,3794,34779,100,366,3894,35145,61,25,2,577
Johnson,10/14/20,9,71,71,925,8954,881,9883,35,26291,915,10,8816,138,873,8,9,0,33,2,9731,152,915,8816,14,138,929,8954,8,7,0,41
Lafayette,10/14/20,3,73,73,141,1264,122,1407,16,6915,130,11,1254,10,114,8,3,0,13,3,1384,23,130,1254,13,10,143,1264,2,1,0,19
Lawrence,10/14/20,13,75,75,640,5336,500,5983,127,16669,577,63,5232,104,452,48,13,0,112,15,5809,174,577,5232,70,104,647,5336,27,16,0,85
Lee,10/14/20,18,77,77,1093,4745,1058,5839,17,9398,1089,4,4727,18,1055,3,17,1,17,0,5816,23,1089,4727,5,18,1094,4745,1,3,0,106
Lincoln,10/14/20,17,79,79,2157,8284,2023,10450,117,13695,2146,11,8196,88,2014,9,16,1,116,1,10342,108,2146,8196,20,88,2166,8284,7,2,0,45
LittleRiver,10/14/20,29,81,81,402,1982,350,2377,23,12417,375,27,1934,48,335,15,24,5,16,7,2309,68,375,1934,20,48,395,1982,2,0,0,10
Logan,10/14/20,2,83,83,516,8439,445,8956,69,21757,510,6,8378,61,442,3,2,0,66,3,8888,68,510,8378,7,61,517,8439,8,4,0,115
Lonoke,10/14/20,20,85,85,1467,24773,1300,26305,147,72206,1263,204,22444,2329,1130,170,18,2,115,32,23707,2598,1263,22444,269,2329,1532,24773,18,18,1,553
Madison,10/14/20,6,87,87,404,4682,372,5087,26,16076,376,28,4581,101,355,17,6,0,15,11,4957,130,376,4581,29,101,405,4682,5,2,0,24
Marion,10/14/20,2,89,89,121,2886,108,3007,11,16438,113,8,2813,73,102,6,1,1,10,1,2926,81,113,2813,8,73,121,2886,1,0,1,71
Miller,10/14/20,13,91,91,1067,7197,930,8265,124,43759,956,111,7069,128,844,86,11,2,101,23,8025,240,956,7069,112,128,1068,7197,19,12,0,89
MissingCountyInfo,10/14/20,0,5,5,2028,50358,1463,52375,565,NA,1808,220,50357,1,1298,165,0,0,510,55,52165,210,1808,50357,209,1,2017,50358,53,19,0,1149
Mississippi,10/14/20,57,93,93,1918,12833,1722,14741,139,42831,1858,60,12751,82,1687,35,46,11,125,14,14609,132,1858,12751,50,82,1908,12833,21,15,2,139
Monroe,10/14/20,0,95,95,187,2672,145,2859,42,7249,179,8,2625,47,142,3,0,0,37,5,2804,55,179,2625,8,47,187,2672,3,4,0,26
Montgomery,10/14/20,8,97,97,175,2494,159,2668,8,8993,172,3,2460,34,156,3,8,0,8,0,2632,36,172,2460,2,34,174,2494,-1,2,1,14
Nevada,10/14/20,14,99,99,257,3974,217,4228,26,8440,241,16,3921,53,205,12,13,1,23,3,4162,66,241,3921,13,53,254,3974,1,0,0,33
Newton,10/14/20,19,101,101,278,2086,239,2359,20,7848,259,19,1936,150,226,13,16,3,17,3,2195,164,259,1936,14,150,273,2086,2,3,0,15
Ouachita,10/14/20,7,103,103,307,6778,273,7092,27,24106,298,9,6644,134,264,9,7,0,27,0,6942,150,298,6644,16,134,314,6778,6,5,0,45
Perry,10/14/20,0,105,105,120,3879,101,3999,19,10322,114,6,3791,88,96,5,0,0,18,1,3905,94,114,3791,6,88,120,3879,1,1,0,57
Phillips,10/14/20,15,107,107,638,7796,551,8440,72,19034,629,9,7711,85,544,7,15,0,70,2,8340,100,629,7711,15,85,644,7796,6,7,0,145
Pike,10/14/20,3,109,109,251,2580,238,2829,10,10808,245,6,2503,77,233,5,2,1,10,0,2748,81,245,2503,4,77,249,2580,1,4,0,17
Poinsett,10/14/20,15,111,111,850,9974,722,10830,113,24054,809,41,9920,54,690,32,14,1,105,8,10729,101,809,9920,47,54,856,9974,22,22,0,193
Polk,10/14/20,4,113,113,319,5192,278,5513,37,20163,313,6,5138,54,276,2,4,0,33,4,5451,62,313,5138,8,54,321,5192,5,7,0,29
Pope,10/14/20,36,115,115,2450,26250,2227,28695,187,63644,2369,81,25928,322,2184,43,32,4,153,34,28297,398,2369,25928,76,322,2445,26250,31,23,0,221
Prairie,10/14/20,4,117,117,185,2642,164,2829,17,8244,171,14,2422,220,155,9,4,0,12,5,2593,236,171,2422,16,220,187,2642,4,7,0,26
Pulaski,10/14/20,188,119,119,10727,154045,9654,164850,884,393463,10282,445,150209,3836,9312,342,174,14,795,89,160491,4359,10282,150209,523,3836,10805,154045,124,72,2,913
Randolph,10/14/20,23,121,121,555,5858,461,6420,71,17603,464,91,5628,230,409,52,18,5,37,34,6092,328,464,5628,98,230,562,5858,10,8,0,59
Saline,10/14/20,27,125,125,2487,36600,2225,39107,234,118009,2346,141,35398,1202,2115,110,25,2,205,29,37744,1363,2346,35398,161,1202,2507,36600,22,31,3,506
Scott,10/14/20,1,127,127,132,3369,114,3501,17,10442,129,3,3341,28,112,2,1,0,16,1,3470,31,129,3341,3,28,132,3369,3,0,0,98
Searcy,10/14/20,1,129,129,169,2723,154,2891,14,7923,161,8,2668,55,148,6,1,0,12,2,2829,62,161,2668,7,55,168,2723,2,1,0,41
Sebastian,10/14/20,81,131,131,4366,54448,3977,58820,307,127461,4246,120,54092,356,3897,80,73,8,275,32,58338,482,4246,54092,126,356,4372,54448,36,51,0,458
Sevier,10/14/20,19,133,133,1240,6972,1200,8209,21,17193,1206,34,6842,130,1179,21,19,0,8,13,8048,161,1206,6842,31,130,1237,6972,8,4,0,31
Sharp,10/14/20,9,135,135,286,4923,245,5207,32,17043,254,32,4786,137,223,22,9,0,22,10,5040,167,254,4786,30,137,284,4923,1,4,0,51
St.Francis,10/14/20,9,123,123,1634,13196,1553,14832,72,26294,1623,11,13150,46,1548,5,9,0,66,6,14773,59,1623,13150,13,46,1636,13196,8,1,1,56
Stone,10/14/20,19,137,137,388,3844,356,4235,13,12446,376,12,3794,50,348,8,19,0,9,4,4170,65,376,3794,15,50,391,3844,1,1,0,16
Union,10/14/20,47,139,139,1028,10481,944,11514,37,39732,949,79,10111,370,886,58,42,5,21,16,11060,454,949,10111,84,370,1033,10481,4,11,0,174
VanBuren,10/14/20,3,141,141,191,5000,178,5197,10,16684,186,5,4836,164,175,3,3,0,8,2,5022,175,186,4836,11,164,197,5000,1,0,0,9
Washington,10/14/20,129,143,143,10552,88287,9880,98904,543,228529,9714,838,84266,4021,9169,711,113,16,432,111,93980,4924,9714,84266,903,4021,10617,88287,65,60,2,705
White,10/14/20,32,145,145,1185,19312,971,20511,182,78804,1015,170,17992,1320,853,118,27,5,135,47,19007,1504,1015,17992,184,1320,1199,19312,30,18,0,267
Woodruff,10/14/20,0,147,147,74,1895,66,1970,8,6660,66,8,1860,35,58,8,0,0,8,0,1926,44,66,1860,9,35,75,1895,0,1,0,8
Yell,10/14/20,30,149,149,1299,11797,1243,13094,26,21573,1289,10,11694,103,1237,6,27,3,25,1,12983,111,1289,11694,8,103,1297,11797,5,2,0,132
Arkansas_all_counties,10/13/20,1611,5630,5630,94167,1098033,84804,1192697,7744,2990671,89351,4816,1073314,24719,81136,3668,1463,148,6744,1000,1162665,30032,89351,1073314,5313,24719,94664,1098033,680,749,25,9237
Arkansas_county,10/13/20,11,1,1,569,7543,437,8131,121,18124,511,58,6736,807,404,33,11,0,96,25,7247,884,511,6736,77,807,588,7543,7,5,0,76
Ashley,10/13/20,12,3,3,484,5768,437,6255,35,20537,470,14,5656,112,432,5,12,0,26,9,6126,129,470,5656,17,112,487,5768,3,1,0,33
Baxter,10/13/20,5,5,5,475,5014,401,5492,69,41219,415,60,4960,54,346,55,5,0,64,5,5375,117,415,4960,63,54,478,5014,6,9,1,84
Benton,10/13/20,102,7,7,7288,80530,6823,87865,362,258980,6893,395,79275,1255,6516,307,86,16,290,72,86168,1697,6893,79275,442,1255,7335,80530,55,53,0,484
Boone,10/13/20,26,9,9,887,12480,774,13371,87,37288,805,82,12367,113,706,68,24,2,75,12,13172,199,805,12367,86,113,891,12480,5,9,0,88
Bradley,10/13/20,8,11,11,350,3797,335,4146,7,10948,348,2,3770,27,334,1,7,1,7,0,4118,28,348,3770,1,27,349,3797,0,0,0,23
Calhoun,10/13/20,0,13,13,39,1847,36,1886,3,5202,38,1,1828,19,35,1,0,0,3,0,1866,20,38,1828,1,19,39,1847,0,0,0,14
Carroll,10/13/20,12,15,15,879,8083,735,8968,132,27887,854,25,8020,63,721,14,12,0,121,11,8874,94,854,8020,31,63,885,8083,9,11,0,87
Chicot,10/13/20,22,17,17,1018,5490,992,6511,4,10826,1008,10,5388,102,983,9,21,1,4,0,6396,115,1008,5388,13,102,1021,5490,0,3,0,25
Clark,10/13/20,5,19,19,429,7741,381,8174,43,22385,396,33,7410,331,356,25,5,0,35,8,7806,368,396,7410,37,331,433,7741,4,4,0,38
Clay,10/13/20,11,21,21,384,5168,327,5552,45,15061,364,20,4918,250,313,14,9,2,41,4,5282,270,364,4918,20,250,384,5168,3,7,0,80
Cleburne,10/13/20,14,23,23,395,7759,344,8160,37,25230,361,34,7429,330,323,21,14,0,24,13,7790,370,361,7429,40,330,401,7759,4,4,0,81
Cleveland,10/13/20,12,25,25,196,3165,180,3361,4,8226,191,5,3108,57,176,4,11,1,4,0,3299,62,191,3108,5,57,196,3165,0,4,0,64
Columbia,10/13/20,19,27,27,619,6096,535,6728,65,23892,556,63,5987,109,483,52,19,0,54,11,6543,185,556,5987,76,109,632,6096,0,5,1,9
Conway,10/13/20,3,29,29,314,7389,285,7701,26,20906,296,18,7197,192,274,11,3,0,19,7,7493,208,296,7197,16,192,312,7389,3,2,0,35
Craighead,10/13/20,32,31,31,3700,40504,3207,44226,460,105701,3561,139,39981,523,3107,100,29,3,424,36,43542,684,3561,39981,161,523,3722,40504,44,45,2,461
Crawford,10/13/20,22,33,33,1758,24203,1537,25962,199,62472,1701,57,23971,232,1493,44,19,3,189,10,25672,290,1701,23971,58,232,1759,24203,8,20,1,204
Crittenden,10/13/20,51,35,35,2077,15171,1971,17240,55,49013,2053,24,15105,66,1956,15,44,7,53,2,17158,82,2053,15105,16,66,2069,15171,3,11,0,80
Cross,10/13/20,19,37,37,515,5537,463,6049,33,16998,483,32,5453,84,439,24,17,2,27,6,5936,113,483,5453,29,84,512,5537,9,10,1,44
Dallas,10/13/20,5,39,39,177,2405,164,2582,8,7432,175,2,2376,29,162,2,5,0,8,0,2551,31,175,2376,2,29,177,2405,2,0,0,11
Desha,10/13/20,7,41,41,348,4554,311,4902,30,11887,338,10,4445,109,305,6,7,0,26,4,4783,119,338,4445,10,109,348,4554,1,6,0,29
Drew,10/13/20,7,43,43,380,6619,356,7003,17,18502,365,15,6370,249,344,12,6,1,15,2,6735,268,365,6370,19,249,384,6619,2,6,0,35
Faulkner,10/13/20,27,45,45,2963,44641,2668,47620,268,122416,2815,148,43404,1237,2548,120,23,4,244,24,46219,1401,2815,43404,164,1237,2979,44641,31,31,0,336
Franklin,10/13/20,2,47,47,418,7510,319,7930,97,17780,399,19,7422,88,306,13,2,0,91,6,7821,109,399,7422,21,88,420,7510,3,2,0,31
Fulton,10/13/20,8,49,49,229,2186,189,2419,32,12139,203,26,1946,240,171,18,7,1,25,7,2149,270,203,1946,30,240,233,2186,4,5,1,60
Garland,10/13/20,57,51,51,2142,35486,1961,37630,124,98296,2097,45,34963,523,1932,29,52,5,113,11,37060,570,2097,34963,47,523,2144,35486,26,14,1,269
Grant,10/13/20,4,53,53,313,6053,273,6372,36,18086,293,20,5785,268,262,11,4,0,27,9,6078,294,293,5785,26,268,319,6053,6,0,1,46
Greene,10/13/20,15,55,55,1122,16263,950,17388,157,44623,1060,62,16052,211,906,44,15,0,139,18,17112,276,1060,16052,65,211,1125,16263,22,8,0,123
Hempstead,10/13/20,5,57,57,469,5739,408,6217,56,22018,433,36,5649,90,385,23,5,0,43,13,6082,135,433,5649,45,90,478,5739,2,4,0,43
HotSpring,10/13/20,30,59,59,2057,15352,1914,17412,113,33520,2045,12,15169,183,1905,9,28,2,112,1,17214,198,2045,15169,15,183,2060,15352,5,8,1,191
Howard,10/13/20,12,61,61,524,4069,487,4596,25,13389,487,37,3948,121,458,29,12,0,17,8,4435,161,487,3948,40,121,527,4069,4,1,0,15
Independence,10/13/20,26,63,63,1311,13143,1200,14466,85,37264,1105,206,12967,176,1023,177,24,2,58,27,14072,394,1105,12967,218,176,1323,13143,6,13,0,45
Izard,10/13/20,1,65,65,352,4039,270,4399,81,13559,326,26,3993,46,253,17,1,0,72,9,4319,80,326,3993,34,46,360,4039,0,8,0,30
Jackson,10/13/20,5,67,67,548,7478,407,8055,136,17225,403,145,7447,31,303,104,4,1,96,40,7850,205,403,7447,174,31,577,7478,2,16,0,72
Jefferson,10/13/20,95,69,69,3802,34629,3367,38462,338,70424,3737,65,34266,363,3327,40,90,5,318,20,38003,459,3737,34266,96,363,3833,34629,28,13,2,247
Johnson,10/13/20,9,71,71,917,8921,874,9842,34,26291,907,10,8785,136,866,8,9,0,32,2,9692,150,907,8785,14,136,921,8921,0,3,0,27
Lafayette,10/13/20,3,73,73,139,1247,121,1388,15,6915,128,11,1238,9,113,8,3,0,12,3,1366,22,128,1238,13,9,141,1247,2,-1,0,8
Lawrence,10/13/20,13,75,75,613,5278,484,5898,116,16669,553,60,5176,102,439,45,13,0,101,15,5729,169,553,5176,67,102,620,5278,9,18,0,47
Lee,10/13/20,18,77,77,1092,4640,1055,5733,19,9398,1088,4,4622,18,1053,2,17,1,18,1,5710,23,1088,4622,5,18,1093,4640,0,1,0,7
Lincoln,10/13/20,17,79,79,2150,8246,2021,10405,112,13695,2140,10,8163,83,2012,9,16,1,112,0,10303,102,2140,8163,19,83,2159,8246,1,5,0,87
LittleRiver,10/13/20,29,81,81,400,1974,350,2367,21,12417,375,25,1927,47,335,15,24,5,16,5,2302,65,375,1927,18,47,393,1974,3,0,1,10
Logan,10/13/20,2,83,83,508,8332,441,8841,65,21757,504,4,8275,57,439,2,2,0,63,2,8779,62,504,8275,5,57,509,8332,4,9,0,41
Lonoke,10/13/20,19,85,85,1449,24238,1282,25749,148,72206,1253,196,22010,2228,1113,169,18,1,122,26,23263,2486,1253,22010,258,2228,1511,24238,35,17,2,470
Madison,10/13/20,6,87,87,399,4663,370,5063,23,16076,371,28,4564,99,354,16,6,0,11,12,4935,128,371,4564,29,99,400,4663,5,0,1,45
Marion,10/13/20,1,89,89,120,2816,108,2936,11,16438,113,7,2796,20,102,6,1,0,10,1,2909,27,113,2796,7,20,120,2816,1,1,1,77
Miller,10/13/20,13,91,91,1048,7127,918,8176,117,43759,945,103,7000,127,836,82,11,2,98,19,7945,231,945,7000,104,127,1049,7127,6,13,0,26
MissingCountyInfo,10/13/20,0,5,5,1975,49262,1444,51226,531,NA,1755,220,49261,1,1278,166,0,0,477,54,51016,210,1755,49261,209,1,1964,49262,-9,-6,0,434
Mississippi,10/13/20,55,93,93,1897,12715,1707,14599,135,42831,1837,60,12641,74,1674,33,44,11,119,16,14478,121,1837,12641,47,74,1884,12715,19,6,1,100
Monroe,10/13/20,0,95,95,184,2649,141,2833,43,7249,177,7,2602,47,139,2,0,0,38,5,2779,54,177,2602,7,47,184,2649,1,0,0,21
Montgomery,10/13/20,7,97,97,176,2479,157,2654,12,8993,173,3,2446,33,154,3,7,0,12,0,2619,35,173,2446,2,33,175,2479,0,2,0,5
Nevada,10/13/20,14,99,99,256,3942,217,4195,25,8440,240,16,3890,52,205,12,13,1,22,3,4130,65,240,3890,13,52,253,3942,3,0,0,85
Newton,10/13/20,19,101,101,276,2073,236,2344,21,7848,257,19,1924,149,223,13,16,3,18,3,2181,163,257,1924,14,149,271,2073,2,2,0,21
Ouachita,10/13/20,7,103,103,301,6739,268,7047,26,24106,292,9,6606,133,260,8,7,0,25,1,6898,149,292,6606,16,133,308,6739,0,3,0,109
Perry,10/13/20,0,105,105,119,3823,100,3942,19,10322,113,6,3727,96,95,5,0,0,18,1,3840,102,113,3727,6,96,119,3823,2,3,0,22
Phillips,10/13/20,15,107,107,632,7657,544,8295,73,19034,623,9,7576,81,537,7,15,0,71,2,8199,96,623,7576,15,81,638,7657,10,14,0,18
Pike,10/13/20,3,109,109,250,2564,234,2812,13,10808,244,6,2490,74,230,4,2,1,12,1,2734,78,244,2490,4,74,248,2564,1,3,0,10
Poinsett,10/13/20,15,111,111,828,9803,700,10632,113,24054,784,44,9762,41,671,29,14,1,99,14,10546,86,784,9762,45,41,829,9803,15,9,1,105
Polk,10/13/20,4,113,113,314,5168,271,5484,39,20163,308,6,5114,54,269,2,4,0,35,4,5422,62,308,5114,8,54,316,5168,6,2,0,36
Pope,10/13/20,36,115,115,2419,26060,2204,28474,179,63644,2344,75,25757,303,2164,40,32,4,148,31,28101,373,2344,25757,70,303,2414,26060,22,21,0,121
Prairie,10/13/20,4,117,117,181,2620,157,2803,20,8244,168,13,2404,216,149,8,4,0,15,5,2572,231,168,2404,15,216,183,2620,0,0,0,29
Pulaski,10/13/20,186,119,119,10603,153256,9582,163935,834,393463,10175,428,149457,3799,9246,336,172,14,756,78,159632,4303,10175,149457,504,3799,10679,153256,78,70,5,1444
Randolph,10/13/20,23,121,121,545,5809,453,6361,69,17603,459,86,5595,214,404,49,18,5,37,32,6054,307,459,5595,93,214,552,5809,10,5,0,61
Saline,10/13/20,24,125,125,2465,36116,2194,38599,246,118009,2330,135,34935,1181,2086,108,22,2,221,25,37265,1334,2330,34935,153,1181,2483,36116,22,15,0,600
Scott,10/13/20,1,127,127,129,3274,114,3403,14,10442,127,2,3248,26,112,2,1,0,14,0,3375,28,127,3248,2,26,129,3274,1,0,0,30
Searcy,10/13/20,1,129,129,167,2684,153,2850,13,7923,159,8,2633,51,147,6,1,0,11,2,2792,58,159,2633,7,51,166,2684,2,2,0,73
Sebastian,10/13/20,81,131,131,4330,54026,3926,58361,322,127461,4221,109,53674,352,3852,74,73,8,295,27,57895,466,4221,53674,114,352,4335,54026,25,40,1,536
Sevier,10/13/20,19,133,133,1232,6949,1196,8178,17,17193,1203,29,6826,123,1176,20,19,0,8,9,8029,149,1203,6826,26,123,1229,6949,3,1,0,13
Sharp,10/13/20,9,135,135,285,4873,241,5158,35,17043,255,30,4737,136,220,21,9,0,26,9,4992,166,255,4737,30,136,285,4873,3,3,0,76
St.Francis,10/13/20,8,123,123,1626,13148,1552,14776,66,26294,1618,8,13105,43,1547,5,8,0,63,3,14723,53,1618,13105,10,43,1628,13148,1,11,0,30
Stone,10/13/20,19,137,137,387,3829,355,4219,13,12446,375,12,3780,49,348,7,19,0,8,5,4155,64,375,3780,15,49,390,3829,8,7,0,24
Union,10/13/20,47,139,139,1024,10311,933,11340,44,39732,948,76,10100,211,876,57,42,5,30,14,11048,292,948,10100,81,211,1029,10311,14,15,0,32
VanBuren,10/13/20,3,141,141,190,4992,178,5188,9,16684,185,5,4828,164,175,3,3,0,7,2,5013,175,185,4828,11,164,196,4992,2,2,0,59
Washington,10/13/20,127,143,143,10487,87647,9820,98199,540,228529,9671,816,83633,4014,9119,701,111,16,441,99,93304,4895,9671,83633,881,4014,10552,87647,45,85,0,500
White,10/13/20,32,145,145,1155,19075,953,20238,170,78804,997,158,17820,1255,838,115,27,5,132,38,18817,1421,997,17820,166,1255,1163,19075,20,21,0,172
Woodruff,10/13/20,0,147,147,74,1887,65,1962,9,6660,66,8,1854,33,58,7,0,0,8,1,1920,42,66,1854,9,33,75,1887,0,2,0,17
Yell,10/13/20,30,149,149,1294,11670,1241,12961,23,21573,1285,9,11572,98,1235,6,27,3,23,0,12857,104,1285,11572,6,98,1291,11670,1,7,0,16
Arkansas_all_counties,10/12/20,1586,5630,5630,93487,1089476,84055,1183427,7839,2990671,88870,4617,1066196,23280,80496,3559,1438,148,6929,910,1155066,28361,88870,1066196,5081,23280,93951,1089476,654,601,17,8867
Arkansas_county,10/12/20,11,1,1,562,7474,432,8054,119,18124,508,54,6709,765,400,32,11,0,97,22,7217,837,508,6709,72,765,580,7474,9,8,-1,112
Ashley,10/12/20,12,3,3,481,5738,436,6222,33,20537,468,13,5633,105,431,5,12,0,25,8,6101,121,468,5633,16,105,484,5738,5,5,0,37
Baxter,10/12/20,4,5,5,469,4936,392,5408,73,41219,409,60,4884,52,340,52,4,0,65,8,5293,115,409,4884,63,52,472,4936,4,6,0,51
Benton,10/12/20,102,7,7,7233,80101,6770,87375,360,258980,6843,390,78860,1241,6474,296,86,16,282,78,85703,1672,6843,78860,431,1241,7274,80101,36,29,-1,771
Boone,10/12/20,26,9,9,882,12397,765,13282,91,37288,799,83,12289,108,698,67,24,2,77,14,13088,194,799,12289,86,108,885,12397,2,8,0,163
Bradley,10/12/20,8,11,11,350,3774,335,4123,7,10948,348,2,3751,23,334,1,7,1,7,0,4099,24,348,3751,1,23,349,3774,1,0,0,18
Calhoun,10/12/20,0,13,13,39,1833,36,1872,3,5202,38,1,1818,15,35,1,0,0,3,0,1856,16,38,1818,1,15,39,1833,0,0,0,16
Carroll,10/12/20,12,15,15,870,8005,724,8881,134,27887,848,22,7942,63,710,14,12,0,126,8,8790,91,848,7942,28,63,876,8005,12,16,0,125
Chicot,10/12/20,22,17,17,1018,5465,989,6486,7,10826,1008,10,5364,101,980,9,21,1,7,0,6372,114,1008,5364,13,101,1021,5465,0,0,0,60
Clark,10/12/20,5,19,19,425,7707,377,8136,43,22385,394,31,7396,311,352,25,5,0,37,6,7790,346,394,7396,35,311,429,7707,3,6,1,182
Clay,10/12/20,11,21,21,381,5091,320,5472,49,15061,361,20,4885,206,308,12,9,2,43,6,5246,226,361,4885,20,206,381,5091,1,5,0,65
Cleburne,10/12/20,14,23,23,391,7682,340,8078,37,25230,359,32,7398,284,322,18,14,0,23,14,7757,321,359,7398,37,284,396,7682,2,-1,2,54
Cleveland,10/12/20,12,25,25,196,3101,176,3297,8,8226,191,5,3046,55,173,3,11,1,7,1,3237,60,191,3046,5,55,196,3101,0,1,0,11
Columbia,10/12/20,18,27,27,619,6087,530,6719,71,23892,555,64,5982,105,478,52,18,0,59,12,6537,182,555,5982,77,105,632,6087,7,4,0,62
Conway,10/12/20,3,29,29,311,7357,283,7666,25,20906,295,16,7175,182,272,11,3,0,20,5,7470,196,295,7175,14,182,309,7357,3,5,0,44
Craighead,10/12/20,30,31,31,3656,40087,3162,43766,463,105701,3528,128,39567,520,3064,98,27,3,436,27,43095,671,3528,39567,151,520,3679,40087,34,43,1,460
Crawford,10/12/20,21,33,33,1750,24007,1517,25758,212,62472,1696,54,23807,200,1475,42,18,3,203,9,25503,255,1696,23807,55,200,1751,24007,14,16,0,376
Crittenden,10/12/20,51,35,35,2074,15094,1960,17160,63,49013,2051,23,15027,67,1946,14,44,7,61,2,17078,82,2051,15027,15,67,2066,15094,7,6,1,66
Cross,10/12/20,18,37,37,506,5502,453,6005,35,16998,477,29,5438,64,431,22,16,2,30,5,5915,90,477,5438,26,64,503,5502,3,4,0,37
Dallas,10/12/20,5,39,39,175,2396,164,2571,6,7432,173,2,2369,27,162,2,5,0,6,0,2542,29,173,2369,2,27,175,2396,1,0,0,13
Desha,10/12/20,7,41,41,347,4526,305,4873,35,11887,337,10,4424,102,300,5,7,0,30,5,4761,112,337,4424,10,102,347,4526,2,2,1,32
Drew,10/12/20,7,43,43,378,6586,350,6968,21,18502,363,15,6339,247,338,12,6,1,19,2,6702,266,363,6339,19,247,382,6586,0,0,0,28
Faulkner,10/12/20,27,45,45,2932,44336,2637,47283,268,122416,2786,146,43191,1145,2520,117,23,4,243,25,45977,1306,2786,43191,161,1145,2947,44336,16,34,1,302
Franklin,10/12/20,2,47,47,415,7482,317,7899,96,17780,398,17,7402,80,304,13,2,0,92,4,7800,99,398,7402,19,80,417,7482,16,12,0,110
Fulton,10/12/20,7,49,49,225,2130,184,2359,34,12139,202,23,1928,202,166,18,6,1,30,4,2130,229,202,1928,27,202,229,2130,0,4,0,17
Garland,10/12/20,56,51,51,2116,35243,1947,37361,113,98296,2074,42,34737,506,1918,29,51,5,105,8,36811,550,2074,34737,44,506,2118,35243,17,16,0,215
Grant,10/12/20,3,53,53,307,6013,273,6327,31,18086,290,17,5757,256,262,11,3,0,25,6,6047,280,290,5757,24,256,314,6013,2,0,0,34
Greene,10/12/20,15,55,55,1100,16162,942,17265,143,44623,1042,58,15956,206,899,43,15,0,128,15,16998,267,1042,15956,61,206,1103,16162,5,11,0,168
Hempstead,10/12/20,5,57,57,467,5698,404,6168,58,22018,434,33,5610,88,382,22,5,0,47,11,6044,124,434,5610,36,88,470,5698,15,9,0,106
HotSpring,10/12/20,29,59,59,2052,15166,1906,17221,117,33520,2040,12,15004,162,1897,9,27,2,116,1,17044,177,2040,15004,15,162,2055,15166,6,2,0,118
Howard,10/12/20,12,61,61,520,4058,486,4581,22,13389,486,34,3942,116,457,29,12,0,17,5,4428,153,486,3942,37,116,523,4058,3,4,0,44
Independence,10/12/20,26,63,63,1305,13104,1187,14421,92,37264,1102,203,12942,162,1016,171,24,2,62,30,14044,377,1102,12942,215,162,1317,13104,4,15,0,127
Izard,10/12/20,1,65,65,352,4009,262,4369,89,13559,326,26,3973,36,245,17,1,0,80,9,4299,70,326,3973,34,36,360,4009,2,2,0,41
Jackson,10/12/20,5,67,67,546,7408,391,7982,150,17225,404,142,7381,27,293,98,4,1,107,43,7785,197,404,7381,170,27,574,7408,6,4,0,213
Jefferson,10/12/20,93,69,69,3774,34410,3354,38215,326,70424,3712,62,34054,356,3316,38,88,5,307,19,37766,449,3712,34054,93,356,3805,34410,33,13,2,250
Johnson,10/12/20,9,71,71,917,8894,871,9815,37,26291,907,10,8764,130,863,8,9,0,35,2,9671,144,907,8764,14,130,921,8894,7,2,1,53
Lafayette,10/12/20,3,73,73,137,1241,122,1380,12,6915,128,9,1233,8,114,8,3,0,11,1,1361,19,128,1233,11,8,139,1241,1,1,0,6
Lawrence,10/12/20,13,75,75,604,5240,466,5851,125,16669,547,57,5144,96,423,43,13,0,111,14,5691,160,547,5144,64,96,611,5240,12,8,0,70
Lee,10/12/20,18,77,77,1092,4633,1054,5726,20,9398,1088,4,4616,17,1052,2,17,1,19,1,5704,22,1088,4616,5,17,1093,4633,1,3,0,22
Lincoln,10/12/20,17,79,79,2149,8160,2016,10318,116,13695,2139,10,8079,81,2008,8,16,1,115,1,10218,100,2139,8079,19,81,2158,8160,1,4,0,91
LittleRiver,10/12/20,28,81,81,397,1967,350,2357,19,12417,374,23,1924,43,335,15,23,5,16,3,2298,59,374,1924,16,43,390,1967,3,0,0,10
Logan,10/12/20,2,83,83,504,8295,432,8800,70,21757,500,4,8245,50,431,1,2,0,67,3,8745,55,500,8245,5,50,505,8295,6,6,0,70
Lonoke,10/12/20,17,85,85,1414,23803,1265,25275,132,72206,1230,184,21795,2008,1096,169,16,1,118,14,23025,2250,1230,21795,242,2008,1472,23803,7,9,0,239
Madison,10/12/20,5,87,87,394,4623,370,5018,19,16076,371,23,4525,98,354,16,5,0,12,7,4896,122,371,4525,24,98,395,4623,0,1,0,34
Marion,10/12/20,0,89,89,119,2740,107,2859,12,16438,112,7,2720,20,101,6,0,0,11,1,2832,27,112,2720,7,20,119,2740,3,1,0,40
Miller,10/12/20,13,91,91,1042,7107,905,8149,124,43759,944,98,6981,126,823,82,11,2,110,14,7925,224,944,6981,98,126,1042,7107,6,10,0,41
MissingCountyInfo,10/12/20,0,5,5,1984,48819,1450,50792,534,NA,1785,199,48818,1,1288,162,0,0,497,37,50603,189,1785,48818,188,1,1973,48819,16,1,0,-2272
Mississippi,10/12/20,54,93,93,1878,12634,1701,14499,123,42831,1820,58,12559,75,1668,33,43,11,109,14,14379,120,1820,12559,45,75,1865,12634,12,12,0,118
Monroe,10/12/20,0,95,95,183,2629,141,2812,42,7249,177,6,2584,45,139,2,0,0,38,4,2761,51,177,2584,6,45,183,2629,1,2,0,29
Montgomery,10/12/20,7,97,97,176,2474,155,2649,14,8993,173,3,2441,33,152,3,7,0,14,0,2614,35,173,2441,2,33,175,2474,3,1,0,44
Nevada,10/12/20,14,99,99,253,3860,217,4110,22,8440,239,14,3808,52,205,12,13,1,21,1,4047,63,239,3808,11,52,250,3860,3,0,0,24
Newton,10/12/20,19,101,101,274,2054,234,2323,21,7848,256,18,1910,144,221,13,16,3,19,2,2166,157,256,1910,13,144,269,2054,1,1,0,46
Ouachita,10/12/20,7,103,103,301,6630,265,6938,29,24106,292,9,6582,48,257,8,7,0,28,1,6874,64,292,6582,16,48,308,6630,8,2,0,115
Perry,10/12/20,0,105,105,117,3803,97,3920,20,10322,111,6,3714,89,92,5,0,0,19,1,3825,95,111,3714,6,89,117,3803,2,2,0,36
Phillips,10/12/20,15,107,107,622,7649,530,8277,77,19034,612,10,7569,80,524,6,15,0,73,4,8181,96,612,7569,16,80,628,7649,3,5,0,58
Pike,10/12/20,3,109,109,249,2555,231,2803,15,10808,244,5,2484,71,228,3,2,1,14,1,2728,75,244,2484,4,71,248,2555,2,4,0,48
Poinsett,10/12/20,14,111,111,813,9713,691,10527,108,24054,774,39,9680,33,662,29,13,1,99,9,10454,73,774,9680,40,33,814,9713,8,8,0,74
Polk,10/12/20,4,113,113,308,5138,269,5447,35,20163,304,4,5091,47,267,2,4,0,33,2,5395,52,304,5091,5,47,309,5138,3,1,0,40
Pope,10/12/20,36,115,115,2397,25961,2183,28352,178,63644,2327,70,25676,285,2145,38,32,4,150,28,28003,349,2327,25676,64,285,2391,25961,7,-1,0,191
Prairie,10/12/20,4,117,117,181,2591,157,2774,20,8244,168,13,2384,207,149,8,4,0,15,5,2552,222,168,2384,15,207,183,2591,0,2,0,11
Pulaski,10/12/20,181,119,119,10525,151890,9512,162491,831,393463,10111,414,148159,3731,9179,333,167,14,764,67,158270,4221,10111,148159,490,3731,10601,151890,92,66,3,2007
Randolph,10/12/20,23,121,121,535,5758,448,6300,64,17603,456,79,5564,194,402,46,18,5,36,28,6020,280,456,5564,86,194,542,5758,9,6,0,75
Saline,10/12/20,24,125,125,2443,35538,2179,37997,239,118009,2311,132,34476,1062,2073,106,22,2,215,24,36787,1210,2311,34476,148,1062,2459,35538,27,16,0,234
Scott,10/12/20,1,127,127,128,3245,114,3373,13,10442,126,2,3220,25,112,2,1,0,13,0,3346,27,126,3220,2,25,128,3245,0,1,0,27
Searcy,10/12/20,1,129,129,165,2613,151,2777,13,7923,159,6,2566,47,145,6,1,0,13,0,2725,52,159,2566,5,47,164,2613,1,1,0,73
Sebastian,10/12/20,80,131,131,4305,53515,3886,57823,338,127461,4204,101,53268,247,3816,70,72,8,315,23,57472,351,4204,53268,104,247,4308,53515,34,41,1,986
Sevier,10/12/20,19,133,133,1229,6939,1195,8165,15,17193,1202,27,6820,119,1175,20,19,0,8,7,8022,143,1202,6820,24,119,1226,6939,1,2,0,28
Sharp,10/12/20,9,135,135,282,4800,238,5081,35,17043,254,28,4722,78,217,21,9,0,28,7,4976,105,254,4722,27,78,281,4800,2,6,1,58
St.Francis,10/12/20,8,123,123,1625,13119,1541,14745,76,26294,1616,9,13082,37,1538,3,8,0,70,6,14698,47,1616,13082,10,37,1626,13119,14,7,0,141
Stone,10/12/20,19,137,137,379,3813,348,4195,12,12446,369,10,3770,43,341,7,19,0,9,3,4139,56,369,3770,13,43,382,3813,0,3,1,47
Union,10/12/20,47,139,139,1010,10293,918,11304,45,39732,936,74,10089,204,866,52,42,5,28,17,11025,279,936,10089,75,204,1011,10293,1,7,0,61
VanBuren,10/12/20,3,141,141,188,4935,176,5129,9,16684,183,5,4808,127,173,3,3,0,7,2,4991,138,183,4808,11,127,194,4935,0,3,0,103
Washington,10/12/20,127,143,143,10442,87192,9735,97697,580,228529,9648,794,83186,4006,9058,677,111,16,479,101,92834,4863,9648,83186,857,4006,10505,87192,62,53,1,989
White,10/12/20,32,145,145,1135,18923,932,20066,171,78804,978,157,17755,1168,822,110,27,5,129,42,18733,1333,978,17755,165,1168,1143,18923,22,12,2,207
Woodruff,10/12/20,0,147,147,74,1870,63,1945,11,6660,66,8,1848,22,56,7,0,0,10,1,1914,31,66,1848,9,22,75,1870,2,3,0,12
Yell,10/12/20,30,149,149,1293,11655,1234,12945,29,21573,1284,9,11557,98,1228,6,27,3,29,0,12841,104,1284,11557,6,98,1290,11655,0,0,0,53
Arkansas_all_counties,10/11/20,1569,5630,5630,92833,1081263,83454,1174564,7801,2990671,88302,4531,1058352,22911,80005,3449,1421,148,6867,934,1146654,27910,88302,1058352,4999,22911,93301,1081263,613,530,17,9168
Arkansas_county,10/11/20,12,1,1,553,7371,424,7941,117,18124,499,54,6636,735,393,31,12,0,94,23,7135,806,499,6636,71,735,570,7371,2,8,0,41
Ashley,10/11/20,12,3,3,476,5706,431,6185,33,20537,463,13,5601,105,426,5,12,0,25,8,6064,121,463,5601,16,105,479,5706,5,1,0,49
Baxter,10/11/20,4,5,5,465,4889,386,5357,75,41219,407,58,4839,50,335,51,4,0,68,7,5246,111,407,4839,61,50,468,4889,6,3,0,46
Benton,10/11/20,103,7,7,7197,79366,6741,86603,352,258980,6816,381,78125,1241,6449,292,86,17,280,72,84941,1662,6816,78125,421,1241,7237,79366,27,51,1,268
Boone,10/11/20,26,9,9,880,12236,757,13119,97,37288,797,83,12127,109,693,64,24,2,80,17,12924,195,797,12127,86,109,883,12236,9,13,0,80
Bradley,10/11/20,8,11,11,349,3757,335,4105,6,10948,347,2,3734,23,334,1,7,1,6,0,4081,24,347,3734,1,23,348,3757,1,0,0,7
Calhoun,10/11/20,0,13,13,39,1817,36,1856,3,5202,38,1,1802,15,35,1,0,0,3,0,1840,16,38,1802,1,15,39,1817,1,0,0,1
Carroll,10/11/20,12,15,15,858,7892,708,8756,138,27887,837,21,7829,63,695,13,12,0,130,8,8666,90,837,7829,27,63,864,7892,12,9,0,41
Chicot,10/11/20,22,17,17,1018,5405,989,6425,7,10826,1008,10,5308,97,980,9,21,1,7,0,6316,109,1008,5308,12,97,1020,5405,0,1,0,56
Clark,10/11/20,4,19,19,422,7528,371,7954,47,22385,391,31,7220,308,346,25,4,0,41,6,7611,343,391,7220,35,308,426,7528,4,5,0,61
Clay,10/11/20,11,21,21,380,5027,315,5408,53,15061,361,19,4821,206,304,11,9,2,47,6,5182,226,361,4821,20,206,381,5027,4,4,0,18
Cleburne,10/11/20,12,23,23,389,7630,341,8024,36,25230,358,31,7349,281,323,18,12,0,23,13,7707,317,358,7349,36,281,394,7630,1,2,0,44
Cleveland,10/11/20,12,25,25,196,3090,175,3286,9,8226,191,5,3035,55,172,3,11,1,8,1,3226,60,191,3035,5,55,196,3090,0,0,0,12
Columbia,10/11/20,18,27,27,612,6032,526,6656,68,23892,549,63,5928,104,475,51,18,0,56,12,6477,179,549,5928,75,104,624,6032,2,8,0,19
Conway,10/11/20,3,29,29,308,7316,278,7622,27,20906,292,16,7135,181,268,10,3,0,21,6,7427,195,292,7135,14,181,306,7316,1,1,0,40
Craighead,10/11/20,29,31,31,3622,39661,3119,43306,473,105701,3495,127,39141,520,3025,94,26,3,443,30,42636,670,3495,39141,150,520,3645,39661,24,26,0,508
Crawford,10/11/20,21,33,33,1736,23645,1501,25382,214,62472,1682,54,23446,199,1459,42,18,3,205,9,25128,254,1682,23446,55,199,1737,23645,32,16,1,238
Crittenden,10/11/20,50,35,35,2067,15035,1954,17093,63,49013,2043,24,14968,67,1940,14,43,7,60,3,17011,82,2043,14968,15,67,2058,15035,8,4,0,54
Cross,10/11/20,18,37,37,503,5468,449,5968,36,16998,474,29,5407,61,427,22,16,2,31,5,5881,87,474,5407,26,61,500,5468,3,5,0,22
Dallas,10/11/20,5,39,39,174,2384,164,2558,5,7432,172,2,2357,27,162,2,5,0,5,0,2529,29,172,2357,2,27,174,2384,0,0,0,11
Desha,10/11/20,6,41,41,345,4496,303,4841,36,11887,336,9,4400,96,298,5,6,0,32,4,4736,105,336,4400,9,96,345,4496,1,2,0,14
Drew,10/11/20,7,43,43,378,6558,350,6940,21,18502,363,15,6314,244,338,12,6,1,19,2,6677,263,363,6314,19,244,382,6558,4,0,0,26
Faulkner,10/11/20,26,45,45,2916,44050,2603,46981,286,122416,2773,143,42932,1118,2488,115,22,4,262,24,45705,1276,2773,42932,158,1118,2931,44050,16,27,0,527
Franklin,10/11/20,2,47,47,399,7388,305,7789,92,17780,384,15,7315,73,292,13,2,0,90,2,7699,90,384,7315,17,73,401,7388,7,3,0,48
Fulton,10/11/20,7,49,49,225,2113,180,2342,38,12139,202,23,1911,202,163,17,6,1,33,5,2113,229,202,1911,27,202,229,2113,5,4,0,24
Garland,10/11/20,56,51,51,2099,35045,1931,37146,112,98296,2057,42,34542,503,1906,25,51,5,100,12,36599,547,2057,34542,44,503,2101,35045,6,13,1,91
Grant,10/11/20,3,53,53,305,5981,273,6293,29,18086,288,17,5725,256,262,11,3,0,23,6,6013,280,288,5725,24,256,312,5981,2,0,1,38
Greene,10/11/20,15,55,55,1095,15999,931,17097,149,44623,1038,57,15793,206,889,42,15,0,134,15,16831,266,1038,15793,60,206,1098,15999,18,11,0,91
Hempstead,10/11/20,5,57,57,452,5607,395,6062,52,22018,420,32,5520,87,375,20,5,0,40,12,5940,122,420,5520,35,87,455,5607,2,2,0,28
HotSpring,10/11/20,29,59,59,2046,15054,1904,17103,113,33520,2034,12,14893,161,1896,8,27,2,111,2,16927,176,2034,14893,15,161,2049,15054,3,0,1,38
Howard,10/11/20,12,61,61,517,4017,482,4537,23,13389,484,33,3932,85,455,27,12,0,17,6,4416,121,484,3932,36,85,520,4017,2,0,0,12
Independence,10/11/20,26,63,63,1301,12981,1172,14294,103,37264,1099,202,12822,159,1013,159,24,2,62,41,13921,373,1099,12822,214,159,1313,12981,5,6,0,28
Izard,10/11/20,1,65,65,350,3970,260,4328,89,13559,323,27,3934,36,243,17,1,0,79,10,4257,71,323,3934,35,36,358,3970,4,2,0,23
Jackson,10/11/20,5,67,67,540,7201,387,7768,148,17225,397,143,7174,27,290,97,4,1,103,45,7571,197,397,7174,170,27,567,7201,39,5,0,116
Jefferson,10/11/20,91,69,69,3741,34193,3341,37965,308,70424,3679,62,33851,342,3303,38,86,5,289,19,37530,435,3679,33851,93,342,3772,34193,12,57,1,469
Johnson,10/11/20,8,71,71,910,8848,869,9762,33,26291,900,10,8719,129,862,7,8,0,30,3,9619,143,900,8719,14,129,914,8848,1,2,1,34
Lafayette,10/11/20,3,73,73,136,1236,121,1374,12,6915,127,9,1228,8,113,8,3,0,11,1,1355,19,127,1228,11,8,138,1236,2,2,0,10
Lawrence,10/11/20,13,75,75,592,5182,458,5781,121,16669,539,53,5087,95,416,42,13,0,110,11,5626,155,539,5087,60,95,599,5182,9,6,0,36
Lee,10/11/20,18,77,77,1091,4612,1051,5704,22,9398,1087,4,4598,14,1049,2,17,1,21,1,5685,19,1087,4598,5,14,1092,4612,0,1,0,28
Lincoln,10/11/20,17,79,79,2148,8070,2012,10227,119,13695,2138,10,7989,81,2005,7,16,1,117,2,10127,100,2138,7989,19,81,2157,8070,7,0,0,28
LittleRiver,10/11/20,28,81,81,394,1960,350,2347,16,12417,371,23,1917,43,334,16,23,5,14,2,2288,59,371,1917,16,43,387,1960,1,1,0,3
Logan,10/11/20,2,83,83,498,8231,426,8730,70,21757,494,4,8182,49,425,1,2,0,67,3,8676,54,494,8182,5,49,499,8231,3,4,0,43
Lonoke,10/11/20,17,85,85,1407,23571,1256,25036,134,72206,1224,183,21634,1937,1090,166,16,1,118,16,22858,2178,1224,21634,241,1937,1465,23571,8,8,0,139
Madison,10/11/20,5,87,87,394,4589,369,4984,20,16076,371,23,4491,98,351,18,5,0,15,5,4862,122,371,4491,24,98,395,4589,1,4,0,32
Marion,10/11/20,0,89,89,116,2703,106,2819,10,16438,109,7,2683,20,101,5,0,0,8,2,2792,27,109,2683,7,20,116,2703,1,1,0,9
Miller,10/11/20,13,91,91,1036,7072,895,8108,128,43759,939,97,6946,126,815,80,11,2,113,15,7885,223,939,6946,97,126,1036,7072,6,5,1,31
MissingCountyInfo,10/11/20,0,5,5,1968,51107,1449,53067,519,NA,1784,184,51106,1,1298,151,0,0,486,33,52890,177,1784,51106,176,1,1960,51107,40,8,0,1822
Mississippi,10/11/20,54,93,93,1866,12528,1689,14381,122,42831,1808,58,12455,73,1658,31,43,11,106,16,14263,118,1808,12455,45,73,1853,12528,17,13,0,71
Monroe,10/11/20,0,95,95,182,2601,139,2783,43,7249,176,6,2559,42,137,2,0,0,39,4,2735,48,176,2559,6,42,182,2601,4,2,0,40
Montgomery,10/11/20,7,97,97,173,2433,154,2605,12,8993,170,3,2400,33,151,3,7,0,12,0,2570,35,170,2400,2,33,172,2433,0,1,0,4
Nevada,10/11/20,14,99,99,250,3839,217,4086,19,8440,236,14,3789,50,205,12,13,1,18,1,4025,61,236,3789,11,50,247,3839,3,3,0,18
Newton,10/11/20,19,101,101,273,2009,233,2277,21,7848,255,18,1865,144,221,12,16,3,18,3,2120,157,255,1865,13,144,268,2009,2,1,0,9
Ouachita,10/11/20,7,103,103,293,6523,263,6823,23,24106,284,9,6476,47,255,8,7,0,22,1,6760,63,284,6476,16,47,300,6523,0,0,0,68
Perry,10/11/20,0,105,105,115,3769,95,3884,20,10322,109,6,3685,84,90,5,0,0,19,1,3794,90,109,3685,6,84,115,3769,0,0,0,24
Phillips,10/11/20,15,107,107,619,7594,525,8219,79,19034,609,10,7517,77,519,6,15,0,75,4,8126,93,609,7517,16,77,625,7594,6,1,0,33
Pike,10/11/20,3,109,109,247,2509,227,2755,17,10808,242,5,2448,61,226,1,2,1,14,3,2690,65,242,2448,4,61,246,2509,0,0,0,9
Poinsett,10/11/20,14,111,111,805,9647,683,10453,108,24054,767,38,9614,33,658,25,13,1,96,12,10381,72,767,9614,39,33,806,9647,15,5,0,91
Polk,10/11/20,4,113,113,305,5101,268,5407,33,20163,301,4,5054,47,267,1,4,0,30,3,5355,52,301,5054,5,47,306,5101,1,1,0,24
Pope,10/11/20,36,115,115,2390,25777,2184,28162,170,63644,2324,66,25500,277,2146,38,32,4,146,24,27824,338,2324,25500,61,277,2385,25777,7,15,0,275
Prairie,10/11/20,4,117,117,181,2580,155,2763,22,8244,168,13,2376,204,147,8,4,0,17,5,2544,219,168,2376,15,204,183,2580,4,4,0,29
Pulaski,10/11/20,178,119,119,10433,149975,9446,160483,808,393463,10031,402,146286,3689,9119,327,164,14,747,61,156317,4166,10031,146286,477,3689,10508,149975,102,49,3,1586
Randolph,10/11/20,23,121,121,526,5692,442,6225,61,17603,455,71,5497,195,399,43,18,5,38,23,5952,273,455,5497,78,195,533,5692,4,3,0,27
Saline,10/11/20,24,125,125,2416,35331,2163,37764,228,118009,2291,125,34277,1054,2060,103,22,2,208,20,36568,1196,2291,34277,142,1054,2433,35331,17,16,0,183
Scott,10/11/20,1,127,127,128,3218,113,3346,14,10442,126,2,3193,25,111,2,1,0,14,0,3319,27,126,3193,2,25,128,3218,0,2,0,13
Searcy,10/11/20,1,129,129,164,2541,150,2704,13,7923,158,6,2498,43,144,6,1,0,13,0,2656,48,158,2498,5,43,163,2541,0,0,0,4
Sebastian,10/11/20,79,131,131,4271,52563,3845,56837,346,127461,4171,100,52317,246,3779,66,71,8,320,26,56488,349,4171,52317,103,246,4274,52563,17,16,2,428
Sevier,10/11/20,19,133,133,1228,6912,1193,8137,16,17193,1201,27,6807,105,1175,18,19,0,7,9,8008,129,1201,6807,24,105,1225,6912,2,1,0,13
Sharp,10/11/20,8,135,135,280,4744,232,5023,40,17043,252,28,4666,78,213,19,8,0,31,9,4918,105,252,4666,27,78,279,4744,6,3,0,37
St.Francis,10/11/20,8,123,123,1611,12992,1534,14604,69,26294,1602,9,12957,35,1532,2,8,0,62,7,14559,45,1602,12957,10,35,1612,12992,4,6,0,24
Stone,10/11/20,18,137,137,379,3766,345,4148,16,12446,369,10,3725,41,338,7,18,0,13,3,4094,54,369,3725,13,41,382,3766,1,-1,1,33
Union,10/11/20,47,139,139,1009,10233,911,11243,51,39732,935,74,10034,199,863,48,42,5,30,21,10969,274,935,10034,75,199,1010,10233,2,5,0,47
VanBuren,10/11/20,3,141,141,188,4832,173,5026,12,16684,183,5,4717,115,170,3,3,0,10,2,4900,126,183,4717,11,115,194,4832,4,0,0,25
Washington,10/11/20,126,143,143,10380,86265,9682,96707,572,228529,9586,794,82262,4003,9019,663,110,16,457,115,91848,4859,9586,82262,856,4003,10442,86265,27,33,3,407
White,10/11/20,30,145,145,1113,18738,920,19865,163,78804,965,148,17587,1151,811,109,26,4,128,35,18552,1313,965,17587,162,1151,1127,18738,20,16,0,157
Woodruff,10/11/20,0,147,147,72,1860,60,1933,12,6660,64,8,1838,22,53,7,0,0,11,1,1902,31,64,1838,9,22,73,1860,1,2,0,6
Yell,10/11/20,30,149,149,1293,11602,1234,12892,29,21573,1284,9,11507,95,1228,6,27,3,29,0,12791,101,1284,11507,6,95,1290,11602,0,2,0,79
Arkansas_all_counties,10/10/20,1552,5630,5630,92220,1072708,82924,1165398,7735,2990671,87748,4472,1049968,22740,79541,3383,1405,147,6793,942,1137716,27682,87748,1049968,4942,22740,92690,1072708,908,619,22,8577
Arkansas_county,10/10/20,12,1,1,551,7332,416,7900,123,18124,499,52,6599,733,386,30,12,0,101,22,7098,802,499,6599,69,733,568,7332,13,6,0,50
Ashley,10/10/20,12,3,3,471,5662,430,6136,29,20537,461,10,5557,105,425,5,12,0,24,5,6018,118,461,5557,13,105,474,5662,6,3,0,42
Baxter,10/10/20,4,5,5,459,4849,383,5311,72,41219,401,58,4799,50,333,50,4,0,64,8,5200,111,401,4799,61,50,462,4849,10,4,0,74
Benton,10/10/20,102,7,7,7170,79125,6690,86336,377,258980,6794,376,77892,1233,6408,282,85,17,300,77,84686,1650,6794,77892,417,1233,7211,79125,49,32,4,331
Boone,10/10/20,26,9,9,871,12165,744,13039,101,37288,788,83,12057,108,683,61,24,2,81,20,12845,194,788,12057,86,108,874,12165,11,1,2,101
Bradley,10/10/20,8,11,11,348,3751,335,4098,5,10948,346,2,3729,22,334,1,7,1,5,0,4075,23,346,3729,1,22,347,3751,0,1,0,11
Calhoun,10/10/20,0,13,13,38,1817,36,1855,2,5202,37,1,1802,15,35,1,0,0,2,0,1839,16,37,1802,1,15,38,1817,0,0,0,2
Carroll,10/10/20,12,15,15,846,7863,699,8715,135,27887,826,20,7800,63,687,12,12,0,127,8,8626,89,826,7800,26,63,852,7863,2,6,1,27
Chicot,10/10/20,22,17,17,1018,5349,988,6369,8,10826,1008,10,5253,96,979,9,21,1,8,0,6261,108,1008,5253,12,96,1020,5349,1,0,0,17
Clark,10/10/20,4,19,19,418,7471,366,7893,48,22385,388,30,7190,281,343,23,4,0,41,7,7578,315,388,7190,34,281,422,7471,6,8,0,51
Clay,10/10/20,11,21,21,376,5013,311,5390,53,15061,357,19,4807,206,300,11,9,2,47,6,5164,226,357,4807,20,206,377,5013,4,7,0,53
Cleburne,10/10/20,12,23,23,388,7587,339,7980,37,25230,357,31,7308,279,322,17,12,0,23,14,7665,315,357,7308,36,279,393,7587,6,0,0,92
Cleveland,10/10/20,12,25,25,196,3078,175,3274,9,8226,191,5,3023,55,172,3,11,1,8,1,3214,60,191,3023,5,55,196,3078,0,0,0,14
Columbia,10/10/20,18,27,27,610,6015,518,6637,74,23892,547,63,5911,104,468,50,18,0,61,13,6458,179,547,5911,75,104,622,6015,8,9,0,44
Conway,10/10/20,3,29,29,307,7277,277,7582,27,20906,291,16,7090,187,267,10,3,0,21,6,7381,201,291,7090,14,187,305,7277,1,2,0,35
Craighead,10/10/20,29,31,31,3598,39177,3093,42798,475,105701,3471,127,38657,520,3000,93,26,3,444,31,42128,670,3471,38657,150,520,3621,39177,59,36,0,378
Crawford,10/10/20,20,33,33,1704,23439,1485,25144,199,62472,1653,51,23240,199,1443,42,17,3,193,6,24893,251,1653,23240,52,199,1705,23439,21,22,0,247
Crittenden,10/10/20,50,35,35,2059,14989,1950,17038,59,49013,2035,24,14922,67,1936,14,43,7,56,3,16957,81,2035,14922,14,67,2049,14989,6,3,2,51
Cross,10/10/20,18,37,37,500,5449,444,5946,38,16998,472,28,5388,61,422,22,16,2,34,4,5860,86,472,5388,25,61,497,5449,0,3,1,14
Dallas,10/10/20,5,39,39,174,2373,164,2547,5,7432,172,2,2346,27,162,2,5,0,5,0,2518,29,172,2346,2,27,174,2373,0,0,0,13
Desha,10/10/20,6,41,41,344,4483,301,4827,37,11887,335,9,4388,95,296,5,6,0,33,4,4723,104,335,4388,9,95,344,4483,4,0,0,7
Drew,10/10/20,7,43,43,374,6536,350,6914,17,18502,359,15,6292,244,338,12,6,1,15,2,6651,263,359,6292,19,244,378,6536,0,0,0,8
Faulkner,10/10/20,26,45,45,2900,43539,2576,46454,297,122416,2757,143,42431,1108,2461,115,22,4,273,24,45188,1266,2757,42431,158,1108,2915,43539,29,18,2,414
Franklin,10/10/20,2,47,47,392,7347,302,7741,88,17780,377,15,7277,70,289,13,2,0,86,2,7654,87,377,7277,17,70,394,7347,16,5,0,134
Fulton,10/10/20,7,49,49,220,2094,176,2318,37,12139,197,23,1892,202,159,17,6,1,32,5,2089,229,197,1892,27,202,224,2094,6,2,1,29
Garland,10/10/20,55,51,51,2093,34960,1918,37055,120,98296,2051,42,34461,499,1893,25,50,5,108,12,36512,543,2051,34461,44,499,2095,34960,10,12,0,124
Grant,10/10/20,2,53,53,303,5945,273,6255,28,18086,286,17,5689,256,262,11,2,0,22,6,5975,280,286,5689,24,256,310,5945,6,2,0,46
Greene,10/10/20,15,55,55,1077,15926,920,17006,142,44623,1022,55,15720,206,879,41,15,0,128,14,16742,264,1022,15720,58,206,1080,15926,24,17,0,119
Hempstead,10/10/20,5,57,57,450,5581,393,6034,52,22018,419,31,5497,84,373,20,5,0,41,11,5916,118,419,5497,34,84,453,5581,7,7,0,21
HotSpring,10/10/20,28,59,59,2043,15019,1904,17065,111,33520,2031,12,14860,159,1896,8,26,2,109,2,16891,174,2031,14860,15,159,2046,15019,11,3,0,124
Howard,10/10/20,12,61,61,515,4007,482,4525,21,13389,483,32,3922,85,455,27,12,0,16,5,4405,120,483,3922,35,85,518,4007,1,1,0,21
Independence,10/10/20,26,63,63,1296,12958,1166,14266,104,37264,1096,200,12798,160,1008,158,24,2,64,40,13894,372,1096,12798,212,160,1308,12958,11,6,0,39
Izard,10/10/20,1,65,65,346,3951,258,4305,87,13559,319,27,3915,36,243,15,1,0,75,12,4234,71,319,3915,35,36,354,3951,8,2,0,22
Jackson,10/10/20,5,67,67,501,7124,382,7652,114,17225,363,138,7097,27,287,95,4,1,72,42,7460,192,363,7097,165,27,528,7124,16,0,1,145
Jefferson,10/10/20,90,69,69,3729,33736,3284,37496,354,70424,3669,60,33392,344,3246,38,85,5,337,17,37061,435,3669,33392,91,344,3760,33736,24,107,1,198
Johnson,10/10/20,7,71,71,909,8815,867,9728,35,26291,898,11,8686,129,860,7,7,0,31,4,9584,144,898,8686,15,129,913,8815,5,2,0,28
Lafayette,10/10/20,3,73,73,134,1228,119,1364,12,6915,125,9,1220,8,111,8,3,0,11,1,1345,19,125,1220,11,8,136,1228,1,0,0,8
Lawrence,10/10/20,13,75,75,583,5155,452,5745,118,16669,532,51,5060,95,410,42,13,0,109,9,5592,153,532,5060,58,95,590,5155,16,4,0,42
Lee,10/10/20,18,77,77,1091,4584,1050,5676,23,9398,1087,4,4570,14,1048,2,17,1,22,1,5657,19,1087,4570,5,14,1092,4584,3,1,0,119
Lincoln,10/10/20,17,79,79,2141,8049,2012,10199,112,13695,2131,10,7968,81,2005,7,16,1,110,2,10099,100,2131,7968,19,81,2150,8049,1,45,0,12
LittleRiver,10/10/20,28,81,81,393,1958,349,2344,16,12417,371,22,1915,43,334,15,23,5,14,2,2286,58,371,1915,15,43,386,1958,3,2,0,8
Logan,10/10/20,2,83,83,495,8191,422,8687,71,21757,491,4,8141,50,421,1,2,0,68,3,8632,55,491,8141,5,50,496,8191,8,4,0,24
Lonoke,10/10/20,17,85,85,1399,23440,1248,24897,134,72206,1217,182,21509,1931,1082,166,16,1,119,15,22726,2171,1217,21509,240,1931,1457,23440,17,10,0,102
Madison,10/10/20,5,87,87,393,4558,365,4952,23,16076,370,23,4461,97,348,17,5,0,17,6,4831,121,370,4461,24,97,394,4558,1,0,0,69
Marion,10/10/20,0,89,89,115,2695,105,2810,10,16438,108,7,2675,20,100,5,0,0,8,2,2783,27,108,2675,7,20,115,2695,1,3,0,25
Miller,10/10/20,12,91,91,1030,7047,890,8077,128,43759,933,97,6921,126,811,79,11,1,111,17,7854,223,933,6921,97,126,1030,7047,13,6,0,28
MissingCountyInfo,10/10/20,0,5,5,1928,49325,1441,51245,487,NA,1744,184,49324,1,1292,149,0,0,452,35,51068,177,1744,49324,176,1,1920,49325,31,0,0,2124
Mississippi,10/10/20,54,93,93,1849,12474,1676,14310,118,42831,1793,56,12401,73,1646,30,43,11,103,15,14194,116,1793,12401,43,73,1836,12474,21,9,0,59
Monroe,10/10/20,0,95,95,178,2565,137,2743,41,7249,172,6,2524,41,135,2,0,0,37,4,2696,47,172,2524,6,41,178,2565,5,2,0,34
Montgomery,10/10/20,7,97,97,173,2429,153,2601,13,8993,170,3,2396,33,150,3,7,0,13,0,2566,35,170,2396,2,33,172,2429,1,2,0,8
Nevada,10/10/20,14,99,99,247,3824,214,4068,19,8440,233,14,3774,50,205,9,13,1,15,4,4007,61,233,3774,11,50,244,3824,3,2,0,28
Newton,10/10/20,19,101,101,271,2002,232,2268,20,7848,253,18,1858,144,220,12,16,3,17,3,2111,157,253,1858,13,144,266,2002,3,1,0,8
Ouachita,10/10/20,7,103,103,293,6455,263,6755,23,24106,284,9,6408,47,255,8,7,0,22,1,6692,63,284,6408,16,47,300,6455,5,2,0,22
Perry,10/10/20,0,105,105,115,3745,95,3860,20,10322,109,6,3661,84,90,5,0,0,19,1,3770,90,109,3661,6,84,115,3745,2,0,0,24
Phillips,10/10/20,15,107,107,613,7567,524,8186,74,19034,603,10,7490,77,518,6,15,0,70,4,8093,93,603,7490,16,77,619,7567,17,2,0,169
Pike,10/10/20,3,109,109,247,2500,227,2746,17,10808,242,5,2442,58,226,1,2,1,14,3,2684,62,242,2442,4,58,246,2500,1,3,0,12
Poinsett,10/10/20,14,111,111,790,9571,678,10362,98,24054,754,36,9538,33,654,24,13,1,87,11,10292,70,754,9538,37,33,791,9571,9,6,-1,60
Polk,10/10/20,4,113,113,304,5078,267,5383,33,20163,300,4,5031,47,266,1,4,0,30,3,5331,52,300,5031,5,47,305,5078,0,1,0,85
Pope,10/10/20,36,115,115,2383,25509,2169,27887,178,63644,2318,65,25232,277,2133,36,32,4,153,25,27550,337,2318,25232,60,277,2378,25509,30,8,0,116
Prairie,10/10/20,4,117,117,177,2555,151,2734,22,8244,164,13,2352,203,145,6,4,0,15,7,2516,218,164,2352,15,203,179,2555,2,2,0,15
Pulaski,10/10/20,175,119,119,10331,148491,9397,158896,758,393463,9931,400,144851,3640,9072,325,161,14,697,61,154782,4114,9931,144851,474,3640,10405,148491,107,44,2,756
Randolph,10/10/20,23,121,121,522,5669,439,6198,60,17603,454,68,5474,195,397,42,18,5,39,21,5928,270,454,5474,75,195,529,5669,3,5,0,20
Saline,10/10/20,24,125,125,2399,35165,2147,37581,227,118009,2276,123,34113,1052,2045,102,22,2,208,19,36389,1192,2276,34113,140,1052,2416,35165,22,15,0,198
Scott,10/10/20,1,127,127,128,3205,111,3333,16,10442,126,2,3180,25,110,1,1,0,15,1,3306,27,126,3180,2,25,128,3205,0,1,0,10
Searcy,10/10/20,1,129,129,164,2537,150,2700,13,7923,158,6,2495,42,144,6,1,0,13,0,2653,47,158,2495,5,42,163,2537,1,1,0,42
Sebastian,10/10/20,77,131,131,4254,52152,3829,56409,347,127461,4156,98,51907,245,3765,64,69,8,321,26,56063,346,4156,51907,101,245,4257,52152,66,46,5,371
Sevier,10/10/20,19,133,133,1226,6901,1192,8125,15,17193,1201,25,6796,105,1175,17,19,0,7,8,7997,128,1201,6796,23,105,1224,6901,2,0,0,22
Sharp,10/10/20,8,135,135,274,4713,229,4986,37,17043,248,26,4635,78,210,19,8,0,30,7,4883,103,248,4635,25,78,273,4713,3,3,1,21
St.Francis,10/10/20,8,123,123,1607,12972,1528,14580,71,26294,1598,9,12937,35,1526,2,8,0,64,7,14535,45,1598,12937,10,35,1608,12972,24,4,0,74
Stone,10/10/20,17,137,137,378,3734,346,4115,15,12446,369,9,3693,41,339,7,17,0,13,2,4062,53,369,3693,12,41,381,3734,1,0,0,37
Union,10/10/20,47,139,139,1007,10188,906,11196,54,39732,934,73,9988,200,861,45,42,5,31,23,10922,274,934,9988,74,200,1008,10188,5,5,0,25
VanBuren,10/10/20,3,141,141,184,4811,173,5001,8,16684,180,4,4694,117,170,3,3,0,7,1,4874,127,180,4694,10,117,190,4811,2,0,0,16
Washington,10/10/20,123,143,143,10353,85885,9649,96300,581,228529,9562,791,81936,3949,8997,652,107,16,458,123,91498,4802,9562,81936,853,3949,10415,85885,73,46,0,420
White,10/10/20,30,145,145,1093,18601,904,19710,159,78804,948,145,17450,1151,798,106,26,4,124,35,18398,1312,948,17450,161,1151,1109,18601,20,4,0,199
Woodruff,10/10/20,0,147,147,71,1855,58,1927,13,6660,63,8,1833,22,51,7,0,0,12,1,1896,31,63,1833,9,22,72,1855,2,0,0,9
Yell,10/10/20,30,149,149,1293,11523,1232,12813,31,21573,1284,9,11428,95,1226,6,27,3,31,0,12712,101,1284,11428,6,95,1290,11523,2,3,0,30
Arkansas_all_counties,10/9/20,1530,5630,5630,91312,1065039,82305,1156803,7468,2990671,86960,4352,1042520,22519,79012,3293,1385,145,6554,914,1129480,27323,86960,1042520,4804,22519,91764,1065039,1167,742,27,19713
Arkansas_county,10/9/20,12,1,1,538,7295,410,7849,116,18124,489,49,6565,730,380,30,12,0,97,19,7054,795,489,6565,65,730,554,7295,11,11,1,136
Ashley,10/9/20,12,3,3,465,5626,427,6094,26,20537,457,8,5522,104,422,5,12,0,23,3,5979,115,457,5522,11,104,468,5626,8,3,0,74
Baxter,10/9/20,4,5,5,449,4785,379,5237,66,41219,391,58,4735,50,329,50,4,0,58,8,5126,111,391,4735,61,50,452,4785,15,8,1,157
Benton,10/9/20,98,7,7,7121,78843,6658,86005,364,258980,6756,365,77662,1181,6389,269,81,17,285,79,84418,1587,6756,77662,406,1181,7162,78843,56,39,0,1167
Boone,10/9/20,24,9,9,860,12075,743,12937,93,37288,777,83,11971,104,683,60,22,2,72,21,12748,189,777,11971,85,104,862,12075,17,13,0,339
Bradley,10/9/20,8,11,11,348,3740,334,4087,6,10948,346,2,3718,22,333,1,7,1,6,0,4064,23,346,3718,1,22,347,3740,3,0,0,41
Calhoun,10/9/20,0,13,13,38,1815,36,1853,2,5202,37,1,1800,15,35,1,0,0,2,0,1837,16,37,1800,1,15,38,1815,0,0,0,15
Carroll,10/9/20,11,15,15,844,7838,693,8688,140,27887,825,19,7776,62,681,12,11,0,133,7,8601,87,825,7776,25,62,850,7838,48,11,0,208
Chicot,10/9/20,22,17,17,1017,5333,988,6352,7,10826,1007,10,5237,96,979,9,21,1,7,0,6244,108,1007,5237,12,96,1019,5333,1,1,0,64
Clark,10/9/20,4,19,19,412,7426,358,7840,50,22385,383,29,7145,281,337,21,4,0,42,8,7528,312,383,7145,31,281,414,7426,3,6,0,177
Clay,10/9/20,11,21,21,372,4964,304,5337,56,15061,354,18,4760,204,293,11,9,2,51,5,5114,223,354,4760,19,204,373,4964,9,4,0,131
Cleburne,10/9/20,12,23,23,382,7501,339,7888,31,25230,352,30,7263,238,322,17,12,0,18,13,7615,273,352,7263,35,238,387,7501,5,5,0,159
Cleveland,10/9/20,12,25,25,196,3064,175,3260,9,8226,191,5,3009,55,172,3,11,1,8,1,3200,60,191,3009,5,55,196,3064,1,1,0,39
Columbia,10/9/20,18,27,27,602,5979,509,6593,75,23892,541,61,5877,102,462,47,18,0,61,14,6418,175,541,5877,73,102,614,5979,7,9,0,154
Conway,10/9/20,3,29,29,306,7243,275,7547,28,20906,290,16,7068,175,265,10,3,0,22,6,7358,189,290,7068,14,175,304,7243,2,4,0,69
Craighead,10/9/20,29,31,31,3539,38858,3057,42418,452,105701,3419,120,38340,518,2968,89,26,3,424,28,41759,659,3419,38340,141,518,3560,38858,88,45,1,1240
Crawford,10/9/20,20,33,33,1683,23213,1463,24897,200,62472,1632,51,23014,199,1423,40,17,3,192,8,24646,251,1632,23014,52,199,1684,23213,28,32,0,675
Crittenden,10/9/20,48,35,35,2053,14944,1947,16987,58,49013,2030,23,14878,66,1933,14,41,7,56,2,16908,79,2030,14878,13,66,2043,14944,12,11,0,138
Cross,10/9/20,17,37,37,500,5435,441,5931,42,16998,472,28,5373,62,421,20,15,2,36,6,5845,86,472,5373,24,62,496,5435,2,1,2,50
Dallas,10/9/20,5,39,39,174,2360,164,2534,5,7432,172,2,2333,27,162,2,5,0,5,0,2505,29,172,2333,2,27,174,2360,0,0,0,32
Desha,10/9/20,6,41,41,340,4480,301,4820,33,11887,331,9,4385,95,296,5,6,0,29,4,4716,104,331,4385,9,95,340,4480,6,3,0,126
Drew,10/9/20,7,43,43,374,6528,350,6906,17,18502,359,15,6284,244,338,12,6,1,15,2,6643,263,359,6284,19,244,378,6528,2,1,0,158
Faulkner,10/9/20,24,45,45,2871,43154,2558,46041,288,122416,2732,139,42038,1116,2445,113,21,3,265,23,44770,1271,2732,42038,155,1116,2887,43154,40,31,1,688
Franklin,10/9/20,2,47,47,376,7229,297,7606,77,17780,361,15,7159,70,285,12,2,0,74,3,7520,86,361,7159,16,70,377,7229,14,5,0,214
Fulton,10/9/20,6,49,49,214,2071,174,2289,34,12139,191,23,1869,202,157,17,5,1,29,5,2060,229,191,1869,27,202,218,2071,1,5,1,113
Garland,10/9/20,55,51,51,2083,34846,1906,36931,122,98296,2044,39,34346,500,1883,23,50,5,111,11,36390,541,2044,34346,41,500,2085,34846,12,23,0,440
Grant,10/9/20,2,53,53,297,5905,271,6209,24,18086,284,13,5651,254,261,10,2,0,21,3,5935,274,284,5651,20,254,304,5905,5,5,0,219
Greene,10/9/20,15,55,55,1053,15831,903,16886,135,44623,999,54,15629,202,864,39,15,0,120,15,16628,258,999,15629,56,202,1055,15831,29,12,0,534
Hempstead,10/9/20,5,57,57,443,5567,386,6013,52,22018,413,30,5483,84,370,16,5,0,38,14,5896,117,413,5483,33,84,446,5567,7,5,1,98
HotSpring,10/9/20,28,59,59,2032,14906,1901,16941,103,33520,2020,12,14747,159,1893,8,26,2,101,2,16767,174,2020,14747,15,159,2035,14906,25,1,0,319
Howard,10/9/20,12,61,61,514,3987,481,4504,21,13389,483,31,3902,85,454,27,12,0,17,4,4385,119,483,3902,34,85,517,3987,3,4,0,33
Independence,10/9/20,26,63,63,1285,12930,1160,14227,99,37264,1087,198,12771,159,1006,154,24,2,57,42,13858,369,1087,12771,210,159,1297,12930,16,26,0,240
Izard,10/9/20,1,65,65,338,3937,256,4283,81,13559,312,26,3901,36,242,14,1,0,69,12,4213,70,312,3901,34,36,346,3937,35,4,0,192
Jackson,10/9/20,4,67,67,485,6995,382,7507,99,17225,355,130,6968,27,287,95,3,1,65,34,7323,184,355,6968,157,27,512,6995,12,5,2,54
Jefferson,10/9/20,89,69,69,3705,33562,3177,37298,438,70424,3645,60,33221,341,3139,38,84,5,421,17,36866,432,3645,33221,91,341,3736,33562,33,42,2,379
Johnson,10/9/20,7,71,71,904,8792,865,9700,32,26291,893,11,8663,129,858,7,7,0,28,4,9556,144,893,8663,15,129,908,8792,8,6,0,73
Lafayette,10/9/20,3,73,73,133,1221,119,1356,11,6915,124,9,1213,8,111,8,3,0,10,1,1337,19,124,1213,11,8,135,1221,1,3,0,19
Lawrence,10/9/20,13,75,75,567,5129,448,5702,106,16669,519,48,5034,95,406,42,13,0,100,6,5553,149,519,5034,54,95,573,5129,21,4,0,106
Lee,10/9/20,18,77,77,1088,4468,1049,5557,21,9398,1084,4,4454,14,1047,2,17,1,20,1,5538,19,1084,4454,5,14,1089,4468,1,3,0,16
Lincoln,10/9/20,17,79,79,2140,8038,1967,10187,156,13695,2130,10,7958,80,1960,7,16,1,154,2,10088,99,2130,7958,19,80,2149,8038,40,4,0,223
LittleRiver,10/9/20,28,81,81,390,1953,347,2335,15,12417,367,23,1910,43,332,15,23,5,12,3,2277,58,367,1910,15,43,382,1953,12,6,1,56
Logan,10/9/20,2,83,83,487,8175,418,8663,67,21757,484,3,8126,49,417,1,2,0,65,2,8610,53,484,8126,4,49,488,8175,7,2,0,104
Lonoke,10/9/20,17,85,85,1382,23355,1238,24795,127,72206,1205,177,21431,1924,1076,162,16,1,113,14,22636,2159,1205,21431,235,1924,1440,23355,12,17,0,342
Madison,10/9/20,5,87,87,392,4490,365,4883,22,16076,369,23,4394,96,348,17,5,0,16,6,4763,120,369,4394,24,96,393,4490,7,7,0,85
Marion,10/9/20,0,89,89,114,2671,102,2785,12,16438,107,7,2651,20,97,5,0,0,10,2,2758,27,107,2651,7,20,114,2671,2,2,0,93
Miller,10/9/20,12,91,91,1017,7032,884,8049,121,43759,923,94,6906,126,809,75,11,1,103,18,7829,220,923,6906,94,126,1017,7032,12,15,1,98
MissingCountyInfo,10/9/20,0,5,5,1897,47232,1441,49121,456,NA,1714,183,47231,1,1292,149,0,0,422,34,48945,176,1714,47231,175,1,1889,47232,-4,-21,0,1380
Mississippi,10/9/20,54,93,93,1828,12436,1667,14251,106,42831,1774,54,12364,72,1640,27,43,11,90,16,14138,113,1774,12364,41,72,1815,12436,20,12,1,185
Monroe,10/9/20,0,95,95,173,2536,135,2709,38,7249,167,6,2495,41,133,2,0,0,34,4,2662,47,167,2495,6,41,173,2536,8,2,0,77
Montgomery,10/9/20,7,97,97,172,2422,151,2593,14,8993,169,3,2389,33,149,2,7,0,13,1,2558,35,169,2389,2,33,171,2422,2,3,0,27
Nevada,10/9/20,14,99,99,244,3799,212,4040,18,8440,230,14,3749,50,203,9,13,1,14,4,3979,61,230,3749,11,50,241,3799,3,3,0,202
Newton,10/9/20,19,101,101,268,1997,231,2260,18,7848,251,17,1853,144,220,11,16,3,15,3,2104,156,251,1853,12,144,263,1997,4,3,0,56
Ouachita,10/9/20,7,103,103,288,6438,261,6733,20,24106,279,9,6391,47,253,8,7,0,19,1,6670,63,279,6391,16,47,295,6438,0,3,0,65
Perry,10/9/20,0,105,105,113,3723,95,3836,18,10322,107,6,3637,86,90,5,0,0,17,1,3744,92,107,3637,6,86,113,3723,1,2,0,39
Phillips,10/9/20,15,107,107,596,7415,522,8017,59,19034,587,9,7338,77,516,6,15,0,56,3,7925,92,587,7338,15,77,602,7415,8,11,0,61
Pike,10/9/20,3,109,109,246,2489,224,2734,19,10808,241,5,2431,58,223,1,2,1,16,3,2672,62,241,2431,4,58,245,2489,3,0,0,35
Poinsett,10/9/20,15,111,111,781,9520,672,10301,94,24054,745,36,9487,33,648,24,14,1,83,11,10232,69,745,9487,36,33,781,9520,18,14,0,222
Polk,10/9/20,4,113,113,304,4993,266,5298,34,20163,300,4,4946,47,265,1,4,0,31,3,5246,52,300,4946,5,47,305,4993,2,1,0,89
Pope,10/9/20,36,115,115,2353,25423,2161,27771,156,63644,2297,56,25148,275,2127,34,32,4,138,18,27445,326,2297,25148,51,275,2348,25423,21,18,0,313
Prairie,10/9/20,4,117,117,175,2542,149,2719,22,8244,162,13,2339,203,143,6,4,0,15,7,2501,218,162,2339,15,203,177,2542,1,3,0,55
Pulaski,10/9/20,173,119,119,10224,147842,9353,158137,697,393463,9833,391,144250,3592,9036,317,159,14,637,60,154083,4054,9833,144250,462,3592,10295,147842,94,44,4,2245
Randolph,10/9/20,23,121,121,519,5652,434,6178,62,17603,451,68,5457,195,393,41,19,4,39,23,5908,270,451,5457,75,195,526,5652,17,8,0,105
Saline,10/9/20,24,125,125,2377,34989,2132,37381,220,118009,2254,123,33940,1049,2031,101,22,2,200,20,36194,1187,2254,33940,138,1049,2392,34989,23,17,0,523
Scott,10/9/20,1,127,127,128,3195,110,3323,17,10442,126,2,3170,25,110,0,1,0,15,2,3296,27,126,3170,2,25,128,3195,1,3,0,30
Searcy,10/9/20,1,129,129,163,2496,149,2658,13,7923,157,6,2455,41,143,6,1,0,13,0,2612,46,157,2455,5,41,162,2496,2,1,0,77
Sebastian,10/9/20,72,131,131,4188,51847,3783,56038,332,127461,4098,90,51602,245,3725,58,64,8,308,24,55700,338,4098,51602,93,245,4191,51847,81,65,5,1107
Sevier,10/9/20,19,133,133,1224,6881,1192,8103,13,17193,1199,25,6776,105,1175,17,19,0,5,8,7975,128,1199,6776,23,105,1222,6881,3,1,0,117
Sharp,10/9/20,7,135,135,271,4695,226,4965,38,17043,247,24,4617,78,207,19,7,0,33,5,4864,101,247,4617,23,78,270,4695,6,3,0,174
St.Francis,10/9/20,8,123,123,1583,12922,1524,14506,51,26294,1577,6,12887,35,1522,2,8,0,47,4,14464,42,1577,12887,7,35,1584,12922,7,10,0,125
Stone,10/9/20,17,137,137,377,3698,346,4078,14,12446,368,9,3659,39,339,7,17,0,12,2,4027,51,368,3659,12,39,380,3698,4,2,1,49
Union,10/9/20,47,139,139,1002,10168,901,11171,54,39732,931,71,9969,199,859,42,42,5,30,24,10900,271,931,9969,72,199,1003,10168,19,11,0,68
VanBuren,10/9/20,3,141,141,182,4797,173,4985,6,16684,178,4,4681,116,170,3,3,0,5,1,4859,126,178,4681,10,116,188,4797,2,1,0,133
Washington,10/9/20,123,143,143,10280,85538,9603,95878,554,228529,9500,780,81605,3933,8959,644,107,16,434,120,91105,4773,9500,81605,840,3933,10340,85538,109,59,1,1474
White,10/9/20,30,145,145,1073,18422,900,19511,143,78804,933,140,17287,1135,796,104,26,4,111,32,18220,1291,933,17287,156,1135,1089,18422,26,17,1,404
Woodruff,10/9/20,0,147,147,69,1848,58,1918,11,6660,61,8,1826,22,51,7,0,0,10,1,1887,31,61,1826,9,22,70,1848,4,0,0,45
Yell,10/9/20,30,149,149,1291,11495,1229,12783,32,21573,1282,9,11401,94,1224,5,27,3,31,1,12683,100,1282,11401,6,94,1288,11495,3,1,0,144
Arkansas_all_counties,10/8/20,1503,5630,5630,90145,1046493,81563,1137064,7070,2990671,85980,4165,1025546,20947,78405,3158,1359,144,6207,863,1111526,25538,85980,1025546,4591,20947,90571,1046493,1265,860,21,15128
Arkansas_county,10/8/20,11,1,1,527,7170,399,7713,117,18124,482,45,6443,727,372,27,11,0,99,18,6925,788,482,6443,61,727,543,7170,29,3,1,141
Ashley,10/8/20,12,3,3,457,5560,424,6020,21,20537,450,7,5465,95,419,5,12,0,19,2,5915,105,450,5465,10,95,460,5560,2,2,1,51
Baxter,10/8/20,3,5,5,434,4643,371,5080,60,41219,379,55,4597,46,324,47,3,0,52,8,4976,104,379,4597,58,46,437,4643,14,5,1,100
Benton,10/8/20,98,7,7,7065,77732,6619,84835,347,258980,6707,358,76731,1001,6358,261,81,17,267,80,83438,1397,6707,76731,396,1001,7103,77732,76,39,0,867
Boone,10/8/20,24,9,9,843,11753,730,12598,89,37288,763,80,11662,91,674,56,22,2,67,22,12425,173,763,11662,82,91,845,11753,17,11,4,273
Bradley,10/8/20,8,11,11,345,3702,334,4046,3,10948,343,2,3681,21,333,1,7,1,3,0,4024,22,343,3681,1,21,344,3702,0,1,0,28
Calhoun,10/8/20,0,13,13,38,1800,36,1838,2,5202,37,1,1785,15,35,1,0,0,2,0,1822,16,37,1785,1,15,38,1800,1,0,0,11
Carroll,10/8/20,11,15,15,796,7678,682,8479,103,27887,777,19,7623,55,670,12,11,0,96,7,8400,79,777,7623,24,55,801,7678,21,8,0,89
Chicot,10/8/20,22,17,17,1016,5270,987,6288,7,10826,1006,10,5177,93,978,9,21,1,7,0,6183,105,1006,5177,12,93,1018,5270,1,0,0,22
Clark,10/8/20,4,19,19,409,7252,352,7663,53,22385,381,28,7025,227,332,20,4,0,45,8,7406,257,381,7025,30,227,411,7252,8,4,0,112
Clay,10/8/20,11,21,21,363,4842,300,5206,51,15061,346,17,4641,201,289,11,9,2,47,4,4987,219,346,4641,18,201,364,4842,11,8,1,60
Cleburne,10/8/20,12,23,23,377,7347,334,7729,31,25230,347,30,7113,234,317,17,12,0,18,13,7460,269,347,7113,35,234,382,7347,5,2,2,76
Cleveland,10/8/20,12,25,25,195,3026,174,3221,9,8226,190,5,2972,54,172,2,11,1,7,2,3162,59,190,2972,5,54,195,3026,1,1,0,19
Columbia,10/8/20,18,27,27,595,5832,500,6439,77,23892,536,59,5736,96,456,44,18,0,62,15,6272,167,536,5736,71,96,607,5832,11,18,0,102
Conway,10/8/20,3,29,29,304,7176,271,7478,30,20906,288,16,6997,179,263,8,3,0,22,8,7285,193,288,6997,14,179,302,7176,4,6,0,79
Craighead,10/8/20,28,31,31,3451,37706,3012,41173,410,105701,3339,112,37294,412,2928,84,25,3,385,25,40633,540,3339,37294,128,412,3467,37706,55,31,0,762
Crawford,10/8/20,20,33,33,1655,22566,1431,24222,204,62472,1608,47,22376,190,1393,38,17,3,198,6,23984,238,1608,22376,48,190,1656,22566,52,30,0,291
Crittenden,10/8/20,48,35,35,2041,14818,1936,16849,57,49013,2018,23,14757,61,1923,13,41,7,54,3,16775,74,2018,14757,13,61,2031,14818,13,13,0,95
Cross,10/8/20,15,37,37,498,5387,440,5881,43,16998,469,29,5327,60,420,20,13,2,36,7,5796,85,469,5327,25,60,494,5387,5,4,1,40
Dallas,10/8/20,5,39,39,174,2328,164,2502,5,7432,172,2,2302,26,162,2,5,0,5,0,2474,28,172,2302,2,26,174,2328,1,0,0,23
Desha,10/8/20,6,41,41,334,4360,298,4694,30,11887,326,8,4271,89,293,5,6,0,27,3,4597,97,326,4271,8,89,334,4360,7,5,0,45
Drew,10/8/20,7,43,43,372,6372,349,6747,16,18502,356,16,6200,172,337,12,6,1,13,3,6556,191,356,6200,19,172,375,6372,4,2,0,109
Faulkner,10/8/20,23,45,45,2831,42506,2527,45354,280,122416,2700,131,41425,1081,2418,109,20,3,261,19,44125,1229,2700,41425,148,1081,2848,42506,36,41,0,395
Franklin,10/8/20,2,47,47,362,7029,292,7392,68,17780,348,14,6960,69,280,12,2,0,66,2,7308,84,348,6960,15,69,363,7029,23,4,0,96
Fulton,10/8/20,5,49,49,213,1959,169,2176,39,12139,190,23,1775,184,153,16,4,1,33,6,1965,211,190,1775,27,184,217,1959,4,3,0,48
Garland,10/8/20,55,51,51,2071,34418,1883,36491,133,98296,2036,35,33936,482,1861,22,50,5,125,8,35972,519,2036,33936,37,482,2073,34418,16,29,0,982
Grant,10/8/20,2,53,53,292,5691,266,5990,24,18086,280,12,5577,114,256,10,2,0,22,2,5857,133,280,5577,19,114,299,5691,8,5,0,71
Greene,10/8/20,15,55,55,1024,15326,891,16352,118,44623,974,50,15139,187,852,39,15,0,107,11,16113,239,974,15139,52,187,1026,15326,29,12,0,347
Hempstead,10/8/20,4,57,57,436,5476,381,5915,51,22018,406,30,5396,80,367,14,4,0,35,16,5802,113,406,5396,33,80,439,5476,9,3,0,29
HotSpring,10/8/20,28,59,59,2007,14612,1900,16622,79,33520,1995,12,14461,151,1892,8,26,2,77,2,16456,166,1995,14461,15,151,2010,14612,16,16,0,239
Howard,10/8/20,12,61,61,511,3957,477,4471,22,13389,481,30,3882,75,451,26,12,0,18,4,4363,108,481,3882,33,75,514,3957,8,5,0,26
Independence,10/8/20,26,63,63,1269,12706,1134,13985,109,37264,1076,193,12557,149,991,143,24,2,61,48,13633,352,1076,12557,203,149,1279,12706,28,15,0,172
Izard,10/8/20,1,65,65,303,3780,252,4091,50,13559,282,21,3760,20,238,14,1,0,43,7,4042,49,282,3760,29,20,311,3780,7,35,0,72
Jackson,10/8/20,2,67,67,473,6953,377,7452,94,17225,350,123,6929,24,283,94,2,0,65,29,7279,173,350,6929,149,24,499,6953,3,13,0,41
Jefferson,10/8/20,87,69,69,3672,33216,3135,36918,449,70424,3617,55,32890,326,3098,37,82,5,436,13,36507,411,3617,32890,85,326,3702,33216,61,38,-1,328
Johnson,10/8/20,7,71,71,896,8727,859,9626,30,26291,887,9,8606,121,853,6,7,0,27,3,9493,133,887,8606,12,121,899,8727,5,10,0,80
Lafayette,10/8/20,3,73,73,132,1203,116,1337,13,6915,124,8,1196,7,109,7,3,0,12,1,1320,17,124,1196,10,7,134,1203,4,4,1,19
Lawrence,10/8/20,13,75,75,546,5044,444,5595,89,16669,500,46,4953,91,403,41,13,0,84,5,5453,142,500,4953,51,91,551,5044,38,10,0,208
Lee,10/8/20,18,77,77,1087,4453,1046,5541,23,9398,1083,4,4439,14,1044,2,17,1,22,1,5522,19,1083,4439,5,14,1088,4453,2,3,0,67
Lincoln,10/8/20,17,79,79,2100,7855,1963,9964,120,13695,2090,10,7776,79,1957,6,16,1,117,3,9866,98,2090,7776,19,79,2109,7855,2,12,1,25
LittleRiver,10/8/20,27,81,81,378,1909,341,2279,10,12417,356,22,1868,41,326,15,22,5,8,2,2224,55,356,1868,14,41,370,1909,3,5,0,20
Logan,10/8/20,2,83,83,480,8078,416,8558,62,21757,476,4,8035,43,415,1,2,0,59,3,8511,47,476,8035,4,43,480,8078,22,4,0,88
Lonoke,10/8/20,17,85,85,1370,23025,1221,24450,132,72206,1193,177,21129,1896,1063,158,16,1,114,18,22322,2128,1193,21129,232,1896,1425,23025,16,20,0,356
Madison,10/8/20,5,87,87,385,4412,358,4798,22,16076,366,19,4329,83,343,15,5,0,18,4,4695,103,366,4329,20,83,386,4412,3,2,0,43
Marion,10/8/20,0,89,89,112,2580,100,2692,12,16438,105,7,2567,13,95,5,0,0,10,2,2672,20,105,2567,7,13,112,2580,2,0,0,45
Miller,10/8/20,11,91,91,1005,6946,869,7951,125,43759,913,92,6823,123,804,65,10,1,99,26,7736,215,913,6823,92,123,1005,6946,43,13,0,115
MissingCountyInfo,10/8/20,0,5,5,1901,45848,1462,47742,439,NA,1733,168,45847,1,1318,144,0,0,415,24,47580,162,1733,45847,161,1,1894,45848,-29,11,0,1332
Mississippi,10/8/20,53,93,93,1808,12271,1655,14065,99,42831,1759,49,12205,66,1630,25,42,11,86,13,13964,101,1759,12205,35,66,1794,12271,9,8,0,106
Monroe,10/8/20,0,95,95,165,2467,133,2632,32,7249,162,3,2426,41,131,2,0,0,31,1,2588,44,162,2426,3,41,165,2467,10,1,0,46
Montgomery,10/8/20,7,97,97,170,2397,148,2567,15,8993,168,2,2365,32,146,2,7,0,15,0,2533,34,168,2365,2,32,170,2397,0,2,1,29
Nevada,10/8/20,14,99,99,241,3600,209,3838,18,8440,227,14,3567,33,200,9,13,1,14,4,3794,44,227,3567,11,33,238,3600,3,0,1,26
Newton,10/8/20,19,101,101,264,1945,228,2204,17,7848,247,17,1835,110,219,9,16,3,12,5,2082,122,247,1835,12,110,259,1945,4,2,0,31
Ouachita,10/8/20,7,103,103,288,6373,258,6667,23,24106,279,9,6327,46,251,7,7,0,21,2,6606,61,279,6327,15,46,294,6373,5,3,0,79
Perry,10/8/20,0,105,105,112,3685,93,3797,19,10322,106,6,3598,87,88,5,0,0,18,1,3704,93,106,3598,6,87,112,3685,6,0,0,114
Phillips,10/8/20,15,107,107,588,7362,511,7954,62,19034,580,8,7287,75,505,6,15,0,60,2,7867,87,580,7287,12,75,592,7362,20,15,0,115
Pike,10/8/20,3,109,109,243,2457,224,2699,16,10808,238,5,2412,45,223,1,2,1,13,3,2650,49,238,2412,4,45,242,2457,3,0,0,51
Poinsett,10/8/20,15,111,111,763,9316,658,10079,90,24054,727,36,9288,28,635,23,14,1,78,12,10015,64,727,9288,36,28,763,9316,24,7,0,114
Polk,10/8/20,4,113,113,302,4906,265,5209,33,20163,299,3,4871,35,264,1,4,0,31,2,5170,39,299,4871,4,35,303,4906,5,1,0,58
Pope,10/8/20,36,115,115,2332,25131,2143,27457,153,63644,2280,52,24870,261,2113,30,32,4,135,18,27150,307,2280,24870,46,261,2326,25131,46,18,0,396
Prairie,10/8/20,4,117,117,174,2488,146,2664,24,8244,161,13,2287,201,140,6,4,0,17,7,2448,216,161,2287,15,201,176,2488,5,2,0,47
Pulaski,10/8/20,169,119,119,10130,145691,9309,155891,651,393463,9753,377,142216,3475,8995,314,155,14,602,49,151969,3922,9753,142216,447,3475,10200,145691,116,80,4,1383
Randolph,10/8/20,23,121,121,502,5564,426,6073,53,17603,436,66,5376,188,385,41,19,4,32,21,5812,261,436,5376,73,188,509,5564,11,8,0,93
Saline,10/8/20,24,125,125,2354,34489,2115,36857,214,118009,2236,118,33472,1017,2016,99,22,2,197,17,35708,1149,2236,33472,132,1017,2368,34489,47,26,0,411
Scott,10/8/20,1,127,127,127,3166,107,3293,19,10442,125,2,3146,20,107,0,1,0,17,2,3271,22,125,3146,2,20,127,3166,8,6,0,111
Searcy,10/8/20,1,129,129,161,2421,148,2581,12,7923,155,6,2380,41,142,6,1,0,12,0,2535,46,155,2380,5,41,160,2421,4,0,0,21
Sebastian,10/8/20,67,131,131,4107,50821,3718,54930,321,127461,4027,80,50583,238,3669,49,59,8,298,23,54610,320,4027,50583,82,238,4109,50821,67,46,2,954
Sevier,10/8/20,19,133,133,1221,6767,1191,7986,11,17193,1199,22,6672,95,1175,16,19,0,5,6,7871,115,1199,6672,20,95,1219,6767,3,3,0,19
Sharp,10/8/20,7,135,135,265,4527,223,4791,35,17043,242,23,4514,13,205,18,7,0,30,5,4756,35,242,4514,22,13,264,4527,3,5,0,74
St.Francis,10/8/20,8,123,123,1576,12804,1514,14381,54,26294,1570,6,12771,33,1512,2,8,0,50,4,14341,40,1570,12771,7,33,1577,12804,6,8,0,134
Stone,10/8/20,16,137,137,373,3653,344,4029,13,12446,365,8,3614,39,337,7,16,0,12,1,3979,50,365,3614,11,39,376,3653,0,11,0,26
Union,10/8/20,47,139,139,983,10119,890,11102,46,39732,923,60,9929,190,854,36,42,5,27,19,10852,250,923,9929,60,190,983,10119,23,13,0,250
VanBuren,10/8/20,3,141,141,180,4666,172,4851,5,16684,177,3,4556,110,169,3,3,0,5,0,4733,118,177,4556,8,110,185,4666,1,1,0,105
Washington,10/8/20,122,143,143,10171,84173,9544,94404,505,228529,9413,758,80564,3609,8920,624,106,16,387,118,89977,4427,9413,80564,818,3609,10231,84173,99,75,1,1107
White,10/8/20,29,145,145,1047,18044,883,19108,135,78804,909,138,16938,1106,782,101,25,4,102,33,17847,1261,909,16938,155,1106,1064,18044,34,11,0,298
Woodruff,10/8/20,0,147,147,65,1807,58,1873,7,6660,57,8,1785,22,51,7,0,0,6,1,1842,31,57,1785,9,22,66,1807,1,2,0,14
Yell,10/8/20,30,149,149,1288,11354,1228,12639,30,21573,1279,9,11262,92,1223,5,27,3,29,1,12541,98,1279,11262,6,92,1285,11354,5,0,0,277
Arkansas_all_counties,10/7/20,1482,5630,5630,88880,1032630,80703,1121921,6686,2990671,84914,3966,1012643,19987,77660,3043,1337,145,5908,778,1097557,24364,84914,1012643,4377,19987,89291,1032630,809,818,13,10880
Arkansas_county,10/7/20,10,1,1,498,7058,396,7567,92,18124,455,43,6336,722,369,27,10,0,76,16,6791,776,455,6336,54,722,509,7058,12,11,0,51
Ashley,10/7/20,11,3,3,455,5511,422,5969,22,20537,449,6,5416,95,418,4,11,0,20,2,5865,104,449,5416,9,95,458,5511,3,1,0,53
Baxter,10/7/20,2,5,5,420,4557,366,4980,52,41219,365,55,4512,45,319,47,2,0,44,8,4877,103,365,4512,58,45,423,4557,9,9,0,-25
Benton,10/7/20,98,7,7,6989,76941,6580,83968,310,258980,6649,340,76063,878,6321,259,81,17,246,64,82712,1256,6649,76063,378,878,7027,76941,31,25,1,1728
Boone,10/7/20,20,9,9,826,11497,719,12325,87,37288,753,73,11425,72,668,51,18,2,67,20,12178,147,753,11425,75,72,828,11497,2,14,0,45
Bradley,10/7/20,8,11,11,345,3674,333,4018,4,10948,343,2,3653,21,332,1,7,1,4,0,3996,22,343,3653,1,21,344,3674,0,0,0,25
Calhoun,10/7/20,0,13,13,37,1790,36,1827,1,5202,36,1,1776,14,35,1,0,0,1,0,1812,15,36,1776,1,14,37,1790,0,0,0,20
Carroll,10/7/20,11,15,15,775,7610,674,8390,90,27887,759,16,7558,52,664,10,11,0,84,6,8317,73,759,7558,21,52,780,7610,4,8,1,41
Chicot,10/7/20,22,17,17,1015,5249,987,6266,6,10826,1004,11,5159,90,978,9,21,1,5,1,6163,103,1004,5159,13,90,1017,5249,1,0,0,155
Clark,10/7/20,4,19,19,401,7148,348,7550,49,22385,376,25,7049,99,329,19,4,0,43,6,7425,125,376,7049,26,99,402,7148,8,9,0,425
Clay,10/7/20,10,21,21,352,4793,292,5146,49,15061,336,16,4592,201,284,8,8,2,43,6,4928,218,336,4592,17,201,353,4793,5,7,0,327
Cleburne,10/7/20,10,23,23,372,7276,332,7653,30,25230,343,29,7048,228,315,17,10,0,18,12,7391,262,343,7048,34,228,377,7276,5,7,0,226
Cleveland,10/7/20,12,25,25,194,3008,173,3202,9,8226,190,4,2957,51,171,2,11,1,8,1,3147,55,190,2957,4,51,194,3008,0,0,0,95
Columbia,10/7/20,18,27,27,584,5741,482,6337,84,23892,529,55,5652,89,443,39,18,0,68,16,6181,156,529,5652,67,89,596,5741,5,14,0,502
Conway,10/7/20,3,29,29,300,7101,265,7399,32,20906,284,16,6923,178,258,7,3,0,23,9,7207,192,284,6923,14,178,298,7101,2,5,0,284
Craighead,10/7/20,28,31,31,3396,36999,2981,40411,386,105701,3286,110,36590,409,2900,81,25,3,360,26,39876,535,3286,36590,126,409,3412,36999,72,59,1,1879
Crawford,10/7/20,20,33,33,1603,22327,1401,23931,182,62472,1559,44,22150,177,1364,37,17,3,178,4,23709,222,1559,22150,45,177,1604,22327,14,27,0,515
Crittenden,10/7/20,48,35,35,2028,14736,1923,16754,57,49013,2007,21,14675,61,1910,13,41,7,56,1,16682,72,2007,14675,11,61,2018,14736,10,14,0,763
Cross,10/7/20,14,37,37,493,5352,436,5842,43,16998,465,28,5293,59,416,20,12,2,37,6,5758,84,465,5293,25,59,490,5352,6,3,0,142
Dallas,10/7/20,5,39,39,173,2306,164,2479,4,7432,171,2,2284,22,162,2,5,0,4,0,2455,24,171,2284,2,22,173,2306,2,7,0,249
Desha,10/7/20,6,41,41,327,4322,293,4649,28,11887,320,7,4234,88,288,5,6,0,26,2,4554,95,320,4234,7,88,327,4322,1,5,0,74
Drew,10/7/20,7,43,43,368,6267,347,6638,14,18502,354,14,6104,163,335,12,6,1,13,1,6458,180,354,6104,17,163,371,6267,2,2,0,202
Faulkner,10/7/20,23,45,45,2795,42147,2486,44959,285,122416,2666,129,41101,1046,2379,107,20,3,266,19,43767,1192,2666,41101,146,1046,2812,42147,30,21,0,2516
Franklin,10/7/20,2,47,47,339,6956,288,7296,49,17780,325,14,6889,67,276,12,2,0,47,2,7214,82,325,6889,15,67,340,6956,6,6,0,43
Fulton,10/7/20,5,49,49,209,1915,166,2128,38,12139,188,21,1736,179,152,14,4,1,32,6,1924,204,188,1736,25,179,213,1915,5,2,0,105
Garland,10/7/20,55,51,51,2055,33452,1854,35506,146,98296,2017,38,33009,443,1833,21,50,5,134,12,35026,480,2017,33009,37,443,2054,33452,13,8,1,699
Grant,10/7/20,2,53,53,284,5628,261,5918,21,18086,273,11,5523,105,251,10,2,0,20,1,5796,122,273,5523,17,105,290,5628,2,2,0,172
Greene,10/7/20,15,55,55,995,15008,879,16004,101,44623,946,49,14824,184,844,35,15,0,87,14,15770,234,946,14824,50,184,996,15008,16,10,0,368
Hempstead,10/7/20,4,57,57,427,5456,378,5886,45,22018,403,24,5378,78,366,12,4,0,33,12,5781,105,403,5378,27,78,430,5456,15,6,0,219
HotSpring,10/7/20,28,59,59,1991,14389,1884,16383,79,33520,1979,12,14243,146,1876,8,26,2,77,2,16222,161,1979,14243,15,146,1994,14389,34,14,0,647
Howard,10/7/20,12,61,61,503,3939,472,4445,19,13389,476,27,3867,72,449,23,12,0,15,4,4343,102,476,3867,30,72,506,3939,-1,0,0,20
Independence,10/7/20,26,63,63,1241,12562,1119,13814,96,37264,1060,181,12420,142,980,139,24,2,56,40,13480,334,1060,12420,192,142,1252,12562,9,6,2,472
Izard,10/7/20,1,65,65,296,3715,217,4019,78,13559,276,20,3696,19,204,13,1,0,71,7,3972,47,276,3696,28,19,304,3715,24,1,0,97
Jackson,10/7/20,2,67,67,470,6915,364,7409,104,17225,346,124,6892,23,277,87,2,0,67,37,7238,171,346,6892,148,23,494,6915,14,11,0,226
Jefferson,10/7/20,88,69,69,3611,32949,3097,36590,425,70424,3562,49,32637,312,3060,37,82,6,419,6,36199,391,3562,32637,79,312,3641,32949,32,76,1,1644
Johnson,10/7/20,7,71,71,891,8652,849,9546,35,26291,883,8,8533,119,844,5,7,0,32,3,9416,130,883,8533,11,119,894,8652,2,2,0,337
Lafayette,10/7/20,2,73,73,128,1188,112,1318,14,6915,121,7,1181,7,106,6,2,0,13,1,1302,16,121,1181,9,7,130,1188,2,1,0,17
Lawrence,10/7/20,13,75,75,508,4874,434,5388,61,16669,466,42,4784,90,394,40,13,0,59,2,5250,138,466,4784,48,90,514,4874,7,4,0,203
Lee,10/7/20,18,77,77,1085,4388,1043,5474,24,9398,1081,4,4376,12,1041,2,17,1,23,1,5457,17,1081,4376,5,12,1086,4388,2,0,0,200
Lincoln,10/7/20,16,79,79,2098,7832,1951,9940,131,13695,2089,9,7759,73,1946,5,15,1,128,3,9848,92,2089,7759,19,73,2108,7832,5,6,0,666
LittleRiver,10/7/20,27,81,81,375,1892,336,2259,12,12417,355,20,1854,38,322,14,22,5,11,1,2209,50,355,1854,12,38,367,1892,1,3,0,16
Logan,10/7/20,2,83,83,458,8012,412,8471,44,21757,455,3,7968,44,411,1,2,0,42,2,8423,48,455,7968,4,44,459,8012,7,4,0,289
Lonoke,10/7/20,17,85,85,1354,22685,1201,24093,136,72206,1182,172,20861,1824,1048,153,16,1,118,18,22043,2050,1182,20861,226,1824,1408,22685,19,45,0,983
Madison,10/7/20,5,87,87,382,4372,356,4755,21,16076,363,19,4295,77,341,15,5,0,17,4,4658,97,363,4295,20,77,383,4372,3,3,0,35
Marion,10/7/20,0,89,89,110,2537,100,2647,10,16438,103,7,2525,12,95,5,0,0,8,2,2628,19,103,2525,7,12,110,2537,1,2,0,3
Miller,10/7/20,11,91,91,962,6874,856,7834,95,43759,892,70,6751,123,799,57,10,1,83,12,7643,191,892,6751,68,123,960,6874,18,8,0,47
MissingCountyInfo,10/7/20,0,5,5,1930,44487,1451,46405,479,NA,1751,179,44486,1,1307,144,0,0,444,35,46237,168,1751,44486,167,1,1918,44487,64,29,0,-20279
Mississippi,10/7/20,53,93,93,1799,12174,1647,13959,98,42831,1752,47,12127,47,1622,25,42,11,87,11,13879,80,1752,12127,33,47,1785,12174,10,11,0,112
Monroe,10/7/20,0,95,95,155,2431,132,2586,23,7249,153,2,2394,37,130,2,0,0,23,0,2547,39,153,2394,2,37,155,2431,6,2,0,38
Montgomery,10/7/20,6,97,97,170,2368,146,2538,18,8993,168,2,2336,32,145,1,6,0,17,1,2504,34,168,2336,2,32,170,2368,0,1,0,21
Nevada,10/7/20,13,99,99,238,3577,209,3812,16,8440,225,13,3551,26,200,9,12,1,13,3,3776,36,225,3551,10,26,235,3577,3,0,0,83
Newton,10/7/20,19,101,101,260,1918,226,2173,15,7848,243,17,1808,110,217,9,16,3,10,5,2051,122,243,1808,12,110,255,1918,1,2,0,25
Ouachita,10/7/20,7,103,103,283,6299,255,6589,21,24106,275,8,6255,44,249,6,7,0,19,2,6530,59,275,6255,15,44,290,6299,2,3,0,375
Perry,10/7/20,0,105,105,106,3577,93,3683,13,10322,100,6,3496,81,88,5,0,0,12,1,3596,87,100,3496,6,81,106,3577,2,2,0,122
Phillips,10/7/20,15,107,107,568,7267,496,7839,57,19034,560,8,7193,74,491,5,15,0,54,3,7753,86,560,7193,12,74,572,7267,10,4,0,199
Pike,10/7/20,3,109,109,240,2409,224,2648,13,10808,236,4,2367,42,223,1,2,1,11,2,2603,45,236,2367,3,42,239,2409,1,0,0,23
Poinsett,10/7/20,15,111,111,739,9226,651,9964,73,24054,703,36,9198,28,631,20,14,1,58,15,9901,63,703,9198,35,28,738,9226,8,4,0,1263
Polk,10/7/20,4,113,113,297,4853,264,5151,29,20163,294,3,4823,30,263,1,4,0,27,2,5117,34,294,4823,4,30,298,4853,11,3,0,87
Pope,10/7/20,36,115,115,2286,24781,2125,27059,125,63644,2239,47,24537,244,2097,28,32,4,110,15,26776,283,2239,24537,39,244,2278,24781,15,13,0,1395
Prairie,10/7/20,4,117,117,169,2446,144,2617,21,8244,160,9,2252,194,138,6,4,0,18,3,2412,205,160,2252,11,194,171,2446,3,1,0,48
Pulaski,10/7/20,165,119,119,10014,144424,9229,154509,619,393463,9653,361,141111,3313,8922,307,151,14,579,40,150764,3745,9653,141111,432,3313,10085,144424,70,93,2,2974
Randolph,10/7/20,23,121,121,491,5482,418,5980,50,17603,428,63,5297,185,380,38,19,4,29,21,5725,255,428,5297,70,185,498,5482,7,11,0,175
Saline,10/7/20,24,125,125,2307,34125,2089,36446,193,118009,2191,116,33147,978,1992,97,22,2,176,17,35338,1108,2191,33147,130,978,2321,34125,15,21,0,1269
Scott,10/7/20,1,127,127,119,3063,101,3182,17,10442,117,2,3045,18,101,0,1,0,15,2,3162,20,117,3045,2,18,119,3063,2,2,0,7
Searcy,10/7/20,1,129,129,157,2404,148,2560,8,7923,151,6,2363,41,142,6,1,0,8,0,2514,46,151,2363,5,41,156,2404,3,2,0,199
Sebastian,10/7/20,65,131,131,4040,49934,3672,53977,302,127461,3966,74,49700,234,3625,47,57,8,283,19,53666,311,3966,49700,77,234,4043,49934,33,51,1,1575
Sevier,10/7/20,19,133,133,1218,6751,1188,7967,11,17193,1198,20,6656,95,1174,14,19,0,5,6,7854,113,1198,6656,18,95,1216,6751,1,0,0,12
Sharp,10/7/20,7,135,135,262,4456,218,4718,37,17043,241,21,4443,13,200,18,7,0,34,3,4684,34,241,4443,21,13,262,4456,4,4,1,173
St.Francis,10/7/20,8,123,123,1570,12676,1506,14247,56,26294,1564,6,12644,32,1505,1,8,0,51,5,14208,39,1564,12644,7,32,1571,12676,2,7,1,49
Stone,10/7/20,16,137,137,373,3627,333,4003,24,12446,365,8,3589,38,327,6,16,0,22,2,3954,49,365,3589,11,38,376,3627,-2,10,0,28
Union,10/7/20,47,139,139,960,9892,877,10853,36,39732,911,49,9720,172,846,31,42,5,23,13,10631,222,911,9720,50,172,961,9892,12,12,0,312
VanBuren,10/7/20,3,141,141,179,4562,171,4746,5,16684,176,3,4454,108,168,3,3,0,5,0,4630,116,176,4454,8,108,184,4562,0,1,0,65
Washington,10/7/20,121,143,143,10072,83165,9469,93296,482,228529,9338,734,79635,3530,8855,614,105,16,378,104,88973,4323,9338,79635,793,3530,10131,83165,42,47,1,1470
White,10/7/20,29,145,145,1013,17780,872,18810,112,78804,886,127,16699,1081,777,95,25,4,84,28,17585,1225,886,16699,144,1081,1030,17780,12,10,0,467
Woodruff,10/7/20,0,147,147,64,1794,56,1859,8,6660,56,8,1773,21,49,7,0,0,7,1,1829,30,56,1773,9,21,65,1794,0,0,0,0
Yell,10/7/20,30,149,149,1283,11082,1228,12362,25,21573,1274,9,10993,89,1223,5,27,3,24,1,12267,95,1274,10993,6,89,1280,11082,12,4,0,793
Arkansas_all_counties,10/6/20,1469,5630,5630,88071,1022559,79885,1111017,6708,2990671,84230,3841,1003441,19118,76930,2955,1321,148,5970,738,1087671,23346,84230,1003441,4228,19118,88458,1022559,641,833,22,9835
Arkansas_county,10/6/20,10,1,1,486,7019,385,7515,91,18124,449,37,6303,716,360,25,9,1,80,11,6752,763,449,6303,47,716,496,7019,26,3,0,108
Ashley,10/6/20,11,3,3,452,5461,421,5916,20,20537,446,6,5382,79,417,4,11,0,18,2,5828,88,446,5382,9,79,455,5461,0,3,0,26
Baxter,10/6/20,2,5,5,411,4591,357,5005,52,41219,358,53,4552,39,314,43,2,0,42,10,4910,95,358,4552,56,39,414,4591,8,17,0,105
Benton,10/6/20,97,7,7,6958,75244,6555,82241,305,258980,6631,327,74371,873,6306,249,80,17,244,61,81002,1239,6631,74371,366,873,6997,75244,48,78,2,603
Boone,10/6/20,20,9,9,824,11454,705,12279,99,37288,751,73,11389,65,656,49,18,2,77,22,12140,139,751,11389,74,65,825,11454,9,11,0,147
Bradley,10/6/20,8,11,11,345,3649,333,3993,4,10948,343,2,3629,20,332,1,7,1,4,0,3972,21,343,3629,1,20,344,3649,0,1,0,19
Calhoun,10/6/20,0,13,13,37,1770,36,1807,1,5202,36,1,1757,13,35,1,0,0,1,0,1793,14,36,1757,1,13,37,1770,0,0,0,6
Carroll,10/6/20,10,15,15,771,7573,666,8349,95,27887,757,14,7529,44,657,9,10,0,90,5,8286,63,757,7529,19,44,776,7573,12,6,0,103
Chicot,10/6/20,22,17,17,1014,5095,987,6110,5,10826,1004,10,5050,45,978,9,21,1,5,0,6054,56,1004,5050,11,45,1015,5095,1,2,0,15
Clark,10/6/20,4,19,19,393,6731,339,7126,50,22385,370,23,6635,96,321,18,4,0,45,5,7005,121,370,6635,25,96,395,6731,9,7,0,40
Clay,10/6/20,10,21,21,347,4471,285,4818,51,15061,330,17,4440,31,277,8,8,2,44,7,4770,48,330,4440,17,31,347,4471,5,3,0,43
Cleburne,10/6/20,10,23,23,367,7055,325,7427,32,25230,338,29,6831,224,308,17,10,0,20,12,7169,258,338,6831,34,224,372,7055,5,1,1,80
Cleveland,10/6/20,12,25,25,194,2913,173,3107,9,8226,190,4,2863,50,171,2,11,1,8,1,3053,54,190,2863,4,50,194,2913,2,2,0,62
Columbia,10/6/20,18,27,27,579,5244,468,5835,93,23892,523,56,5164,80,434,34,18,0,71,22,5687,148,523,5164,68,80,591,5244,14,19,0,36
Conway,10/6/20,3,29,29,298,6819,260,7115,35,20906,282,16,6645,174,253,7,3,0,26,9,6927,188,282,6645,14,174,296,6819,1,2,0,40
Craighead,10/6/20,27,31,31,3324,35192,2922,38531,374,105701,3218,106,34790,402,2842,80,24,3,351,23,38008,523,3218,34790,121,402,3339,35192,37,56,1,421
Crawford,10/6/20,20,33,33,1589,21826,1374,23416,195,62472,1546,43,21650,176,1338,36,17,3,191,4,23196,220,1546,21650,44,176,1590,21826,14,18,3,367
Crittenden,10/6/20,48,35,35,2018,13983,1909,15991,61,49013,1997,21,13954,29,1896,13,41,7,60,1,15951,40,1997,13954,11,29,2008,13983,11,11,0,82
Cross,10/6/20,14,37,37,487,5216,433,5700,40,16998,462,25,5165,51,414,19,12,2,36,4,5627,73,462,5165,22,51,484,5216,0,7,0,35
Dallas,10/6/20,5,39,39,171,2059,157,2230,9,7432,169,2,2038,21,156,1,5,0,8,1,2207,23,169,2038,2,21,171,2059,0,3,0,18
Desha,10/6/20,6,41,41,326,4249,288,4575,32,11887,319,7,4167,82,283,5,6,0,30,2,4486,89,319,4167,7,82,326,4249,6,3,0,49
Drew,10/6/20,7,43,43,366,6067,345,6436,14,18502,353,13,5909,158,333,12,6,1,14,0,6262,174,353,5909,16,158,369,6067,3,0,0,42
Faulkner,10/6/20,23,45,45,2765,39661,2465,42444,276,122416,2642,123,38621,1040,2362,103,20,3,259,17,41263,1181,2642,38621,141,1040,2783,39661,37,46,1,380
Franklin,10/6/20,2,47,47,333,6919,282,7253,49,17780,321,12,6852,67,271,11,2,0,48,1,7173,80,321,6852,13,67,334,6919,6,4,0,105
Fulton,10/6/20,5,49,49,204,1815,164,2022,35,12139,183,21,1702,113,150,14,4,1,29,6,1885,137,183,1702,24,113,207,1815,3,5,0,39
Garland,10/6/20,54,51,51,2042,32766,1846,34809,142,98296,2003,39,32403,363,1825,21,49,5,129,13,34406,403,2003,32403,40,363,2043,32766,5,33,1,172
Grant,10/6/20,2,53,53,282,5458,259,5746,21,18086,272,10,5354,104,249,10,2,0,21,0,5626,120,272,5354,16,104,288,5458,4,5,0,45
Greene,10/6/20,15,55,55,979,14656,869,15636,95,44623,933,46,14493,163,834,35,15,0,84,11,15426,210,933,14493,47,163,980,14656,19,14,0,194
Hempstead,10/6/20,4,57,57,412,5252,372,5667,36,22018,390,22,5175,77,361,11,4,0,25,11,5565,102,390,5175,25,77,415,5252,4,9,0,38
HotSpring,10/6/20,28,59,59,1957,13776,1870,15736,59,33520,1945,12,13634,142,1862,8,26,2,57,2,15579,157,1945,13634,15,142,1960,13776,0,12,0,72
Howard,10/6/20,12,61,61,504,3918,472,4424,20,13389,476,28,3851,67,449,23,12,0,15,5,4327,97,476,3851,30,67,506,3918,1,2,0,14
Independence,10/6/20,24,63,63,1232,12099,1113,13344,95,37264,1055,177,11961,138,978,135,22,2,55,40,13016,328,1055,11961,190,138,1245,12099,15,9,1,161
Izard,10/6/20,1,65,65,272,3642,216,3922,55,13559,254,18,3626,16,203,13,1,0,50,5,3880,42,254,3626,26,16,280,3642,4,3,1,52
Jackson,10/6/20,2,67,67,456,6703,353,7184,101,17225,344,112,6680,23,271,82,2,0,71,30,7024,160,344,6680,137,23,481,6703,7,14,0,142
Jefferson,10/6/20,87,69,69,3579,31337,3021,34930,470,70424,3517,62,31029,308,2979,42,79,8,458,12,34546,384,3517,31029,76,308,3593,31337,17,22,1,201
Johnson,10/6/20,7,71,71,889,8317,847,9209,35,26291,881,8,8208,109,842,5,7,0,32,3,9089,120,881,8208,11,109,892,8317,4,7,0,51
Lafayette,10/6/20,2,73,73,126,1173,111,1301,13,6915,120,6,1166,7,105,6,2,0,13,0,1286,15,120,1166,8,7,128,1173,3,5,0,13
Lawrence,10/6/20,13,75,75,501,4678,430,5185,58,16669,461,40,4592,86,391,39,13,0,57,1,5053,132,461,4592,46,86,507,4678,6,20,0,75
Lee,10/6/20,18,77,77,1083,4190,1043,5274,22,9398,1080,3,4178,12,1041,2,17,1,22,0,5258,16,1080,4178,4,12,1084,4190,2,0,0,21
Lincoln,10/6/20,16,79,79,2093,7171,1945,9274,132,13695,2084,9,7118,53,1940,5,15,1,129,3,9202,72,2084,7118,19,53,2103,7171,0,6,0,86
LittleRiver,10/6/20,27,81,81,374,1877,333,2243,14,12417,355,19,1839,38,320,13,22,5,13,1,2194,49,355,1839,11,38,366,1877,1,1,0,15
Logan,10/6/20,2,83,83,451,7730,408,8182,41,21757,449,2,7691,39,407,1,2,0,40,1,8140,42,449,7691,3,39,452,7730,5,2,1,78
Lonoke,10/6/20,17,85,85,1335,21721,1156,23109,162,72206,1166,169,19909,1812,1009,147,16,1,141,21,21075,2034,1166,19909,222,1812,1388,21721,17,32,0,171
Madison,10/6/20,5,87,87,379,4340,353,4721,21,16076,362,17,4267,73,338,15,5,0,19,2,4629,92,362,4267,19,73,381,4340,2,8,0,46
Marion,10/6/20,0,89,89,109,2535,98,2644,11,16438,103,6,2523,12,93,5,0,0,10,1,2626,18,103,2523,6,12,109,2535,2,4,0,105
Miller,10/6/20,11,91,91,944,6845,848,7787,85,43759,879,65,6724,121,792,56,10,1,77,8,7603,184,879,6724,63,121,942,6845,25,10,0,150
MissingCountyInfo,10/6/20,0,5,5,1866,64830,1422,66688,444,NA,1675,191,64829,1,1281,141,0,0,394,50,66504,184,1675,64829,183,1,1858,64830,-99,-51,0,-1034
Mississippi,10/6/20,53,93,93,1789,12072,1636,13848,99,42831,1745,44,12026,46,1613,23,42,11,89,10,13771,77,1745,12026,31,46,1776,12072,12,12,0,110
Monroe,10/6/20,0,95,95,149,2399,130,2548,19,7249,147,2,2362,37,128,2,0,0,19,0,2509,39,147,2362,2,37,149,2399,1,1,0,24
Montgomery,10/6/20,6,97,97,170,2347,145,2517,19,8993,168,2,2315,32,144,1,6,0,18,1,2483,34,168,2315,2,32,170,2347,1,2,0,9
Nevada,10/6/20,13,99,99,235,3497,209,3729,13,8440,223,12,3471,26,200,9,12,1,11,2,3694,35,223,3471,9,26,232,3497,1,2,0,10
Newton,10/6/20,19,101,101,259,1894,224,2148,16,7848,243,16,1816,78,216,8,16,3,11,5,2059,89,243,1816,11,78,254,1894,2,8,0,15
Ouachita,10/6/20,7,103,103,281,5926,252,6214,22,24106,273,8,5882,44,246,6,7,0,20,2,6155,59,273,5882,15,44,288,5926,3,3,0,29
Perry,10/6/20,0,105,105,104,3457,91,3561,13,10322,98,6,3375,82,86,5,0,0,12,1,3473,88,98,3375,6,82,104,3457,6,2,0,111
Phillips,10/6/20,15,107,107,558,7078,492,7640,51,19034,550,8,7005,73,488,4,15,0,47,4,7555,85,550,7005,12,73,562,7078,8,8,1,72
Pike,10/6/20,3,109,109,239,2387,224,2625,12,10808,235,4,2346,41,223,1,2,1,10,2,2581,44,235,2346,3,41,238,2387,2,2,0,26
Poinsett,10/6/20,15,111,111,731,7971,647,8701,69,24054,698,33,7943,28,628,19,14,1,56,13,8641,60,698,7943,32,28,730,7971,13,9,0,65
Polk,10/6/20,4,113,113,286,4777,261,5064,21,20163,284,2,4754,23,260,1,4,0,20,1,5038,26,284,4754,3,23,287,4777,5,6,0,70
Pope,10/6/20,36,115,115,2271,23401,2112,25664,123,63644,2231,40,23184,217,2082,30,32,4,117,6,25415,249,2231,23184,32,217,2263,23401,17,34,0,107
Prairie,10/6/20,4,117,117,166,2401,143,2569,19,8244,159,7,2208,193,138,5,4,0,17,2,2367,202,159,2208,9,193,168,2401,2,1,1,16
Pulaski,10/6/20,163,119,119,9944,141520,9136,151533,644,393463,9590,354,138251,3269,8838,298,149,14,602,42,147841,3692,9590,138251,423,3269,10013,141520,85,78,3,2110
Randolph,10/6/20,23,121,121,484,5314,407,5805,54,17603,426,58,5164,150,370,37,19,4,37,17,5590,215,426,5164,65,150,491,5314,7,6,0,166
Saline,10/6/20,24,125,125,2292,32871,2068,35176,199,118009,2178,114,31907,964,1972,96,22,2,183,16,34085,1091,2178,31907,127,964,2305,32871,17,18,0,488
Scott,10/6/20,1,127,127,117,3058,99,3175,17,10442,116,1,3042,16,99,0,1,0,16,1,3158,17,116,3042,1,16,117,3058,2,1,0,104
Searcy,10/6/20,1,129,129,154,2208,146,2361,7,7923,148,6,2169,39,141,5,1,0,6,1,2317,44,148,2169,5,39,153,2208,0,2,0,28
Sebastian,10/6/20,64,131,131,4007,48392,3621,52401,321,127461,3941,66,48164,228,3582,39,56,8,302,19,52105,296,3941,48164,68,228,4009,48392,33,42,1,861
Sevier,10/6/20,19,133,133,1217,6740,1188,7955,10,17193,1197,20,6655,85,1174,14,19,0,4,6,7852,103,1197,6655,18,85,1215,6740,3,3,0,19
Sharp,10/6/20,6,135,135,258,4287,214,4545,38,17043,237,21,4274,13,196,18,6,0,35,3,4511,34,237,4274,21,13,258,4287,2,4,0,61
St.Francis,10/6/20,7,123,123,1568,12629,1499,14198,62,26294,1563,5,12599,30,1498,1,7,0,58,4,14162,36,1563,12599,6,30,1569,12629,4,9,1,126
Stone,10/6/20,16,137,137,375,3597,323,3975,36,12446,367,8,3559,38,317,6,16,0,34,2,3926,49,367,3559,11,38,378,3597,2,2,1,33
Union,10/6/20,47,139,139,948,9592,865,10541,36,39732,908,40,9424,168,836,29,42,5,30,6,10332,209,908,9424,41,168,949,9592,3,5,0,31
VanBuren,10/6/20,3,141,141,179,4497,170,4681,6,16684,176,3,4402,95,167,3,3,0,6,0,4578,103,176,4402,8,95,184,4497,1,0,0,70
Washington,10/6/20,120,143,143,10030,81737,9422,91816,488,228529,9309,721,78261,3476,8818,604,104,16,387,101,87570,4246,9309,78261,770,3476,10079,81737,81,75,1,845
White,10/6/20,29,145,145,1001,17325,862,18343,110,78804,879,122,16249,1076,768,94,25,4,86,24,17128,1215,879,16249,139,1076,1018,17325,26,20,0,362
Woodruff,10/6/20,0,147,147,64,1794,56,1859,8,6660,56,8,1773,21,49,7,0,0,7,1,1829,30,56,1773,9,21,65,1794,1,1,0,12
Yell,10/6/20,30,149,149,1271,10301,1224,11569,17,21573,1263,8,10223,78,1219,5,27,3,17,0,11486,83,1263,10223,5,78,1268,10301,0,2,0,16
Arkansas_all_counties,10/5/20,1447,5630,5630,87430,1013365,79052,1101172,6922,2990671,83698,3732,995446,17919,76204,2848,1299,148,6186,736,1079144,22028,83698,995446,4109,17919,87807,1013365,417,694,22,6968
Arkansas_county,10/5/20,10,1,1,460,6937,382,7407,68,18124,429,31,6226,711,357,25,9,1,63,5,6655,752,429,6226,41,711,470,6937,1,6,0,37
Ashley,10/5/20,11,3,3,452,5435,418,5890,23,20537,446,6,5359,76,414,4,11,0,21,2,5805,85,446,5359,9,76,455,5435,0,2,0,19
Baxter,10/5/20,2,5,5,403,4494,340,4901,61,41219,351,52,4457,37,300,40,2,0,49,12,4808,93,351,4457,56,37,407,4494,1,12,0,79
Benton,10/5/20,95,7,7,6910,74689,6477,81640,337,258980,6596,314,73854,835,6244,233,78,17,273,64,80450,1190,6596,73854,355,835,6951,74689,20,59,0,187
Boone,10/5/20,20,9,9,815,11316,694,12132,101,37288,743,72,11254,62,649,45,18,2,76,25,11997,135,743,11254,73,62,816,11316,9,12,1,270
Bradley,10/5/20,8,11,11,345,3630,332,3974,5,10948,343,2,3611,19,331,1,7,1,5,0,3954,20,343,3611,1,19,344,3630,0,0,0,13
Calhoun,10/5/20,0,13,13,37,1764,36,1801,1,5202,36,1,1751,13,35,1,0,0,1,0,1787,14,36,1751,1,13,37,1764,1,0,0,7
Carroll,10/5/20,10,15,15,759,7482,660,8246,89,27887,746,13,7440,42,651,9,10,0,85,4,8186,60,746,7440,18,42,764,7482,2,7,0,23
Chicot,10/5/20,22,17,17,1013,5081,985,6095,6,10826,1003,10,5038,43,976,9,21,1,6,0,6041,54,1003,5038,11,43,1014,5081,0,1,0,24
Clark,10/5/20,4,19,19,384,6700,332,7086,48,22385,363,21,6607,93,316,16,4,0,43,5,6970,116,363,6607,23,93,386,6700,3,3,0,43
Clay,10/5/20,10,21,21,342,4433,282,4775,49,15061,326,16,4404,29,274,8,8,2,43,6,4730,45,326,4404,16,29,342,4433,3,6,1,16
Cleburne,10/5/20,9,23,23,362,6980,324,7346,29,25230,336,26,6802,178,307,17,9,0,20,9,7138,208,336,6802,30,178,366,6980,2,2,0,67
Cleveland,10/5/20,12,25,25,192,2853,171,3045,9,8226,189,3,2804,49,169,2,11,1,9,0,2993,52,189,2804,3,49,192,2853,0,0,0,10
Columbia,10/5/20,18,27,27,565,5222,449,5800,98,23892,512,53,5143,79,420,29,18,0,74,24,5655,145,512,5143,66,79,578,5222,10,17,0,24
Conway,10/5/20,3,29,29,297,6780,258,7075,36,20906,282,15,6617,163,251,7,3,0,28,8,6899,176,282,6617,13,163,295,6780,3,2,0,23
Craighead,10/5/20,26,31,31,3287,34808,2866,38110,394,105701,3186,101,34419,389,2787,79,23,3,375,19,37605,505,3186,34419,116,389,3302,34808,26,28,2,191
Crawford,10/5/20,17,33,33,1575,21473,1356,23049,202,62472,1532,43,21392,81,1320,36,14,3,198,4,22924,125,1532,21392,44,81,1576,21473,15,16,1,207
Crittenden,10/5/20,48,35,35,2007,13912,1898,15909,61,49013,1986,21,13883,29,1885,13,41,7,60,1,15869,40,1986,13883,11,29,1997,13912,0,4,0,29
Cross,10/5/20,14,37,37,487,5181,426,5665,47,16998,462,25,5142,39,411,15,12,2,39,8,5604,61,462,5142,22,39,484,5181,7,5,0,23
Dallas,10/5/20,5,39,39,171,2041,154,2212,12,7432,169,2,2021,20,153,1,5,0,11,1,2190,22,169,2021,2,20,171,2041,0,0,0,10
Desha,10/5/20,6,41,41,320,4206,285,4525,29,11887,314,6,4130,76,280,5,6,0,28,1,4444,81,314,4130,5,76,319,4206,0,4,0,48
Drew,10/5/20,7,43,43,363,6028,345,6394,11,18502,350,13,5872,156,333,12,6,1,11,0,6222,172,350,5872,16,156,366,6028,0,1,0,14
Faulkner,10/5/20,22,45,45,2728,39318,2419,42063,286,122416,2609,119,38354,964,2319,100,19,3,270,16,40963,1100,2609,38354,136,964,2745,39318,24,30,0,274
Franklin,10/5/20,2,47,47,327,6820,278,7148,47,17780,315,12,6766,54,267,11,2,0,46,1,7081,67,315,6766,13,54,328,6820,2,8,0,31
Fulton,10/5/20,5,49,49,201,1779,159,1984,37,12139,181,20,1673,106,147,12,4,1,30,7,1854,130,181,1673,24,106,205,1779,3,6,0,17
Garland,10/5/20,53,51,51,2037,32599,1813,34637,171,98296,1998,39,32270,329,1792,21,48,5,158,13,34268,369,1998,32270,40,329,2038,32599,9,11,0,173
Grant,10/5/20,2,53,53,278,5417,254,5701,22,18086,268,10,5321,96,245,9,2,0,21,1,5589,112,268,5321,16,96,284,5417,1,1,0,21
Greene,10/5/20,15,55,55,960,14481,855,15443,90,44623,916,44,14328,153,820,35,15,0,81,9,15244,199,916,14328,46,153,962,14481,4,13,2,39
Hempstead,10/5/20,4,57,57,408,5218,363,5629,41,22018,388,20,5144,74,354,9,4,0,30,11,5532,97,388,5144,23,74,411,5218,3,2,0,27
HotSpring,10/5/20,28,59,59,1957,13704,1858,15665,71,33520,1944,13,13565,139,1850,8,26,2,68,3,15509,156,1944,13565,17,139,1961,13704,3,11,0,50
Howard,10/5/20,12,61,61,503,3905,470,4410,21,13389,476,27,3847,58,448,22,12,0,16,5,4323,87,476,3847,29,58,505,3905,0,0,0,11
Independence,10/5/20,23,63,63,1217,11953,1104,13180,90,37264,1049,168,11834,119,976,128,21,2,52,38,12883,297,1049,11834,178,119,1227,11953,4,11,1,38
Izard,10/5/20,0,65,65,268,3594,213,3870,55,13559,251,17,3578,16,200,13,0,0,51,4,3829,41,251,3578,25,16,276,3594,0,2,0,22
Jackson,10/5/20,2,67,67,449,6568,339,7041,108,17225,339,110,6547,21,265,74,2,0,72,36,6886,155,339,6547,134,21,473,6568,8,6,1,50
Jefferson,10/5/20,86,69,69,3562,31153,2999,34728,476,70424,3501,61,30852,301,2957,42,78,8,465,11,34353,375,3501,30852,74,301,3575,31153,19,26,1,477
Johnson,10/5/20,7,71,71,885,8270,840,9158,38,26291,877,8,8172,98,835,5,7,0,35,3,9049,109,877,8172,11,98,888,8270,2,10,0,24
Lafayette,10/5/20,2,73,73,123,1163,106,1288,15,6915,117,6,1157,6,101,5,2,0,14,1,1274,14,117,1157,8,6,125,1163,1,2,0,3
Lawrence,10/5/20,13,75,75,495,4609,410,5110,72,16669,454,41,4524,85,371,39,13,0,70,2,4978,132,454,4524,47,85,501,4609,3,7,0,18
Lee,10/5/20,18,77,77,1081,4171,1043,5253,20,9398,1078,3,4159,12,1041,2,17,1,20,0,5237,16,1078,4159,4,12,1082,4171,0,2,0,10
Lincoln,10/5/20,16,79,79,2093,7085,1939,9187,138,13695,2084,9,7052,33,1934,5,15,1,135,3,9136,51,2084,7052,18,33,2102,7085,5,4,1,51
LittleRiver,10/5/20,27,81,81,373,1863,332,2228,14,12417,354,19,1832,31,319,13,22,5,13,1,2186,42,354,1832,11,31,365,1863,0,1,1,9
Logan,10/5/20,1,83,83,446,7657,406,8104,39,21757,444,2,7627,30,405,1,1,0,38,1,8071,33,444,7627,3,30,447,7657,0,4,0,34
Lonoke,10/5/20,17,85,85,1318,21567,1124,22936,177,72206,1156,162,19789,1778,986,138,16,1,154,23,20945,1991,1156,19789,213,1778,1369,21567,4,16,0,117
Madison,10/5/20,5,87,87,377,4296,345,4675,27,16076,361,16,4227,69,333,12,5,0,23,4,4588,87,361,4227,18,69,379,4296,1,5,1,23
Marion,10/5/20,0,89,89,107,2432,94,2539,13,16438,102,5,2420,12,89,5,0,0,13,0,2522,17,102,2420,5,12,107,2432,0,3,0,18
Miller,10/5/20,11,91,91,919,6720,838,7637,70,43759,857,62,6601,119,785,53,10,1,62,8,7458,179,857,6601,60,119,917,6720,9,9,0,24
MissingCountyInfo,10/5/20,0,5,5,1965,65765,1473,67721,492,NA,1749,216,65765,0,1317,156,0,0,432,60,67514,207,1749,65765,207,0,1956,65765,-36,-3,0,659
Mississippi,10/5/20,53,93,93,1777,11974,1624,13737,99,42831,1735,42,11933,41,1603,21,42,11,89,10,13668,69,1735,11933,28,41,1763,11974,4,15,0,27
Monroe,10/5/20,0,95,95,148,2376,129,2524,19,7249,146,2,2340,36,127,2,0,0,19,0,2486,38,146,2340,2,36,148,2376,3,2,0,14
Montgomery,10/5/20,6,97,97,169,2339,143,2508,20,8993,167,2,2307,32,142,1,6,0,19,1,2474,34,167,2307,2,32,169,2339,0,3,0,25
Nevada,10/5/20,13,99,99,234,3488,207,3719,14,8440,222,12,3462,26,199,8,12,1,11,3,3684,35,222,3462,9,26,231,3488,1,0,0,4
Newton,10/5/20,19,101,101,257,1881,216,2133,22,7848,242,15,1804,77,208,8,16,3,18,4,2046,87,242,1804,10,77,252,1881,1,7,0,11
Ouachita,10/5/20,7,103,103,278,5900,249,6185,22,24106,270,8,5856,44,243,6,7,0,20,2,6126,59,270,5856,15,44,285,5900,3,4,0,27
Perry,10/5/20,0,105,105,98,3352,89,3450,9,10322,93,5,3273,79,84,5,0,0,9,0,3366,84,93,3273,5,79,98,3352,2,3,0,10
Phillips,10/5/20,14,107,107,550,7014,484,7568,52,19034,543,7,6944,70,481,3,14,0,48,4,7487,81,543,6944,11,70,554,7014,0,10,1,5
Pike,10/5/20,3,109,109,237,2363,222,2599,12,10808,233,4,2331,32,221,1,2,1,10,2,2564,35,233,2331,3,32,236,2363,0,0,0,33
Poinsett,10/5/20,15,111,111,718,7919,638,8635,65,24054,687,31,7895,24,620,18,14,1,53,12,8582,53,687,7895,29,24,716,7919,7,6,0,38
Polk,10/5/20,4,113,113,281,4712,255,4994,22,20163,279,2,4693,19,254,1,4,0,21,1,4972,22,279,4693,3,19,282,4712,1,1,0,17
Pope,10/5/20,36,115,115,2254,23311,2078,25557,140,63644,2218,36,23105,206,2053,25,32,4,133,7,25323,234,2218,23105,28,206,2246,23311,11,15,1,69
Prairie,10/5/20,3,117,117,164,2387,142,2553,19,8244,157,7,2194,193,137,5,3,0,17,2,2351,202,157,2194,9,193,166,2387,3,2,0,15
Pulaski,10/5/20,160,119,119,9859,139495,9058,149424,640,393463,9521,338,136314,3181,8764,294,146,14,610,30,145835,3589,9521,136314,408,3181,9929,139495,89,85,4,1550
Randolph,10/5/20,23,121,121,477,5155,401,5639,53,17603,421,56,5035,120,365,36,19,4,37,16,5456,183,421,5035,63,120,484,5155,5,2,1,14
Saline,10/5/20,24,125,125,2275,32400,2050,34688,200,118009,2165,110,31460,940,1958,92,22,2,184,16,33625,1063,2165,31460,123,940,2288,32400,14,36,0,190
Scott,10/5/20,1,127,127,115,2956,98,3071,16,10442,114,1,2943,13,98,0,1,0,15,1,3057,14,114,2943,1,13,115,2956,3,2,0,81
Searcy,10/5/20,1,129,129,154,2180,144,2333,9,7923,148,6,2150,30,140,4,1,0,7,2,2298,35,148,2150,5,30,153,2180,0,2,0,15
Sebastian,10/5/20,63,131,131,3974,47564,3579,51540,331,127461,3911,63,47486,78,3541,38,55,8,314,17,51397,143,3911,47486,65,78,3976,47564,28,31,1,443
Sevier,10/5/20,19,133,133,1214,6724,1185,7936,10,17193,1197,17,6643,81,1171,14,19,0,7,3,7840,96,1197,6643,15,81,1212,6724,1,1,0,11
Sharp,10/5/20,6,135,135,256,4228,210,4483,40,17043,235,21,4216,12,193,17,6,0,36,4,4451,32,235,4216,20,12,255,4228,2,2,0,20
St.Francis,10/5/20,6,123,123,1564,12507,1490,14072,68,26294,1560,4,12481,26,1489,1,6,0,65,3,14041,31,1560,12481,5,26,1565,12507,1,4,0,33
Stone,10/5/20,15,137,137,373,3566,321,3942,37,12446,365,8,3530,36,315,6,15,0,35,2,3895,47,365,3530,11,36,376,3566,0,11,0,33
Union,10/5/20,47,139,139,945,9564,860,10510,38,39732,905,40,9398,166,832,28,42,5,31,7,10303,207,905,9398,41,166,946,9564,2,4,0,19
VanBuren,10/5/20,3,141,141,178,4428,170,4611,5,16684,175,3,4349,79,167,3,3,0,5,0,4524,87,175,4349,8,79,183,4428,0,2,0,122
Washington,10/5/20,119,143,143,9949,80973,9347,90971,483,228529,9243,706,77641,3332,8760,587,103,16,380,103,86884,4087,9243,77641,755,3332,9998,80973,50,57,1,452
White,10/5/20,29,145,145,975,16989,842,17978,104,78804,860,115,16056,933,755,87,25,4,80,24,16916,1062,860,16056,129,933,989,16989,9,11,0,79
Woodruff,10/5/20,0,147,147,63,1783,55,1847,8,6660,55,8,1766,17,48,7,0,0,7,1,1821,26,55,1766,9,17,64,1783,2,0,0,12
Yell,10/5/20,30,149,149,1271,10285,1222,11553,19,21573,1263,8,10211,74,1217,5,27,3,19,0,11474,79,1263,10211,5,74,1268,10285,3,2,0,15
Arkansas_all_counties,10/4/20,1425,5630,5630,87013,1006814,78358,1094203,7222,2990671,83306,3707,989037,17777,75615,2743,1278,147,6405,817,1072343,21860,83306,989037,4083,17777,87389,1006814,488,586,18,16463
Arkansas_county,10/4/20,10,1,1,459,6901,376,7370,73,18124,428,31,6190,711,352,24,9,1,67,6,6618,752,428,6190,41,711,469,6901,5,4,0,530
Ashley,10/4/20,11,3,3,452,5416,416,5871,25,20537,446,6,5341,75,412,4,11,0,23,2,5787,84,446,5341,9,75,455,5416,1,3,0,61
Baxter,10/4/20,2,5,5,402,4416,328,4822,72,41219,350,52,4379,37,293,35,2,0,55,17,4729,93,350,4379,56,37,406,4416,5,5,0,58
Benton,10/4/20,95,7,7,6890,74522,6418,81454,376,258980,6583,307,73692,830,6196,222,78,17,308,68,80275,1179,6583,73692,349,830,6932,74522,18,33,2,465
Boone,10/4/20,19,9,9,806,11055,682,11861,105,37288,734,72,10993,62,641,41,17,2,76,29,11727,134,734,10993,72,62,806,11055,10,5,0,168
Bradley,10/4/20,8,11,11,345,3617,332,3961,5,10948,343,2,3598,19,331,1,7,1,5,0,3941,20,343,3598,1,19,344,3617,0,1,0,26
Calhoun,10/4/20,0,13,13,36,1758,36,1794,0,5202,35,1,1744,14,35,1,0,0,0,0,1779,15,35,1744,1,14,36,1758,0,0,0,11
Carroll,10/4/20,10,15,15,757,7461,653,8223,94,27887,745,12,7419,42,644,9,10,0,91,3,8164,59,745,7419,17,42,762,7461,11,5,0,79
Chicot,10/4/20,22,17,17,1013,5057,984,6071,7,10826,1003,10,5016,41,975,9,21,1,7,0,6019,52,1003,5016,11,41,1014,5057,0,1,0,53
Clark,10/4/20,4,19,19,381,6660,329,7043,48,22385,361,20,6567,93,314,15,4,0,43,5,6928,115,361,6567,22,93,383,6660,4,4,0,84
Clay,10/4/20,9,21,21,339,4420,276,4759,53,15061,323,16,4391,29,268,8,7,2,47,6,4714,45,323,4391,16,29,339,4420,7,2,1,37
Cleburne,10/4/20,9,23,23,360,6915,322,7279,29,25230,335,25,6739,176,306,16,9,0,20,9,7074,205,335,6739,29,176,364,6915,2,2,0,141
Cleveland,10/4/20,12,25,25,192,2843,171,3035,9,8226,189,3,2794,49,169,2,11,1,9,0,2983,52,189,2794,3,49,192,2843,2,1,0,28
Columbia,10/4/20,18,27,27,555,5208,432,5775,105,23892,504,51,5131,77,410,22,18,0,76,29,5635,140,504,5131,63,77,567,5208,10,11,0,77
Conway,10/4/20,3,29,29,294,6760,256,7053,35,20906,280,14,6597,163,249,7,3,0,28,7,6877,176,280,6597,13,163,293,6760,0,2,0,174
Craighead,10/4/20,24,31,31,3261,34643,2838,37920,398,105701,3163,98,34254,389,2761,77,21,3,380,18,37417,503,3163,34254,114,389,3277,34643,34,31,0,604
Crawford,10/4/20,16,33,33,1560,21281,1340,22842,204,62472,1517,43,21235,46,1305,35,13,3,199,5,22752,90,1517,21235,44,46,1561,21281,17,20,0,291
Crittenden,10/4/20,48,35,35,2007,13883,1894,15880,65,49013,1986,21,13854,29,1881,13,41,7,64,1,15840,40,1986,13854,11,29,1997,13883,2,2,2,55
Cross,10/4/20,14,37,37,480,5165,421,5642,45,16998,455,25,5126,39,407,14,12,2,36,9,5581,61,455,5126,22,39,477,5165,5,3,1,63
Dallas,10/4/20,5,39,39,171,2031,154,2202,12,7432,169,2,2013,18,153,1,5,0,11,1,2182,20,169,2013,2,18,171,2031,2,0,0,17
Desha,10/4/20,6,41,41,320,4158,281,4477,33,11887,314,6,4083,75,277,4,6,0,31,2,4397,80,314,4083,5,75,319,4158,4,3,0,73
Drew,10/4/20,7,43,43,363,6014,344,6380,12,18502,350,13,5861,153,332,12,6,1,12,0,6211,169,350,5861,16,153,366,6014,0,1,0,113
Faulkner,10/4/20,22,45,45,2704,39068,2389,41789,293,122416,2589,115,38117,951,2292,97,19,3,278,15,40706,1083,2589,38117,132,951,2721,39068,25,51,0,624
Franklin,10/4/20,2,47,47,325,6791,270,7117,53,17780,313,12,6738,53,259,11,2,0,52,1,7051,66,313,6738,13,53,326,6791,5,4,0,82
Fulton,10/4/20,5,49,49,198,1765,153,1966,40,12139,177,21,1659,106,141,12,4,1,32,8,1836,130,177,1659,24,106,201,1765,2,8,1,406
Garland,10/4/20,53,51,51,2028,32435,1802,34464,173,98296,1989,39,32111,324,1781,21,48,5,160,13,34100,364,1989,32111,40,324,2029,32435,9,7,0,349
Grant,10/4/20,2,53,53,277,5397,253,5680,22,18086,267,10,5301,96,244,9,2,0,21,1,5568,112,267,5301,16,96,283,5397,1,2,0,68
Greene,10/4/20,13,55,55,956,14446,842,15404,100,44623,912,44,14293,153,811,31,13,0,87,13,15205,199,912,14293,46,153,958,14446,6,5,0,114
Hempstead,10/4/20,4,57,57,405,5194,361,5602,40,22018,386,19,5121,73,352,9,4,0,30,10,5507,95,386,5121,22,73,408,5194,1,2,0,76
HotSpring,10/4/20,28,59,59,1954,13657,1847,15615,79,33520,1941,13,13519,138,1840,7,26,2,75,4,15460,155,1941,13519,17,138,1958,13657,8,3,0,339
Howard,10/4/20,12,61,61,503,3894,470,4399,21,13389,476,27,3836,58,448,22,12,0,16,5,4312,87,476,3836,29,58,505,3894,0,2,0,41
Independence,10/4/20,22,63,63,1213,11919,1093,13142,98,37264,1046,167,11802,117,969,124,21,1,56,42,12848,294,1046,11802,177,117,1223,11919,3,6,0,86
Izard,10/4/20,0,65,65,268,3572,211,3848,57,13559,251,17,3556,16,198,13,0,0,53,4,3807,41,251,3556,25,16,276,3572,1,47,0,13
Jackson,10/4/20,1,67,67,441,6526,333,6989,107,17225,329,112,6505,21,264,69,1,0,64,43,6834,155,329,6505,134,21,463,6526,21,3,0,133
Jefferson,10/4/20,85,69,69,3543,30695,2973,34252,484,70424,3483,60,30393,302,2932,41,77,8,473,11,33876,376,3483,30393,74,302,3557,30695,31,18,2,370
Johnson,10/4/20,7,71,71,883,8248,830,9134,46,26291,875,8,8150,98,826,4,7,0,42,4,9025,109,875,8150,11,98,886,8248,7,3,0,116
Lafayette,10/4/20,2,73,73,122,1161,104,1285,16,6915,116,6,1155,6,99,5,2,0,15,1,1271,14,116,1155,8,6,124,1161,2,0,0,10
Lawrence,10/4/20,13,75,75,492,4594,403,5092,76,16669,451,41,4509,85,364,39,13,0,74,2,4960,132,451,4509,47,85,498,4594,7,6,0,96
Lee,10/4/20,18,77,77,1081,4161,1041,5243,22,9398,1078,3,4149,12,1039,2,17,1,22,0,5227,16,1078,4149,4,12,1082,4161,2,0,0,39
Lincoln,10/4/20,15,79,79,2088,7039,1935,9136,138,13695,2080,8,7009,30,1931,4,14,1,135,3,9089,47,2080,7009,17,30,2097,7039,2,6,0,40
LittleRiver,10/4/20,26,81,81,373,1854,331,2219,16,12417,354,19,1823,31,318,13,21,5,15,1,2177,42,354,1823,11,31,365,1854,2,2,0,29
Logan,10/4/20,1,83,83,446,7623,402,8070,43,21757,444,2,7594,29,401,1,1,0,42,1,8038,32,444,7594,3,29,447,7623,3,4,0,59
Lonoke,10/4/20,17,85,85,1314,21454,1108,22819,189,72206,1153,161,19676,1778,972,136,16,1,165,24,20829,1990,1153,19676,212,1778,1365,21454,12,11,0,1021
Madison,10/4/20,4,87,87,376,4274,340,4652,32,16076,360,16,4205,69,329,11,4,0,27,5,4565,87,360,4205,18,69,378,4274,1,0,1,105
Marion,10/4/20,0,89,89,107,2414,91,2521,16,16438,102,5,2402,12,86,5,0,0,16,0,2504,17,102,2402,5,12,107,2414,0,1,0,9
Miller,10/4/20,11,91,91,910,6705,829,7613,70,43759,851,59,6586,119,777,52,10,1,64,6,7437,176,851,6586,57,119,908,6705,10,3,0,75
MissingCountyInfo,10/4/20,0,5,5,2001,65070,1476,67065,525,NA,1764,237,65070,0,1319,157,0,0,445,80,66834,231,1764,65070,231,0,1995,65070,28,36,0,1172
Mississippi,10/4/20,53,93,93,1773,11951,1609,13709,111,42831,1731,42,11909,42,1590,19,42,11,99,12,13640,69,1731,11909,27,42,1758,11951,11,10,0,76
Monroe,10/4/20,0,95,95,145,2365,127,2510,18,7249,143,2,2329,36,125,2,0,0,18,0,2472,38,143,2329,2,36,145,2365,2,3,0,50
Montgomery,10/4/20,6,97,97,169,2314,140,2483,23,8993,167,2,2282,32,139,1,6,0,22,1,2449,34,167,2282,2,32,169,2314,2,2,0,27
Nevada,10/4/20,13,99,99,233,3485,207,3715,13,8440,221,12,3459,26,199,8,12,1,10,3,3680,35,221,3459,9,26,230,3485,2,0,0,21
Newton,10/4/20,19,101,101,256,1871,209,2122,28,7848,241,15,1794,77,202,7,16,3,23,5,2035,87,241,1794,10,77,251,1871,5,0,0,89
Ouachita,10/4/20,7,103,103,275,5876,245,6158,23,24106,268,7,5832,44,239,6,7,0,22,1,6100,58,268,5832,14,44,282,5876,0,1,1,73
Perry,10/4/20,0,105,105,96,3344,86,3440,10,10322,92,4,3265,79,82,4,0,0,10,0,3357,83,92,3265,4,79,96,3344,2,1,0,34
Phillips,10/4/20,13,107,107,550,7009,474,7563,63,19034,543,7,6938,71,472,2,13,0,58,5,7481,82,543,6938,11,71,554,7009,2,4,0,86
Pike,10/4/20,3,109,109,237,2330,222,2566,12,10808,233,4,2299,31,221,1,2,1,10,2,2532,34,233,2299,3,31,236,2330,0,2,0,16
Poinsett,10/4/20,15,111,111,711,7888,632,8597,64,24054,682,29,7864,24,615,17,14,1,53,11,8546,51,682,7864,27,24,709,7888,3,3,1,75
Polk,10/4/20,4,113,113,280,4696,254,4977,22,20163,278,2,4679,17,253,1,4,0,21,1,4957,20,278,4679,3,17,281,4696,1,1,0,59
Pope,10/4/20,35,115,115,2243,23253,2063,25488,145,63644,2210,33,23046,207,2043,20,31,4,136,9,25256,232,2210,23046,25,207,2235,23253,0,11,1,233
Prairie,10/4/20,3,117,117,161,2375,140,2538,18,8244,154,7,2182,193,135,5,3,0,16,2,2336,202,154,2182,9,193,163,2375,2,2,0,175
Pulaski,10/4/20,156,119,119,9770,138034,8973,147874,640,393463,9433,337,134865,3169,8689,284,142,14,601,39,144298,3576,9433,134865,407,3169,9840,138034,50,90,1,2427
Randolph,10/4/20,22,121,121,472,5146,399,5625,51,17603,417,55,5028,118,364,35,18,4,35,16,5445,180,417,5028,62,118,479,5146,2,4,0,110
Saline,10/4/20,24,125,125,2261,32224,2014,34498,222,118009,2154,107,31303,921,1928,86,22,2,203,19,33457,1041,2154,31303,120,921,2274,32224,13,12,0,625
Scott,10/4/20,1,127,127,112,2878,96,2990,15,10442,111,1,2865,13,96,0,1,0,14,1,2976,14,111,2865,1,13,112,2878,0,0,0,26
Searcy,10/4/20,1,129,129,154,2165,142,2318,11,7923,148,6,2135,30,138,4,1,0,9,2,2283,35,148,2135,5,30,153,2165,0,-1,0,21
Sebastian,10/4/20,62,131,131,3946,47149,3548,51096,335,127461,3882,64,47083,66,3511,37,54,8,316,19,50965,131,3882,47083,65,66,3947,47149,20,15,1,430
Sevier,10/4/20,19,133,133,1213,6714,1184,7925,10,17193,1197,16,6633,81,1171,13,19,0,7,3,7830,95,1197,6633,14,81,1211,6714,0,0,0,34
Sharp,10/4/20,6,135,135,254,4210,208,4463,40,17043,233,21,4198,12,191,17,6,0,36,4,4431,32,233,4198,20,12,253,4210,4,2,0,56
St.Francis,10/4/20,6,123,123,1563,12475,1486,14039,71,26294,1559,4,12449,26,1486,0,6,0,67,4,14008,31,1559,12449,5,26,1564,12475,4,4,0,63
Stone,10/4/20,15,137,137,373,3533,310,3909,48,12446,365,8,3497,36,304,6,15,0,46,2,3862,47,365,3497,11,36,376,3533,2,3,2,42
Union,10/4/20,47,139,139,943,9547,856,10491,40,39732,903,40,9381,166,828,28,42,5,33,7,10284,207,903,9381,41,166,944,9547,1,5,1,108
VanBuren,10/4/20,3,141,141,178,4306,168,4489,7,16684,175,3,4226,80,165,3,3,0,7,0,4401,88,175,4226,8,80,183,4306,0,0,0,23
Washington,10/4/20,118,143,143,9899,80571,9290,90518,491,228529,9202,697,77259,3312,8717,573,102,16,383,108,86461,4057,9202,77259,745,3312,9947,80571,22,37,0,2099
White,10/4/20,29,145,145,966,16919,831,17899,106,78804,851,115,15988,931,746,85,25,4,80,26,16839,1060,851,15988,129,931,980,16919,8,3,0,624
Woodruff,10/4/20,0,147,147,61,1773,55,1835,6,6660,53,8,1756,17,48,7,0,0,5,1,1809,26,53,1756,9,17,62,1773,1,1,0,15
Yell,10/4/20,30,149,149,1268,10273,1220,11538,18,21573,1260,8,10197,76,1215,5,27,3,18,0,11457,81,1260,10197,5,76,1265,10273,1,2,0,66
Arkansas_all_counties,10/3/20,1407,5630,5630,86525,990839,77772,1077735,7338,2990671,82851,3674,981887,8952,75092,2680,1260,147,6491,847,1064738,12997,82851,981887,4045,8952,86896,990839,746,722,16,10861
Arkansas_county,10/3/20,10,1,1,454,6376,372,6840,72,18124,423,31,6139,237,349,23,9,1,65,7,6562,278,423,6139,41,237,464,6376,11,6,0,123
Ashley,10/3/20,11,3,3,451,5356,413,5809,27,20537,444,7,5327,29,408,5,11,0,25,2,5771,38,444,5327,9,29,453,5356,4,2,0,60
Baxter,10/3/20,2,5,5,397,4363,323,4764,72,41219,345,52,4346,17,289,34,2,0,54,18,4691,73,345,4346,56,17,401,4363,7,8,0,27
Benton,10/3/20,93,7,7,6872,74075,6385,80987,393,258980,6565,307,73578,497,6168,217,76,17,320,73,80143,844,6565,73578,347,497,6912,74075,65,54,0,493
Boone,10/3/20,19,9,9,796,10897,677,11693,100,37288,725,71,10880,17,636,41,17,2,72,28,11605,88,725,10880,71,17,796,10897,9,17,4,86
Bradley,10/3/20,8,11,11,345,3591,331,3935,6,10948,343,2,3585,6,330,1,7,1,6,0,3928,7,343,3585,1,6,344,3591,0,1,0,10
Calhoun,10/3/20,0,13,13,36,1747,36,1783,0,5202,35,1,1742,5,35,1,0,0,0,0,1777,6,35,1742,1,5,36,1747,0,0,0,4
Carroll,10/3/20,10,15,15,746,7393,648,8144,88,27887,734,12,7388,5,639,9,10,0,85,3,8122,22,734,7388,17,5,751,7393,4,15,0,26
Chicot,10/3/20,22,17,17,1013,5004,983,6018,8,10826,1003,10,4987,17,974,9,21,1,8,0,5990,28,1003,4987,11,17,1014,5004,0,0,0,29
Clark,10/3/20,4,19,19,377,6580,325,6959,48,22385,357,20,6535,45,311,14,4,0,42,6,6892,67,357,6535,22,45,379,6580,5,0,0,54
Clay,10/3/20,8,21,21,332,4390,274,4722,49,15061,317,15,4377,13,266,8,6,2,44,5,4694,28,317,4377,15,13,332,4390,5,11,0,39
Cleburne,10/3/20,9,23,23,358,6776,320,7138,29,25230,333,25,6679,97,305,15,9,0,19,10,7012,126,333,6679,29,97,362,6776,8,2,0,79
Cleveland,10/3/20,12,25,25,190,2817,170,3007,8,8226,187,3,2786,31,168,2,11,1,8,0,2973,34,187,2786,3,31,190,2817,1,1,0,15
Columbia,10/3/20,18,27,27,545,5141,421,5697,106,23892,496,49,5108,33,403,18,18,0,75,31,5604,93,496,5108,60,33,556,5141,11,12,0,56
Conway,10/3/20,3,29,29,294,6586,254,6879,37,20906,279,15,6516,70,247,7,3,0,29,8,6795,84,279,6516,14,70,293,6586,9,1,0,96
Craighead,10/3/20,24,31,31,3227,34073,2807,37316,395,105701,3129,98,33942,131,2734,73,21,3,373,22,37071,245,3129,33942,114,131,3243,34073,53,47,1,442
Crawford,10/3/20,16,33,33,1543,21007,1320,22551,207,62472,1500,43,20997,10,1285,35,13,3,202,5,22497,54,1500,20997,44,10,1544,21007,20,19,0,264
Crittenden,10/3/20,46,35,35,2005,13830,1892,15825,67,49013,1984,21,13814,16,1879,13,39,7,66,1,15798,27,1984,13814,11,16,1995,13830,8,6,0,107
Cross,10/3/20,13,37,37,475,5107,418,5579,44,16998,450,25,5083,24,404,14,11,2,35,9,5533,46,450,5083,22,24,472,5107,5,4,0,162
Dallas,10/3/20,5,39,39,169,2016,154,2185,10,7432,167,2,2006,10,153,1,5,0,9,1,2173,12,167,2006,2,10,169,2016,1,0,0,13
Desha,10/3/20,6,41,41,316,4089,278,4404,32,11887,310,6,4056,33,274,4,6,0,30,2,4366,38,310,4056,5,33,315,4089,3,4,0,33
Drew,10/3/20,7,43,43,363,5901,343,6267,13,18502,350,13,5850,51,331,12,6,1,13,0,6200,67,350,5850,16,51,366,5901,2,1,0,28
Faulkner,10/3/20,22,45,45,2679,38469,2338,41165,319,122416,2565,114,37742,727,2242,96,19,3,304,15,40307,858,2565,37742,131,727,2696,38469,36,21,2,576
Franklin,10/3/20,2,47,47,320,6714,266,7035,52,17780,308,12,6705,9,255,11,2,0,51,1,7013,22,308,6705,13,9,321,6714,2,2,0,86
Fulton,10/3/20,4,49,49,196,1361,145,1560,47,12139,175,21,1360,1,135,10,3,1,37,10,1535,25,175,1360,24,1,199,1361,7,9,0,22
Garland,10/3/20,53,51,51,2019,32095,1795,34115,171,98296,1980,39,32001,94,1774,21,48,5,158,13,33981,134,1980,32001,40,94,2020,32095,17,26,0,172
Grant,10/3/20,2,53,53,276,5330,251,5612,23,18086,266,10,5275,55,242,9,2,0,22,1,5541,71,266,5275,16,55,282,5330,1,2,0,21
Greene,10/3/20,13,55,55,950,14338,837,15290,99,44623,906,44,14231,107,808,29,13,0,84,15,15137,153,906,14231,46,107,952,14338,10,6,2,89
Hempstead,10/3/20,4,57,57,404,5119,359,5525,41,22018,385,19,5094,25,351,8,4,0,30,11,5479,46,385,5094,21,25,406,5119,6,2,0,108
HotSpring,10/3/20,28,59,59,1946,13326,1844,15276,74,33520,1934,12,13285,41,1837,7,26,2,71,3,15219,57,1934,13285,16,41,1950,13326,12,4,0,146
Howard,10/3/20,12,61,61,503,3853,468,4358,23,13389,476,27,3821,32,446,22,12,0,18,5,4297,61,476,3821,29,32,505,3853,2,3,0,23
Independence,10/3/20,22,63,63,1210,11836,1087,13056,101,37264,1043,167,11777,59,964,123,21,1,58,43,12820,236,1043,11777,177,59,1220,11836,33,18,1,84
Izard,10/3/20,0,65,65,267,3560,164,3835,103,13559,250,17,3548,12,152,12,0,0,98,5,3798,37,250,3548,25,12,275,3560,1,0,0,17
Jackson,10/3/20,1,67,67,420,6414,330,6855,89,17225,307,113,6403,11,263,67,1,0,43,46,6710,145,307,6403,134,11,441,6414,23,6,0,95
Jefferson,10/3/20,83,69,69,3512,30356,2955,33882,473,70424,3452,60,30172,184,2917,38,75,8,459,14,33624,258,3452,30172,74,184,3526,30356,48,66,2,240
Johnson,10/3/20,7,71,71,876,8139,827,9018,42,26291,868,8,8110,29,823,4,7,0,38,4,8978,40,868,8110,11,29,879,8139,2,2,0,126
Lafayette,10/3/20,2,73,73,120,1153,104,1275,14,6915,114,6,1151,2,99,5,2,0,13,1,1265,10,114,1151,8,2,122,1153,1,6,0,10
Lawrence,10/3/20,13,75,75,485,4505,397,4996,75,16669,444,41,4490,15,359,38,13,0,72,3,4934,62,444,4490,47,15,491,4505,5,6,0,39
Lee,10/3/20,18,77,77,1079,4124,1041,5204,20,9398,1076,3,4119,5,1039,2,17,1,20,0,5195,9,1076,4119,4,5,1080,4124,5,4,0,107
Lincoln,10/3/20,15,79,79,2086,7001,1929,9096,142,13695,2078,8,6980,21,1925,4,14,1,139,3,9058,38,2078,6980,17,21,2095,7001,39,41,0,141
LittleRiver,10/3/20,26,81,81,371,1827,329,2190,16,12417,352,19,1810,17,316,13,21,5,15,1,2162,28,352,1810,11,17,363,1827,1,0,0,11
Logan,10/3/20,1,83,83,443,7567,398,8011,44,21757,442,1,7555,12,397,1,1,0,44,0,7997,14,442,7555,2,12,444,7567,2,3,0,49
Lonoke,10/3/20,17,85,85,1302,20445,1097,21798,188,72206,1142,160,19427,1018,962,135,16,1,164,24,20569,1229,1142,19427,211,1018,1353,20445,15,27,0,201
Madison,10/3/20,3,87,87,375,4170,340,4547,32,16076,359,16,4150,20,329,11,3,0,27,5,4509,38,359,4150,18,20,377,4170,4,3,0,35
Marion,10/3/20,0,89,89,107,2405,90,2512,17,16438,102,5,2398,7,85,5,0,0,17,0,2500,12,102,2398,5,7,107,2405,1,6,0,8
Miller,10/3/20,11,91,91,900,6640,826,7538,63,43759,841,59,6571,69,774,52,10,1,57,6,7412,126,841,6571,57,69,898,6640,17,12,0,52
MissingCountyInfo,10/3/20,0,5,5,1973,63926,1440,65895,533,NA,1752,221,63926,0,1291,149,0,0,461,72,65678,217,1752,63926,217,0,1969,63926,-76,-49,0,2231
Mississippi,10/3/20,53,93,93,1762,11886,1599,13633,110,42831,1720,42,11869,17,1582,17,42,11,96,14,13589,44,1720,11869,27,17,1747,11886,17,9,1,89
Monroe,10/3/20,0,95,95,143,2317,124,2460,19,7249,141,2,2301,16,123,1,0,0,18,1,2442,18,141,2301,2,16,143,2317,-1,0,0,26
Montgomery,10/3/20,6,97,97,167,2289,138,2456,23,8993,165,2,2272,17,137,1,6,0,22,1,2437,19,165,2272,2,17,167,2289,0,5,0,5
Nevada,10/3/20,13,99,99,231,3466,207,3694,11,8440,220,11,3454,12,199,8,12,1,9,2,3674,20,220,3454,8,12,228,3466,4,6,0,92
Newton,10/3/20,19,101,101,251,1787,209,2033,23,7848,236,15,1786,1,202,7,16,3,18,5,2022,11,236,1786,10,1,246,1787,0,4,0,4
Ouachita,10/3/20,6,103,103,275,5803,244,6084,25,24106,267,8,5774,29,238,6,6,0,23,2,6041,43,267,5774,14,29,281,5803,2,1,0,76
Perry,10/3/20,0,105,105,94,3312,85,3406,9,10322,90,4,3244,68,81,4,0,0,9,0,3334,72,90,3244,4,68,94,3312,4,2,0,34
Phillips,10/3/20,13,107,107,548,6925,470,7476,65,19034,541,7,6893,32,468,2,13,0,60,5,7434,42,541,6893,10,32,551,6925,3,6,0,152
Pike,10/3/20,3,109,109,237,2314,220,2550,14,10808,233,4,2293,21,219,1,2,1,12,2,2526,24,233,2293,3,21,236,2314,3,1,0,15
Poinsett,10/3/20,14,111,111,708,7816,629,8522,65,24054,679,29,7803,13,613,16,13,1,53,12,8482,40,679,7803,27,13,706,7816,5,7,0,57
Polk,10/3/20,4,113,113,279,4638,253,4918,22,20163,277,2,4633,5,252,1,4,0,21,1,4910,8,277,4633,3,5,280,4638,4,1,0,90
Pope,10/3/20,34,115,115,2243,23020,2052,25255,157,63644,2211,32,22876,144,2034,18,30,4,147,10,25087,168,2211,22876,24,144,2235,23020,33,14,0,298
Prairie,10/3/20,3,117,117,159,2202,138,2363,18,8244,152,7,2168,34,133,5,3,0,16,2,2320,43,152,2168,9,34,161,2202,0,1,1,47
Pulaski,10/3/20,155,119,119,9720,135657,8883,145446,681,393463,9386,334,133835,1822,8604,279,141,14,640,41,143221,2225,9386,133835,403,1822,9789,135657,72,70,1,1028
Randolph,10/3/20,22,121,121,470,5038,395,5515,53,17603,415,55,4969,69,360,35,18,4,37,16,5384,131,415,4969,62,69,477,5038,3,2,0,26
Saline,10/3/20,24,125,125,2248,31612,2002,33873,221,118009,2142,106,31133,479,1918,84,22,2,201,20,33275,598,2142,31133,119,479,2261,31612,15,16,1,236
Scott,10/3/20,1,127,127,112,2852,96,2964,15,10442,111,1,2852,0,96,0,1,0,14,1,2963,1,111,2852,1,0,112,2852,1,2,0,25
Searcy,10/3/20,1,129,129,154,2144,143,2297,10,7923,148,6,2125,19,139,4,1,0,8,2,2273,24,148,2125,5,19,153,2144,1,0,0,13
Sebastian,10/3/20,61,131,131,3926,46739,3533,50666,331,127461,3863,63,46727,12,3496,37,53,8,313,18,50590,76,3863,46727,64,12,3927,46739,24,29,0,313
Sevier,10/3/20,19,133,133,1213,6680,1184,7891,10,17193,1197,16,6622,58,1171,13,19,0,7,3,7819,72,1197,6622,14,58,1211,6680,4,3,0,26
Sharp,10/3/20,6,135,135,250,4158,206,4408,38,17043,230,20,4147,11,189,17,6,0,35,3,4377,31,230,4147,20,11,250,4158,4,4,0,47
St.Francis,10/3/20,6,123,123,1559,12416,1482,13976,71,26294,1555,4,12407,9,1482,0,6,0,67,4,13962,14,1555,12407,5,9,1560,12416,4,8,0,62
Stone,10/3/20,13,137,137,371,3493,307,3867,51,12446,363,8,3481,12,301,6,13,0,49,2,3844,23,363,3481,11,12,374,3493,3,2,0,32
Union,10/3/20,46,139,139,942,9440,851,10383,45,39732,902,40,9360,80,826,25,41,5,35,10,10262,121,902,9360,41,80,943,9440,7,3,0,52
VanBuren,10/3/20,3,141,141,178,4283,168,4466,7,16684,175,3,4210,73,165,3,3,0,7,0,4385,81,175,4210,8,73,183,4283,-1,1,0,72
Washington,10/3/20,118,143,143,9877,78494,9253,88420,506,228529,9183,694,77054,1440,8687,566,102,16,394,112,86237,2183,9183,77054,743,1440,9926,78494,68,61,0,602
White,10/3/20,29,145,145,958,16303,828,17275,101,78804,845,113,15868,435,744,84,25,4,76,25,16713,562,845,15868,127,435,972,16303,18,20,0,337
Woodruff,10/3/20,0,147,147,60,1759,54,1820,6,6660,52,8,1749,10,47,7,0,0,5,1,1801,19,52,1749,9,10,61,1759,1,5,0,18
Yell,10/3/20,30,149,149,1267,10208,1218,11472,19,21573,1259,8,10160,48,1213,5,27,3,19,0,11419,53,1259,10160,5,48,1264,10208,3,2,0,52
Arkansas_all_counties,10/2/20,1391,5630,5630,85779,980724,77050,1066849,7330,2990671,82309,3470,971951,8773,74473,2577,1245,146,6583,747,1054260,12589,82309,971951,3816,8773,86125,980724,958,864,7,12122
Arkansas_county,10/2/20,10,1,1,443,6264,366,6717,67,18124,413,30,6027,237,345,21,9,1,59,8,6440,277,413,6027,40,237,453,6264,11,7,0,138
Ashley,10/2/20,11,3,3,447,5300,411,5749,25,20537,441,6,5272,28,407,4,11,0,23,2,5713,36,441,5272,8,28,449,5300,4,0,0,71
Baxter,10/2/20,2,5,5,390,4343,315,4735,73,41219,342,48,4326,17,282,33,2,0,58,15,4668,67,342,4326,50,17,392,4343,7,5,0,181
Benton,10/2/20,93,7,7,6807,73647,6331,80492,382,258980,6542,265,73150,497,6133,198,76,17,332,50,79692,800,6542,73150,303,497,6845,73647,40,54,0,495
Boone,10/2/20,15,9,9,787,10820,660,11608,112,37288,721,66,10803,17,623,37,13,2,85,27,11524,84,721,10803,67,17,788,10820,13,17,1,150
Bradley,10/2/20,8,11,11,345,3581,330,3925,7,10948,343,2,3576,5,329,1,7,1,7,0,3919,6,343,3576,1,5,344,3581,1,3,0,19
Calhoun,10/2/20,0,13,13,36,1743,36,1779,0,5202,35,1,1738,5,35,1,0,0,0,0,1773,6,35,1738,1,5,36,1743,0,2,0,15
Carroll,10/2/20,10,15,15,742,7371,633,8117,99,27887,731,11,7366,5,625,8,10,0,96,3,8097,20,731,7366,15,5,746,7371,17,11,0,66
Chicot,10/2/20,22,17,17,1013,4975,983,5989,8,10826,1003,10,4958,17,974,9,21,1,8,0,5961,28,1003,4958,11,17,1014,4975,4,3,0,23
Clark,10/2/20,4,19,19,372,6531,325,6903,43,22385,352,20,6486,45,311,14,4,0,37,6,6838,65,352,6486,20,45,372,6531,5,8,0,73
Clay,10/2/20,8,21,21,327,4356,263,4683,55,15061,312,15,4346,10,257,6,6,2,48,7,4658,25,312,4346,15,10,327,4356,3,4,0,31
Cleburne,10/2/20,9,23,23,350,6705,318,7058,23,25230,332,18,6611,94,303,15,9,0,20,3,6943,115,332,6611,21,94,353,6705,7,5,0,99
Cleveland,10/2/20,12,25,25,189,2803,169,2992,8,8226,186,3,2773,30,167,2,11,1,8,0,2959,33,186,2773,3,30,189,2803,2,0,0,74
Columbia,10/2/20,18,27,27,534,5096,409,5641,107,23892,490,44,5063,33,394,15,18,0,78,29,5553,88,490,5063,55,33,545,5096,14,9,0,45
Conway,10/2/20,3,29,29,285,6499,253,6784,29,20906,273,12,6434,65,246,7,3,0,24,5,6707,77,273,6434,12,65,285,6499,6,0,0,43
Craighead,10/2/20,23,31,31,3174,33684,2760,36871,390,105701,3082,92,33589,95,2690,70,20,3,371,19,36671,200,3082,33589,105,95,3187,33684,50,50,0,361
Crawford,10/2/20,16,33,33,1523,20763,1301,22286,206,62472,1480,43,20753,10,1266,35,13,3,201,5,22233,53,1480,20753,43,10,1523,20763,20,23,0,312
Crittenden,10/2/20,46,35,35,1997,13731,1886,15718,65,49013,1976,21,13723,8,1873,13,39,7,64,1,15699,19,1976,13723,11,8,1987,13731,14,11,0,49
Cross,10/2/20,13,37,37,470,4950,414,5416,43,16998,448,22,4927,23,402,12,11,2,35,8,5375,41,448,4927,18,23,466,4950,9,6,0,42
Dallas,10/2/20,5,39,39,168,2004,154,2172,9,7432,166,2,1994,10,153,1,5,0,8,1,2160,12,166,1994,2,10,168,2004,1,1,0,17
Desha,10/2/20,6,41,41,313,4059,274,4371,33,11887,308,5,4027,32,271,3,6,0,31,2,4335,36,308,4027,4,32,312,4059,6,1,0,80
Drew,10/2/20,7,43,43,361,5875,342,6239,12,18502,349,12,5824,51,331,11,6,1,12,0,6173,66,349,5824,15,51,364,5875,2,1,0,41
Faulkner,10/2/20,20,45,45,2643,37929,2317,40588,306,122416,2534,109,37232,697,2226,91,17,3,291,15,39766,822,2534,37232,125,697,2659,37929,47,24,0,344
Franklin,10/2/20,2,47,47,318,6630,264,6949,52,17780,306,12,6622,8,254,10,2,0,50,2,6928,21,306,6622,13,8,319,6630,14,6,0,207
Fulton,10/2/20,4,49,49,189,1346,136,1537,49,12139,169,20,1345,1,126,10,3,1,40,9,1514,23,169,1345,22,1,191,1346,3,6,0,20
Garland,10/2/20,53,51,51,2002,31940,1769,33943,180,98296,1967,35,31847,93,1751,18,48,5,168,12,33814,129,1967,31847,36,93,2003,31940,25,21,0,608
Grant,10/2/20,2,53,53,275,5310,249,5591,24,18086,265,10,5255,55,240,9,2,0,23,1,5520,71,265,5255,16,55,281,5310,1,0,0,134
Greene,10/2/20,11,55,55,940,14259,831,15201,97,44623,903,37,14152,107,802,29,11,0,89,8,15055,146,903,14152,39,107,942,14259,12,13,0,221
Hempstead,10/2/20,4,57,57,398,5017,357,5416,37,22018,378,20,4992,25,349,8,4,0,25,12,5370,46,378,4992,21,25,399,5017,5,2,0,63
HotSpring,10/2/20,28,59,59,1934,13192,1840,15129,66,33520,1922,12,13152,40,1833,7,26,2,63,3,15074,55,1922,13152,15,40,1937,13192,6,3,1,155
Howard,10/2/20,12,61,61,501,3832,465,4335,24,13389,475,26,3800,32,445,20,12,0,18,6,4275,60,475,3800,28,32,503,3832,8,6,0,45
Independence,10/2/20,21,63,63,1177,11785,1069,12970,87,37264,1030,147,11726,59,955,114,20,1,55,32,12756,214,1030,11726,155,59,1185,11785,15,14,0,266
Izard,10/2/20,0,65,65,266,3544,164,3818,102,13559,248,18,3532,12,151,13,0,0,97,5,3780,38,248,3532,26,12,274,3544,6,3,0,48
Jackson,10/2/20,1,67,67,397,6342,324,6759,72,17225,299,98,6331,11,261,63,1,0,37,35,6630,129,299,6331,118,11,417,6342,17,10,0,110
Jefferson,10/2/20,81,69,69,3464,30164,2889,33641,493,70424,3407,57,29983,181,2853,36,73,8,480,13,33390,251,3407,29983,70,181,3477,30164,51,71,1,432
Johnson,10/2/20,7,71,71,874,8015,825,8892,42,26291,867,7,7986,29,822,3,7,0,38,4,8853,39,867,7986,10,29,877,8015,8,6,0,72
Lafayette,10/2/20,2,73,73,119,1144,98,1265,19,6915,114,5,1142,2,96,2,2,0,16,3,1256,9,114,1142,7,2,121,1144,1,3,0,16
Lawrence,10/2/20,13,75,75,480,4471,391,4956,76,16669,439,41,4457,14,353,38,13,0,73,3,4896,60,439,4457,46,14,485,4471,9,9,1,43
Lee,10/2/20,18,77,77,1074,4022,1037,5097,19,9398,1071,3,4017,5,1035,2,17,1,19,0,5088,9,1071,4017,4,5,1075,4022,6,2,0,14
Lincoln,10/2/20,15,79,79,2047,6899,1888,8955,144,13695,2039,8,6878,21,1884,4,14,1,141,3,8917,38,2039,6878,17,21,2056,6899,21,69,0,98
LittleRiver,10/2/20,26,81,81,370,1817,329,2178,15,12417,350,20,1800,17,316,13,21,5,13,2,2150,28,350,1800,11,17,361,1817,4,2,0,33
Logan,10/2/20,1,83,83,441,7520,395,7962,45,21757,440,1,7510,10,394,1,1,0,45,0,7950,12,440,7510,2,10,442,7520,16,3,0,111
Lonoke,10/2/20,17,85,85,1287,20259,1070,21595,200,72206,1136,151,19241,1018,940,130,16,1,180,20,20377,1218,1136,19241,200,1018,1336,20259,24,18,0,270
Madison,10/2/20,3,87,87,371,4139,337,4512,31,16076,356,15,4119,20,327,10,3,0,26,5,4475,37,356,4119,17,20,373,4139,1,1,0,38
Marion,10/2/20,0,89,89,106,2398,84,2504,22,16438,101,5,2391,7,79,5,0,0,22,0,2492,12,101,2391,5,7,106,2398,1,0,0,18
Miller,10/2/20,11,91,91,883,6605,814,7486,58,43759,827,56,6536,69,764,50,10,1,53,5,7363,123,827,6536,54,69,881,6605,16,10,0,75
MissingCountyInfo,10/2/20,0,5,5,2049,61619,1489,63667,560,NA,1804,245,61618,1,1330,159,0,0,474,86,63422,245,1804,61618,244,1,2048,61619,79,25,0,1921
Mississippi,10/2/20,52,93,93,1745,11814,1590,13544,103,42831,1706,39,11798,16,1573,17,41,11,92,11,13504,40,1706,11798,24,16,1730,11814,17,7,1,89
Monroe,10/2/20,0,95,95,144,2290,124,2434,20,7249,142,2,2275,15,123,1,0,0,19,1,2417,17,142,2275,2,15,144,2290,5,6,0,32
Montgomery,10/2/20,6,97,97,167,2284,133,2451,28,8993,165,2,2267,17,132,1,6,0,27,1,2432,19,165,2267,2,17,167,2284,7,0,0,20
Nevada,10/2/20,13,99,99,227,3378,201,3602,13,8440,217,10,3367,11,194,7,12,1,11,2,3584,18,217,3367,7,11,224,3378,1,3,0,83
Newton,10/2/20,19,101,101,251,1783,205,2029,27,7848,236,15,1782,1,198,7,16,3,22,5,2018,11,236,1782,10,1,246,1783,1,3,0,18
Ouachita,10/2/20,6,103,103,273,5729,243,6008,24,24106,266,7,5701,28,237,6,6,0,23,1,5967,41,266,5701,13,28,279,5729,3,2,0,47
Perry,10/2/20,0,105,105,90,3282,83,3372,7,10322,86,4,3222,60,79,4,0,0,7,0,3308,64,86,3222,4,60,90,3282,0,1,0,31
Phillips,10/2/20,13,107,107,545,6776,464,7324,68,19034,538,7,6746,30,462,2,13,0,63,5,7284,40,538,6746,10,30,548,6776,16,4,0,64
Pike,10/2/20,3,109,109,234,2302,219,2535,12,10808,231,3,2281,21,218,1,2,1,11,1,2512,23,231,2281,2,21,233,2302,0,0,0,18
Poinsett,10/2/20,14,111,111,703,7764,622,8464,67,24054,676,27,7751,13,606,16,13,1,57,10,8427,37,676,7751,24,13,700,7764,10,10,0,54
Polk,10/2/20,4,113,113,275,4552,252,4828,19,20163,273,2,4547,5,251,1,4,0,18,1,4820,8,273,4547,3,5,276,4552,3,0,0,33
Pope,10/2/20,34,115,115,2210,22755,2038,24956,138,63644,2182,28,22609,146,2023,15,30,4,129,9,24791,165,2182,22609,19,146,2201,22755,30,13,1,361
Prairie,10/2/20,2,117,117,159,2155,137,2316,20,8244,152,7,2122,33,132,5,2,0,18,2,2274,42,152,2122,9,33,161,2155,1,2,0,28
Pulaski,10/2/20,154,119,119,9648,134701,8813,144416,680,393463,9324,324,132895,1806,8539,274,141,13,643,37,142219,2197,9324,132895,391,1806,9715,134701,36,64,0,998
Randolph,10/2/20,22,121,121,467,5015,393,5489,52,17603,414,53,4952,63,359,34,18,4,37,15,5366,123,414,4952,60,63,474,5015,19,15,0,64
Saline,10/2/20,23,125,125,2233,31391,1986,33637,223,118009,2132,101,30916,475,1906,80,21,2,204,19,33048,589,2132,30916,114,475,2246,31391,36,19,0,417
Scott,10/2/20,1,127,127,111,2828,94,2939,16,10442,110,1,2828,0,94,0,1,0,15,1,2938,1,110,2828,1,0,111,2828,0,0,0,46
Searcy,10/2/20,1,129,129,153,2132,143,2284,9,7923,147,6,2113,19,139,4,1,0,7,2,2260,24,147,2113,5,19,152,2132,2,1,0,51
Sebastian,10/2/20,61,131,131,3902,46450,3504,50353,336,127461,3842,60,46438,12,3469,35,53,8,319,17,50280,73,3842,46438,61,12,3903,46450,46,39,0,534
Sevier,10/2/20,19,133,133,1209,6658,1181,7865,9,17193,1194,15,6600,58,1168,13,19,0,7,2,7794,71,1194,6600,13,58,1207,6658,1,0,1,31
Sharp,10/2/20,6,135,135,246,4115,202,4361,38,17043,228,18,4105,10,188,14,6,0,34,4,4333,28,228,4105,18,10,246,4115,4,1,0,101
St.Francis,10/2/20,6,123,123,1555,12358,1474,13914,75,26294,1552,3,12350,8,1474,0,6,0,72,3,13902,12,1552,12350,4,8,1556,12358,8,22,0,68
Stone,10/2/20,13,137,137,368,3464,305,3835,50,12446,361,7,3452,12,299,6,13,0,49,1,3813,22,361,3452,10,12,371,3464,1,3,0,41
Union,10/2/20,46,139,139,935,9395,848,10333,41,39732,897,38,9317,78,825,23,41,5,31,10,10214,119,897,9317,41,78,938,9395,11,10,0,80
VanBuren,10/2/20,3,141,141,179,4210,167,4394,9,16684,176,3,4149,61,164,3,3,0,9,0,4325,69,176,4149,8,61,184,4210,1,0,0,45
Washington,10/2/20,118,143,143,9809,77960,9192,87815,499,228529,9149,660,76525,1435,8636,556,102,16,411,88,85674,2141,9149,76525,706,1435,9855,77960,46,67,0,713
White,10/2/20,29,145,145,940,15984,808,16938,103,78804,834,106,15569,415,727,81,25,4,82,21,16403,535,834,15569,120,415,954,15984,15,23,0,175
Woodruff,10/2/20,0,147,147,59,1742,49,1802,10,6660,51,8,1732,10,43,6,0,0,8,2,1783,19,51,1732,9,10,60,1742,2,0,0,41
Yell,10/2/20,30,149,149,1264,10159,1216,11420,18,21573,1256,8,10112,47,1212,4,27,3,17,1,11368,52,1256,10112,5,47,1261,10159,4,1,0,52
Arkansas_all_counties,10/1/20,1384,5630,5630,84821,969560,76186,1054699,7244,2990671,81531,3290,961085,8475,73734,2452,1238,146,6552,692,1042616,12083,81531,961085,3608,8475,85139,969560,1124,874,15,13260
Arkansas_county,10/1/20,10,1,1,432,6137,359,6579,63,18124,404,28,5899,238,339,20,9,1,56,7,6303,276,404,5899,38,238,442,6137,6,5,1,103
Ashley,10/1/20,11,3,3,443,5233,411,5678,21,20537,437,6,5208,25,407,4,11,0,19,2,5645,33,437,5208,8,25,445,5233,7,1,1,56
Baxter,10/1/20,2,5,5,383,4169,310,4553,71,41219,337,46,4152,17,279,31,2,0,56,15,4489,64,337,4152,47,17,384,4169,17,5,0,73
Benton,10/1/20,93,7,7,6767,73192,6277,79994,396,258980,6519,248,72734,458,6089,188,76,17,353,43,79253,741,6519,72734,283,458,6802,73192,68,44,0,777
Boone,10/1/20,14,9,9,774,10683,643,11457,117,37288,714,60,10668,15,608,35,12,2,94,23,11382,75,714,10668,60,15,774,10683,22,12,1,362
Bradley,10/1/20,8,11,11,344,3563,327,3906,9,10948,342,2,3558,5,326,1,7,1,9,0,3900,6,342,3558,1,5,343,3563,2,2,0,26
Calhoun,10/1/20,0,13,13,36,1728,34,1764,2,5202,35,1,1723,5,33,1,0,0,2,0,1758,6,35,1723,1,5,36,1728,0,0,0,17
Carroll,10/1/20,10,15,15,725,7322,622,8051,93,27887,714,11,7318,4,615,7,10,0,89,4,8032,19,714,7318,15,4,729,7322,15,13,0,67
Chicot,10/1/20,22,17,17,1009,4956,980,5966,7,10826,1000,9,4939,17,972,8,21,1,7,0,5939,27,1000,4939,10,17,1010,4956,2,2,0,32
Clark,10/1/20,4,19,19,367,6463,317,6830,46,22385,347,20,6418,45,305,12,4,0,38,8,6765,65,347,6418,20,45,367,6463,10,2,0,82
Clay,10/1/20,8,21,21,324,4328,259,4652,56,15061,309,15,4322,6,253,6,6,2,49,7,4631,21,309,4322,15,6,324,4328,10,1,0,48
Cleburne,10/1/20,9,23,23,343,6613,313,6957,21,25230,325,18,6521,92,298,15,9,0,18,3,6846,111,325,6521,19,92,344,6613,5,1,0,68
Cleveland,10/1/20,12,25,25,187,2731,169,2918,6,8226,184,3,2701,30,167,2,11,1,6,0,2885,33,184,2701,3,30,187,2731,1,1,0,54
Columbia,10/1/20,18,27,27,520,5065,400,5596,102,23892,480,40,5033,32,385,15,18,0,77,25,5513,83,480,5033,51,32,531,5065,20,13,0,53
Conway,10/1/20,3,29,29,279,6462,253,6741,23,20906,269,10,6394,68,246,7,3,0,20,3,6663,78,269,6394,10,68,279,6462,6,2,0,109
Craighead,10/1/20,23,31,31,3124,33373,2710,36504,390,105701,3033,91,33282,91,2644,66,20,3,368,22,36315,189,3033,33282,98,91,3131,33373,48,77,1,364
Crawford,10/1/20,16,33,33,1503,20471,1278,21974,209,62472,1462,41,20461,10,1244,34,13,3,205,4,21923,51,1462,20461,41,10,1503,20471,38,22,0,343
Crittenden,10/1/20,46,35,35,1983,13696,1875,15669,62,49013,1963,20,13688,8,1862,13,39,7,62,0,15651,18,1963,13688,10,8,1973,13696,13,11,0,43
Cross,10/1/20,13,37,37,461,4917,408,5373,40,16998,442,19,4894,23,397,11,11,2,34,6,5336,37,442,4894,14,23,456,4917,8,3,0,29
Dallas,10/1/20,5,39,39,167,1988,153,2155,9,7432,165,2,1979,9,152,1,5,0,8,1,2144,11,165,1979,2,9,167,1988,1,1,0,28
Desha,10/1/20,6,41,41,307,3985,273,4291,28,11887,303,4,3953,32,270,3,6,0,27,1,4256,35,303,3953,3,32,306,3985,7,2,0,50
Drew,10/1/20,7,43,43,359,5836,341,6198,11,18502,347,12,5787,49,331,10,6,1,10,1,6134,64,347,5787,15,49,362,5836,0,0,0,67
Faulkner,10/1/20,20,45,45,2596,37632,2293,40243,283,122416,2492,104,36942,690,2205,88,17,3,270,13,39434,809,2492,36942,119,690,2611,37632,30,27,0,383
Franklin,10/1/20,2,47,47,304,6437,258,6742,44,17780,292,12,6428,9,248,10,2,0,42,2,6720,22,292,6428,13,9,305,6437,11,8,0,126
Fulton,10/1/20,4,49,49,186,1329,130,1517,52,12139,166,20,1328,1,120,10,3,1,43,9,1494,23,166,1328,22,1,188,1329,9,5,0,28
Garland,10/1/20,53,51,51,1977,31357,1748,33335,176,98296,1947,30,31265,92,1730,18,48,5,169,7,33212,123,1947,31265,31,92,1978,31357,28,26,0,659
Grant,10/1/20,2,53,53,274,5177,249,5457,23,18086,264,10,5123,54,240,9,2,0,22,1,5387,70,264,5123,16,54,280,5177,2,6,0,73
Greene,10/1/20,11,55,55,928,14050,818,14979,99,44623,891,37,13948,102,789,29,11,0,91,8,14839,140,891,13948,38,102,929,14050,19,19,1,166
Hempstead,10/1/20,4,57,57,393,4959,355,5353,34,22018,374,19,4934,25,348,7,4,0,22,12,5308,45,374,4934,20,25,394,4959,11,2,0,51
HotSpring,10/1/20,27,59,59,1928,13043,1837,14974,64,33520,1917,11,13004,39,1830,7,25,2,62,2,14921,53,1917,13004,14,39,1931,13043,7,3,0,94
Howard,10/1/20,12,61,61,493,3795,459,4290,22,13389,468,25,3764,31,444,15,12,0,12,10,4232,58,468,3764,27,31,495,3795,8,3,0,41
Independence,10/1/20,21,63,63,1162,11534,1055,12704,86,37264,1026,136,11480,54,948,107,20,1,58,28,12506,198,1026,11480,144,54,1170,11534,14,20,0,104
Izard,10/1/20,0,65,65,260,3502,161,3770,99,13559,245,15,3490,12,150,11,0,0,95,4,3735,35,245,3490,23,12,268,3502,7,7,0,28
Jackson,10/1/20,1,67,67,380,6249,314,6644,65,17225,287,93,6238,11,256,58,1,0,30,35,6525,119,287,6238,108,11,395,6249,21,14,0,92
Jefferson,10/1/20,80,69,69,3413,29783,2818,33206,514,70424,3357,56,29607,176,2781,37,72,8,503,11,32964,242,3357,29607,66,176,3423,29783,20,55,1,383
Johnson,10/1/20,7,71,71,866,7951,819,8820,40,26291,859,7,7924,27,817,2,7,0,35,5,8783,37,859,7924,10,27,869,7951,7,6,0,44
Lafayette,10/1/20,2,73,73,118,1129,95,1249,21,6915,113,5,1127,2,93,2,2,0,18,3,1240,9,113,1127,7,2,120,1129,1,1,0,10
Lawrence,10/1/20,12,75,75,471,4437,382,4911,77,16669,430,41,4424,13,344,38,12,0,74,3,4854,57,430,4424,44,13,474,4437,10,9,0,143
Lee,10/1/20,18,77,77,1068,4014,1035,5083,15,9398,1065,3,4009,5,1033,2,17,1,15,0,5074,9,1065,4009,4,5,1069,4014,3,2,0,12
Lincoln,10/1/20,15,79,79,2026,6822,1819,8857,192,13695,2018,8,6804,18,1816,3,14,1,188,4,8822,35,2018,6804,17,18,2035,6822,1,16,0,18
LittleRiver,10/1/20,26,81,81,366,1788,327,2145,13,12417,347,19,1771,17,314,13,21,5,12,1,2118,27,347,1771,10,17,357,1788,4,2,0,13
Logan,10/1/20,1,83,83,425,7425,392,7851,32,21757,424,1,7415,10,391,1,1,0,32,0,7839,12,424,7415,2,10,426,7425,4,2,0,167
Lonoke,10/1/20,17,85,85,1263,20013,1052,21325,194,72206,1118,145,19021,992,927,125,16,1,175,19,20139,1186,1118,19021,194,992,1312,20013,33,19,0,493
Madison,10/1/20,3,87,87,370,4102,336,4474,31,16076,355,15,4088,14,326,10,3,0,26,5,4443,31,355,4088,17,14,372,4102,5,2,0,35
Marion,10/1/20,0,89,89,105,2381,84,2486,21,16438,100,5,2374,7,79,5,0,0,21,0,2474,12,100,2374,5,7,105,2381,3,-1,0,33
Miller,10/1/20,11,91,91,867,6546,804,7412,52,43759,816,51,6477,69,756,48,10,1,50,2,7293,119,816,6477,50,69,866,6546,10,11,0,54
MissingCountyInfo,10/1/20,0,5,5,1970,59777,1464,61745,506,NA,1767,203,59776,1,1332,132,0,0,435,71,61543,202,1767,59776,201,1,1968,59777,59,36,0,2278
Mississippi,10/1/20,51,93,93,1728,11742,1583,13457,94,42831,1692,36,11726,16,1566,17,40,11,86,8,13418,39,1692,11726,23,16,1715,11742,20,17,0,102
Monroe,10/1/20,0,95,95,139,2263,118,2402,21,7249,137,2,2249,14,117,1,0,0,20,1,2386,16,137,2249,2,14,139,2263,4,6,0,18
Montgomery,10/1/20,6,97,97,160,2271,133,2431,21,8993,159,1,2254,17,132,1,6,0,21,0,2413,18,159,2254,1,17,160,2271,5,1,0,35
Nevada,10/1/20,13,99,99,226,3296,198,3519,15,8440,216,10,3285,11,191,7,12,1,13,2,3501,18,216,3285,7,11,223,3296,2,3,0,20
Newton,10/1/20,19,101,101,250,1766,202,2011,29,7848,235,15,1765,1,195,7,16,3,24,5,2000,11,235,1765,10,1,245,1766,2,2,0,23
Ouachita,10/1/20,6,103,103,270,5685,241,5961,23,24106,263,7,5658,27,235,6,6,0,22,1,5921,40,263,5658,13,27,276,5685,1,2,0,79
Perry,10/1/20,0,105,105,90,3251,82,3341,8,10322,86,4,3191,60,78,4,0,0,8,0,3277,64,86,3191,4,60,90,3251,1,0,0,81
Phillips,10/1/20,13,107,107,529,6728,460,7260,56,19034,523,6,6698,30,458,2,13,0,52,4,7221,39,523,6698,9,30,532,6728,14,4,1,53
Pike,10/1/20,3,109,109,234,2284,219,2517,12,10808,231,3,2263,21,218,1,2,1,11,1,2494,23,231,2263,2,21,233,2284,0,2,0,43
Poinsett,10/1/20,14,111,111,693,7720,612,8408,67,24054,668,25,7708,12,598,14,13,1,57,10,8376,32,668,7708,20,12,688,7720,18,11,0,76
Polk,10/1/20,4,113,113,272,4522,252,4795,16,20163,270,2,4517,5,251,1,4,0,15,1,4787,8,270,4517,3,5,273,4522,4,3,0,45
Pope,10/1/20,33,115,115,2180,22424,2025,24595,122,63644,2154,26,22282,142,2011,14,29,4,114,8,24436,159,2154,22282,17,142,2171,22424,14,9,0,252
Prairie,10/1/20,2,117,117,158,2128,135,2288,21,8244,151,7,2096,32,130,5,2,0,19,2,2247,41,151,2096,9,32,160,2128,4,1,0,52
Pulaski,10/1/20,154,119,119,9612,133739,8749,143418,708,393463,9291,321,131953,1786,8480,269,141,13,669,39,141244,2174,9291,131953,388,1786,9679,133739,103,67,1,1084
Randolph,10/1/20,22,121,121,448,4970,378,5424,48,17603,401,47,4918,52,349,29,18,4,34,14,5319,105,401,4918,53,52,454,4970,6,6,0,90
Saline,10/1/20,23,125,125,2197,31010,1967,33220,206,118009,2101,96,30544,466,1888,79,21,2,191,15,32645,575,2101,30544,109,466,2210,31010,67,15,0,409
Scott,10/1/20,1,127,127,111,2782,94,2893,16,10442,110,1,2782,0,94,0,1,0,15,1,2892,1,110,2782,1,0,111,2782,5,0,0,121
Searcy,10/1/20,1,129,129,151,2083,142,2233,8,7923,145,6,2065,18,138,4,1,0,6,2,2210,23,145,2065,5,18,150,2083,3,-1,0,17
Sebastian,10/1/20,61,131,131,3856,45962,3465,49819,329,127461,3803,53,45950,12,3432,33,53,8,317,12,49753,66,3803,45950,54,12,3857,45962,44,56,0,683
Sevier,10/1/20,18,133,133,1208,6628,1181,7834,9,17193,1193,15,6571,57,1168,13,18,0,7,2,7764,70,1193,6571,13,57,1206,6628,1,0,0,19
Sharp,10/1/20,6,135,135,242,4018,201,4260,35,17043,224,18,4010,8,188,13,6,0,30,5,4234,26,224,4010,18,8,242,4018,3,-1,0,44
St.Francis,10/1/20,6,123,123,1547,12298,1452,13846,89,26294,1545,2,12290,8,1452,0,6,0,87,2,13835,11,1545,12290,3,8,1548,12298,5,33,0,28
Stone,10/1/20,13,137,137,367,3424,302,3794,52,12446,360,7,3412,12,296,6,13,0,51,1,3772,22,360,3412,10,12,370,3424,2,5,0,38
Union,10/1/20,46,139,139,924,9326,838,10251,40,39732,889,35,9250,76,821,17,41,5,27,13,10139,112,889,9250,36,76,925,9326,13,5,6,152
VanBuren,10/1/20,3,141,141,178,4166,167,4349,8,16684,175,3,4107,59,164,3,3,0,8,0,4282,67,175,4107,8,59,183,4166,2,0,0,48
Washington,10/1/20,118,143,143,9763,77293,9125,87103,520,228529,9109,654,75976,1317,8579,546,102,16,428,92,85085,2018,9109,75976,701,1317,9810,77293,118,74,0,875
White,10/1/20,29,145,145,925,15824,785,16763,111,78804,829,96,15416,408,712,73,25,4,92,19,16245,518,829,15416,110,408,939,15824,27,26,0,206
Woodruff,10/1/20,0,147,147,57,1703,49,1761,8,6660,50,7,1693,10,43,6,0,0,7,1,1743,18,50,1693,8,10,58,1703,2,3,0,6
Yell,10/1/20,30,149,149,1260,10111,1215,11368,15,21573,1252,8,10063,48,1211,4,27,3,14,1,11315,53,1252,10063,5,48,1257,10111,1,5,1,182
Arkansas_all_counties,9/30/20,1369,5630,5630,83697,957424,75312,1041417,7009,2990671,80610,3087,949107,8317,73007,2305,1223,146,6373,636,1029717,11700,80610,949107,3383,8317,83993,957424,942,872,19,22487
Arkansas_county,9/30/20,9,1,1,426,6040,354,6475,63,18124,400,26,5802,238,336,18,8,1,56,7,6202,273,400,5802,35,238,435,6040,9,10,1,81
Ashley,9/30/20,10,3,3,436,5184,410,5622,16,20537,430,6,5159,25,406,4,10,0,14,2,5589,33,430,5159,8,25,438,5184,1,4,0,25
Baxter,9/30/20,2,5,5,366,4113,305,4480,59,41219,324,42,4096,17,275,30,2,0,47,12,4420,60,324,4096,43,17,367,4113,9,10,0,40
Benton,9/30/20,93,7,7,6699,72483,6233,79214,372,258980,6463,236,72039,444,6054,179,76,17,332,40,78502,712,6463,72039,268,444,6731,72483,64,63,1,555
Boone,9/30/20,13,9,9,752,10343,631,11096,108,37288,699,53,10328,15,597,34,11,2,91,17,11027,69,699,10328,54,15,753,10343,16,10,0,85
Bradley,9/30/20,8,11,11,342,3539,325,3880,9,10948,340,2,3534,5,324,1,7,1,9,0,3874,6,340,3534,1,5,341,3539,0,0,0,6
Calhoun,9/30/20,0,13,13,36,1711,34,1747,2,5202,35,1,1706,5,33,1,0,0,2,0,1741,6,35,1706,1,5,36,1711,0,0,0,9
Carroll,9/30/20,10,15,15,710,7270,609,7984,91,27887,700,10,7266,4,603,6,10,0,87,4,7966,18,700,7266,14,4,714,7270,22,10,0,174
Chicot,9/30/20,22,17,17,1007,4926,978,5934,7,10826,998,9,4909,17,971,7,21,1,6,1,5907,27,998,4909,10,17,1008,4926,0,1,0,15
Clark,9/30/20,4,19,19,357,6391,315,6748,38,22385,341,16,6346,45,304,11,4,0,33,5,6687,61,341,6346,16,45,357,6391,7,5,0,91
Clay,9/30/20,8,21,21,314,4290,258,4604,47,15061,300,14,4284,6,252,6,6,2,41,6,4584,20,300,4284,14,6,314,4290,10,5,0,48
Cleburne,9/30/20,9,23,23,338,6550,312,6889,17,25230,323,15,6460,90,298,14,9,0,16,1,6783,106,323,6460,16,90,339,6550,4,2,1,63
Cleveland,9/30/20,12,25,25,186,2678,168,2864,6,8226,183,3,2648,30,166,2,11,1,6,0,2831,33,183,2648,3,30,186,2678,0,12,0,9
Columbia,9/30/20,18,27,27,500,5032,387,5546,95,23892,465,35,5000,32,374,13,18,0,73,22,5465,81,465,5000,49,32,514,5032,20,6,0,35
Conway,9/30/20,3,29,29,273,6359,251,6632,19,20906,265,8,6289,70,244,7,3,0,18,1,6554,78,265,6289,8,70,273,6359,1,6,0,34
Craighead,9/30/20,22,31,31,3076,33057,2633,36140,420,105701,2987,89,32966,91,2570,63,19,3,397,23,35953,187,2987,32966,96,91,3083,33057,61,52,0,424
Crawford,9/30/20,16,33,33,1465,20166,1256,21629,193,62472,1426,39,20156,10,1226,30,13,3,187,6,21582,47,1426,20156,37,10,1463,20166,29,21,0,178
Crittenden,9/30/20,46,35,35,1970,13666,1864,15626,60,49013,1950,20,13658,8,1851,13,39,7,60,0,15608,18,1950,13658,10,8,1960,13666,11,13,0,94
Cross,9/30/20,13,37,37,453,4896,405,5344,35,16998,438,15,4873,23,394,11,11,2,33,2,5311,33,438,4873,10,23,448,4896,7,4,0,133
Dallas,9/30/20,5,39,39,166,1961,152,2127,9,7432,165,1,1952,9,151,1,5,0,9,0,2117,10,165,1952,1,9,166,1961,0,0,1,8
Desha,9/30/20,6,41,41,300,3942,271,4241,23,11887,297,3,3910,32,269,2,6,0,22,1,4207,34,297,3910,2,32,299,3942,0,2,0,20
Drew,9/30/20,7,43,43,359,5769,341,6131,11,18502,347,12,5720,49,331,10,6,1,10,1,6067,64,347,5720,15,49,362,5769,2,1,0,36
Faulkner,9/30/20,20,45,45,2566,37279,2266,39859,280,122416,2466,100,36590,689,2182,84,17,3,267,13,39056,803,2466,36590,114,689,2580,37279,35,31,0,248
Franklin,9/30/20,2,47,47,293,6322,250,6616,41,17780,282,11,6313,9,241,9,2,0,39,2,6595,21,282,6313,12,9,294,6322,7,11,0,57
Fulton,9/30/20,4,49,49,177,1310,125,1488,48,12139,159,18,1309,1,115,10,3,1,41,7,1468,20,159,1309,19,1,178,1310,8,6,1,30
Garland,9/30/20,53,51,51,1949,30726,1722,32674,174,98296,1920,29,30635,91,1705,17,48,5,167,7,32555,119,1920,30635,28,91,1948,30726,19,18,0,527
Grant,9/30/20,2,53,53,272,5106,243,5384,27,18086,263,9,5052,54,234,9,2,0,27,0,5315,69,263,5052,15,54,278,5106,1,11,0,47
Greene,9/30/20,10,55,55,909,13903,799,14813,100,44623,873,36,13801,102,772,27,10,0,91,9,14674,139,873,13801,37,102,910,13903,15,12,0,193
Hempstead,9/30/20,4,57,57,382,4919,353,5301,25,22018,366,16,4894,25,346,7,4,0,16,9,5260,41,366,4894,16,25,382,4919,6,1,0,121
HotSpring,9/30/20,27,59,59,1921,12956,1834,14877,60,33520,1911,10,12917,39,1827,7,25,2,59,1,14828,49,1911,12917,10,39,1921,12956,4,14,0,149
Howard,9/30/20,12,61,61,485,3762,456,4249,17,13389,461,24,3750,12,443,13,12,0,6,11,4211,38,461,3750,26,12,487,3762,3,3,0,19
Independence,9/30/20,21,63,63,1148,11444,1035,12599,92,37264,1021,127,11390,54,937,98,20,1,64,28,12411,188,1021,11390,134,54,1155,11444,32,20,1,100
Izard,9/30/20,0,65,65,253,3481,154,3742,99,13559,241,12,3469,12,145,9,0,0,96,3,3710,32,241,3469,20,12,261,3481,1,2,0,31
Jackson,9/30/20,1,67,67,359,6178,300,6553,58,17225,284,75,6167,11,252,48,1,0,31,27,6451,102,284,6167,91,11,375,6178,24,6,0,56
Jefferson,9/30/20,79,69,69,3393,29420,2763,32822,550,70424,3338,55,29247,173,2727,36,71,8,539,11,32585,237,3338,29247,64,173,3402,29420,24,81,2,359
Johnson,9/30/20,7,71,71,859,7914,813,8776,39,26291,852,7,7887,27,812,1,7,0,33,6,8739,37,852,7887,10,27,862,7914,0,6,0,47
Lafayette,9/30/20,2,73,73,117,1120,94,1239,21,6915,112,5,1118,2,92,2,2,0,18,3,1230,9,112,1118,7,2,119,1120,3,1,0,12
Lawrence,9/30/20,12,75,75,461,4304,373,4768,76,16669,421,40,4291,13,337,36,12,0,72,4,4712,56,421,4291,43,13,464,4304,12,4,0,48
Lee,9/30/20,18,77,77,1065,4005,1033,5071,14,9398,1062,3,4000,5,1031,2,17,1,14,0,5062,9,1062,4000,4,5,1066,4005,2,4,0,110
Lincoln,9/30/20,15,79,79,2025,6805,1803,8838,207,13695,2016,9,6787,18,1801,2,14,1,201,6,8803,35,2016,6787,17,18,2033,6805,5,6,0,79
LittleRiver,9/30/20,26,81,81,362,1779,325,2132,11,12417,345,17,1762,17,314,11,21,5,10,1,2107,25,345,1762,8,17,353,1779,3,0,1,6
Logan,9/30/20,1,83,83,421,7262,390,7684,30,21757,420,1,7252,10,389,1,1,0,30,0,7672,12,420,7252,2,10,422,7262,6,-1,0,55
Lonoke,9/30/20,17,85,85,1230,19553,1033,20833,180,72206,1087,143,18572,981,912,121,16,1,159,21,19659,1174,1087,18572,193,981,1280,19553,20,13,1,283
Madison,9/30/20,3,87,87,365,4072,334,4439,28,16076,350,15,4058,14,324,10,3,0,23,5,4408,31,350,4058,17,14,367,4072,8,3,0,44
Marion,9/30/20,0,89,89,102,2351,85,2453,17,16438,97,5,2344,7,80,5,0,0,17,0,2441,12,97,2344,5,7,102,2351,3,6,0,19
Miller,9/30/20,11,91,91,857,6502,793,7358,53,43759,810,47,6433,69,751,42,10,1,49,4,7243,115,810,6433,46,69,856,6502,16,12,0,34
MissingCountyInfo,9/30/20,0,5,5,1911,57558,1428,59467,483,NA,1724,187,57557,1,1313,115,0,0,411,72,59281,186,1724,57557,185,1,1909,57558,19,44,0,1503
Mississippi,9/30/20,51,93,93,1708,11660,1566,13355,91,42831,1674,34,11644,16,1551,15,40,11,83,8,13318,37,1674,11644,21,16,1695,11660,14,14,0,108
Monroe,9/30/20,0,95,95,135,2249,112,2384,23,7249,133,2,2235,14,112,0,0,0,21,2,2368,16,133,2235,2,14,135,2249,0,1,0,20
Montgomery,9/30/20,6,97,97,155,2241,132,2396,17,8993,154,1,2224,17,131,1,6,0,17,0,2378,18,154,2224,1,17,155,2241,1,10,1,9
Nevada,9/30/20,13,99,99,224,3278,195,3498,16,8440,214,10,3267,11,188,7,12,1,14,2,3481,17,214,3267,6,11,220,3278,1,3,0,25
Newton,9/30/20,19,101,101,248,1745,200,1988,29,7848,234,14,1744,1,193,7,16,3,25,4,1978,10,234,1744,9,1,243,1745,4,2,0,8
Ouachita,9/30/20,6,103,103,269,5607,239,5881,24,24106,261,8,5580,27,233,6,6,0,22,2,5841,40,261,5580,13,27,274,5607,5,5,0,27
Perry,9/30/20,0,105,105,89,3171,82,3260,7,10322,85,4,3109,62,78,4,0,0,7,0,3194,66,85,3109,4,62,89,3171,1,2,0,94
Phillips,9/30/20,12,107,107,515,6689,456,7207,47,19034,510,5,6658,31,454,2,12,0,44,3,7168,39,510,6658,8,31,518,6689,6,6,0,123
Pike,9/30/20,3,109,109,234,2241,217,2474,14,10808,231,3,2221,20,216,1,2,1,13,1,2452,22,231,2221,2,20,233,2241,3,1,0,14
Poinsett,9/30/20,14,111,111,675,7662,601,8333,60,24054,659,16,7650,12,591,10,13,1,55,5,8309,24,659,7650,12,12,671,7662,12,6,0,92
Polk,9/30/20,4,113,113,268,4481,249,4750,15,20163,266,2,4476,5,248,1,4,0,14,1,4742,8,266,4476,3,5,269,4481,0,0,0,25
Pope,9/30/20,33,115,115,2166,22186,2016,24343,117,63644,2142,24,22045,141,2005,11,29,4,108,9,24187,156,2142,22045,15,141,2157,22186,13,18,2,119
Prairie,9/30/20,2,117,117,154,2080,134,2236,18,8244,147,7,2048,32,129,5,2,0,16,2,2195,41,147,2048,9,32,156,2080,4,1,0,20
Pulaski,9/30/20,153,119,119,9509,132758,8682,142330,673,393463,9200,309,131017,1741,8420,262,140,13,639,34,140217,2113,9200,131017,372,1741,9572,132758,87,73,1,1315
Randolph,9/30/20,22,121,121,442,4886,372,5332,48,17603,395,47,4835,51,345,27,18,4,32,16,5230,102,395,4835,51,51,446,4886,12,9,0,88
Saline,9/30/20,23,125,125,2130,30668,1952,32809,154,118009,2039,91,30208,460,1875,77,21,2,142,12,32247,562,2039,30208,102,460,2141,30668,14,13,0,319
Scott,9/30/20,1,127,127,106,2666,94,2772,11,10442,105,1,2666,0,94,0,1,0,10,1,2771,1,105,2666,1,0,106,2666,0,0,0,140
Searcy,9/30/20,1,129,129,148,2069,143,2216,4,7923,144,4,2051,18,139,4,1,0,4,0,2195,21,144,2051,3,18,147,2069,2,2,0,8
Sebastian,9/30/20,61,131,131,3812,45323,3409,49135,341,127461,3761,51,45311,12,3378,31,53,8,329,12,49072,63,3761,45311,51,12,3812,45323,33,33,1,437
Sevier,9/30/20,18,133,133,1207,6610,1181,7815,8,17193,1193,14,6553,57,1168,13,18,0,7,1,7746,69,1193,6553,12,57,1205,6610,1,0,0,13
Sharp,9/30/20,6,135,135,239,3977,202,4214,31,17043,221,18,3969,8,189,13,6,0,26,5,4190,24,221,3969,16,8,237,3977,11,6,0,61
St.Francis,9/30/20,6,123,123,1542,12275,1419,13819,117,26294,1542,0,12267,8,1419,0,6,0,117,0,13809,10,1542,12267,2,8,1544,12275,23,6,0,12086
Stone,9/30/20,13,137,137,365,3388,297,3756,55,12446,358,7,3376,12,291,6,13,0,54,1,3734,22,358,3376,10,12,368,3388,4,5,0,52
Union,9/30/20,40,139,139,911,9187,833,10099,38,39732,879,32,9111,76,818,15,35,5,26,12,9990,109,879,9111,33,76,912,9187,10,3,2,64
VanBuren,9/30/20,3,141,141,176,4120,167,4301,6,16684,173,3,4061,59,164,3,3,0,6,0,4234,67,173,4061,8,59,181,4120,2,2,0,14
Washington,9/30/20,118,143,143,9645,76536,9051,86228,476,228529,9023,622,75274,1262,8527,524,102,16,394,82,84297,1931,9023,75274,669,1262,9692,76536,96,70,0,584
White,9/30/20,29,145,145,898,15645,759,16557,110,78804,811,87,15240,405,693,66,25,4,93,17,16051,506,811,15240,101,405,912,15645,32,21,2,256
Woodruff,9/30/20,0,147,147,55,1699,46,1755,9,6660,48,7,1689,10,41,5,0,0,7,2,1737,18,48,1689,8,10,56,1699,1,1,0,4
Yell,9/30/20,29,149,149,1259,9930,1210,11186,20,21573,1251,8,9882,48,1206,4,26,3,19,1,11133,53,1251,9882,5,48,1256,9930,1,8,0,22
Arkansas_all_counties,9/29/20,1350,5630,5630,82755,935879,74440,1018891,6960,2990671,80003,2752,927902,7977,72265,2175,1204,146,6529,431,1007905,10986,80003,927902,3009,7977,83012,935879,706,867,21,10799
Arkansas_county,9/29/20,8,1,1,417,5968,344,6394,65,18124,393,24,5751,217,326,18,7,1,60,5,6144,250,393,5751,33,217,426,5968,4,4,0,92
Ashley,9/29/20,10,3,3,435,5160,406,5597,19,20537,430,5,5135,25,402,4,10,0,18,1,5565,32,430,5135,7,25,437,5160,1,3,0,92
Baxter,9/29/20,2,5,5,357,4082,295,4440,60,41219,316,41,4065,17,266,29,2,0,48,12,4381,59,316,4065,42,17,358,4082,6,18,0,32
Benton,9/29/20,92,7,7,6635,71992,6170,78655,373,258980,6431,204,71567,425,6015,155,75,17,341,32,77998,657,6431,71567,232,425,6663,71992,50,55,5,615
Boone,9/29/20,13,9,9,736,10274,621,11010,102,37288,690,46,10259,15,589,32,11,2,90,12,10949,61,690,10259,46,15,736,10274,10,11,1,73
Bradley,9/29/20,8,11,11,342,3533,325,3874,9,10948,340,2,3528,5,324,1,7,1,9,0,3868,6,340,3528,1,5,341,3533,0,4,0,16
Calhoun,9/29/20,0,13,13,36,1702,34,1738,2,5202,35,1,1697,5,33,1,0,0,2,0,1732,6,35,1697,1,5,36,1702,0,0,0,3
Carroll,9/29/20,10,15,15,688,7118,599,7809,79,27887,680,8,7114,4,593,6,10,0,77,2,7794,15,680,7114,11,4,691,7118,16,10,0,90
Chicot,9/29/20,22,17,17,1007,4911,977,5919,8,10826,998,9,4894,17,970,7,21,1,7,1,5892,27,998,4894,10,17,1008,4911,1,6,0,11
Clark,9/29/20,4,19,19,350,6307,310,6657,36,22385,335,15,6262,45,299,11,4,0,32,4,6597,60,335,6262,15,45,350,6307,4,2,0,99
Clay,9/29/20,8,21,21,304,4252,253,4556,42,15061,293,11,4246,6,249,4,6,2,37,5,4539,17,293,4246,11,6,304,4252,6,6,0,61
Cleburne,9/29/20,8,23,23,334,6491,310,6826,16,25230,320,14,6401,90,297,13,8,0,15,1,6721,105,320,6401,15,90,335,6491,3,6,0,96
Cleveland,9/29/20,12,25,25,186,2669,156,2855,18,8226,183,3,2640,29,154,2,11,1,18,0,2823,32,183,2640,3,29,186,2669,1,0,0,11
Columbia,9/29/20,18,27,27,480,5017,381,5510,81,23892,450,30,4985,32,368,13,18,0,64,17,5435,75,450,4985,43,32,493,5017,11,5,0,31
Conway,9/29/20,3,29,29,272,6326,245,6598,24,20906,265,7,6248,78,239,6,3,0,23,1,6513,85,265,6248,7,78,272,6326,5,5,0,93
Craighead,9/29/20,22,31,31,3015,32694,2581,35715,411,105701,2939,76,32644,50,2523,58,19,3,396,15,35583,132,2939,32644,82,50,3021,32694,29,42,0,186
Crawford,9/29/20,16,33,33,1436,20017,1235,21451,185,62472,1400,36,20007,10,1205,30,13,3,182,3,21407,44,1400,20007,34,10,1434,20017,21,33,1,572
Crittenden,9/29/20,46,35,35,1959,13583,1851,15532,62,49013,1939,20,13579,4,1838,13,39,7,62,0,15518,14,1939,13579,10,4,1949,13583,11,7,0,97
Cross,9/29/20,13,37,37,446,4770,401,5211,32,16998,435,11,4752,18,392,9,11,2,32,0,5187,24,435,4752,6,18,441,4770,6,7,0,21
Dallas,9/29/20,4,39,39,166,1953,152,2119,10,7432,165,1,1944,9,151,1,4,0,10,0,2109,10,165,1944,1,9,166,1953,3,2,0,8
Desha,9/29/20,6,41,41,300,3922,269,4221,25,11887,297,3,3893,29,267,2,6,0,24,1,4190,31,297,3893,2,29,299,3922,3,1,1,44
Drew,9/29/20,7,43,43,357,5735,340,6095,10,18502,345,12,5686,49,330,10,6,1,9,1,6031,64,345,5686,15,49,360,5735,0,4,0,29
Faulkner,9/29/20,20,45,45,2531,37066,2235,39611,276,122416,2433,98,36391,675,2153,82,17,3,263,13,38824,787,2433,36391,112,675,2545,37066,29,46,1,306
Franklin,9/29/20,2,47,47,286,6272,239,6559,45,17780,279,7,6263,9,234,5,2,0,43,2,6542,17,279,6263,8,9,287,6272,4,4,0,74
Fulton,9/29/20,3,49,49,169,1288,119,1458,47,12139,152,17,1287,1,109,10,2,1,41,6,1439,19,152,1287,18,1,170,1288,7,7,0,24
Garland,9/29/20,53,51,51,1930,30218,1704,32145,173,98296,1903,27,30130,88,1687,17,48,5,168,5,32033,112,1903,30130,24,88,1927,30218,12,24,0,363
Grant,9/29/20,2,53,53,271,5060,232,5337,37,18086,262,9,5006,54,223,9,2,0,37,0,5268,69,262,5006,15,54,277,5060,2,1,0,51
Greene,9/29/20,10,55,55,894,13725,787,14619,97,44623,860,34,13628,97,762,25,10,0,88,9,14488,131,860,13628,34,97,894,13725,11,9,0,91
Hempstead,9/29/20,4,57,57,376,4804,352,5180,20,22018,365,11,4781,23,345,7,4,0,16,4,5146,34,365,4781,11,23,376,4804,5,1,0,55
HotSpring,9/29/20,27,59,59,1917,12811,1820,14728,70,33520,1909,8,12772,39,1814,6,25,2,70,0,14681,47,1909,12772,8,39,1917,12811,4,7,0,282
Howard,9/29/20,12,61,61,482,3746,453,4229,17,13389,461,21,3735,11,442,11,12,0,7,10,4196,33,461,3735,22,11,483,3746,10,4,0,18
Independence,9/29/20,20,63,63,1116,11376,1015,12499,81,37264,1010,106,11324,52,924,91,19,1,67,14,12334,165,1010,11324,113,52,1123,11376,13,22,0,69
Izard,9/29/20,0,65,65,252,3451,152,3711,100,13559,241,11,3439,12,144,8,0,0,97,3,3680,31,241,3439,19,12,260,3451,8,5,0,95
Jackson,9/29/20,1,67,67,335,6146,294,6497,40,17225,282,53,6135,11,250,44,1,0,31,9,6417,80,282,6135,69,11,351,6146,8,5,0,75
Jefferson,9/29/20,77,69,69,3369,29085,2682,32462,610,70424,3316,53,28915,170,2647,35,69,8,600,10,32231,231,3316,28915,61,170,3377,29085,19,40,2,168
Johnson,9/29/20,7,71,71,859,7867,807,8729,45,26291,853,6,7841,26,806,1,7,0,40,5,8694,35,853,7841,9,26,862,7867,6,3,1,47
Lafayette,9/29/20,2,73,73,114,1111,93,1227,19,6915,109,5,1109,2,91,2,2,0,16,3,1218,9,109,1109,7,2,116,1111,0,2,0,7
Lawrence,9/29/20,12,75,75,449,4268,369,4719,68,16669,412,37,4256,12,334,35,12,0,66,2,4668,51,412,4256,39,12,451,4268,7,13,0,54
Lee,9/29/20,18,77,77,1063,3897,1029,4960,16,9398,1060,3,3892,5,1027,2,17,1,16,0,4952,8,1060,3892,3,5,1063,3897,1,1,0,10
Lincoln,9/29/20,15,79,79,2020,6731,1797,8759,208,13695,2012,8,6713,18,1795,2,14,1,203,5,8725,34,2012,6713,16,18,2028,6731,1,3,0,82
LittleRiver,9/29/20,25,81,81,359,1776,325,2126,9,12417,342,17,1760,16,314,11,20,5,8,1,2102,24,342,1760,8,16,350,1776,1,4,0,3
Logan,9/29/20,1,83,83,415,7213,391,7629,23,21757,414,1,7204,9,390,1,1,0,23,0,7618,11,414,7204,2,9,416,7213,4,3,0,81
Lonoke,9/29/20,16,85,85,1210,19290,1020,20550,174,72206,1074,136,18310,980,903,117,15,1,156,18,19384,1166,1074,18310,186,980,1260,19290,17,12,3,310
Madison,9/29/20,3,87,87,357,4036,331,4395,23,16076,346,11,4022,14,322,9,3,0,21,2,4368,27,346,4022,13,14,359,4036,2,5,0,30
Marion,9/29/20,0,89,89,99,2335,79,2435,20,16438,96,3,2328,7,76,3,0,0,20,0,2424,11,96,2328,4,7,100,2335,0,3,0,10
Miller,9/29/20,11,91,91,841,6484,781,7322,49,43759,801,40,6416,68,744,37,10,1,47,2,7217,105,801,6416,37,68,838,6484,8,10,0,29
MissingCountyInfo,9/29/20,0,5,5,1892,56074,1384,57959,508,NA,1761,131,56073,1,1284,100,0,0,477,31,57834,125,1761,56073,124,1,1885,56074,-8,32,0,844
Mississippi,9/29/20,51,93,93,1694,11566,1552,13247,91,42831,1665,29,11556,10,1539,13,40,11,86,5,13221,26,1665,11556,16,10,1681,11566,5,10,1,43
Monroe,9/29/20,0,95,95,135,2229,111,2364,24,7249,133,2,2216,13,111,0,0,0,22,2,2349,15,133,2216,2,13,135,2229,1,3,0,34
Montgomery,9/29/20,5,97,97,154,2233,122,2387,27,8993,153,1,2216,17,121,1,5,0,27,0,2369,18,153,2216,1,17,154,2233,0,0,0,6
Nevada,9/29/20,13,99,99,223,3254,192,3473,18,8440,213,10,3243,11,185,7,12,1,16,2,3456,17,213,3243,6,11,219,3254,2,5,0,96
Newton,9/29/20,19,101,101,244,1741,198,1980,27,7848,232,12,1740,1,191,7,16,3,25,2,1972,8,232,1740,7,1,239,1741,2,6,0,16
Ouachita,9/29/20,6,103,103,264,5585,234,5854,24,24106,257,7,5561,24,228,6,6,0,23,1,5818,36,257,5561,12,24,269,5585,1,6,0,30
Perry,9/29/20,0,105,105,88,3078,80,3166,8,10322,84,4,3021,57,76,4,0,0,8,0,3105,61,84,3021,4,57,88,3078,0,2,0,28
Phillips,9/29/20,12,107,107,509,6572,450,7083,47,19034,505,4,6545,27,448,2,12,0,45,2,7050,33,505,6545,6,27,511,6572,14,5,0,40
Pike,9/29/20,3,109,109,231,2230,216,2460,12,10808,228,3,2210,20,215,1,2,1,11,1,2438,22,228,2210,2,20,230,2230,1,1,0,14
Poinsett,9/29/20,14,111,111,663,7582,595,8241,54,24054,648,15,7573,9,585,10,13,1,50,4,8221,20,648,7573,11,9,659,7582,3,6,0,42
Polk,9/29/20,4,113,113,268,4456,249,4725,15,20163,266,2,4452,4,248,1,4,0,14,1,4718,7,266,4452,3,4,269,4456,2,0,0,28
Pope,9/29/20,31,115,115,2153,22080,1998,24225,124,63644,2131,22,21952,128,1988,10,27,4,116,8,24083,142,2131,21952,14,128,2145,22080,13,17,0,169
Prairie,9/29/20,2,117,117,150,2064,133,2216,15,8244,145,5,2032,32,128,5,2,0,15,0,2177,39,145,2032,7,32,152,2064,0,0,0,26
Pulaski,9/29/20,152,119,119,9422,131530,8609,141012,661,393463,9129,293,129845,1685,8360,249,139,13,630,31,138974,2038,9129,129845,353,1685,9482,131530,71,90,3,1874
Randolph,9/29/20,22,121,121,430,4810,363,5241,45,17603,392,38,4777,33,339,24,18,4,35,10,5169,72,392,4777,39,33,431,4810,9,11,0,57
Saline,9/29/20,23,125,125,2116,30363,1939,32488,153,118009,2031,85,29932,431,1863,76,21,2,146,7,31963,525,2031,29932,94,431,2125,30363,27,27,0,412
Scott,9/29/20,1,127,127,106,2526,94,2632,11,10442,105,1,2526,0,94,0,1,0,10,1,2631,1,105,2526,1,0,106,2526,5,0,0,26
Searcy,9/29/20,1,129,129,146,2063,141,2207,4,7923,142,4,2044,19,137,4,1,0,4,0,2186,21,142,2044,2,19,144,2063,4,3,0,14
Sebastian,9/29/20,60,131,131,3779,44919,3376,48698,342,127461,3732,47,44907,12,3346,30,52,8,333,9,48639,59,3732,44907,47,12,3779,44919,41,40,0,1051
Sevier,9/29/20,18,133,133,1206,6598,1181,7802,7,17193,1192,14,6542,56,1168,13,18,0,6,1,7734,68,1192,6542,12,56,1204,6598,3,4,0,12
Sharp,9/29/20,6,135,135,228,3927,196,4152,26,17043,212,16,3919,8,183,13,6,0,23,3,4131,21,212,3919,13,8,225,3927,5,6,0,24
St.Francis,9/29/20,6,123,123,1519,212,1413,1733,100,26294,1519,0,212,0,1413,0,6,0,100,0,1731,2,1519,212,2,0,1521,212,7,2,0,9
Stone,9/29/20,13,137,137,361,3340,292,3704,56,12446,355,6,3328,12,286,6,13,0,56,0,3683,21,355,3328,9,12,364,3340,9,7,0,27
Union,9/29/20,38,139,139,901,9133,830,10036,32,39732,874,27,9058,75,815,15,33,5,25,7,9932,104,874,9058,29,75,903,9133,7,7,1,64
VanBuren,9/29/20,3,141,141,174,4108,165,4287,6,16684,171,3,4052,56,162,3,3,0,6,0,4223,64,171,4052,8,56,179,4108,0,2,0,17
Washington,9/29/20,118,143,143,9549,76048,8981,85636,450,228529,8975,574,74829,1219,8474,507,102,16,399,51,83804,1832,8975,74829,613,1219,9588,76048,92,89,0,854
White,9/29/20,27,145,145,866,15421,738,16300,101,78804,785,81,15039,382,674,64,23,4,88,13,15824,476,785,15039,94,382,879,15421,17,14,1,190
Woodruff,9/29/20,0,147,147,54,1696,45,1751,9,6660,47,7,1687,9,40,5,0,0,7,2,1734,17,47,1687,8,9,55,1696,1,1,0,9
Yell,9/29/20,29,149,149,1258,9909,1202,11164,27,21573,1250,8,9861,48,1198,4,26,3,26,1,11111,53,1250,9861,5,48,1255,9909,2,6,0,37
Arkansas_all_counties,9/28/20,1329,5630,5630,82049,925786,73573,1008047,7142,2990671,79521,2528,918177,7609,71509,2064,1183,146,6824,318,997698,10349,79521,918177,2740,7609,82261,925786,807,971,21,57145
Arkansas_county,9/28/20,8,1,1,413,5880,340,6301,65,18124,389,24,5664,216,324,16,7,1,58,7,6053,248,389,5664,32,216,421,5880,7,7,0,173
Ashley,9/28/20,10,3,3,434,5069,403,5505,21,20537,429,5,5045,24,400,3,10,0,19,2,5474,31,429,5045,7,24,436,5069,3,3,0,261
Baxter,9/28/20,2,5,5,351,4056,277,4408,72,41219,314,37,4039,17,248,29,2,0,64,8,4353,55,314,4039,38,17,352,4056,6,5,0,72
Benton,9/28/20,87,7,7,6585,71427,6115,78032,383,258980,6404,181,70999,428,5973,142,70,17,361,22,77403,629,6404,70999,201,428,6605,71427,11,24,1,1366
Boone,9/28/20,12,9,9,726,10211,610,10937,104,37288,685,41,10196,15,579,31,10,2,96,8,10881,56,685,10196,41,15,726,10211,6,10,0,405
Bradley,9/28/20,8,11,11,342,3517,321,3858,13,10948,340,2,3514,3,320,1,7,1,13,0,3854,4,340,3514,1,3,341,3517,0,1,0,78
Calhoun,9/28/20,0,13,13,36,1699,34,1735,2,5202,35,1,1694,5,33,1,0,0,2,0,1729,6,35,1694,1,5,36,1699,0,0,0,193
Carroll,9/28/20,10,15,15,672,7044,589,7718,73,27887,665,7,7040,4,583,6,10,0,72,1,7705,13,665,7040,9,4,674,7044,7,4,0,130
Chicot,9/28/20,22,17,17,1006,4901,971,5908,13,10826,998,8,4888,13,964,7,21,1,13,0,5886,22,998,4888,9,13,1007,4901,0,-1,1,228
Clark,9/28/20,4,19,19,346,6212,308,6557,34,22385,332,14,6168,44,297,11,4,0,31,3,6500,57,332,6168,13,44,345,6212,4,8,0,236
Clay,9/28/20,8,21,21,298,4197,247,4495,42,15061,290,8,4191,6,243,4,6,2,40,2,4481,14,290,4191,8,6,298,4197,3,7,0,185
Cleburne,9/28/20,8,23,23,331,6398,304,6730,19,25230,318,13,6307,91,291,13,8,0,19,0,6625,105,318,6307,14,91,332,6398,0,1,0,519
Cleveland,9/28/20,12,25,25,185,2659,156,2844,17,8226,182,3,2633,26,154,2,11,1,17,0,2815,29,182,2633,3,26,185,2659,1,-1,2,52
Columbia,9/28/20,18,27,27,469,4997,376,5479,75,23892,443,26,4965,32,364,12,18,0,61,14,5408,71,443,4965,39,32,482,4997,18,21,0,745
Conway,9/28/20,3,29,29,267,6238,240,6506,24,20906,263,4,6170,68,236,4,3,0,24,0,6433,73,263,6170,5,68,268,6238,0,1,0,162
Craighead,9/28/20,22,31,31,2986,32537,2539,35527,424,105701,2915,71,32487,50,2480,59,19,3,415,9,35402,125,2915,32487,75,50,2990,32537,36,20,0,1751
Crawford,9/28/20,15,33,33,1415,19466,1202,20875,198,62472,1384,31,19457,9,1174,28,12,3,198,0,20841,34,1384,19457,25,9,1409,19466,13,10,0,1298
Crittenden,9/28/20,46,35,35,1948,13497,1844,15434,58,49013,1928,20,13493,4,1831,13,39,7,58,0,15421,13,1928,13493,9,4,1937,13497,3,13,0,334
Cross,9/28/20,13,37,37,440,4755,394,5189,33,16998,429,11,4737,18,385,9,11,2,33,0,5166,23,429,4737,5,18,434,4755,6,11,0,240
Dallas,9/28/20,4,39,39,163,1948,150,2111,9,7432,162,1,1939,9,149,1,4,0,9,0,2101,10,162,1939,1,9,163,1948,1,2,0,37
Desha,9/28/20,5,41,41,297,3881,268,4177,24,11887,295,2,3853,28,266,2,5,0,24,0,4148,29,295,3853,1,28,296,3881,3,1,0,213
Drew,9/28/20,7,43,43,357,5706,336,6066,14,18502,345,12,5662,44,326,10,6,1,13,1,6007,59,345,5662,15,44,360,5706,0,0,0,456
Faulkner,9/28/20,19,45,45,2502,36789,2189,39304,294,122416,2413,89,36104,685,2111,78,16,3,286,8,38517,787,2413,36104,102,685,2515,36789,29,43,0,253
Franklin,9/28/20,2,47,47,282,6202,235,6485,45,17780,276,6,6193,9,230,5,2,0,44,1,6469,16,276,6193,7,9,283,6202,2,5,0,613
Fulton,9/28/20,3,49,49,162,1271,112,1434,47,12139,148,14,1270,1,103,9,2,1,43,4,1418,16,148,1270,15,1,163,1271,1,0,0,50
Garland,9/28/20,53,51,51,1918,29867,1680,31781,185,98296,1894,24,29785,82,1664,16,48,5,182,3,31679,102,1894,29785,20,82,1914,29867,26,32,1,1431
Grant,9/28/20,2,53,53,269,5011,231,5286,36,18086,260,9,4959,52,222,9,2,0,36,0,5219,67,260,4959,15,52,275,5011,3,4,0,270
Greene,9/28/20,10,55,55,883,13645,778,14528,95,44623,853,30,13547,98,753,25,10,0,90,5,14400,128,853,13547,30,98,883,13645,10,6,0,450
Hempstead,9/28/20,4,57,57,371,4754,351,5126,16,22018,362,9,4731,23,344,7,4,0,14,2,5093,33,362,4731,10,23,372,4754,2,2,0,291
HotSpring,9/28/20,27,59,59,1913,12533,1813,14445,73,33520,1906,7,12497,36,1808,5,25,2,73,0,14403,42,1906,12497,6,36,1912,12533,9,13,1,507
Howard,9/28/20,12,61,61,472,3738,449,4211,11,13389,460,12,3728,10,441,8,12,0,7,4,4188,23,460,3728,13,10,473,3738,1,2,2,177
Independence,9/28/20,20,63,63,1103,11320,993,12429,90,37264,1008,95,11269,51,912,81,19,1,77,13,12277,152,1008,11269,101,51,1109,11320,8,15,1,593
Izard,9/28/20,0,65,65,244,3364,147,3616,97,13559,235,9,3352,12,140,7,0,0,95,2,3587,29,235,3352,17,12,252,3364,0,2,0,78
Jackson,9/28/20,1,67,67,327,6079,289,6422,37,17225,280,47,6068,11,247,42,1,0,32,5,6348,74,280,6068,63,11,343,6079,3,2,0,72
Jefferson,9/28/20,75,69,69,3350,28936,2642,32293,633,70424,3300,50,28771,165,2609,33,67,8,624,9,32071,222,3300,28771,57,165,3357,28936,51,58,2,669
Johnson,9/28/20,6,71,71,853,7826,804,8682,43,26291,849,4,7800,26,803,1,6,0,40,3,8649,33,849,7800,7,26,856,7826,2,1,0,934
Lafayette,9/28/20,2,73,73,114,1104,91,1220,21,6915,109,5,1102,2,89,2,2,0,18,3,1211,9,109,1102,7,2,116,1104,7,5,0,118
Lawrence,9/28/20,12,75,75,442,4221,356,4665,74,16669,405,37,4209,12,322,34,12,0,71,3,4614,51,405,4209,39,12,444,4221,1,4,0,173
Lee,9/28/20,18,77,77,1062,3888,1028,4950,16,9398,1059,3,3883,5,1026,2,17,1,16,0,4942,8,1059,3883,3,5,1062,3888,5,4,0,53
Lincoln,9/28/20,15,79,79,2019,6650,1794,8677,210,13695,2013,6,6635,15,1792,2,14,1,207,3,8648,29,2013,6635,14,15,2027,6650,6,9,0,78
LittleRiver,9/28/20,25,81,81,358,1774,321,2123,12,12417,342,16,1758,16,311,10,20,5,11,1,2100,23,342,1758,7,16,349,1774,0,2,0,26
Logan,9/28/20,1,83,83,411,7136,388,7548,22,21757,410,1,7127,9,387,1,1,0,22,0,7537,11,410,7127,2,9,412,7136,4,2,0,792
Lonoke,9/28/20,13,85,85,1193,18997,1008,20237,172,72206,1063,130,18052,945,897,111,12,1,154,18,19115,1122,1063,18052,177,945,1240,18997,12,10,1,696
Madison,9/28/20,3,87,87,355,4008,326,4365,26,16076,344,11,3994,14,317,9,3,0,24,2,4338,27,344,3994,13,14,357,4008,3,1,0,158
Marion,9/28/20,0,89,89,99,2325,76,2425,23,16438,96,3,2318,7,73,3,0,0,23,0,2414,11,96,2318,4,7,100,2325,1,1,0,36
Miller,9/28/20,11,91,91,833,6463,771,7293,51,43759,795,38,6395,68,736,35,10,1,49,2,7190,103,795,6395,35,68,830,6463,5,7,0,198
MissingCountyInfo,9/28/20,0,5,5,1900,55222,1352,57114,548,NA,1788,112,55222,0,1259,93,0,0,529,19,57010,104,1788,55222,104,0,1892,55222,128,166,0,30356
Mississippi,9/28/20,50,93,93,1689,11528,1542,13204,97,42831,1661,28,11517,11,1529,13,39,11,93,4,13178,26,1661,11517,15,11,1676,11528,8,12,0,222
Monroe,9/28/20,0,95,95,134,2196,108,2330,26,7249,133,1,2184,12,108,0,0,0,25,1,2317,13,133,2184,1,12,134,2196,3,1,0,51
Montgomery,9/28/20,5,97,97,154,2227,122,2381,27,8993,153,1,2210,17,121,1,5,0,27,0,2363,18,153,2210,1,17,154,2227,3,-1,1,89
Nevada,9/28/20,13,99,99,221,3160,187,3375,21,8440,212,9,3149,11,181,6,12,1,19,2,3361,14,212,3149,3,11,215,3160,1,5,0,121
Newton,9/28/20,19,101,101,242,1727,192,1964,31,7848,231,11,1726,1,185,7,16,3,30,1,1957,7,231,1726,6,1,237,1727,1,2,0,45
Ouachita,9/28/20,6,103,103,263,5556,228,5823,29,24106,256,7,5532,24,223,5,6,0,27,2,5788,35,256,5532,11,24,267,5556,0,5,0,284
Perry,9/28/20,0,105,105,88,3050,78,3138,10,10322,84,4,2990,60,74,4,0,0,10,0,3074,64,84,2990,4,60,88,3050,0,1,0,28
Phillips,9/28/20,12,107,107,495,6546,445,7043,38,19034,492,3,6519,27,443,2,12,0,37,1,7011,32,492,6519,5,27,497,6546,1,3,0,110
Pike,9/28/20,3,109,109,230,2217,215,2446,12,10808,228,2,2197,20,214,1,2,1,12,0,2425,21,228,2197,1,20,229,2217,3,0,0,70
Poinsett,9/28/20,14,111,111,660,7543,589,8199,57,24054,647,13,7534,9,580,9,13,1,54,3,8181,18,647,7534,9,9,656,7543,3,8,1,306
Polk,9/28/20,4,113,113,266,4430,249,4697,13,20163,265,1,4426,4,248,1,4,0,13,0,4691,6,265,4426,2,4,267,4430,5,1,0,684
Pope,9/28/20,31,115,115,2140,21924,1981,24056,128,63644,2120,20,21797,127,1972,9,27,4,121,7,23917,139,2120,21797,12,127,2132,21924,13,16,0,1896
Prairie,9/28/20,2,117,117,150,2038,133,2190,15,8244,145,5,2006,32,128,5,2,0,15,0,2151,39,145,2006,7,32,152,2038,0,-1,1,97
Pulaski,9/28/20,149,119,119,9351,129727,8519,139135,683,393463,9075,276,128064,1663,8276,243,136,13,663,20,137139,1996,9075,128064,333,1663,9408,129727,188,219,0,5646
Randolph,9/28/20,22,121,121,421,4762,352,5184,47,17603,387,34,4729,33,332,20,18,4,37,10,5116,68,387,4729,35,33,422,4762,4,7,0,247
Saline,9/28/20,23,125,125,2089,29978,1912,32074,153,118009,2008,81,29549,429,1839,73,21,2,147,6,31557,517,2008,29549,88,429,2096,29978,25,22,0,2185
Scott,9/28/20,1,127,127,101,2505,94,2606,6,10442,101,0,2505,0,94,0,1,0,6,0,2606,0,101,2505,0,0,101,2505,0,0,0,255
Searcy,9/28/20,1,129,129,142,2053,138,2193,3,7923,138,4,2036,17,134,4,1,0,3,0,2174,19,138,2036,2,17,140,2053,0,1,0,235
Sebastian,9/28/20,60,131,131,3738,43909,3336,47646,341,127461,3697,41,43897,12,3308,28,52,8,336,5,47594,52,3697,43897,40,12,3737,43909,34,26,0,2971
Sevier,9/28/20,18,133,133,1203,6589,1177,7789,8,17193,1190,13,6533,56,1166,11,18,0,6,2,7723,66,1190,6533,10,56,1200,6589,0,0,0,42
Sharp,9/28/20,6,135,135,223,3908,190,4128,27,17043,210,13,3901,7,180,10,6,0,24,3,4111,17,210,3901,10,7,220,3908,3,9,0,154
St.Francis,9/28/20,6,123,123,1512,210,1411,1724,95,26294,1512,0,210,0,1411,0,6,0,95,0,1722,2,1512,210,2,0,1514,210,6,8,0,-11723
Stone,9/28/20,13,137,137,352,3322,285,3677,54,12446,346,6,3311,11,279,6,13,0,54,0,3657,20,346,3311,9,11,355,3322,5,2,1,112
Union,9/28/20,37,139,139,894,9076,823,9970,33,39732,871,23,9042,34,811,12,32,5,27,6,9913,57,871,9042,23,34,894,9076,2,2,1,656
VanBuren,9/28/20,3,141,141,174,4091,163,4271,8,16684,172,2,4035,56,161,2,3,0,8,0,4207,64,172,4035,8,56,180,4091,0,2,0,162
Washington,9/28/20,118,143,143,9457,75286,8892,84776,447,228529,8902,555,74286,1000,8403,489,102,16,397,50,83188,1588,8902,74286,588,1000,9490,75286,42,63,1,2889
White,9/28/20,26,145,145,849,15248,724,16108,99,78804,777,72,14874,374,662,62,22,4,93,6,15651,457,777,14874,83,374,860,15248,8,11,3,832
Woodruff,9/28/20,0,147,147,53,1688,44,1742,9,6660,47,6,1679,9,39,5,0,0,8,1,1726,16,47,1679,7,9,54,1688,0,1,0,88
Yell,9/28/20,29,149,149,1256,9874,1196,11127,31,21573,1248,8,9829,45,1192,4,26,3,30,1,11077,50,1248,9829,5,45,1253,9874,2,3,0,185
Arkansas_all_counties,9/27/20,1308,5630,5630,81242,869448,72602,950893,7327,2990671,78735,2507,861892,7556,70605,1997,1160,148,6965,362,940627,10266,78735,861892,2710,7556,81445,869448,487,551,23,6742
Arkansas_county,9/27/20,8,1,1,406,5714,333,6128,65,18124,382,24,5499,215,317,16,7,1,58,7,5881,247,382,5499,32,215,414,5714,2,4,1,45
Ashley,9/27/20,10,3,3,431,4811,400,5244,21,20537,426,5,4787,24,397,3,10,0,19,2,5213,31,426,4787,7,24,433,4811,0,1,0,3
Baxter,9/27/20,2,5,5,345,3990,272,4336,71,41219,308,37,3973,17,243,29,2,0,63,8,4281,55,308,3973,38,17,346,3990,8,6,0,37
Benton,9/27/20,86,7,7,6574,70072,6091,76665,397,258980,6397,177,69644,428,5954,137,69,17,374,23,76041,624,6397,69644,196,428,6593,70072,46,35,0,184
Boone,9/27/20,12,9,9,720,9812,600,10532,108,37288,680,40,9797,15,570,30,10,2,100,8,10477,55,680,9797,40,15,720,9812,9,10,2,52
Bradley,9/27/20,8,11,11,342,3439,320,3780,14,10948,340,2,3436,3,319,1,7,1,14,0,3776,4,340,3436,1,3,341,3439,0,3,0,7
Calhoun,9/27/20,0,13,13,36,1506,34,1542,2,5202,35,1,1501,5,33,1,0,0,2,0,1536,6,35,1501,1,5,36,1506,0,0,0,1
Carroll,9/27/20,10,15,15,665,6921,585,7588,70,27887,658,7,6917,4,579,6,10,0,69,1,7575,13,658,6917,9,4,667,6921,13,7,1,46
Chicot,9/27/20,21,17,17,1006,4673,972,5680,13,10826,998,8,4660,13,965,7,20,1,13,0,5658,22,998,4660,9,13,1007,4673,1,1,1,9
Clark,9/27/20,4,19,19,342,5980,300,6321,38,22385,328,14,5936,44,289,11,4,0,35,3,6264,57,328,5936,13,44,341,5980,4,4,0,52
Clay,9/27/20,8,21,21,295,4015,240,4310,46,15061,287,8,4009,6,236,4,6,2,44,2,4296,14,287,4009,8,6,295,4015,1,0,0,17
Cleburne,9/27/20,8,23,23,331,5879,303,6211,20,25230,318,13,5789,90,290,13,8,0,20,0,6107,104,318,5789,14,90,332,5879,3,1,0,38
Cleveland,9/27/20,10,25,25,184,2608,157,2792,17,8226,181,3,2582,26,155,2,9,1,17,0,2763,29,181,2582,3,26,184,2608,0,0,0,3
Columbia,9/27/20,18,27,27,451,4270,355,4734,78,23892,425,26,4238,32,343,12,18,0,64,14,4663,71,425,4238,39,32,464,4270,8,2,0,17
Conway,9/27/20,3,29,29,267,6076,239,6344,25,20906,263,4,6007,69,235,4,3,0,25,0,6270,74,263,6007,5,69,268,6076,3,3,0,69
Craighead,9/27/20,22,31,31,2950,30822,2519,33777,408,105701,2882,68,30772,50,2463,56,19,3,399,9,33654,123,2882,30772,73,50,2955,30822,16,28,0,200
Crawford,9/27/20,15,33,33,1402,18181,1192,19575,195,62472,1371,31,18172,9,1164,28,12,3,195,0,19543,32,1371,18172,23,9,1394,18181,19,14,0,140
Crittenden,9/27/20,46,35,35,1945,13166,1831,15100,68,49013,1925,20,13162,4,1822,9,39,7,64,4,15087,13,1925,13162,9,4,1934,13166,1,6,0,31
Cross,9/27/20,13,37,37,434,4521,383,4949,38,16998,423,11,4503,18,375,8,11,2,37,1,4926,23,423,4503,5,18,428,4521,2,0,2,117
Dallas,9/27/20,4,39,39,162,1912,148,2074,10,7432,161,1,1903,9,147,1,4,0,10,0,2064,10,161,1903,1,9,162,1912,0,0,0,4
Desha,9/27/20,5,41,41,294,3671,267,3964,22,11887,292,2,3643,28,265,2,5,0,22,0,3935,29,292,3643,1,28,293,3671,0,2,0,17
Drew,9/27/20,7,43,43,357,5250,336,5610,14,18502,345,12,5206,44,326,10,6,1,13,1,5551,59,345,5206,15,44,360,5250,0,1,0,10
Faulkner,9/27/20,19,45,45,2473,36565,2146,39051,308,122416,2384,89,35867,698,2070,76,16,3,298,10,38251,800,2384,35867,102,698,2486,36565,21,51,0,452
Franklin,9/27/20,2,47,47,280,5591,230,5870,48,17780,274,6,5582,9,225,5,2,0,47,1,5856,14,274,5582,5,9,279,5591,1,1,0,26
Fulton,9/27/20,3,49,49,161,1222,112,1384,46,12139,147,14,1221,1,103,9,2,1,42,4,1368,16,147,1221,15,1,162,1222,4,0,0,13
Garland,9/27/20,52,51,51,1892,28462,1648,30350,192,98296,1868,24,28381,81,1633,15,47,5,188,4,30249,101,1868,28381,20,81,1888,28462,8,5,1,141
Grant,9/27/20,2,53,53,266,4744,227,5016,37,18086,257,9,4692,52,218,9,2,0,37,0,4949,67,257,4692,15,52,272,4744,3,0,0,23
Greene,9/27/20,10,55,55,873,13205,772,14078,91,44623,843,30,13107,98,748,24,10,0,85,6,13950,128,843,13107,30,98,873,13205,3,6,0,44
Hempstead,9/27/20,4,57,57,369,4465,349,4834,16,22018,360,9,4442,23,342,7,4,0,14,2,4802,32,360,4442,9,23,369,4465,3,1,0,20
HotSpring,9/27/20,26,59,59,1904,12035,1800,13938,78,33520,1897,7,11999,36,1795,5,24,2,78,0,13896,42,1897,11999,6,36,1903,12035,0,3,0,88
Howard,9/27/20,10,61,61,471,3562,447,4034,14,13389,459,12,3552,10,440,7,10,0,9,5,4011,23,459,3552,13,10,472,3562,2,1,1,7
Independence,9/27/20,19,63,63,1095,10735,978,11836,98,37264,1001,94,10684,51,899,79,18,1,84,14,11685,151,1001,10684,100,51,1101,10735,4,7,0,22
Izard,9/27/20,0,65,65,244,3286,145,3538,99,13559,235,9,3274,12,138,7,0,0,97,2,3509,29,235,3274,17,12,252,3286,2,0,0,11
Jackson,9/27/20,1,67,67,324,6010,287,6350,36,17225,279,45,5999,11,247,40,1,0,31,5,6278,72,279,5999,61,11,340,6010,2,4,0,6
Jefferson,9/27/20,73,69,69,3299,28318,2584,31624,642,70424,3249,50,28153,165,2551,33,66,7,632,10,31402,222,3249,28153,57,165,3306,28318,159,32,2,509
Johnson,9/27/20,6,71,71,851,6894,803,7748,42,26291,847,4,6869,25,802,1,6,0,39,3,7716,32,847,6869,7,25,854,6894,4,-1,1,45
Lafayette,9/27/20,2,73,73,107,993,86,1102,19,6915,103,4,991,2,85,1,2,0,16,3,1094,8,103,991,6,2,109,993,3,1,0,6
Lawrence,9/27/20,12,75,75,441,4049,352,4492,77,16669,404,37,4037,12,319,33,12,0,73,4,4441,51,404,4037,39,12,443,4049,4,9,0,21
Lee,9/27/20,18,77,77,1057,3840,1024,4897,15,9398,1054,3,3835,5,1022,2,17,1,15,0,4889,8,1054,3835,3,5,1057,3840,1,0,0,59
Lincoln,9/27/20,15,79,79,2013,6578,1785,8599,213,13695,2007,6,6563,15,1784,1,14,1,209,4,8570,29,2007,6563,14,15,2021,6578,2,6,0,40
LittleRiver,9/27/20,25,81,81,358,1748,319,2097,14,12417,342,16,1732,16,309,10,20,5,13,1,2074,23,342,1732,7,16,349,1748,3,2,0,9
Logan,9/27/20,1,83,83,407,6348,386,6756,20,21757,406,1,6339,9,385,1,1,0,20,0,6745,11,406,6339,2,9,408,6348,1,1,0,33
Lonoke,9/27/20,12,85,85,1181,18313,998,19539,171,72206,1049,132,17370,943,887,111,11,1,151,20,18419,1120,1049,17370,177,943,1226,18313,10,12,1,111
Madison,9/27/20,3,87,87,352,3853,325,4207,24,16076,342,10,3839,14,317,8,3,0,22,2,4181,26,342,3839,12,14,354,3853,1,0,0,15
Marion,9/27/20,0,89,89,98,2290,75,2389,23,16438,95,3,2283,7,72,3,0,0,23,0,2378,11,95,2283,4,7,99,2290,3,2,0,16
Miller,9/27/20,11,91,91,828,6270,764,7095,53,43759,790,38,6202,68,731,33,10,1,49,4,6992,103,790,6202,35,68,825,6270,6,3,0,19
MissingCountyInfo,9/27/20,0,5,5,1772,24994,1186,26758,586,NA,1659,113,24994,0,1096,90,0,0,563,23,26653,105,1659,24994,105,0,1764,24994,-85,30,0,1571
Mississippi,9/27/20,50,93,93,1681,11314,1530,12982,101,42831,1653,28,11303,11,1517,13,39,11,97,4,12956,26,1653,11303,15,11,1668,11314,13,15,0,42
Monroe,9/27/20,0,95,95,131,2148,107,2279,24,7249,130,1,2136,12,107,0,0,0,23,1,2266,13,130,2136,1,12,131,2148,0,1,0,11
Montgomery,9/27/20,4,97,97,151,2141,123,2292,24,8993,150,1,2124,17,122,1,4,0,24,0,2274,18,150,2124,1,17,151,2141,1,1,0,9
Nevada,9/27/20,13,99,99,220,3040,182,3254,25,8440,211,9,3030,10,176,6,12,1,23,2,3241,13,211,3030,3,10,214,3040,0,4,0,7
Newton,9/27/20,19,101,101,241,1683,190,1919,32,7848,230,11,1682,1,183,7,16,3,31,1,1912,7,230,1682,6,1,236,1683,2,5,1,11
Ouachita,9/27/20,6,103,103,263,5272,223,5539,34,24106,256,7,5248,24,218,5,6,0,32,2,5504,35,256,5248,11,24,267,5272,5,3,0,14
Perry,9/27/20,0,105,105,88,3022,77,3110,11,10322,84,4,2962,60,73,4,0,0,11,0,3046,64,84,2962,4,60,88,3022,0,3,0,23
Phillips,9/27/20,12,107,107,494,6437,442,6933,40,19034,491,3,6410,27,440,2,12,0,39,1,6901,32,491,6410,5,27,496,6437,4,7,0,130
Pike,9/27/20,3,109,109,227,2150,215,2376,9,10808,225,2,2130,20,214,1,2,1,9,0,2355,21,225,2130,1,20,226,2150,0,1,0,10
Poinsett,9/27/20,13,111,111,657,7240,581,7893,63,24054,644,13,7231,9,572,9,12,1,60,3,7875,18,644,7231,9,9,653,7240,6,4,1,49
Polk,9/27/20,4,113,113,261,3751,248,4013,9,20163,260,1,3747,4,247,1,4,0,9,0,4007,6,260,3747,2,4,262,3751,2,1,0,15
Pope,9/27/20,31,115,115,2127,20041,1965,22161,131,63644,2108,19,19916,125,1956,9,27,4,125,6,22024,137,2108,19916,12,125,2120,20041,20,10,0,131
Prairie,9/27/20,1,117,117,150,1941,134,2093,15,8244,145,5,1909,32,129,5,1,0,15,0,2054,39,145,1909,7,32,152,1941,0,0,0,10
Pulaski,9/27/20,149,119,119,9163,124269,8300,133490,714,393463,8889,274,122607,1662,8062,238,136,13,691,23,131496,1994,8889,122607,332,1662,9221,124269,28,63,1,959
Randolph,9/27/20,22,121,121,417,4519,345,4937,50,17603,383,34,4486,33,328,17,18,4,37,13,4869,68,383,4486,35,33,418,4519,3,7,0,25
Saline,9/27/20,23,125,125,2064,27818,1890,29889,150,118009,1983,81,27391,427,1821,69,21,2,140,10,29374,515,1983,27391,88,427,2071,27818,20,12,0,214
Scott,9/27/20,1,127,127,101,2250,94,2351,6,10442,101,0,2250,0,94,0,1,0,6,0,2351,0,101,2250,0,0,101,2250,1,0,0,7
Searcy,9/27/20,1,129,129,142,1818,137,1958,4,7923,138,4,1801,17,133,4,1,0,4,0,1939,19,138,1801,2,17,140,1818,1,1,0,3
Sebastian,9/27/20,60,131,131,3704,40972,3310,44672,333,127461,3660,44,40960,12,3283,27,49,11,327,6,44620,52,3660,40960,40,12,3700,40972,27,21,0,160
Sevier,9/27/20,18,133,133,1203,6547,1177,7747,8,17193,1190,13,6492,55,1166,11,18,0,6,2,7682,65,1190,6492,10,55,1200,6547,1,0,2,13
Sharp,9/27/20,6,135,135,220,3757,181,3974,33,17043,207,13,3750,7,177,4,6,0,24,9,3957,17,207,3750,10,7,217,3757,2,7,0,21
St.Francis,9/27/20,6,123,123,1506,11939,1403,13447,97,26294,1506,0,11931,8,1403,0,6,0,97,0,13437,10,1506,11931,2,8,1508,11939,3,3,0,45
Stone,9/27/20,12,137,137,347,3215,283,3565,52,12446,341,6,3204,11,277,6,12,0,52,0,3545,20,341,3204,9,11,350,3215,2,9,3,13
Union,9/27/20,36,139,139,892,8422,821,9314,34,39732,870,22,8388,34,809,12,31,5,29,5,9258,56,870,8388,22,34,892,8422,1,7,0,28
VanBuren,9/27/20,3,141,141,174,3929,161,4109,10,16684,172,2,3872,57,159,2,3,0,10,0,4044,65,172,3872,8,57,180,3929,1,0,0,16
Washington,9/27/20,117,143,143,9415,72439,8829,81886,469,228529,8870,545,71497,942,8351,478,101,16,418,51,80367,1519,8870,71497,577,942,9447,72439,36,51,2,232
White,9/27/20,23,145,145,841,14424,713,15276,105,78804,769,72,14053,371,656,57,19,4,94,11,14822,454,769,14053,83,371,852,14424,4,9,0,60
Woodruff,9/27/20,0,147,147,53,1600,43,1654,10,6660,47,6,1591,9,38,5,0,0,9,1,1638,16,47,1591,7,9,54,1600,1,0,0,5
Yell,9/27/20,29,149,149,1254,9691,1193,10942,32,21573,1246,8,9648,43,1189,4,26,3,31,1,10894,48,1246,9648,5,43,1251,9691,2,2,0,73
Arkansas_all_counties,9/26/20,1285,5630,5630,80755,863193,72051,944159,7414,2990671,78260,2495,855635,7558,70091,1960,1137,148,7027,387,933895,10264,78260,855635,2706,7558,80966,863193,809,625,19,7806
Arkansas_county,9/26/20,7,1,1,404,5671,329,6083,68,18124,380,24,5456,215,314,15,6,1,60,8,5836,247,380,5456,32,215,412,5671,13,5,1,57
Ashley,9/26/20,10,3,3,431,4808,399,5241,22,20537,426,5,4784,24,396,3,10,0,20,2,5210,31,426,4784,7,24,433,4808,0,1,0,18
Baxter,9/26/20,2,5,5,337,3961,266,4300,69,41219,301,36,3944,17,237,29,2,0,62,7,4245,55,301,3944,38,17,339,3961,6,7,0,37
Benton,9/26/20,86,7,7,6528,69934,6056,76482,386,258980,6352,176,69505,429,5921,135,69,17,362,24,75857,625,6352,69505,196,429,6548,69934,28,39,2,279
Boone,9/26/20,10,9,9,711,9769,590,10480,111,37288,672,39,9754,15,561,29,8,2,103,8,10426,54,672,9754,39,15,711,9769,5,46,0,37
Bradley,9/26/20,8,11,11,342,3432,317,3773,17,10948,340,2,3429,3,316,1,7,1,17,0,3769,4,340,3429,1,3,341,3432,0,1,0,6
Calhoun,9/26/20,0,13,13,36,1505,34,1541,2,5202,35,1,1500,5,33,1,0,0,2,0,1535,6,35,1500,1,5,36,1505,1,2,0,0
Carroll,9/26/20,9,15,15,652,6888,578,7542,65,27887,645,7,6884,4,573,5,9,0,63,2,7529,13,645,6884,9,4,654,6888,2,4,0,51
Chicot,9/26/20,20,17,17,1005,4665,971,5671,14,10826,997,8,4652,13,964,7,19,1,14,0,5649,22,997,4652,9,13,1006,4665,1,-1,1,10
Clark,9/26/20,4,19,19,338,5932,296,6269,38,22385,324,14,5888,44,285,11,4,0,35,3,6212,57,324,5888,13,44,337,5932,6,5,0,20
Clay,9/26/20,8,21,21,294,3999,240,4293,45,15061,286,8,3993,6,236,4,6,2,43,2,4279,14,286,3993,8,6,294,3999,8,3,0,29
Cleburne,9/26/20,8,23,23,328,5844,302,6173,18,25230,315,13,5754,90,289,13,8,0,18,0,6069,104,315,5754,14,90,329,5844,4,0,0,29
Cleveland,9/26/20,10,25,25,184,2605,157,2789,17,8226,181,3,2579,26,155,2,9,1,17,0,2760,29,181,2579,3,26,184,2605,0,1,0,17
Columbia,9/26/20,18,27,27,443,4261,353,4717,72,23892,418,25,4229,32,341,12,18,0,59,13,4647,70,418,4229,38,32,456,4261,9,4,0,25
Conway,9/26/20,3,29,29,264,6010,236,6275,25,20906,260,4,5937,73,232,4,3,0,25,0,6197,78,260,5937,5,73,265,6010,1,1,0,35
Craighead,9/26/20,22,31,31,2934,30638,2491,33578,420,105701,2867,67,30588,50,2436,55,19,3,411,9,33455,123,2867,30588,73,50,2940,30638,58,40,0,239
Crawford,9/26/20,15,33,33,1383,18060,1178,19435,190,62472,1352,31,18051,9,1150,28,12,3,190,0,19403,32,1352,18051,23,9,1375,18060,22,15,0,132
Crittenden,9/26/20,46,35,35,1944,13136,1825,15069,73,49013,1924,20,13132,4,1816,9,39,7,69,4,15056,13,1924,13132,9,4,1933,13136,21,12,0,59
Cross,9/26/20,11,37,37,432,4406,383,4832,38,16998,421,11,4387,19,375,8,9,2,37,1,4808,24,421,4387,5,19,426,4406,2,4,0,22
Dallas,9/26/20,4,39,39,162,1908,148,2070,10,7432,161,1,1899,9,147,1,4,0,10,0,2060,10,161,1899,1,9,162,1908,0,-1,1,6
Desha,9/26/20,5,41,41,294,3654,265,3947,24,11887,292,2,3626,28,263,2,5,0,24,0,3918,29,292,3626,1,28,293,3654,4,4,0,-2
Drew,9/26/20,7,43,43,357,5240,335,5600,15,18502,345,12,5196,44,325,10,6,1,14,1,5541,59,345,5196,15,44,360,5240,2,0,1,10
Faulkner,9/26/20,19,45,45,2452,36134,2095,38597,338,122416,2361,91,35448,686,2019,76,16,3,326,12,37809,788,2361,35448,102,686,2463,36134,20,26,0,365
Franklin,9/26/20,2,47,47,279,5566,229,5844,48,17780,273,6,5558,8,224,5,2,0,47,1,5831,13,273,5558,5,8,278,5566,6,3,0,46
Fulton,9/26/20,3,49,49,157,1213,112,1371,42,12139,143,14,1212,1,105,7,2,1,36,6,1355,16,143,1212,15,1,158,1213,4,2,0,19
Garland,9/26/20,51,51,51,1884,28329,1643,30209,190,98296,1860,24,28248,81,1628,15,46,5,186,4,30108,101,1860,28248,20,81,1880,28329,19,21,0,200
Grant,9/26/20,2,53,53,263,4724,227,4993,34,18086,254,9,4672,52,218,9,2,0,34,0,4926,67,254,4672,15,52,269,4724,7,2,0,32
Greene,9/26/20,10,55,55,870,13164,766,14034,94,44623,840,30,13066,98,743,23,10,0,87,7,13906,128,840,13066,30,98,870,13164,11,10,0,84
Hempstead,9/26/20,4,57,57,366,4448,348,4815,14,22018,358,8,4425,23,341,7,4,0,13,1,4783,32,358,4425,9,23,367,4448,3,2,0,26
HotSpring,9/26/20,26,59,59,1904,11947,1797,13850,81,33520,1897,7,11911,36,1793,4,24,2,80,1,13808,42,1897,11911,6,36,1903,11947,20,8,0,82
Howard,9/26/20,9,61,61,469,3557,446,4027,14,13389,457,12,3547,10,440,6,9,0,8,6,4004,23,457,3547,13,10,470,3557,1,5,0,6
Independence,9/26/20,19,63,63,1091,10717,971,11814,101,37264,998,93,10666,51,894,77,18,1,86,15,11664,150,998,10666,99,51,1097,10717,15,7,0,54
Izard,9/26/20,0,65,65,242,3277,145,3527,97,13559,233,9,3265,12,138,7,0,0,95,2,3498,29,233,3265,17,12,250,3277,4,3,0,18
Jackson,9/26/20,1,67,67,322,6006,283,6344,38,17225,277,45,5995,11,244,39,1,0,32,6,6272,72,277,5995,61,11,338,6006,1,5,0,177
Jefferson,9/26/20,71,69,69,3140,27968,2552,31114,517,70424,3089,51,27803,165,2519,33,64,7,506,11,30892,222,3089,27803,57,165,3146,27968,33,26,3,166
Johnson,9/26/20,5,71,71,847,6853,804,7703,38,26291,843,4,6828,25,803,1,5,0,35,3,7671,32,843,6828,7,25,850,6853,10,3,0,32
Lafayette,9/26/20,2,73,73,104,990,85,1096,17,6915,100,4,988,2,84,1,2,0,14,3,1088,8,100,988,6,2,106,990,0,2,0,6
Lawrence,9/26/20,12,75,75,437,4032,343,4470,82,16669,400,37,4020,12,311,32,12,0,77,5,4420,50,400,4020,38,12,438,4032,13,8,0,29
Lee,9/26/20,18,77,77,1056,3782,1024,4838,14,9398,1053,3,3777,5,1022,2,17,1,14,0,4830,8,1053,3777,3,5,1056,3782,2,1,0,14
Lincoln,9/26/20,15,79,79,2011,6540,1779,8559,217,13695,2005,6,6525,15,1778,1,14,1,213,4,8530,29,2005,6525,14,15,2019,6540,50,4,0,73
LittleRiver,9/26/20,25,81,81,355,1742,317,2088,13,12417,339,16,1726,16,307,10,20,5,12,1,2065,23,339,1726,7,16,346,1742,1,0,0,4
Logan,9/26/20,1,83,83,406,6316,385,6723,20,21757,405,1,6307,9,384,1,1,0,20,0,6712,11,405,6307,2,9,407,6316,3,2,0,21
Lonoke,9/26/20,11,85,85,1171,18212,986,19429,174,72206,1040,131,17270,942,878,108,10,1,152,22,18310,1119,1040,17270,177,942,1217,18212,18,13,0,121
Madison,9/26/20,3,87,87,351,3839,325,4192,23,16076,341,10,3825,14,317,8,3,0,21,2,4166,26,341,3825,12,14,353,3839,5,1,0,26
Marion,9/26/20,0,89,89,95,2277,73,2373,22,16438,92,3,2270,7,70,3,0,0,22,0,2362,11,92,2270,4,7,96,2277,6,4,0,62
Miller,9/26/20,11,91,91,822,6257,761,7077,50,43759,786,36,6189,68,728,33,10,1,48,2,6975,102,786,6189,34,68,820,6257,4,9,0,24
MissingCountyInfo,9/26/20,0,5,5,1857,23338,1156,25188,701,NA,1742,115,23338,0,1067,89,0,0,675,26,25080,108,1742,23338,108,0,1850,23338,91,27,0,2534
Mississippi,9/26/20,50,93,93,1668,11285,1515,12940,103,42831,1640,28,11275,10,1503,12,39,11,98,5,12915,25,1640,11275,15,10,1655,11285,11,11,0,74
Monroe,9/26/20,0,95,95,131,2137,106,2268,25,7249,130,1,2125,12,106,0,0,0,24,1,2255,13,130,2125,1,12,131,2137,3,0,0,9
Montgomery,9/26/20,4,97,97,150,2133,122,2283,24,8993,149,1,2116,17,121,1,4,0,24,0,2265,18,149,2116,1,17,150,2133,5,0,0,10
Nevada,9/26/20,13,99,99,220,3033,178,3247,29,8440,211,9,3023,10,172,6,12,1,27,2,3234,13,211,3023,3,10,214,3033,0,3,0,27
Newton,9/26/20,18,101,101,239,1674,185,1908,36,7848,228,11,1673,1,178,7,15,3,35,1,1901,7,228,1673,6,1,234,1674,3,3,0,7
Ouachita,9/26/20,6,103,103,258,5263,220,5526,32,24106,252,6,5239,24,215,5,6,0,31,1,5491,35,252,5239,11,24,263,5263,3,2,0,11
Perry,9/26/20,0,105,105,88,2999,74,3087,14,10322,84,4,2936,63,70,4,0,0,14,0,3020,67,84,2936,4,63,88,2999,0,1,0,19
Phillips,9/26/20,12,107,107,490,6311,435,6803,43,19034,487,3,6284,27,433,2,12,0,42,1,6771,32,487,6284,5,27,492,6311,5,4,1,43
Pike,9/26/20,3,109,109,227,2140,214,2366,10,10808,225,2,2120,20,213,1,2,1,10,0,2345,21,225,2120,1,20,226,2140,1,0,0,13
Poinsett,9/26/20,12,111,111,651,7197,577,7844,62,24054,638,13,7188,9,568,9,11,1,59,3,7826,18,638,7188,9,9,647,7197,6,5,1,55
Polk,9/26/20,4,113,113,259,3738,247,3998,8,20163,258,1,3734,4,246,1,4,0,8,0,3992,6,258,3734,2,4,260,3738,1,1,0,5
Pope,9/26/20,31,115,115,2107,19930,1955,22031,121,63644,2089,18,19806,124,1946,9,27,4,116,5,21895,136,2089,19806,12,124,2101,19930,11,14,1,85
Prairie,9/26/20,1,117,117,150,1931,134,2083,15,8244,145,5,1899,32,129,5,1,0,15,0,2044,39,145,1899,7,32,152,1931,4,1,0,14
Pulaski,9/26/20,148,119,119,9135,123338,8237,132531,750,393463,8862,273,121678,1660,8001,236,135,13,726,24,130540,1991,8862,121678,331,1660,9193,123338,76,63,1,697
Randolph,9/26/20,22,121,121,414,4497,338,4913,54,17603,381,33,4463,34,321,17,18,4,42,12,4844,69,381,4463,35,34,416,4497,3,3,0,15
Saline,9/26/20,23,125,125,2044,27624,1878,29676,142,118009,1964,80,27197,427,1810,68,21,2,132,10,29161,515,1964,27197,88,427,2052,27624,14,8,0,176
Scott,9/26/20,1,127,127,100,2244,94,2344,5,10442,100,0,2244,0,94,0,1,0,5,0,2344,0,100,2244,0,0,100,2244,0,0,0,17
Searcy,9/26/20,1,129,129,141,1816,136,1955,4,7923,137,4,1799,17,132,4,1,0,4,0,1936,19,137,1799,2,17,139,1816,0,0,0,10
Sebastian,9/26/20,60,131,131,3677,40839,3289,44512,327,127461,3633,44,40827,12,3264,25,49,11,319,8,44460,52,3633,40827,40,12,3673,40839,39,32,1,230
Sevier,9/26/20,16,133,133,1202,6535,1177,7735,9,17193,1190,12,6480,55,1168,9,16,0,6,3,7670,65,1190,6480,10,55,1200,6535,1,1,0,6
Sharp,9/26/20,6,135,135,218,3738,174,3953,38,17043,205,13,3731,7,171,3,6,0,28,10,3936,17,205,3731,10,7,215,3738,2,2,0,22
St.Francis,9/26/20,6,123,123,1503,11897,1400,13402,97,26294,1503,0,11889,8,1400,0,6,0,97,0,13392,10,1503,11889,2,8,1505,11897,5,3,0,33
Stone,9/26/20,9,137,137,345,3204,274,3552,62,12446,339,6,3192,12,268,6,9,0,62,0,3531,21,339,3192,9,12,348,3204,3,3,0,15
Union,9/26/20,36,139,139,891,8395,814,9286,40,39732,869,22,8361,34,803,11,31,5,34,6,9230,56,869,8361,22,34,891,8395,11,4,2,25
VanBuren,9/26/20,3,141,141,173,3914,161,4093,9,16684,171,2,3851,63,159,2,3,0,9,0,4022,71,171,3851,8,63,179,3914,0,1,0,19
Washington,9/26/20,115,143,143,9379,72243,8778,81654,486,228529,8835,544,71301,942,8307,471,99,16,429,57,80136,1518,8835,71301,576,942,9411,72243,51,55,1,442
White,9/26/20,23,145,145,837,14368,704,15216,110,78804,765,72,13994,374,648,56,19,4,98,12,14759,457,765,13994,83,374,848,14368,9,15,2,341
Woodruff,9/26/20,0,147,147,52,1596,43,1649,9,6660,46,6,1587,9,38,5,0,0,8,1,1633,16,46,1587,7,9,53,1596,0,0,0,13
Yell,9/26/20,29,149,149,1252,9620,1191,10869,32,21573,1244,8,9577,43,1187,4,26,3,31,1,10821,48,1244,9577,5,43,1249,9620,2,4,0,36
Arkansas_all_counties,9/25/20,1266,5630,5630,79946,856196,71426,936350,7249,2990671,77472,2474,848822,7374,69521,1905,1116,150,6830,419,926294,10056,77472,848822,2682,7374,80154,856196,897,689,20,8000
Arkansas_county,9/25/20,6,1,1,391,5627,324,6026,61,18124,368,23,5413,214,310,14,5,1,53,8,5781,245,368,5413,31,214,399,5627,15,4,1,212
Ashley,9/25/20,10,3,3,431,4790,398,5223,23,20537,426,5,4768,22,395,3,10,0,21,2,5194,29,426,4768,7,22,433,4790,2,0,0,83
Baxter,9/25/20,2,5,5,331,3930,259,4262,70,41219,296,35,3915,15,232,27,2,0,62,8,4211,51,296,3915,36,15,332,3930,14,15,0,91
Benton,9/25/20,84,7,7,6500,69683,6017,76203,399,258980,6326,174,69254,429,5889,128,67,17,370,29,75580,623,6326,69254,194,429,6520,69683,42,49,0,1583
Boone,9/25/20,10,9,9,706,9737,544,10443,152,37288,667,39,9722,15,517,27,8,2,142,10,10389,54,667,9722,39,15,706,9737,18,16,0,239
Bradley,9/25/20,8,11,11,342,3426,316,3767,18,10948,340,2,3423,3,315,1,7,1,18,0,3763,4,340,3423,1,3,341,3426,2,1,0,27
Calhoun,9/25/20,0,13,13,35,1506,32,1541,3,5202,34,1,1500,6,31,1,0,0,3,0,1534,7,34,1500,1,6,35,1506,1,2,0,37
Carroll,9/25/20,9,15,15,650,6839,574,7491,67,27887,643,7,6835,4,569,5,9,0,65,2,7478,13,643,6835,9,4,652,6839,11,6,0,84
Chicot,9/25/20,19,17,17,1004,4656,972,5661,13,10826,996,8,4642,14,965,7,18,1,13,0,5638,23,996,4642,9,14,1005,4656,0,2,0,51
Clark,9/25/20,4,19,19,332,5918,291,6249,37,22385,318,14,5874,44,280,11,4,0,34,3,6192,57,318,5874,13,44,331,5918,3,4,0,160
Clay,9/25/20,8,21,21,286,3978,237,4264,40,15061,278,8,3972,6,233,4,6,2,38,2,4250,14,278,3972,8,6,286,3978,2,0,1,111
Cleburne,9/25/20,8,23,23,324,5819,302,6144,14,25230,311,13,5733,86,289,13,8,0,14,0,6044,100,311,5733,14,86,325,5819,4,5,0,157
Cleveland,9/25/20,10,25,25,184,2588,156,2772,18,8226,181,3,2562,26,154,2,9,1,18,0,2743,29,181,2562,3,26,184,2588,5,2,0,29
Columbia,9/25/20,18,27,27,434,4245,349,4692,67,23892,409,25,4213,32,337,12,18,0,54,13,4622,70,409,4213,38,32,447,4245,22,8,0,165
Conway,9/25/20,3,29,29,263,5976,235,6240,25,20906,259,4,5913,63,231,4,3,0,25,0,6172,68,259,5913,5,63,264,5976,6,2,0,128
Craighead,9/25/20,22,31,31,2876,30457,2451,33339,402,105701,2811,65,30408,49,2397,54,19,3,394,8,33219,120,2811,30408,71,49,2882,30457,62,33,1,748
Crawford,9/25/20,15,33,33,1361,17950,1163,19303,183,62472,1331,30,17942,8,1136,27,12,3,183,0,19273,30,1331,17942,22,8,1353,17950,45,23,0,406
Crittenden,9/25/20,46,35,35,1923,13098,1813,15010,64,49013,1903,20,13094,4,1804,9,39,7,60,4,14997,13,1903,13094,9,4,1912,13098,6,20,0,93
Cross,9/25/20,11,37,37,430,4386,379,4809,40,16998,418,12,4367,19,372,7,9,2,37,3,4785,24,418,4367,5,19,423,4386,2,5,2,74
Dallas,9/25/20,3,39,39,162,1902,149,2064,10,7432,161,1,1893,9,148,1,3,0,10,0,2054,10,161,1893,1,9,162,1902,1,4,0,21
Desha,9/25/20,5,41,41,290,3660,261,3949,24,11887,288,2,3632,28,259,2,5,0,24,0,3920,29,288,3632,1,28,289,3660,2,1,0,108
Drew,9/25/20,6,43,43,355,5232,335,5590,14,18502,343,12,5188,44,325,10,5,1,13,1,5531,59,343,5188,15,44,358,5232,2,1,0,52
Faulkner,9/25/20,19,45,45,2432,35789,2069,38232,344,122416,2342,90,35108,681,1998,71,16,3,328,16,37450,782,2342,35108,101,681,2443,35789,41,35,0,1133
Franklin,9/25/20,2,47,47,273,5526,226,5798,45,17780,267,6,5517,9,221,5,2,0,44,1,5784,14,267,5517,5,9,272,5526,6,8,0,90
Fulton,9/25/20,3,49,49,153,1198,110,1352,40,12139,140,13,1197,1,103,7,2,1,35,5,1337,15,140,1197,14,1,154,1198,14,9,0,55
Garland,9/25/20,51,51,51,1865,28148,1622,30010,192,98296,1842,23,28069,79,1608,14,46,5,188,4,29911,99,1842,28069,20,79,1862,28148,38,18,1,670
Grant,9/25/20,2,53,53,256,4699,225,4961,29,18086,247,9,4651,48,216,9,2,0,29,0,4898,63,247,4651,15,48,262,4699,1,4,0,60
Greene,9/25/20,10,55,55,859,13091,756,13951,93,44623,830,29,12993,98,734,22,10,0,86,7,13823,128,830,12993,30,98,860,13091,23,14,1,520
Hempstead,9/25/20,4,57,57,363,4425,346,4788,13,22018,354,9,4403,22,340,6,4,0,10,3,4757,31,354,4403,9,22,363,4425,1,0,0,389
HotSpring,9/25/20,26,59,59,1884,11885,1789,13768,69,33520,1877,7,11849,36,1785,4,24,2,68,1,13726,42,1877,11849,6,36,1883,11885,9,5,0,180
Howard,9/25/20,9,61,61,468,3552,441,4021,18,13389,456,12,3542,10,435,6,9,0,12,6,3998,23,456,3542,13,10,469,3552,3,1,0,70
Independence,9/25/20,19,63,63,1076,10678,964,11760,93,37264,984,92,10627,51,888,76,18,1,78,15,11611,149,984,10627,98,51,1082,10678,12,15,2,288
Izard,9/25/20,0,65,65,238,3263,142,3509,96,13559,229,9,3251,12,135,7,0,0,94,2,3480,29,229,3251,17,12,246,3263,15,4,0,59
Jackson,9/25/20,1,67,67,321,5830,278,6167,42,17225,276,45,5819,11,240,38,1,0,35,7,6095,72,276,5819,61,11,337,5830,8,6,0,56
Jefferson,9/25/20,68,69,69,3107,27835,2526,30948,513,70424,3056,51,27671,164,2493,33,61,7,502,11,30727,221,3056,27671,57,164,3113,27835,33,44,3,327
Johnson,9/25/20,5,71,71,837,6831,801,7672,31,26291,834,3,6805,26,800,1,5,0,29,2,7639,33,834,6805,7,26,841,6831,3,1,0,165
Lafayette,9/25/20,2,73,73,104,984,83,1090,19,6915,100,4,982,2,82,1,2,0,16,3,1082,8,100,982,6,2,106,984,2,0,0,66
Lawrence,9/25/20,12,75,75,424,4016,335,4441,77,16669,388,36,4004,12,304,31,12,0,72,5,4392,49,388,4004,37,12,425,4016,14,15,0,65
Lee,9/25/20,18,77,77,1054,3770,1023,4824,13,9398,1051,3,3765,5,1021,2,17,1,13,0,4816,8,1051,3765,3,5,1054,3770,1,1,0,38
Lincoln,9/25/20,15,79,79,1961,6517,1775,8486,171,13695,1955,6,6502,15,1774,1,14,1,167,4,8457,29,1955,6502,14,15,1969,6517,13,2,0,58
LittleRiver,9/25/20,25,81,81,354,1739,317,2084,12,12417,338,16,1723,16,307,10,20,5,11,1,2061,23,338,1723,7,16,345,1739,1,0,0,38
Logan,9/25/20,1,83,83,403,6298,383,6702,19,21757,402,1,6292,6,382,1,1,0,19,0,6694,8,402,6292,2,6,404,6298,2,1,0,122
Lonoke,9/25/20,11,85,85,1153,18109,973,19306,169,72206,1020,133,17170,939,866,107,9,2,145,24,18190,1116,1020,17170,177,939,1197,18109,32,11,0,374
Madison,9/25/20,3,87,87,346,3818,324,4166,19,16076,336,10,3804,14,316,8,3,0,17,2,4140,26,336,3804,12,14,348,3818,6,2,1,78
Marion,9/25/20,0,89,89,89,2221,69,2312,20,16438,86,3,2214,7,66,3,0,0,20,0,2300,12,86,2214,5,7,91,2221,4,4,0,22
Miller,9/25/20,11,91,91,818,6237,752,7053,55,43759,782,36,6179,58,719,33,10,1,53,2,6961,92,782,6179,34,58,816,6237,8,13,0,105
MissingCountyInfo,9/25/20,0,5,5,1766,20895,1129,22653,637,NA,1650,116,20895,0,1041,88,0,0,609,28,22545,108,1650,20895,108,0,1758,20895,-12,-2,0,-10401
Mississippi,9/25/20,50,93,93,1657,11222,1504,12866,103,42831,1629,28,11211,11,1492,12,39,11,98,5,12840,26,1629,11211,15,11,1644,11222,9,9,0,135
Monroe,9/25/20,0,95,95,128,2131,106,2259,22,7249,127,1,2119,12,106,0,0,0,21,1,2246,13,127,2119,1,12,128,2131,4,1,0,40
Montgomery,9/25/20,4,97,97,145,2128,122,2273,19,8993,144,1,2112,16,121,1,4,0,19,0,2256,17,144,2112,1,16,145,2128,3,2,0,39
Nevada,9/25/20,13,99,99,220,3006,175,3220,32,8440,211,9,2996,10,170,5,12,1,29,3,3207,13,211,2996,3,10,214,3006,4,3,0,230
Newton,9/25/20,18,101,101,236,1670,182,1901,36,7848,225,11,1669,1,175,7,15,3,35,1,1894,7,225,1669,6,1,231,1670,8,9,0,22
Ouachita,9/25/20,6,103,103,255,5255,218,5515,31,24106,249,6,5231,24,213,5,6,0,30,1,5480,35,249,5231,11,24,260,5255,1,3,0,146
Perry,9/25/20,0,105,105,88,2980,73,3068,15,10322,84,4,2922,58,69,4,0,0,15,0,3006,62,84,2922,4,58,88,2980,2,0,0,59
Phillips,9/25/20,11,107,107,485,6273,431,6760,43,19034,482,3,6246,27,429,2,11,0,42,1,6728,32,482,6246,5,27,487,6273,13,4,0,249
Pike,9/25/20,3,109,109,226,2128,214,2353,9,10808,224,2,2108,20,213,1,2,1,9,0,2332,21,224,2108,1,20,225,2128,1,0,0,38
Poinsett,9/25/20,11,111,111,645,7148,572,7789,62,24054,632,13,7139,9,563,9,10,1,59,3,7771,18,632,7139,9,9,641,7148,8,7,0,83
Polk,9/25/20,4,113,113,258,3734,246,3993,8,20163,257,1,3730,4,245,1,4,0,8,0,3987,6,257,3730,2,4,259,3734,1,0,0,54
Pope,9/25/20,30,115,115,2096,19856,1941,21947,125,63644,2080,16,19725,131,1933,8,25,5,122,3,21805,142,2080,19725,11,131,2091,19856,17,11,0,562
Prairie,9/25/20,1,117,117,146,1921,133,2069,12,8244,141,5,1889,32,128,5,1,0,12,0,2030,39,141,1889,7,32,148,1921,0,1,0,23
Pulaski,9/25/20,147,119,119,9059,122717,8174,131834,738,393463,8792,267,121080,1637,7947,227,134,13,711,27,129872,1962,8792,121080,325,1637,9117,122717,78,80,1,2115
Randolph,9/25/20,22,121,121,411,4485,335,4897,54,17603,377,34,4452,33,319,16,18,4,40,14,4829,68,377,4452,35,33,412,4485,2,2,0,56
Saline,9/25/20,23,125,125,2030,27462,1870,29500,136,118009,1952,78,27045,417,1803,67,21,2,127,9,28997,503,1952,27045,86,417,2038,27462,10,13,0,644
Scott,9/25/20,1,127,127,100,2227,94,2327,5,10442,100,0,2227,0,94,0,1,0,5,0,2327,0,100,2227,0,0,100,2227,3,1,0,29
Searcy,9/25/20,1,129,129,141,1806,136,1945,4,7923,137,4,1788,18,132,4,1,0,4,0,1925,20,137,1788,2,18,139,1806,0,0,0,30
Sebastian,9/25/20,59,131,131,3638,40648,3257,44282,321,127461,3594,44,40636,12,3232,25,48,11,313,8,44230,52,3594,40636,40,12,3634,40648,48,28,0,825
Sevier,9/25/20,16,133,133,1201,6530,1176,7729,9,17193,1189,12,6475,55,1167,9,16,0,6,3,7664,65,1189,6475,10,55,1199,6530,2,3,0,31
Sharp,9/25/20,6,135,135,216,3718,172,3931,38,17043,203,13,3711,7,169,3,6,0,28,10,3914,17,203,3711,10,7,213,3718,2,4,0,111
St.Francis,9/25/20,6,123,123,1498,11869,1397,13369,95,26294,1498,0,11861,8,1397,0,6,0,95,0,13359,10,1498,11861,2,8,1500,11869,6,2,0,85
Stone,9/25/20,9,137,137,342,3192,271,3537,62,12446,336,6,3180,12,265,6,9,0,62,0,3516,21,336,3180,9,12,345,3192,7,2,2,52
Union,9/25/20,34,139,139,880,8381,810,9260,35,39732,857,23,8349,32,799,11,29,5,28,7,9206,54,857,8349,22,32,879,8381,6,2,2,436
VanBuren,9/25/20,3,141,141,173,3895,160,4074,10,16684,171,2,3835,60,158,2,3,0,10,0,4006,68,171,3835,8,60,179,3895,0,0,0,152
Washington,9/25/20,114,143,143,9328,71852,8723,81212,491,228529,8787,541,71003,849,8264,459,98,16,425,66,79790,1422,8787,71003,573,849,9360,71852,78,72,2,1734
White,9/25/20,21,145,145,828,14036,689,14875,118,78804,757,71,13673,363,635,54,17,4,105,13,14430,445,757,13673,82,363,839,14036,33,14,0,314
Woodruff,9/25/20,0,147,147,52,1583,43,1636,9,6660,46,6,1575,8,38,5,0,0,8,1,1621,15,46,1575,7,8,53,1583,3,1,0,23
Yell,9/25/20,29,149,149,1250,9586,1187,10833,34,21573,1242,8,9540,46,1183,4,26,3,33,1,10782,51,1242,9540,5,46,1247,9586,3,1,0,397
Arkansas_all_counties,9/24/20,1246,5630,5630,79049,849093,70737,928335,7061,2990671,76676,2373,840737,8356,68902,1835,1097,149,6672,389,917413,10922,76676,840737,2566,8356,79242,849093,1086,785,17,11931
Arkansas_county,9/24/20,5,1,1,376,5430,320,5814,51,18124,357,19,5216,214,307,13,5,0,45,6,5573,241,357,5216,27,214,384,5430,5,2,0,71
Ashley,9/24/20,10,3,3,429,4709,398,5140,21,20537,424,5,4687,22,395,3,10,0,19,2,5111,29,424,4687,7,22,431,4709,1,2,1,-28
Baxter,9/24/20,2,5,5,317,3853,244,4171,71,41219,287,30,3838,15,219,25,2,0,66,5,4125,46,287,3838,31,15,318,3853,15,8,0,68
Benton,9/24/20,84,7,7,6458,68142,5968,74617,406,258980,6292,166,67799,343,5843,125,67,17,382,24,74091,526,6292,67799,183,343,6475,68142,59,60,2,678
Boone,9/24/20,10,9,9,688,9516,528,10203,150,37288,654,34,9501,15,506,22,8,2,140,10,10155,48,654,9501,33,15,687,9516,24,19,0,424
Bradley,9/24/20,8,11,11,340,3401,315,3740,17,10948,338,2,3398,3,314,1,7,1,17,0,3736,4,338,3398,1,3,339,3401,0,0,0,18
Calhoun,9/24/20,0,13,13,34,1470,30,1504,4,5202,33,1,1465,5,29,1,0,0,4,0,1498,6,33,1465,1,5,34,1470,0,0,0,14
Carroll,9/24/20,9,15,15,639,6766,568,7407,62,27887,632,7,6762,4,563,5,9,0,60,2,7394,13,632,6762,9,4,641,6766,9,10,0,86
Chicot,9/24/20,19,17,17,1004,4605,970,5609,15,10826,995,9,4592,13,962,8,18,1,15,0,5587,22,995,4592,9,13,1004,4605,3,1,0,18
Clark,9/24/20,4,19,19,329,5761,287,6089,38,22385,317,12,5731,30,277,10,4,0,36,2,6048,41,317,5731,11,30,328,5761,7,6,0,117
Clay,9/24/20,7,21,21,284,3869,237,4153,39,15061,277,7,3863,6,233,4,5,2,38,1,4140,13,277,3863,7,6,284,3869,7,7,0,85
Cleburne,9/24/20,8,23,23,320,5666,297,5987,15,25230,307,13,5576,90,284,13,8,0,15,0,5883,104,307,5576,14,90,321,5666,5,6,0,68
Cleveland,9/24/20,10,25,25,179,2564,154,2743,15,8226,176,3,2538,26,152,2,9,1,15,0,2714,29,176,2538,3,26,179,2564,0,3,0,114
Columbia,9/24/20,18,27,27,412,4102,341,4525,53,23892,388,24,4072,30,330,11,18,0,40,13,4460,65,388,4072,35,30,423,4102,13,5,0,39
Conway,9/24/20,3,29,29,257,5854,233,6112,21,20906,253,4,5786,68,229,4,3,0,21,0,6039,73,253,5786,5,68,258,5854,2,5,0,75
Craighead,9/24/20,21,31,31,2814,29771,2418,32591,374,105701,2750,64,29723,48,2365,53,18,3,366,8,32473,118,2750,29723,70,48,2820,29771,55,43,0,323
Crawford,9/24/20,15,33,33,1316,17589,1140,18898,161,62472,1287,29,17581,8,1114,26,12,3,161,0,18868,30,1287,17581,22,8,1309,17589,13,28,0,109
Crittenden,9/24/20,46,35,35,1917,13011,1793,14917,78,49013,1897,20,13007,4,1785,8,39,7,73,5,14904,13,1897,13007,9,4,1906,13011,14,7,1,110
Cross,9/24/20,9,37,37,428,4314,374,4735,45,16998,416,12,4296,18,367,7,7,2,42,3,4712,23,416,4296,5,18,421,4314,6,4,1,66
Dallas,9/24/20,3,39,39,161,1882,145,2043,13,7432,160,1,1873,9,144,1,3,0,13,0,2033,10,160,1873,1,9,161,1882,3,2,0,19
Desha,9/24/20,5,41,41,288,3554,260,3841,23,11887,286,2,3526,28,258,2,5,0,23,0,3812,29,286,3526,1,28,287,3554,4,1,0,37
Drew,9/24/20,6,43,43,353,5182,334,5538,13,18502,341,12,5139,43,324,10,5,1,12,1,5480,58,341,5139,15,43,356,5182,3,2,0,46
Faulkner,9/24/20,19,45,45,2391,34697,2034,37098,338,122416,2301,90,34005,692,1964,70,16,3,321,17,36306,792,2301,34005,100,692,2401,34697,28,29,0,370
Franklin,9/24/20,2,47,47,267,5442,218,5709,47,17780,263,4,5433,9,215,3,2,0,46,1,5696,13,263,5433,4,9,267,5442,6,2,0,133
Fulton,9/24/20,3,49,49,139,1157,101,1297,35,12139,128,11,1156,1,97,4,2,1,29,6,1284,13,128,1156,12,1,140,1157,5,1,0,30
Garland,9/24/20,50,51,51,1827,27516,1604,29340,173,98296,1805,22,27437,79,1591,13,45,5,169,4,29242,98,1805,27437,19,79,1824,27516,29,10,1,807
Grant,9/24/20,2,53,53,255,4640,221,4901,32,18086,246,9,4592,48,212,9,2,0,32,0,4838,63,246,4592,15,48,261,4640,3,0,0,168
Greene,9/24/20,9,55,55,836,12594,742,13430,85,44623,811,25,12499,95,723,19,9,0,79,6,13310,120,811,12499,25,95,836,12594,13,14,1,169
Hempstead,9/24/20,4,57,57,362,4037,346,4399,12,22018,353,9,4015,22,340,6,4,0,9,3,4368,31,353,4015,9,22,362,4037,3,2,0,32
HotSpring,9/24/20,26,59,59,1875,11714,1784,13588,65,33520,1868,7,11678,36,1780,4,24,2,64,1,13546,42,1868,11678,6,36,1874,11714,12,6,0,374
Howard,9/24/20,9,61,61,465,3485,440,3951,16,13389,455,10,3475,10,434,6,9,0,12,4,3930,21,455,3475,11,10,466,3485,2,0,1,21
Independence,9/24/20,17,63,63,1064,10402,949,11471,98,37264,975,89,10357,45,875,74,16,1,84,14,11332,139,975,10357,94,45,1069,10402,13,19,0,98
Izard,9/24/20,0,65,65,223,3219,138,3450,85,13559,214,9,3207,12,131,7,0,0,83,2,3421,29,214,3207,17,12,231,3219,21,1,0,57
Jackson,9/24/20,1,67,67,313,5782,272,6111,40,17225,273,40,5771,11,236,36,1,0,36,4,6044,67,273,5771,56,11,329,5782,11,6,0,23
Jefferson,9/24/20,65,69,69,3074,27541,2482,30620,527,70424,3027,47,27378,163,2451,31,58,7,518,9,30405,215,3027,27378,52,163,3079,27541,75,42,1,527
Johnson,9/24/20,5,71,71,834,6669,800,7507,29,26291,831,3,6644,25,799,1,5,0,27,2,7475,32,831,6644,7,25,838,6669,5,0,0,26
Lafayette,9/24/20,2,73,73,102,920,83,1024,17,6915,98,4,918,2,82,1,2,0,14,3,1016,8,98,918,6,2,104,920,4,0,0,14
Lawrence,9/24/20,12,75,75,410,3965,320,4376,78,16669,375,35,3954,11,291,29,12,0,72,6,4329,47,375,3954,36,11,411,3965,19,4,0,117
Lee,9/24/20,18,77,77,1053,3733,1022,4786,13,9398,1050,3,3728,5,1020,2,17,1,13,0,4778,8,1050,3728,3,5,1053,3733,1,2,0,11
Lincoln,9/24/20,15,79,79,1948,6472,1773,8428,160,13695,1943,5,6457,15,1772,1,14,1,157,3,8400,28,1943,6457,13,15,1956,6472,5,6,0,85
LittleRiver,9/24/20,25,81,81,353,1702,317,2047,11,12417,338,15,1686,16,307,10,20,5,11,0,2024,23,338,1686,7,16,345,1702,1,3,0,23
Logan,9/24/20,1,83,83,401,6178,382,6580,18,21757,400,1,6170,8,381,1,1,0,18,0,6570,10,400,6170,2,8,402,6178,3,2,0,79
Lonoke,9/24/20,11,85,85,1121,17767,962,18931,148,72206,992,129,16842,925,856,106,9,2,127,21,17834,1097,992,16842,172,925,1164,17767,19,11,0,266
Madison,9/24/20,2,87,87,340,3746,322,4088,16,16076,330,10,3732,14,314,8,2,0,14,2,4062,26,330,3732,12,14,342,3746,3,0,0,-70
Marion,9/24/20,0,89,89,85,2203,65,2290,20,16438,82,3,2196,7,62,3,0,0,20,0,2278,12,82,2196,5,7,87,2203,2,0,0,27
Miller,9/24/20,11,91,91,810,6140,739,6947,60,43759,774,36,6091,49,707,32,10,1,57,3,6865,82,774,6091,33,49,807,6140,13,11,0,40
MissingCountyInfo,9/24/20,0,5,5,1778,31284,1131,33052,647,NA,1662,116,30024,1260,1041,90,0,0,621,26,31686,1366,1662,30024,106,1260,1768,31284,154,72,0,1904
Mississippi,9/24/20,50,93,93,1648,11096,1495,12731,103,42831,1620,28,11086,10,1483,12,39,11,98,5,12706,25,1620,11086,15,10,1635,11096,12,19,0,78
Monroe,9/24/20,0,95,95,124,2095,105,2219,19,7249,123,1,2083,12,105,0,0,0,18,1,2206,13,123,2083,1,12,124,2095,3,2,0,10
Montgomery,9/24/20,4,97,97,142,2092,120,2234,18,8993,141,1,2076,16,119,1,4,0,18,0,2217,17,141,2076,1,16,142,2092,3,2,0,57
Nevada,9/24/20,13,99,99,216,2780,172,2990,31,8440,209,7,2770,10,169,3,12,1,28,3,2979,11,209,2770,1,10,210,2780,2,3,0,30
Newton,9/24/20,18,101,101,228,1656,173,1879,37,7848,217,11,1655,1,167,6,15,3,35,2,1872,7,217,1655,6,1,223,1656,2,3,0,28
Ouachita,9/24/20,6,103,103,254,5110,215,5369,33,24106,248,6,5086,24,211,4,6,0,31,2,5334,35,248,5086,11,24,259,5110,2,5,0,81
Perry,9/24/20,0,105,105,86,2923,73,3009,13,10322,82,4,2863,60,69,4,0,0,13,0,2945,64,82,2863,4,60,86,2923,1,0,0,39
Phillips,9/24/20,11,107,107,472,6037,427,6511,34,19034,470,2,6009,28,425,2,11,0,34,0,6479,32,470,6009,4,28,474,6037,2,1,0,57
Pike,9/24/20,3,109,109,225,2091,214,2315,8,10808,223,2,2071,20,213,1,2,1,8,0,2294,21,223,2071,1,20,224,2091,2,1,0,57
Poinsett,9/24/20,11,111,111,637,7073,565,7706,61,24054,626,11,7064,9,556,9,10,1,60,1,7690,16,626,7064,7,9,633,7073,5,3,0,57
Polk,9/24/20,4,113,113,257,3681,246,3939,7,20163,256,1,3677,4,245,1,4,0,7,0,3933,6,256,3677,2,4,258,3681,4,0,0,33
Pope,9/24/20,30,115,115,2079,19311,1930,21385,119,63644,2066,13,19188,123,1923,7,25,5,118,1,21254,131,2066,19188,8,123,2074,19311,25,8,0,216
Prairie,9/24/20,1,117,117,146,1898,132,2046,13,8244,141,5,1866,32,127,5,1,0,13,0,2007,39,141,1866,7,32,148,1898,4,1,0,16
Pulaski,9/24/20,146,119,119,8981,120680,8094,129717,741,393463,8719,262,119048,1632,7875,219,133,13,711,30,127767,1950,8719,119048,318,1632,9037,120680,100,56,3,1268
Randolph,9/24/20,22,121,121,409,4431,333,4841,54,17603,376,33,4399,32,318,15,18,4,40,14,4775,66,376,4399,34,32,410,4431,14,6,0,66
Saline,9/24/20,23,125,125,2020,26828,1857,28856,139,118009,1942,78,26453,375,1792,65,21,2,128,11,28395,461,1942,26453,86,375,2028,26828,13,13,0,281
Scott,9/24/20,1,127,127,97,2201,93,2298,3,10442,97,0,2201,0,93,0,1,0,3,0,2298,0,97,2201,0,0,97,2201,0,0,0,27
Searcy,9/24/20,1,129,129,141,1776,136,1915,4,7923,137,4,1759,17,132,4,1,0,4,0,1896,19,137,1759,2,17,139,1776,0,1,0,20
Sebastian,9/24/20,59,131,131,3590,39871,3229,43457,301,127461,3549,41,39859,12,3204,25,48,11,296,5,43408,49,3549,39859,37,12,3586,39871,47,41,1,280
Sevier,9/24/20,16,133,133,1199,6501,1173,7698,10,17193,1189,10,6446,55,1165,8,16,0,8,2,7635,63,1189,6446,8,55,1197,6501,3,1,0,78
Sharp,9/24/20,6,135,135,214,3609,168,3820,40,17043,202,12,3602,7,165,3,6,0,31,9,3804,16,202,3602,9,7,211,3609,6,3,0,58
St.Francis,9/24/20,6,123,123,1492,11790,1395,13284,91,26294,1492,0,11782,8,1395,0,6,0,91,0,13274,10,1492,11782,2,8,1494,11790,1,9,0,32
Stone,9/24/20,7,137,137,335,3147,269,3485,59,12446,329,6,3136,11,263,6,7,0,59,0,3465,20,329,3136,9,11,338,3147,13,5,0,78
Union,9/24/20,32,139,139,874,7951,808,8823,33,39732,854,20,7918,33,798,10,27,5,28,5,8772,51,854,7918,18,33,872,7951,16,10,0,36
VanBuren,9/24/20,3,141,141,173,3743,160,3922,10,16684,171,2,3687,56,158,2,3,0,10,0,3858,64,171,3687,8,56,179,3743,1,0,1,111
Washington,9/24/20,112,143,143,9250,70196,8651,79480,487,228529,8731,519,69437,759,8210,441,96,16,425,62,78168,1312,8731,69437,553,759,9284,70196,72,112,3,546
White,9/24/20,21,145,145,795,13755,675,14559,99,78804,723,72,13398,357,621,54,17,4,85,14,14121,438,723,13398,81,357,804,13755,27,13,0,221
Woodruff,9/24/20,0,147,147,49,1563,42,1613,7,6660,43,6,1555,8,38,4,0,0,5,2,1598,15,43,1555,7,8,50,1563,1,1,0,12
Yell,9/24/20,29,149,149,1247,9192,1186,10436,32,21573,1239,8,9149,43,1182,4,26,3,31,1,10388,48,1239,9149,5,43,1244,9192,7,2,0,170
Arkansas_all_counties,9/23/20,1229,5630,5630,77963,838248,69952,916400,6777,2990671,75646,2317,831301,6947,68178,1774,1080,149,6383,394,906947,9453,75646,831301,2506,6947,78152,838248,982,768,20,7965
Arkansas_county,9/23/20,5,1,1,371,5364,318,5741,48,18124,353,18,5148,216,305,13,5,0,43,5,5501,240,353,5148,24,216,377,5364,8,3,1,94
Ashley,9/23/20,9,3,3,428,4738,396,5168,23,20537,423,5,4717,21,393,3,9,0,21,2,5140,28,423,4717,7,21,430,4738,3,1,0,37
Baxter,9/23/20,2,5,5,302,3800,236,4104,64,41219,274,28,3785,15,211,25,2,0,61,3,4059,45,274,3785,30,15,304,3800,12,10,1,50
Benton,9/23/20,82,7,7,6399,67523,5908,73939,409,258980,6235,164,67211,312,5792,116,65,17,378,31,73446,493,6235,67211,181,312,6416,67523,64,41,0,542
Boone,9/23/20,10,9,9,664,9116,509,9779,145,37288,631,33,9101,15,492,17,8,2,131,14,9732,47,631,9101,32,15,663,9116,8,11,1,313
Bradley,9/23/20,8,11,11,340,3383,315,3722,17,10948,338,2,3380,3,314,1,7,1,17,0,3718,4,338,3380,1,3,339,3383,4,2,0,19
Calhoun,9/23/20,0,13,13,34,1456,30,1490,4,5202,33,1,1450,6,29,1,0,0,4,0,1483,7,33,1450,1,6,34,1456,0,1,0,9
Carroll,9/23/20,9,15,15,630,6689,558,7321,63,27887,624,6,6685,4,553,5,9,0,62,1,7309,12,624,6685,8,4,632,6689,2,10,0,51
Chicot,9/23/20,19,17,17,1001,4590,969,5591,13,10826,992,9,4577,13,961,8,18,1,13,0,5569,22,992,4577,9,13,1001,4590,3,-1,1,13
Clark,9/23/20,4,19,19,322,5651,281,5972,37,22385,310,12,5622,29,273,8,4,0,33,4,5932,40,310,5622,11,29,321,5651,6,2,0,51
Clay,9/23/20,7,21,21,277,3791,230,4068,39,15061,270,7,3785,6,226,4,5,2,38,1,4055,13,270,3785,7,6,277,3791,10,3,0,63
Cleburne,9/23/20,8,23,23,315,5603,291,5919,16,25230,302,13,5515,88,279,12,8,0,15,1,5817,102,302,5515,14,88,316,5603,-1,1,0,141
Cleveland,9/23/20,10,25,25,179,2450,151,2629,18,8226,176,3,2424,26,149,2,9,1,18,0,2600,29,176,2424,3,26,179,2450,0,1,0,14
Columbia,9/23/20,18,27,27,399,4076,336,4487,45,23892,380,19,4046,30,325,11,18,0,37,8,4426,61,380,4046,31,30,411,4076,6,7,0,39
Conway,9/23/20,3,29,29,255,5781,228,6037,24,20906,251,4,5716,65,224,4,3,0,24,0,5967,70,251,5716,5,65,256,5781,3,1,0,90
Craighead,9/23/20,21,31,31,2759,29503,2375,32268,362,105701,2697,62,29455,48,2323,52,18,3,355,7,32152,116,2697,29455,68,48,2765,29503,83,49,0,344
Crawford,9/23/20,15,33,33,1303,17493,1112,18789,176,62472,1274,29,17485,8,1087,25,12,3,175,1,18759,30,1274,17485,22,8,1296,17493,13,17,0,170
Crittenden,9/23/20,45,35,35,1903,12915,1786,14807,72,49013,1883,20,12911,4,1778,8,38,7,67,5,14794,13,1883,12911,9,4,1892,12915,8,11,0,71
Cross,9/23/20,8,37,37,422,4254,370,4669,44,16998,410,12,4236,18,363,7,6,2,41,3,4646,23,410,4236,5,18,415,4254,4,6,0,26
Dallas,9/23/20,3,39,39,158,1866,143,2024,12,7432,157,1,1857,9,142,1,3,0,12,0,2014,10,157,1857,1,9,158,1866,1,1,1,15
Desha,9/23/20,5,41,41,284,3521,259,3804,20,11887,282,2,3497,24,257,2,5,0,20,0,3779,25,282,3497,1,24,283,3521,3,2,0,25
Drew,9/23/20,6,43,43,350,5139,332,5492,12,18502,339,11,5096,43,322,10,5,1,12,0,5435,57,339,5096,14,43,353,5139,0,3,0,26
Faulkner,9/23/20,19,45,45,2363,34355,2005,36728,339,122416,2274,89,33686,669,1934,71,16,3,324,15,35960,768,2274,33686,99,669,2373,34355,55,34,0,385
Franklin,9/23/20,2,47,47,261,5315,216,5576,43,17780,257,4,5306,9,213,3,2,0,42,1,5563,13,257,5306,4,9,261,5315,10,3,0,59
Fulton,9/23/20,3,49,49,134,1132,100,1267,31,12139,124,10,1131,1,97,3,2,1,25,6,1255,12,124,1131,11,1,135,1132,6,2,0,23
Garland,9/23/20,49,51,51,1798,26738,1594,28533,155,98296,1776,22,26659,79,1581,13,44,5,151,4,28435,98,1776,26659,19,79,1795,26738,27,12,0,402
Grant,9/23/20,2,53,53,252,4475,221,4733,29,18086,243,9,4428,47,212,9,2,0,29,0,4671,62,243,4428,15,47,258,4475,2,1,0,42
Greene,9/23/20,8,55,55,823,12438,728,13262,87,44623,801,22,12343,95,711,17,8,0,82,5,13144,118,801,12343,23,95,824,12438,18,8,0,158
Hempstead,9/23/20,4,57,57,359,4008,344,4368,11,22018,351,8,3986,22,339,5,4,0,8,3,4337,31,351,3986,9,22,360,4008,0,1,0,13
HotSpring,9/23/20,26,59,59,1863,11352,1778,13214,59,33520,1856,7,11316,36,1775,3,24,2,57,2,13172,42,1856,11316,6,36,1862,11352,14,8,0,340
Howard,9/23/20,8,61,61,463,3466,440,3930,15,13389,453,10,3456,10,434,6,8,0,11,4,3909,21,453,3456,11,10,464,3466,5,3,0,14
Independence,9/23/20,17,63,63,1051,10317,930,11373,104,37264,962,89,10272,45,862,68,16,1,84,20,11234,139,962,10272,94,45,1056,10317,16,18,1,89
Izard,9/23/20,0,65,65,202,3183,137,3393,65,13559,194,8,3171,12,130,7,0,0,64,1,3365,28,194,3171,16,12,210,3183,5,4,0,32
Jackson,9/23/20,1,67,67,302,5770,266,6088,35,17225,263,39,5759,11,231,35,1,0,31,4,6022,66,263,5759,55,11,318,5770,9,9,0,30
Jefferson,9/23/20,64,69,69,2999,27089,2440,30092,495,70424,2954,45,26927,162,2411,29,57,7,486,9,29881,211,2954,26927,49,162,3003,27089,54,54,1,341
Johnson,9/23/20,5,71,71,829,6648,800,7481,24,26291,826,3,6622,26,799,1,5,0,22,2,7448,33,826,6622,7,26,833,6648,7,2,0,63
Lafayette,9/23/20,2,73,73,98,910,83,1010,13,6915,95,3,908,2,83,0,2,0,10,3,1003,7,95,908,5,2,100,910,5,4,0,8
Lawrence,9/23/20,12,75,75,391,3867,316,4260,63,16669,356,35,3856,11,287,29,12,0,57,6,4212,48,356,3856,37,11,393,3867,12,8,0,80
Lee,9/23/20,18,77,77,1052,3723,1020,4775,14,9398,1049,3,3718,5,1018,2,17,1,14,0,4767,8,1049,3718,3,5,1052,3723,2,5,0,51
Lincoln,9/23/20,15,79,79,1943,6392,1767,8343,161,13695,1940,3,6377,15,1766,1,14,1,160,1,8317,26,1940,6377,11,15,1951,6392,2,5,0,24
LittleRiver,9/23/20,25,81,81,352,1680,314,2024,13,12417,337,15,1664,16,304,10,20,5,13,0,2001,23,337,1664,7,16,344,1680,1,0,0,24
Logan,9/23/20,1,83,83,398,6102,380,6501,17,21757,397,1,6094,8,379,1,1,0,17,0,6491,10,397,6094,2,8,399,6102,4,0,0,39
Lonoke,9/23/20,11,85,85,1102,17520,951,18665,140,72206,974,128,16600,920,847,104,9,2,118,22,17574,1091,974,16600,171,920,1145,17520,50,7,0,482
Madison,9/23/20,2,87,87,337,3819,322,4158,13,16076,327,10,3805,14,314,8,2,0,11,2,4132,26,327,3805,12,14,339,3819,4,3,0,32
Marion,9/23/20,0,89,89,83,2178,65,2263,18,16438,80,3,2171,7,62,3,0,0,18,0,2251,12,80,2171,5,7,85,2178,2,3,0,30
Miller,9/23/20,11,91,91,797,6113,728,6906,58,43759,763,34,6064,49,698,30,10,1,55,3,6827,79,763,6064,30,49,793,6113,11,8,0,26
MissingCountyInfo,9/23/20,0,5,5,1624,29534,1059,31148,565,NA,1516,108,29533,1,969,90,0,0,547,18,31049,99,1516,29533,98,1,1614,29534,32,39,0,-1599
Mississippi,9/23/20,50,93,93,1636,11030,1476,12653,110,42831,1608,28,11020,10,1464,12,39,11,105,5,12628,25,1608,11020,15,10,1623,11030,17,15,0,115
Monroe,9/23/20,0,95,95,121,2088,103,2209,18,7249,121,0,2076,12,103,0,0,0,18,0,2197,12,121,2076,0,12,121,2088,2,1,0,13
Montgomery,9/23/20,4,97,97,139,2038,118,2177,17,8993,138,1,2022,16,117,1,4,0,17,0,2160,17,138,2022,1,16,139,2038,0,1,0,5
Nevada,9/23/20,13,99,99,214,2752,169,2960,32,8440,207,7,2742,10,166,3,12,1,29,3,2949,11,207,2742,1,10,208,2752,3,1,0,44
Newton,9/23/20,18,101,101,226,1630,170,1851,38,7848,215,11,1629,1,164,6,15,3,36,2,1844,7,215,1629,6,1,221,1630,4,3,0,23
Ouachita,9/23/20,6,103,103,252,5031,210,5288,36,24106,246,6,5007,24,206,4,6,0,34,2,5253,35,246,5007,11,24,257,5031,6,8,0,59
Perry,9/23/20,0,105,105,85,2885,73,2970,12,10322,81,4,2826,59,69,4,0,0,12,0,2907,63,81,2826,4,59,85,2885,1,0,0,156
Phillips,9/23/20,11,107,107,470,5982,426,6454,33,19034,468,2,5954,28,424,2,11,0,33,0,6422,32,468,5954,4,28,472,5982,5,3,0,133
Pike,9/23/20,3,109,109,223,2036,213,2258,7,10808,221,2,2017,19,212,1,2,1,7,0,2238,20,221,2017,1,19,222,2036,0,6,0,13
Poinsett,9/23/20,11,111,111,632,7021,562,7649,59,24054,621,11,7012,9,553,9,10,1,58,1,7633,16,621,7012,7,9,628,7021,10,5,1,81
Polk,9/23/20,4,113,113,253,3652,246,3906,3,20163,252,1,3648,4,245,1,4,0,3,0,3900,6,252,3648,2,4,254,3652,1,1,0,30
Pope,9/23/20,30,115,115,2054,19120,1922,21169,102,63644,2041,13,18994,126,1915,7,25,5,101,1,21035,134,2041,18994,8,126,2049,19120,18,9,0,183
Prairie,9/23/20,1,117,117,142,1886,131,2030,10,8244,137,5,1854,32,126,5,1,0,10,0,1991,39,137,1854,7,32,144,1886,4,2,0,33
Pulaski,9/23/20,143,119,119,8881,119512,8038,128448,700,393463,8621,260,117891,1621,7823,215,130,13,668,32,126512,1936,8621,117891,315,1621,8936,119512,77,86,6,1390
Randolph,9/23/20,22,121,121,395,4379,327,4774,46,17603,366,29,4347,32,315,12,18,4,33,13,4713,61,366,4347,29,32,395,4379,5,4,0,31
Saline,9/23/20,23,125,125,2007,26560,1844,28575,139,118009,1929,78,26190,370,1777,67,21,2,130,9,28119,456,1929,26190,86,370,2015,26560,39,27,0,294
Scott,9/23/20,1,127,127,97,2174,93,2271,3,10442,97,0,2174,0,93,0,1,0,3,0,2271,0,97,2174,0,0,97,2174,1,1,0,134
Searcy,9/23/20,1,129,129,141,1756,135,1895,5,7923,137,4,1738,18,131,4,1,0,5,0,1875,20,137,1738,2,18,139,1756,0,1,1,18
Sebastian,9/23/20,58,131,131,3543,39638,3188,43175,296,127461,3501,42,39626,12,3164,24,47,11,289,7,43127,48,3501,39626,36,12,3537,39638,51,25,1,595
Sevier,9/23/20,16,133,133,1196,6426,1172,7620,8,17193,1187,9,6371,55,1164,8,16,0,7,1,7558,62,1187,6371,7,55,1194,6426,2,2,0,49
Sharp,9/23/20,6,135,135,208,3557,165,3763,37,17043,197,11,3550,7,162,3,6,0,29,8,3747,16,197,3550,9,7,206,3557,6,4,0,35
St.Francis,9/23/20,6,123,123,1491,11759,1386,13252,99,26294,1491,0,11751,8,1386,0,6,0,99,0,13242,10,1491,11751,2,8,1493,11759,13,0,1,61
Stone,9/23/20,7,137,137,322,3082,264,3406,51,12446,316,6,3072,10,258,6,7,0,51,0,3388,18,316,3072,8,10,324,3082,5,4,0,48
Union,9/23/20,32,139,139,858,7931,798,8787,27,39732,838,20,7898,33,789,9,27,5,21,6,8736,51,838,7898,18,33,856,7931,9,8,1,28
VanBuren,9/23/20,2,141,141,172,3633,160,3811,10,16684,170,2,3573,60,158,2,2,0,10,0,3743,68,170,3573,8,60,178,3633,3,3,0,67
Washington,9/23/20,109,143,143,9178,69722,8539,78931,530,228529,8665,513,69034,688,8113,426,93,16,459,71,77699,1232,8665,69034,544,688,9209,69722,75,98,1,553
White,9/23/20,21,145,145,768,13561,662,14340,85,78804,699,69,13206,355,610,52,17,4,72,13,13905,435,699,13206,80,355,779,13561,24,16,1,300
Woodruff,9/23/20,0,147,147,48,1552,41,1601,7,6660,42,6,1544,8,37,4,0,0,5,2,1586,15,42,1544,7,8,49,1552,2,5,0,14
Yell,9/23/20,29,149,149,1240,9029,1184,10266,27,21573,1232,8,8984,45,1180,4,26,3,26,1,10216,50,1232,8984,5,45,1237,9029,6,6,0,69
Arkansas_all_counties,9/22/20,1209,5630,5630,76981,831265,69184,908424,6583,2990671,74772,2209,823225,8040,67519,1665,1060,149,6188,395,897997,10427,74772,823225,2387,8040,77159,831265,617,728,12,6785
Arkansas_county,9/22/20,4,1,1,363,5278,315,5647,44,18124,347,16,5058,220,303,12,4,0,40,4,5405,242,347,5058,22,220,369,5278,4,4,0,43
Ashley,9/22/20,9,3,3,425,4704,395,5131,21,20537,421,4,4683,21,392,3,9,0,20,1,5104,27,421,4683,6,21,427,4704,0,1,0,2
Baxter,9/22/20,1,5,5,290,3762,226,4054,63,41219,263,27,3747,15,201,25,1,0,61,2,4010,44,263,3747,29,15,292,3762,5,14,0,44
Benton,9/22/20,82,7,7,6335,67045,5867,73391,386,258980,6175,160,66793,252,5758,109,65,17,352,34,72968,423,6175,66793,171,252,6346,67045,67,32,2,310
Boone,9/22/20,9,9,9,656,8811,498,9465,149,37288,623,33,8796,15,482,16,7,2,134,15,9419,46,623,8796,31,15,654,8811,19,15,0,46
Bradley,9/22/20,8,11,11,336,3368,313,3703,15,10948,334,2,3365,3,313,0,7,1,14,1,3699,4,334,3365,1,3,335,3368,0,0,0,6
Calhoun,9/22/20,0,13,13,34,1447,29,1481,5,5202,33,1,1442,5,28,1,0,0,5,0,1475,6,33,1442,1,5,34,1447,0,1,0,2
Carroll,9/22/20,9,15,15,628,6640,548,7268,71,27887,622,6,6636,4,544,4,9,0,69,2,7258,10,622,6636,6,4,628,6640,3,5,0,38
Chicot,9/22/20,18,17,17,998,4580,970,5578,10,10826,989,9,4569,11,962,8,17,1,10,0,5558,20,989,4569,9,11,998,4580,3,4,1,13
Clark,9/22/20,4,19,19,316,5606,279,5921,33,22385,304,12,5577,29,271,8,4,0,29,4,5881,40,304,5577,11,29,315,5606,2,1,0,29
Clay,9/22/20,7,21,21,267,3738,227,4005,32,15061,260,7,3732,6,223,4,5,2,31,1,3992,13,260,3732,7,6,267,3738,3,5,0,15
Cleburne,9/22/20,8,23,23,316,5461,290,5778,18,25230,303,13,5371,90,278,12,8,0,17,1,5674,104,303,5371,14,90,317,5461,2,4,0,32
Cleveland,9/22/20,10,25,25,179,2436,150,2615,19,8226,176,3,2410,26,148,2,9,1,19,0,2586,29,176,2410,3,26,179,2436,0,4,0,9
Columbia,9/22/20,18,27,27,393,4043,329,4447,46,23892,374,19,4013,30,319,10,18,0,37,9,4387,60,374,4013,30,30,404,4043,10,2,0,18
Conway,9/22/20,3,29,29,252,5694,227,5947,22,20906,248,4,5625,69,223,4,3,0,22,0,5873,74,248,5625,5,69,253,5694,4,1,0,33
Craighead,9/22/20,21,31,31,2676,29242,2326,31924,328,105701,2614,62,29194,48,2275,51,18,3,320,8,31808,116,2614,29194,68,48,2682,29242,36,39,0,195
Crawford,9/22/20,15,33,33,1290,17336,1095,18620,180,62472,1263,27,17328,8,1072,23,12,3,179,1,18591,29,1263,17328,21,8,1284,17336,19,26,0,149
Crittenden,9/22/20,45,35,35,1895,12852,1775,14737,75,49013,1877,18,12848,4,1767,8,38,7,72,3,14725,12,1877,12848,8,4,1885,12852,8,4,0,30
Cross,9/22/20,8,37,37,418,4232,364,4643,46,16998,406,12,4214,18,357,7,6,2,43,3,4620,23,406,4214,5,18,411,4232,3,16,0,24
Dallas,9/22/20,2,39,39,157,1852,142,2009,13,7432,156,1,1843,9,141,1,2,0,13,0,1999,10,156,1843,1,9,157,1852,1,1,0,7
Desha,9/22/20,5,41,41,281,3499,257,3779,19,11887,279,2,3475,24,255,2,5,0,19,0,3754,25,279,3475,1,24,280,3499,1,0,0,20
Drew,9/22/20,6,43,43,350,5113,329,5466,15,18502,339,11,5070,43,319,10,5,1,15,0,5409,57,339,5070,14,43,353,5113,0,1,0,4
Faulkner,9/22/20,19,45,45,2308,34025,1971,36343,318,122416,2222,86,33368,657,1902,69,16,3,304,14,35590,753,2222,33368,96,657,2318,34025,31,27,0,243
Franklin,9/22/20,2,47,47,251,5266,213,5517,36,17780,248,3,5258,8,210,3,2,0,36,0,5506,11,248,5258,3,8,251,5266,3,4,0,24
Fulton,9/22/20,3,49,49,128,1115,98,1244,27,12139,119,9,1114,1,96,2,2,1,21,6,1233,11,119,1114,10,1,129,1115,1,3,0,7
Garland,9/22/20,49,51,51,1771,26363,1582,28132,140,98296,1751,20,26285,78,1570,12,44,5,137,3,28036,96,1751,26285,18,78,1769,26363,21,12,0,408
Grant,9/22/20,2,53,53,250,4435,220,4690,28,18086,241,9,4391,44,211,9,2,0,28,0,4632,58,241,4391,14,44,255,4435,1,0,0,15
Greene,9/22/20,8,55,55,805,12298,720,13104,77,44623,786,19,12203,95,706,14,8,0,72,5,12989,115,786,12203,20,95,806,12298,10,15,1,58
Hempstead,9/22/20,4,57,57,359,3995,343,4355,12,22018,351,8,3973,22,338,5,4,0,9,3,4324,31,351,3973,9,22,360,3995,1,1,0,12
HotSpring,9/22/20,26,59,59,1849,11026,1770,12874,53,33520,1843,6,10991,35,1767,3,24,2,52,1,12834,40,1843,10991,5,35,1848,11026,2,10,0,102
Howard,9/22/20,8,61,61,458,3457,437,3916,13,13389,450,8,3448,9,432,5,8,0,10,3,3898,18,450,3448,9,9,459,3457,2,2,0,4
Independence,9/22/20,16,63,63,1035,10244,912,11283,107,37264,954,81,10199,45,851,61,15,1,88,19,11153,130,954,10199,85,45,1039,10244,5,22,2,40
Izard,9/22/20,0,65,65,197,3156,133,3361,64,13559,189,8,3144,12,126,7,0,0,63,1,3333,28,189,3144,16,12,205,3156,3,3,0,9
Jackson,9/22/20,1,67,67,293,5749,257,6057,35,17225,255,38,5738,11,228,29,1,0,26,9,5993,64,255,5738,53,11,308,5749,3,17,0,20
Jefferson,9/22/20,63,69,69,2945,26802,2386,29751,496,70424,2900,45,26644,158,2357,29,56,7,487,9,29544,207,2900,26644,49,158,2949,26802,17,26,0,198
Johnson,9/22/20,5,71,71,822,6592,798,7418,19,26291,821,1,6567,25,797,1,5,0,19,0,7388,30,821,6567,5,25,826,6592,3,2,0,27
Lafayette,9/22/20,2,73,73,93,907,79,1001,12,6915,93,0,905,2,79,0,2,0,12,0,998,3,93,905,1,2,94,907,1,0,0,1
Lawrence,9/22/20,12,75,75,379,3799,308,4180,59,16669,344,35,3788,11,283,25,12,0,49,10,4132,48,344,3788,37,11,381,3799,5,12,1,26
Lee,9/22/20,18,77,77,1050,3674,1015,4724,17,9398,1048,2,3669,5,1014,1,17,1,17,0,4717,7,1048,3669,2,5,1050,3674,0,1,0,7
Lincoln,9/22/20,15,79,79,1941,6370,1762,8319,164,13695,1938,3,6355,15,1761,1,14,1,163,1,8293,26,1938,6355,11,15,1949,6370,0,3,0,9
LittleRiver,9/22/20,25,81,81,351,1657,314,2000,12,12417,336,15,1641,16,304,10,20,5,12,0,1977,23,336,1641,7,16,343,1657,6,7,0,10
Logan,9/22/20,1,83,83,394,6067,380,6462,13,21757,393,1,6059,8,379,1,1,0,13,0,6452,10,393,6059,2,8,395,6067,1,2,0,32
Lonoke,9/22/20,11,85,85,1052,17088,944,18182,97,72206,931,121,16184,904,843,101,9,2,79,18,17115,1067,931,16184,163,904,1094,17088,10,11,0,113
Madison,9/22/20,2,87,87,333,3791,319,4126,12,16076,324,9,3777,14,311,8,2,0,11,1,4101,25,324,3777,11,14,335,3791,1,3,0,10
Marion,9/22/20,0,89,89,81,2150,62,2233,19,16438,78,3,2143,7,59,3,0,0,19,0,2221,12,78,2143,5,7,83,2150,5,2,0,24
Miller,9/22/20,11,91,91,786,6098,720,6880,55,43759,752,34,6050,48,690,30,10,1,52,3,6802,78,752,6050,30,48,782,6098,12,4,0,31
MissingCountyInfo,9/22/20,0,5,5,1592,31165,1020,32747,572,NA,1491,101,29896,1269,936,84,0,0,555,17,31387,1360,1491,29896,91,1269,1582,31165,-94,1,0,1009
Mississippi,9/22/20,50,93,93,1619,10932,1461,12539,108,42831,1594,25,10923,9,1450,11,39,11,105,3,12517,22,1594,10923,13,9,1607,10932,23,5,0,62
Monroe,9/22/20,0,95,95,119,2077,102,2196,17,7249,119,0,2063,14,102,0,0,0,17,0,2182,14,119,2063,0,14,119,2077,0,0,0,10
Montgomery,9/22/20,4,97,97,139,2033,117,2172,18,8993,138,1,2017,16,116,1,4,0,18,0,2155,17,138,2017,1,16,139,2033,0,0,0,14
Nevada,9/22/20,13,99,99,211,2711,168,2918,30,8440,206,5,2702,9,165,3,12,1,29,1,2908,10,206,2702,1,9,207,2711,2,3,0,10
Newton,9/22/20,18,101,101,222,1611,167,1829,37,7848,213,9,1610,1,162,5,15,3,36,1,1823,6,213,1610,5,1,218,1611,5,9,0,13
Ouachita,9/22/20,6,103,103,246,4978,202,5229,38,24106,240,6,4954,24,198,4,6,0,36,2,5194,35,240,4954,11,24,251,4978,-1,4,0,18
Perry,9/22/20,0,105,105,84,2730,73,2814,11,10322,80,4,2671,59,69,4,0,0,11,0,2751,63,80,2671,4,59,84,2730,1,0,0,9
Phillips,9/22/20,11,107,107,465,5854,423,6321,31,19034,463,2,5826,28,421,2,11,0,31,0,6289,32,463,5826,4,28,467,5854,5,3,0,13
Pike,9/22/20,3,109,109,223,2023,207,2245,13,10808,221,2,2004,19,206,1,2,1,13,0,2225,20,221,2004,1,19,222,2023,2,2,0,23
Poinsett,9/22/20,10,111,111,622,6950,557,7568,55,24054,611,11,6941,9,548,9,9,1,54,1,7552,16,611,6941,7,9,618,6950,7,11,1,50
Polk,9/22/20,4,113,113,252,3623,245,3876,3,20163,251,1,3619,4,244,1,4,0,3,0,3870,6,251,3619,2,4,253,3623,1,4,0,6
Pope,9/22/20,30,115,115,2036,18955,1913,20986,93,63644,2024,12,18835,120,1906,7,25,5,93,0,20859,127,2024,18835,7,120,2031,18955,8,6,0,61
Prairie,9/22/20,1,117,117,138,1857,129,1997,8,8244,133,5,1825,32,124,5,1,0,8,0,1958,39,133,1825,7,32,140,1857,1,0,0,13
Pulaski,9/22/20,137,119,119,8804,118199,7952,127056,715,393463,8551,253,116605,1594,7745,207,124,13,682,33,125156,1900,8551,116605,306,1594,8857,118199,134,80,0,1631
Randolph,9/22/20,22,121,121,390,4353,323,4743,45,17603,363,27,4320,33,314,9,18,4,31,14,4683,60,363,4320,27,33,390,4353,3,7,0,20
Saline,9/22/20,23,125,125,1968,26305,1817,28281,127,118009,1894,74,25938,367,1757,60,21,2,115,12,27832,449,1894,25938,82,367,1976,26305,17,23,2,290
Scott,9/22/20,1,127,127,96,2041,92,2137,3,10442,96,0,2041,0,92,0,1,0,3,0,2137,0,96,2041,0,0,96,2041,1,0,0,10
Searcy,9/22/20,0,129,129,141,1738,134,1877,7,7923,137,4,1721,17,130,4,0,0,7,0,1858,19,137,1721,2,17,139,1738,0,2,0,0
Sebastian,9/22/20,57,131,131,3492,39094,3163,42580,271,127461,3451,41,39083,11,3140,23,46,11,264,7,42534,46,3451,39083,35,11,3486,39094,33,46,1,390
Sevier,9/22/20,16,133,133,1194,6379,1170,7571,8,17193,1185,9,6326,53,1162,8,16,0,7,1,7511,60,1185,6326,7,53,1192,6379,0,1,0,12
Sharp,9/22/20,6,135,135,202,3528,161,3728,35,17043,194,8,3521,7,159,2,6,0,29,6,3715,13,194,3521,6,7,200,3528,4,6,0,15
St.Francis,9/22/20,5,123,123,1478,11711,1386,13191,87,26294,1478,0,11703,8,1386,0,5,0,87,0,13181,10,1478,11703,2,8,1480,11711,4,4,0,31
Stone,9/22/20,7,137,137,317,3039,260,3358,50,12446,311,6,3029,10,254,6,7,0,50,0,3340,18,311,3029,8,10,319,3039,8,2,0,15
Union,9/22/20,31,139,139,849,7912,790,8760,27,39732,831,18,7879,33,782,8,26,5,22,5,8710,50,831,7879,17,33,848,7912,8,4,0,19
VanBuren,9/22/20,2,141,141,169,3569,157,3744,10,16684,169,0,3510,59,157,0,2,0,10,0,3679,65,169,3510,6,59,175,3569,0,4,0,11
Washington,9/22/20,108,143,143,9103,69244,8441,78376,554,228529,8610,493,68596,648,8044,397,92,16,474,80,77206,1170,8610,68596,522,648,9132,69244,97,123,1,267
White,9/22/20,20,145,145,744,13285,646,14040,78,78804,677,67,12929,356,599,47,16,4,62,16,13606,434,677,12929,78,356,755,13285,13,5,0,247
Woodruff,9/22/20,0,147,147,46,1540,36,1587,10,6660,41,5,1532,8,32,4,0,0,9,1,1573,14,41,1532,6,8,47,1540,0,1,0,3
Yell,9/22/20,29,149,149,1234,8966,1178,10197,27,21573,1227,7,8923,43,1174,4,26,3,27,0,10150,47,1227,8923,4,43,1231,8966,1,3,0,14
Arkansas_all_counties,9/21/20,1197,5630,5630,76364,825097,68456,901625,6706,2990671,74286,2078,817238,7859,66934,1522,1048,149,6299,407,891524,10101,74286,817238,2242,7859,76528,825097,641,603,16,12423
Arkansas_county,9/21/20,4,1,1,359,5239,311,5604,44,18124,344,15,5047,192,301,10,4,0,39,5,5391,213,344,5047,21,192,365,5239,5,2,0,280
Ashley,9/21/20,9,3,3,425,4702,394,5129,22,20537,421,4,4681,21,392,2,9,0,20,2,5102,27,421,4681,6,21,427,4702,3,2,0,69
Baxter,9/21/20,1,5,5,285,3723,212,4010,72,41219,261,24,3708,15,191,21,1,0,69,3,3969,41,261,3708,26,15,287,3723,12,18,0,71
Benton,9/21/20,80,7,7,6268,66802,5835,73077,353,258980,6115,153,66550,252,5730,105,63,17,322,31,72665,412,6115,66550,160,252,6275,66802,42,32,1,911
Boone,9/21/20,9,9,9,637,8784,483,9419,145,37288,611,26,8769,15,470,13,7,2,134,11,9380,39,611,8769,24,15,635,8784,11,21,1,255
Bradley,9/21/20,8,11,11,336,3362,313,3697,15,10948,334,2,3359,3,313,0,7,1,14,1,3693,4,334,3359,1,3,335,3362,1,0,1,31
Calhoun,9/21/20,0,13,13,34,1445,28,1479,6,5202,33,1,1439,6,27,1,0,0,6,0,1472,7,33,1439,1,6,34,1445,0,1,0,41
Carroll,9/21/20,9,15,15,625,6605,543,7229,73,27887,620,5,6601,4,541,2,9,0,70,3,7221,8,620,6601,4,4,624,6605,13,9,0,124
Chicot,9/21/20,17,17,17,995,4570,966,5566,12,10826,987,8,4558,12,959,7,16,1,12,0,5545,21,987,4558,9,12,996,4570,1,0,0,42
Clark,9/21/20,4,19,19,314,5579,278,5892,32,22385,302,12,5550,29,271,7,4,0,27,5,5852,40,302,5550,11,29,313,5579,4,5,0,61
Clay,9/21/20,7,21,21,264,3726,222,3989,34,15061,258,6,3721,5,219,3,5,2,33,1,3979,10,258,3721,5,5,263,3726,4,5,0,72
Cleburne,9/21/20,8,23,23,314,5431,286,5746,20,25230,301,13,5345,86,274,12,8,0,19,1,5646,100,301,5345,14,86,315,5431,0,3,0,86
Cleveland,9/21/20,10,25,25,179,2427,146,2606,23,8226,176,3,2402,25,144,2,9,1,23,0,2578,28,176,2402,3,25,179,2427,0,3,0,39
Columbia,9/21/20,18,27,27,383,4035,327,4428,38,23892,370,13,4007,28,317,10,18,0,35,3,4377,51,370,4007,23,28,393,4035,7,4,0,46
Conway,9/21/20,3,29,29,248,5665,226,5914,19,20906,244,4,5600,65,222,4,3,0,19,0,5844,70,244,5600,5,65,249,5665,2,1,0,50
Craighead,9/21/20,21,31,31,2640,29083,2287,31729,331,105701,2580,60,29045,38,2240,47,18,3,321,10,31625,104,2580,29045,66,38,2646,29083,40,40,1,332
Crawford,9/21/20,15,33,33,1271,17206,1069,18471,187,62472,1244,27,17198,8,1046,23,12,3,186,1,18442,29,1244,17198,21,8,1265,17206,21,17,0,320
Crittenden,9/21/20,45,35,35,1887,12830,1771,14707,71,49013,1870,17,12826,4,1764,7,38,7,68,3,14696,11,1870,12826,7,4,1877,12830,16,17,0,77
Cross,9/21/20,8,37,37,415,4211,348,4620,59,16998,404,11,4199,12,341,7,6,2,57,2,4603,17,404,4199,5,12,409,4211,10,13,1,64
Dallas,9/21/20,2,39,39,156,1846,141,2002,13,7432,155,1,1837,9,140,1,2,0,13,0,1992,10,155,1837,1,9,156,1846,0,1,0,17
Desha,9/21/20,5,41,41,280,3480,257,3759,18,11887,278,2,3457,23,255,2,5,0,18,0,3735,24,278,3457,1,23,279,3480,0,0,0,49
Drew,9/21/20,6,43,43,350,5109,328,5462,16,18502,339,11,5067,42,318,10,5,1,16,0,5406,56,339,5067,14,42,353,5109,2,0,0,79
Faulkner,9/21/20,19,45,45,2277,33813,1944,36102,314,122416,2194,83,33161,652,1879,65,16,3,299,15,35355,747,2194,33161,95,652,2289,33813,17,11,2,482
Franklin,9/21/20,2,47,47,248,5245,209,5493,37,17780,245,3,5236,9,206,3,2,0,37,0,5481,12,245,5236,3,9,248,5245,12,7,0,222
Fulton,9/21/20,3,49,49,127,1109,95,1236,29,12139,119,8,1108,1,94,1,2,1,23,6,1227,9,119,1108,8,1,127,1109,5,2,0,27
Garland,9/21/20,49,51,51,1750,25976,1570,27723,131,98296,1732,18,25901,75,1559,11,44,5,129,2,27633,90,1732,25901,15,75,1747,25976,4,8,1,290
Grant,9/21/20,2,53,53,249,4421,220,4675,27,18086,240,9,4381,40,211,9,2,0,27,0,4621,54,240,4381,14,40,254,4421,2,3,0,60
Greene,9/21/20,7,55,55,795,12250,705,13046,83,44623,779,16,12163,87,695,10,7,0,77,6,12942,104,779,12163,17,87,796,12250,7,10,0,201
Hempstead,9/21/20,4,57,57,358,3984,342,4343,12,22018,350,8,3965,19,337,5,4,0,9,3,4315,28,350,3965,9,19,359,3984,3,4,0,70
HotSpring,9/21/20,26,59,59,1847,10926,1760,12772,61,33520,1841,6,10892,34,1757,3,24,2,60,1,12733,39,1841,10892,5,34,1846,10926,8,4,1,69
Howard,9/21/20,8,61,61,456,3455,435,3914,13,13389,450,6,3448,7,430,5,8,0,12,1,3898,16,450,3448,9,7,459,3455,0,3,0,26
Independence,9/21/20,14,63,63,1030,10209,890,11243,126,37264,952,78,10167,42,835,55,13,1,104,22,11119,124,952,10167,82,42,1034,10209,5,13,0,411
Izard,9/21/20,0,65,65,194,3150,130,3352,64,13559,188,6,3139,11,125,5,0,0,63,1,3327,25,188,3139,14,11,202,3150,45,0,0,86
Jackson,9/21/20,1,67,67,290,5732,240,6037,49,17225,251,39,5721,11,216,24,1,0,34,15,5972,65,251,5721,54,11,305,5732,3,6,0,34
Jefferson,9/21/20,63,69,69,2928,26621,2360,29553,505,70424,2884,44,26468,153,2331,29,56,7,497,8,29352,201,2884,26468,48,153,2932,26621,37,23,1,550
Johnson,9/21/20,5,71,71,819,6568,796,7391,18,26291,818,1,6542,26,795,1,5,0,18,0,7360,31,818,6542,5,26,823,6568,3,2,0,94
Lafayette,9/21/20,2,73,73,92,907,79,1000,11,6915,92,0,905,2,79,0,2,0,11,0,997,3,92,905,1,2,93,907,2,1,0,15
Lawrence,9/21/20,11,75,75,374,3778,296,4154,67,16669,340,34,3767,11,274,22,11,0,55,12,4107,47,340,3767,36,11,376,3778,11,5,0,76
Lee,9/21/20,18,77,77,1050,3667,1014,4717,18,9398,1048,2,3662,5,1013,1,17,1,18,0,4710,7,1048,3662,2,5,1050,3667,4,0,0,52
Lincoln,9/21/20,15,79,79,1941,6361,1759,8310,167,13695,1938,3,6346,15,1758,1,14,1,166,1,8284,26,1938,6346,11,15,1949,6361,11,7,0,114
LittleRiver,9/21/20,25,81,81,345,1653,307,1990,13,12417,331,14,1638,15,298,9,20,5,13,0,1969,21,331,1638,6,15,337,1653,1,0,1,16
Logan,9/21/20,1,83,83,393,6036,378,6430,14,21757,392,1,6028,8,377,1,1,0,14,0,6420,10,392,6028,2,8,394,6036,2,1,0,73
Lonoke,9/21/20,11,85,85,1042,16985,933,18069,98,72206,924,118,16092,893,835,98,9,2,80,18,17016,1053,924,16092,160,893,1084,16985,9,8,1,1030
Madison,9/21/20,2,87,87,332,3782,316,4116,14,16076,324,8,3768,14,310,6,2,0,12,2,4092,24,324,3768,10,14,334,3782,0,2,0,53
Marion,9/21/20,0,89,89,76,2131,60,2209,16,16438,73,3,2124,7,57,3,0,0,16,0,2197,12,73,2124,5,7,78,2131,0,1,0,27
Miller,9/21/20,11,91,91,774,6079,716,6849,47,43759,741,33,6040,39,688,28,10,1,43,4,6781,68,741,6040,29,39,770,6079,4,10,0,113
MissingCountyInfo,9/21/20,0,5,5,1686,30062,1019,31739,667,NA,1576,110,28791,1271,929,90,0,0,647,20,30367,1372,1576,28791,101,1271,1677,30062,-5,11,0,-2505
Mississippi,9/21/20,50,93,93,1596,10893,1456,12477,90,42831,1573,23,10886,7,1445,11,39,11,89,1,12459,18,1573,10886,11,7,1584,10893,8,13,0,108
Monroe,9/21/20,0,95,95,119,2067,102,2186,17,7249,119,0,2053,14,102,0,0,0,17,0,2172,14,119,2053,0,14,119,2067,1,1,0,25
Montgomery,9/21/20,4,97,97,139,2019,117,2158,18,8993,138,1,2003,16,116,1,4,0,18,0,2141,17,138,2003,1,16,139,2019,3,1,0,43
Nevada,9/21/20,13,99,99,209,2703,165,2909,31,8440,205,4,2695,8,163,2,12,1,30,1,2900,9,205,2695,1,8,206,2703,1,3,0,56
Newton,9/21/20,18,101,101,217,1603,158,1816,41,7848,210,7,1602,1,155,3,15,3,40,1,1812,4,210,1602,3,1,213,1603,3,4,0,21
Ouachita,9/21/20,6,103,103,247,4959,198,5211,43,24106,241,6,4935,24,194,4,6,0,41,2,5176,35,241,4935,11,24,252,4959,3,5,0,152
Perry,9/21/20,0,105,105,83,2722,73,2805,10,10322,79,4,2662,60,69,4,0,0,10,0,2741,64,79,2662,4,60,83,2722,2,3,0,41
Phillips,9/21/20,11,107,107,460,5846,420,6308,29,19034,458,2,5818,28,418,2,11,0,29,0,6276,32,458,5818,4,28,462,5846,4,2,0,54
Pike,9/21/20,3,109,109,221,2002,205,2222,13,10808,219,2,1983,19,204,1,2,1,13,0,2202,20,219,1983,1,19,220,2002,3,1,0,29
Poinsett,9/21/20,9,111,111,615,6907,546,7518,60,24054,605,10,6902,5,537,9,8,1,60,0,7507,11,605,6902,6,5,611,6907,9,6,0,72
Polk,9/21/20,4,113,113,251,3618,241,3870,6,20163,250,1,3616,2,240,1,4,0,6,0,3866,4,250,3616,2,2,252,3618,0,2,0,41
Pope,9/21/20,30,115,115,2028,18902,1907,20925,91,63644,2016,12,18785,117,1900,7,25,5,91,0,20801,124,2016,18785,7,117,2023,18902,11,8,1,272
Prairie,9/21/20,1,117,117,137,1845,129,1984,7,8244,132,5,1815,30,124,5,1,0,7,0,1947,37,132,1815,7,30,139,1845,1,0,0,34
Pulaski,9/21/20,137,119,119,8670,116702,7872,125420,661,393463,8434,236,115130,1572,7680,192,124,13,630,31,123564,1856,8434,115130,284,1572,8718,116702,74,57,1,2502
Randolph,9/21/20,22,121,121,387,4336,316,4721,49,17603,361,26,4314,22,308,8,18,4,35,14,4675,46,361,4314,24,22,385,4336,4,0,0,93
Saline,9/21/20,21,125,125,1951,26032,1794,27991,135,118009,1884,67,25670,362,1740,54,19,2,124,11,27554,437,1884,25670,75,362,1959,26032,13,13,1,458
Scott,9/21/20,1,127,127,95,2032,92,2127,2,10442,95,0,2032,0,92,0,1,0,2,0,2127,0,95,2032,0,0,95,2032,0,0,0,140
Searcy,9/21/20,0,129,129,141,1738,132,1877,9,7923,137,4,1721,17,128,4,0,0,9,0,1858,19,137,1721,2,17,139,1738,0,1,0,22
Sebastian,9/21/20,56,131,131,3459,38737,3117,42190,285,127461,3420,39,38727,10,3098,19,45,11,276,9,42147,43,3420,38727,33,10,3453,38737,25,30,0,621
Sevier,9/21/20,16,133,133,1194,6367,1169,7559,9,17193,1185,9,6327,40,1161,8,16,0,8,1,7512,47,1185,6327,7,40,1192,6367,0,0,0,75
Sharp,9/21/20,6,135,135,198,3517,155,3714,37,17043,193,5,3512,5,153,2,6,0,34,3,3705,9,193,3512,4,5,197,3517,7,1,0,115
St.Francis,9/21/20,5,123,123,1474,11684,1382,13160,87,26294,1474,0,11676,8,1382,0,5,0,87,0,13150,10,1474,11676,2,8,1476,11684,6,5,0,521
Stone,9/21/20,7,137,137,309,3032,258,3343,44,12446,303,6,3022,10,252,6,7,0,44,0,3325,18,303,3022,8,10,311,3032,7,9,0,49
Union,9/21/20,31,139,139,841,7901,786,8741,23,39732,826,15,7871,30,779,7,26,5,20,3,8697,44,826,7871,14,30,840,7901,1,3,0,65
VanBuren,9/21/20,2,141,141,169,3558,153,3733,14,16684,169,0,3496,62,153,0,2,0,14,0,3665,68,169,3496,6,62,175,3558,0,2,0,36
Washington,9/21/20,107,143,143,9006,69074,8318,78102,581,228529,8557,449,68426,648,7981,337,91,16,485,96,76983,1119,8557,68426,471,648,9028,69074,56,88,0,1453
White,9/21/20,20,145,145,731,13051,641,13793,70,78804,667,64,12700,351,595,46,16,4,56,14,13367,426,667,12700,75,351,742,13051,13,4,1,429
Woodruff,9/21/20,0,147,147,46,1537,35,1584,11,6660,41,5,1529,8,31,4,0,0,10,1,1570,14,41,1529,6,8,47,1537,1,1,0,28
Yell,9/21/20,29,149,149,1233,8953,1175,10183,29,21573,1226,7,8911,42,1171,4,26,3,29,0,10137,46,1226,8911,4,42,1230,8953,1,4,0,66
Arkansas_all_counties,9/20/20,1181,5630,5630,75723,813315,67853,889200,6685,2990671,73690,2033,810294,3021,66397,1456,1033,148,6256,429,883984,5216,73690,810294,2195,3021,75885,813315,563,435,0,3469
Arkansas_county,9/20/20,4,1,1,354,4964,309,5324,41,18124,339,15,4950,14,299,10,4,0,36,5,5289,35,339,4950,21,14,360,4964,6,3,0,-148
Ashley,9/20/20,9,3,3,422,4636,392,5060,21,20537,418,4,4619,17,390,2,9,0,19,2,5037,23,418,4619,6,17,424,4636,4,0,0,34
Baxter,9/20/20,1,5,5,273,3664,194,3939,78,41219,249,24,3651,13,173,21,1,0,75,3,3900,39,249,3651,26,13,275,3664,7,7,0,15
Benton,9/20/20,79,7,7,6226,65933,5803,72167,344,258980,6078,148,65766,167,5702,101,62,17,314,30,71844,323,6078,65766,156,167,6234,65933,54,23,0,88
Boone,9/20/20,8,9,9,626,8540,462,9164,156,37288,600,26,8535,5,450,12,6,2,144,12,9135,29,600,8535,24,5,624,8540,20,9,0,57
Bradley,9/20/20,7,11,11,335,3332,313,3666,15,10948,333,2,3329,3,313,0,6,1,14,1,3662,4,333,3329,1,3,334,3332,1,0,0,12
Calhoun,9/20/20,0,13,13,34,1404,27,1438,7,5202,33,1,1400,4,26,1,0,0,7,0,1433,5,33,1400,1,4,34,1404,0,0,0,3
Carroll,9/20/20,9,15,15,612,6494,534,7106,69,27887,608,4,6493,1,533,1,9,0,66,3,7101,5,608,6493,4,1,612,6494,8,8,0,72
Chicot,9/20/20,17,17,17,994,4529,966,5524,11,10826,986,8,4521,8,959,7,16,1,11,0,5507,17,986,4521,9,8,995,4529,2,0,0,0
Clark,9/20/20,4,19,19,310,5522,273,5831,33,22385,298,12,5501,21,267,6,4,0,27,6,5799,32,298,5501,11,21,309,5522,3,3,0,30
Clay,9/20/20,7,21,21,260,3658,217,3917,35,15061,254,6,3656,2,215,2,5,2,33,2,3910,7,254,3656,5,2,259,3658,2,2,0,5
Cleburne,9/20/20,8,23,23,314,5345,283,5660,23,25230,301,13,5301,44,271,12,8,0,22,1,5602,58,301,5301,14,44,315,5345,3,2,0,15
Cleveland,9/20/20,10,25,25,179,2388,143,2567,26,8226,176,3,2371,17,141,2,9,1,26,0,2547,20,176,2371,3,17,179,2388,1,1,0,6
Columbia,9/20/20,18,27,27,376,3996,323,4381,35,23892,363,13,3977,19,315,8,18,0,30,5,4340,41,363,3977,22,19,385,3996,2,5,0,-1
Conway,9/20/20,3,29,29,246,5617,225,5864,18,20906,242,4,5556,61,221,4,3,0,18,0,5798,66,242,5556,5,61,247,5617,1,0,0,51
Craighead,9/20/20,20,31,31,2600,28791,2247,31394,332,105701,2539,61,28784,7,2203,44,17,3,318,14,31323,71,2539,28784,64,7,2603,28791,16,33,0,123
Crawford,9/20/20,15,33,33,1250,16907,1052,18151,183,62472,1223,27,16905,2,1030,22,12,3,181,2,18128,23,1223,16905,21,2,1244,16907,17,13,0,197
Crittenden,9/20/20,45,35,35,1871,12769,1754,14629,72,49013,1854,17,12768,1,1747,7,38,7,69,3,14622,7,1854,12768,6,1,1860,12769,3,32,0,55
Cross,9/20/20,7,37,37,405,4157,335,4556,63,16998,394,11,4155,2,328,7,5,2,61,2,4549,7,394,4155,5,2,399,4157,3,3,0,107
Dallas,9/20/20,2,39,39,156,1829,140,1985,14,7432,155,1,1820,9,139,1,2,0,14,0,1975,10,155,1820,1,9,156,1829,0,0,0,5
Desha,9/20/20,5,41,41,280,3431,257,3710,18,11887,278,2,3424,7,255,2,5,0,18,0,3702,8,278,3424,1,7,279,3431,2,4,0,0
Drew,9/20/20,6,43,43,348,5032,328,5383,14,18502,337,11,5008,24,318,10,5,1,14,0,5345,38,337,5008,14,24,351,5032,1,0,0,9
Faulkner,9/20/20,17,45,45,2260,33348,1933,35620,310,122416,2180,80,32846,502,1869,64,14,3,297,13,35026,594,2180,32846,92,502,2272,33348,59,11,0,622
Franklin,9/20/20,2,47,47,236,5035,202,5271,32,17780,233,3,5030,5,199,3,2,0,32,0,5263,8,233,5030,3,5,236,5035,3,2,0,31
Fulton,9/20/20,3,49,49,122,1087,93,1209,26,12139,114,8,1087,0,92,1,2,1,20,6,1201,8,114,1087,8,0,122,1087,3,3,0,4
Garland,9/20/20,48,51,51,1746,25690,1562,27433,136,98296,1729,17,25628,62,1552,10,43,5,134,2,27357,76,1729,25628,14,62,1743,25690,10,21,0,185
Grant,9/20/20,2,53,53,247,4363,217,4615,28,18086,238,9,4344,19,209,8,2,0,27,1,4582,33,238,4344,14,19,252,4363,2,0,0,20
Greene,9/20/20,7,55,55,788,12056,695,12845,86,44623,772,16,11987,69,686,9,7,0,79,7,12759,86,772,11987,17,69,789,12056,3,3,0,35
Hempstead,9/20/20,4,57,57,355,3917,338,4274,13,22018,348,7,3906,11,334,4,4,0,10,3,4254,20,348,3906,9,11,357,3917,0,0,0,5
HotSpring,9/20/20,25,59,59,1839,10865,1756,12702,58,33520,1833,6,10835,30,1753,3,23,2,57,1,12668,34,1833,10835,4,30,1837,10865,8,2,0,120
Howard,9/20/20,8,61,61,456,3429,432,3888,16,13389,450,6,3425,4,430,2,8,0,12,4,3875,13,450,3425,9,4,459,3429,1,0,0,9
Independence,9/20/20,14,63,63,1025,9803,877,10832,134,37264,948,77,9774,29,825,52,13,1,110,24,10722,110,948,9774,81,29,1029,9803,12,5,0,49
Izard,9/20/20,0,65,65,149,3109,130,3266,19,13559,143,6,3099,10,125,5,0,0,18,1,3242,24,143,3099,14,10,157,3109,2,0,0,8
Jackson,9/20/20,1,67,67,287,5701,234,6004,52,17225,249,38,5696,5,213,21,1,0,35,17,5945,59,249,5696,54,5,303,5701,0,6,0,-3
Jefferson,9/20/20,62,69,69,2891,26108,2337,29003,492,70424,2848,43,26034,74,2310,27,56,6,482,10,28882,121,2848,26034,47,74,2895,26108,47,17,0,202
Johnson,9/20/20,5,71,71,816,6477,794,7297,17,26291,815,1,6465,12,793,1,5,0,17,0,7280,17,815,6465,5,12,820,6477,1,3,0,19
Lafayette,9/20/20,2,73,73,90,894,78,985,10,6915,90,0,893,1,78,0,2,0,10,0,983,2,90,893,1,1,91,894,2,0,0,2
Lawrence,9/20/20,11,75,75,363,3713,291,4078,61,16669,330,33,3707,6,270,21,11,0,49,12,4037,41,330,3707,35,6,365,3713,4,2,0,19
Lee,9/20/20,18,77,77,1046,3619,1014,4665,14,9398,1044,2,3618,1,1013,1,17,1,14,0,4662,3,1044,3618,2,1,1046,3619,2,1,0,-3
Lincoln,9/20/20,15,79,79,1930,6258,1752,8196,163,13695,1927,3,6247,11,1751,1,14,1,162,1,8174,22,1927,6247,11,11,1938,6258,13,3,0,109
LittleRiver,9/20/20,24,81,81,344,1638,307,1974,13,12417,330,14,1628,10,298,9,19,5,13,0,1958,16,330,1628,6,10,336,1638,0,0,0,-4
Logan,9/20/20,1,83,83,391,5965,377,6357,13,21757,390,1,5957,8,376,1,1,0,13,0,6347,10,390,5957,2,8,392,5965,2,1,0,21
Lonoke,9/20/20,10,85,85,1033,15964,925,17039,98,72206,915,118,15803,161,829,96,8,2,78,20,16718,321,915,15803,160,161,1075,15964,6,10,0,-552
Madison,9/20/20,2,87,87,332,3729,314,4063,16,16076,324,8,3726,3,309,5,2,0,13,3,4050,13,324,3726,10,3,334,3729,1,1,0,-7
Marion,9/20/20,0,89,89,76,2104,59,2182,17,16438,73,3,2098,6,56,3,0,0,17,0,2171,11,73,2098,5,6,78,2104,1,1,0,15
Miller,9/20/20,11,91,91,770,5970,706,6736,53,43759,737,33,5955,15,678,28,10,1,49,4,6692,44,737,5955,29,15,766,5970,2,7,0,-1
MissingCountyInfo,9/20/20,0,5,5,1691,32562,1008,34246,683,NA,1585,106,32562,0,920,88,0,0,665,18,34147,99,1585,32562,99,0,1684,32562,42,12,0,1128
Mississippi,9/20/20,50,93,93,1588,10793,1443,12369,95,42831,1565,23,10788,5,1434,9,39,11,92,3,12353,16,1565,10788,11,5,1576,10793,4,8,0,30
Monroe,9/20/20,0,95,95,118,2043,101,2161,17,7249,118,0,2037,6,101,0,0,0,17,0,2155,6,118,2037,0,6,118,2043,4,0,0,1
Montgomery,9/20/20,4,97,97,136,1979,116,2115,16,8993,135,1,1978,1,115,1,4,0,16,0,2113,2,135,1978,1,1,136,1979,0,0,0,-8
Nevada,9/20/20,13,99,99,208,2648,162,2854,33,8440,205,3,2643,5,161,1,12,1,32,1,2848,6,205,2643,1,5,206,2648,7,2,0,22
Newton,9/20/20,18,101,101,214,1585,154,1795,42,7848,207,7,1584,1,151,3,15,3,41,1,1791,4,207,1584,3,1,210,1585,5,3,0,32
Ouachita,9/20/20,6,103,103,244,4810,193,5059,45,24106,238,6,4793,17,189,4,6,0,43,2,5031,28,238,4793,11,17,249,4810,1,6,0,4
Perry,9/20/20,0,105,105,81,2683,70,2764,11,10322,77,4,2636,47,66,4,0,0,11,0,2713,51,77,2636,4,47,81,2683,1,0,0,16
Phillips,9/20/20,11,107,107,456,5796,418,6254,27,19034,454,2,5784,12,416,2,11,0,27,0,6238,16,454,5784,4,12,458,5796,3,2,0,-3
Pike,9/20/20,3,109,109,218,1976,204,2193,11,10808,216,2,1959,17,203,1,2,1,11,0,2175,18,216,1959,1,17,217,1976,0,2,0,12
Poinsett,9/20/20,9,111,111,606,6844,540,7446,57,24054,596,10,6844,0,531,9,8,1,57,0,7440,6,596,6844,6,0,602,6844,3,2,0,14
Polk,9/20/20,4,113,113,251,3577,239,3829,8,20163,250,1,3576,1,239,0,4,0,7,1,3826,3,250,3576,2,1,252,3577,0,0,0,24
Pope,9/20/20,29,115,115,2017,18641,1899,20653,89,63644,2005,12,18544,97,1892,7,24,5,89,0,20549,104,2005,18544,7,97,2012,18641,15,6,0,78
Prairie,9/20/20,1,117,117,136,1812,129,1950,6,8244,131,5,1803,9,124,5,1,0,6,0,1934,16,131,1803,7,9,138,1812,0,0,0,-13
Pulaski,9/20/20,136,119,119,8596,114274,7815,122917,645,393463,8364,232,113640,634,7628,187,123,13,613,32,122004,913,8364,113640,279,634,8643,114274,40,35,0,316
Randolph,9/20/20,22,121,121,383,4247,316,4628,45,17603,359,24,4233,14,308,8,18,4,33,12,4592,36,359,4233,22,14,381,4247,4,1,0,11
Saline,9/20/20,20,125,125,1938,25587,1781,27533,137,118009,1872,66,25399,188,1729,52,18,2,125,12,27271,262,1872,25399,74,188,1946,25587,11,10,0,58
Scott,9/20/20,1,127,127,95,1892,92,1987,2,10442,95,0,1892,0,92,0,1,0,2,0,1987,0,95,1892,0,0,95,1892,0,0,0,12
Searcy,9/20/20,0,129,129,141,1716,131,1855,10,7923,137,4,1699,17,127,4,0,0,10,0,1836,19,137,1699,2,17,139,1716,2,2,0,7
Sebastian,9/20/20,56,131,131,3434,38141,3087,41569,290,127461,3395,39,38139,2,3072,15,45,11,277,13,41534,35,3395,38139,33,2,3428,38141,24,16,0,322
Sevier,9/20/20,16,133,133,1194,6292,1169,7484,9,17193,1185,9,6283,9,1161,8,16,0,8,1,7468,16,1185,6283,7,9,1192,6292,1,3,0,4
Sharp,9/20/20,6,135,135,191,3409,154,3600,31,17043,187,4,3408,1,153,1,6,0,28,3,3595,5,187,3408,4,1,191,3409,3,1,0,29
St.Francis,9/20/20,5,123,123,1468,11169,1377,12639,86,26294,1468,0,11167,2,1377,0,5,0,86,0,12635,4,1468,11167,2,2,1470,11169,3,1,0,33
Stone,9/20/20,7,137,137,302,2990,249,3294,46,12446,296,6,2983,7,243,6,7,0,46,0,3279,15,296,2983,8,7,304,2990,0,0,0,10
Union,9/20/20,31,139,139,840,7837,783,8676,25,39732,825,15,7812,25,777,6,26,5,21,4,8637,39,825,7812,14,25,839,7837,1,6,0,2
VanBuren,9/20/20,2,141,141,169,3522,151,3696,16,16684,169,0,3469,53,151,0,2,0,16,0,3638,58,169,3469,5,53,174,3522,1,3,0,22
Washington,9/20/20,107,143,143,8950,67677,8230,76647,613,228529,8517,433,67489,188,7904,326,91,16,522,91,76006,641,8517,67489,453,188,8970,67677,36,59,0,-234
White,9/20/20,19,145,145,718,12635,637,13364,62,78804,656,62,12516,119,593,44,15,4,48,14,13172,192,656,12516,73,119,729,12635,4,8,0,-168
Woodruff,9/20/20,0,147,147,45,1510,34,1556,11,6660,40,5,1506,4,30,4,0,0,10,1,1546,10,40,1506,6,4,46,1510,4,0,0,4
Yell,9/20/20,29,149,149,1232,8888,1171,10117,32,21573,1225,7,8850,38,1167,4,26,3,32,0,10075,42,1225,8850,4,38,1229,8888,4,0,0,64
Arkansas_all_counties,9/19/20,1181,5630,5630,75160,810409,67418,885735,6557,2990671,73141,2019,802685,7724,66003,1415,1033,148,6101,456,875826,9909,73141,802685,2185,7724,75326,810409,1078,671,8,9813
Arkansas_county,9/19/20,4,1,1,348,5118,306,5472,38,18124,333,15,4925,193,298,8,4,0,31,7,5258,214,333,4925,21,193,354,5118,10,8,0,104
Ashley,9/19/20,9,3,3,418,4606,392,5026,17,20537,414,4,4588,18,390,2,9,0,15,2,5002,24,414,4588,6,18,420,4606,1,-1,1,42
Baxter,9/19/20,1,5,5,266,3656,187,3924,78,41219,242,24,3641,15,166,21,1,0,75,3,3883,41,242,3641,26,15,268,3656,9,7,0,75
Benton,9/19/20,79,7,7,6172,65899,5780,72081,313,258980,6026,146,65649,250,5680,100,62,17,284,29,71675,406,6026,65649,156,250,6182,65899,86,56,0,314
Boone,9/19/20,8,9,9,606,8503,453,9106,145,37288,581,25,8488,15,443,10,6,2,132,13,9069,37,581,8488,22,15,603,8503,10,10,0,62
Bradley,9/19/20,7,11,11,334,3321,313,3654,14,10948,332,2,3318,3,313,0,6,1,13,1,3650,4,332,3318,1,3,333,3321,2,3,0,21
Calhoun,9/19/20,0,13,13,34,1401,27,1435,7,5202,33,1,1395,6,26,1,0,0,7,0,1428,7,33,1395,1,6,34,1401,2,1,0,6
Carroll,9/19/20,9,15,15,604,6430,526,7034,69,27887,600,4,6426,4,525,1,9,0,66,3,7026,8,600,6426,4,4,604,6430,5,3,0,30
Chicot,9/19/20,17,17,17,992,4531,966,5524,9,10826,984,8,4519,12,959,7,16,1,9,0,5503,21,984,4519,9,12,993,4531,1,0,0,33
Clark,9/19/20,4,19,19,307,5495,270,5801,33,22385,295,12,5467,28,266,4,4,0,25,8,5762,39,295,5467,11,28,306,5495,6,1,0,39
Clay,9/19/20,7,21,21,258,3655,215,3912,35,15061,253,5,3650,5,213,2,5,2,34,1,3903,9,253,3650,4,5,257,3655,4,4,0,71
Cleburne,9/19/20,8,23,23,311,5333,281,5645,22,25230,298,13,5251,82,269,12,8,0,21,1,5549,96,298,5251,14,82,312,5333,7,9,1,108
Cleveland,9/19/20,10,25,25,178,2383,142,2561,26,8226,175,3,2358,25,140,2,9,1,26,0,2533,28,175,2358,3,25,178,2383,0,4,0,17
Columbia,9/19/20,18,27,27,374,3999,318,4382,38,23892,361,13,3973,26,310,8,18,0,33,5,4334,48,361,3973,22,26,383,3999,9,2,0,35
Conway,9/19/20,3,29,29,245,5567,225,5813,17,20906,241,4,5498,69,221,4,3,0,17,0,5739,74,241,5498,5,69,246,5567,3,3,0,127
Craighead,9/19/20,20,31,31,2584,28684,2214,31272,349,105701,2524,60,28646,38,2171,43,17,3,335,14,31170,102,2524,28646,64,38,2588,28684,61,29,0,260
Crawford,9/19/20,15,33,33,1233,16727,1039,17954,179,62472,1206,27,16719,8,1018,21,12,3,176,3,17925,29,1206,16719,21,8,1227,16727,29,15,0,121
Crittenden,9/19/20,45,35,35,1868,12717,1722,14574,101,49013,1851,17,12713,4,1715,7,38,7,98,3,14564,10,1851,12713,6,4,1857,12717,12,7,0,73
Cross,9/19/20,7,37,37,402,4053,332,4449,63,16998,391,11,4042,11,325,7,5,2,61,2,4433,16,391,4042,5,11,396,4053,7,6,0,47
Dallas,9/19/20,2,39,39,156,1824,140,1980,14,7432,155,1,1815,9,139,1,2,0,14,0,1970,10,155,1815,1,9,156,1824,0,3,0,15
Desha,9/19/20,5,41,41,278,3433,253,3710,20,11887,276,2,3411,22,251,2,5,0,20,0,3687,23,276,3411,1,22,277,3433,3,3,0,35
Drew,9/19/20,6,43,43,347,5024,328,5374,13,18502,336,11,4987,37,318,10,5,1,13,0,5323,51,336,4987,14,37,350,5024,1,0,0,18
Faulkner,9/19/20,17,45,45,2201,32785,1922,34998,262,122416,2123,78,32148,637,1858,64,14,3,251,11,34271,727,2123,32148,90,637,2213,32785,34,25,0,381
Franklin,9/19/20,2,47,47,233,5007,200,5240,31,17780,230,3,4999,8,197,3,2,0,31,0,5229,11,230,4999,3,8,233,5007,3,6,0,30
Fulton,9/19/20,3,49,49,119,1086,90,1205,26,12139,111,8,1085,1,90,0,2,1,19,7,1196,9,111,1085,8,1,119,1086,6,2,0,13
Garland,9/19/20,48,51,51,1736,25515,1541,27248,147,98296,1719,17,25441,74,1531,10,43,5,145,2,27160,88,1719,25441,14,74,1733,25515,22,7,0,156
Grant,9/19/20,2,53,53,245,4345,217,4595,26,18086,236,9,4307,38,209,8,2,0,25,1,4543,52,236,4307,14,38,250,4345,2,1,0,29
Greene,9/19/20,7,55,55,785,12024,692,12810,86,44623,769,16,11944,80,684,8,7,0,78,8,12713,97,769,11944,17,80,786,12024,21,11,0,136
Hempstead,9/19/20,4,57,57,355,3912,338,4270,13,22018,349,6,3893,19,334,4,4,0,11,2,4242,28,349,3893,9,19,358,3912,2,0,0,53
HotSpring,9/19/20,25,59,59,1831,10753,1754,12582,52,33520,1825,6,10719,34,1751,3,23,2,51,1,12544,38,1825,10719,4,34,1829,10753,-1,4,0,113
Howard,9/19/20,8,61,61,455,3421,432,3880,15,13389,450,5,3414,7,430,2,8,0,12,3,3864,16,450,3414,9,7,459,3421,3,1,0,20
Independence,9/19/20,14,63,63,1013,9766,872,10783,127,37264,936,77,9729,37,822,50,13,1,101,26,10665,118,936,9729,81,37,1017,9766,27,10,1,65
Izard,9/19/20,0,65,65,147,3103,130,3258,17,13559,141,6,3092,11,125,5,0,0,16,1,3233,25,141,3092,14,11,155,3103,3,4,0,27
Jackson,9/19/20,1,67,67,287,5704,228,6007,58,17225,249,38,5693,11,210,18,1,0,38,20,5942,65,249,5693,54,11,303,5704,8,6,0,22
Jefferson,9/19/20,62,69,69,2844,25953,2320,28801,462,70424,2801,43,25802,151,2295,25,56,6,450,12,28603,198,2801,25802,47,151,2848,25953,63,28,1,443
Johnson,9/19/20,5,71,71,815,6459,791,7278,19,26291,814,1,6433,26,791,0,5,0,18,1,7247,31,814,6433,5,26,819,6459,1,-1,0,26
Lafayette,9/19/20,2,73,73,88,894,78,983,8,6915,88,0,892,2,78,0,2,0,8,0,980,3,88,892,1,2,89,894,2,1,0,37
Lawrence,9/19/20,11,75,75,359,3698,289,4058,59,16669,326,33,3687,11,269,20,11,0,46,13,4013,45,326,3687,34,11,360,3698,13,4,0,45
Lee,9/19/20,18,77,77,1044,3624,1013,4668,13,9398,1042,2,3619,5,1012,1,17,1,13,0,4661,7,1042,3619,2,5,1044,3624,2,2,0,58
Lincoln,9/19/20,15,79,79,1917,6162,1749,8087,153,13695,1915,2,6151,11,1748,1,14,1,153,0,8066,21,1915,6151,10,11,1925,6162,31,1,0,75
LittleRiver,9/19/20,24,81,81,344,1642,307,1978,13,12417,330,14,1627,15,298,9,19,5,13,0,1957,21,330,1627,6,15,336,1642,3,5,0,40
Logan,9/19/20,1,83,83,389,5946,376,6336,12,21757,388,1,5938,8,375,1,1,0,12,0,6326,10,388,5938,2,8,390,5946,3,1,0,31
Lonoke,9/19/20,10,85,85,1027,16522,915,17589,102,72206,906,121,15627,895,821,94,8,2,77,25,16533,1056,906,15627,161,895,1067,16522,26,18,1,333
Madison,9/19/20,2,87,87,331,3737,313,4070,16,16076,323,8,3723,14,309,4,2,0,12,4,4046,24,323,3723,10,14,333,3737,3,0,0,33
Marion,9/19/20,0,89,89,75,2090,58,2167,17,16438,72,3,2083,7,56,2,0,0,16,1,2155,12,72,2083,5,7,77,2090,2,2,0,51
Miller,9/19/20,11,91,91,768,5973,699,6737,58,43759,735,33,5934,39,672,27,10,1,53,5,6669,68,735,5934,29,39,764,5973,7,7,0,29
MissingCountyInfo,9/19/20,0,5,5,1649,31476,996,33118,653,NA,1546,103,30205,1271,909,87,0,0,637,16,31751,1367,1546,30205,96,1271,1642,31476,28,-25,0,2518
Mississippi,9/19/20,50,93,93,1584,10767,1435,12339,99,42831,1561,23,10761,6,1426,9,39,11,96,3,12322,17,1561,10761,11,6,1572,10767,20,13,0,81
Monroe,9/19/20,0,95,95,114,2046,101,2160,13,7249,114,0,2032,14,101,0,0,0,13,0,2146,14,114,2032,0,14,114,2046,4,0,0,19
Montgomery,9/19/20,4,97,97,136,1987,116,2123,16,8993,135,1,1972,15,115,1,4,0,16,0,2107,16,135,1972,1,15,136,1987,0,3,0,6
Nevada,9/19/20,13,99,99,201,2633,160,2832,28,8440,198,3,2625,8,159,1,12,1,27,1,2823,9,198,2625,1,8,199,2633,6,0,0,83
Newton,9/19/20,18,101,101,209,1558,151,1763,40,7848,202,7,1557,1,148,3,15,3,39,1,1759,4,202,1557,3,1,205,1558,9,6,0,24
Ouachita,9/19/20,6,103,103,243,4807,187,5055,50,24106,237,6,4785,22,183,4,6,0,48,2,5022,33,237,4785,11,22,248,4807,5,4,0,61
Perry,9/19/20,0,105,105,80,2668,70,2748,10,10322,76,4,2620,48,66,4,0,0,10,0,2696,52,76,2620,4,48,80,2668,0,1,0,37
Phillips,9/19/20,11,107,107,453,5802,416,6257,26,19034,451,2,5774,28,414,2,11,0,26,0,6225,32,451,5774,4,28,455,5802,8,2,0,132
Pike,9/19/20,3,109,109,218,1964,202,2181,13,10808,216,2,1945,19,201,1,2,1,13,0,2161,20,216,1945,1,19,217,1964,3,2,0,10
Poinsett,9/19/20,9,111,111,603,6833,538,7432,56,24054,593,10,6828,5,529,9,8,1,56,0,7421,11,593,6828,6,5,599,6833,8,9,0,58
Polk,9/19/20,4,113,113,251,3553,239,3805,8,20163,250,1,3551,2,239,0,4,0,7,1,3801,4,250,3551,2,2,252,3553,-1,0,0,16
Pope,9/19/20,29,115,115,2002,18578,1893,20575,80,63644,1990,12,18463,115,1886,7,24,5,80,0,20453,122,1990,18463,7,115,1997,18578,14,6,0,156
Prairie,9/19/20,1,117,117,136,1825,129,1963,6,8244,131,5,1795,30,124,5,1,0,6,0,1926,37,131,1795,7,30,138,1825,2,1,0,9
Pulaski,9/19/20,136,119,119,8556,113998,7780,122603,640,393463,8326,230,112457,1541,7595,185,123,13,608,32,120783,1820,8326,112457,279,1541,8605,113998,83,76,1,1094
Randolph,9/19/20,22,121,121,379,4240,315,4617,42,17603,355,24,4217,23,307,8,18,4,30,12,4572,45,355,4217,22,23,377,4240,5,3,0,27
Saline,9/19/20,20,125,125,1927,25540,1771,27475,136,118009,1861,66,25184,356,1719,52,18,2,124,12,27045,430,1861,25184,74,356,1935,25540,14,13,0,312
Scott,9/19/20,1,127,127,95,1880,92,1975,2,10442,95,0,1880,0,92,0,1,0,2,0,1975,0,95,1880,0,0,95,1880,1,0,0,21
Searcy,9/19/20,0,129,129,139,1711,129,1848,10,7923,135,4,1693,18,125,4,0,0,10,0,1828,20,135,1693,2,18,137,1711,1,2,0,12
Sebastian,9/19/20,56,131,131,3410,37843,3071,41248,282,127461,3372,38,37833,10,3058,13,45,11,268,14,41205,43,3372,37833,33,10,3405,37843,32,23,0,188
Sevier,9/19/20,16,133,133,1193,6289,1166,7480,11,17193,1184,9,6271,18,1158,8,16,0,10,1,7455,25,1184,6271,7,18,1191,6289,5,7,0,30
Sharp,9/19/20,6,135,135,188,3383,153,3571,29,17043,185,3,3379,4,152,1,6,0,27,2,3564,7,185,3379,3,4,188,3383,4,2,0,23
St.Francis,9/19/20,5,123,123,1465,11139,1376,12606,84,26294,1465,0,11132,7,1376,0,5,0,84,0,12597,9,1465,11132,2,7,1467,11139,22,6,1,66
Stone,9/19/20,7,137,137,302,2980,249,3284,46,12446,296,6,2971,9,243,6,7,0,46,0,3267,17,296,2971,8,9,304,2980,1,4,0,15
Union,9/19/20,31,139,139,839,7836,777,8675,30,39732,825,14,7807,29,772,5,26,5,26,4,8632,43,825,7807,14,29,839,7836,3,10,0,40
VanBuren,9/19/20,2,141,141,168,3501,148,3674,18,16684,168,0,3436,65,148,0,2,0,18,0,3604,70,168,3436,5,65,173,3501,1,2,0,52
Washington,9/19/20,107,143,143,8914,67947,8171,76879,636,228529,8479,435,67301,646,7855,316,91,16,533,103,75780,1099,8479,67301,453,646,8932,67947,217,171,1,567
White,9/19/20,19,145,145,714,12807,629,13533,66,78804,653,61,12463,344,585,44,15,4,53,13,13116,417,653,12463,73,344,726,12807,22,11,0,205
Woodruff,9/19/20,0,147,147,41,1510,34,1552,7,6660,36,5,1502,8,30,4,0,0,6,1,1538,14,36,1502,6,8,42,1510,1,0,0,8
Yell,9/19/20,29,149,149,1228,8828,1171,10053,28,21573,1221,7,8787,41,1167,4,26,3,28,0,10008,45,1221,8787,4,41,1225,8828,6,1,0,44
Arkansas_all_counties,9/18/20,1173,5630,5630,74082,801674,66747,876022,6158,2990671,72338,1744,794097,7577,65542,1205,1025,148,5767,391,866435,9587,72338,794097,2010,7577,74348,801674,871,806,7,11451
Arkansas_county,9/18/20,4,1,1,338,5024,298,5371,36,18124,329,9,4830,194,294,4,4,0,31,5,5159,212,329,4830,18,194,347,5024,4,1,0,79
Ashley,9/18/20,8,3,3,417,4565,393,4984,16,20537,413,4,4547,18,391,2,8,0,14,2,4960,24,413,4547,6,18,419,4565,3,2,0,84
Baxter,9/18/20,1,5,5,257,3590,180,3849,76,41219,234,23,3575,15,161,19,1,0,72,4,3809,40,234,3575,25,15,259,3590,14,3,0,108
Benton,9/18/20,79,7,7,6086,65671,5724,71775,283,258980,5974,112,65425,246,5650,74,62,17,262,21,71399,376,5974,65425,130,246,6104,65671,56,46,0,697
Boone,9/18/20,8,9,9,596,8451,443,9045,145,37288,573,23,8436,15,434,9,6,2,133,12,9009,36,573,8436,21,15,594,8451,12,8,0,349
Bradley,9/18/20,7,11,11,332,3302,310,3633,15,10948,330,2,3299,3,310,0,6,1,14,1,3629,4,330,3299,1,3,331,3302,3,4,0,38
Calhoun,9/18/20,0,13,13,32,1397,26,1429,6,5202,31,1,1393,4,25,1,0,0,6,0,1424,5,31,1393,1,4,32,1397,0,1,0,21
Carroll,9/18/20,9,15,15,599,6405,523,7004,67,27887,595,4,6401,4,522,1,9,0,64,3,6996,8,595,6401,4,4,599,6405,5,11,0,52
Chicot,9/18/20,17,17,17,991,4499,966,5491,8,10826,983,8,4488,11,959,7,16,1,8,0,5471,20,983,4488,9,11,992,4499,0,1,0,25
Clark,9/18/20,4,19,19,301,5462,269,5763,28,22385,291,10,5434,28,265,4,4,0,22,6,5725,38,291,5434,10,28,301,5462,7,4,0,67
Clay,9/18/20,7,21,21,254,3588,211,3841,35,15061,249,5,3583,5,209,2,5,2,34,1,3832,9,249,3583,4,5,253,3588,3,6,0,134
Cleburne,9/18/20,7,23,23,304,5232,272,5538,25,25230,293,11,5155,77,263,9,7,0,23,2,5448,90,293,5155,13,77,306,5232,2,3,0,83
Cleveland,9/18/20,10,25,25,178,2366,138,2544,30,8226,175,3,2343,23,136,2,9,1,30,0,2518,26,175,2343,3,23,178,2366,0,1,0,34
Columbia,9/18/20,18,27,27,365,3973,316,4345,31,23892,353,12,3948,25,309,7,18,0,26,5,4301,44,353,3948,19,25,372,3973,6,7,0,41
Conway,9/18/20,3,29,29,242,5443,222,5686,17,20906,240,2,5373,70,220,2,3,0,17,0,5613,73,240,5373,3,70,243,5443,4,4,0,123
Craighead,9/18/20,20,31,31,2523,28485,2185,31013,317,105701,2469,54,28447,38,2145,40,17,3,306,11,30916,97,2469,28447,59,38,2528,28485,33,44,0,354
Crawford,9/18/20,15,33,33,1204,16635,1024,17839,165,62472,1184,20,16627,8,1010,14,12,3,162,3,17811,28,1184,16627,20,8,1204,16635,34,11,0,399
Crittenden,9/18/20,45,35,35,1856,12656,1715,14503,96,49013,1842,14,12652,4,1710,5,38,7,94,2,14494,9,1842,12652,5,4,1847,12656,8,4,0,85
Cross,9/18/20,7,37,37,395,4013,326,4404,62,16998,389,6,4001,12,322,4,5,2,62,0,4390,14,389,4001,2,12,391,4013,8,4,0,66
Dallas,9/18/20,2,39,39,156,1809,137,1965,17,7432,155,1,1800,9,136,1,2,0,17,0,1955,10,155,1800,1,9,156,1809,4,1,0,33
Desha,9/18/20,5,41,41,275,3401,250,3676,20,11887,274,1,3380,21,249,1,5,0,20,0,3654,22,274,3380,1,21,275,3401,4,2,0,55
Drew,9/18/20,6,43,43,346,5007,328,5356,12,18502,335,11,4969,38,318,10,5,1,12,0,5304,52,335,4969,14,38,349,5007,0,3,0,71
Faulkner,9/18/20,17,45,45,2167,32438,1897,34620,253,122416,2101,66,31790,648,1842,55,14,3,245,8,33891,729,2101,31790,81,648,2182,32438,29,21,1,393
Franklin,9/18/20,2,47,47,230,4980,194,5210,34,17780,227,3,4972,8,191,3,2,0,34,0,5199,11,227,4972,3,8,230,4980,-1,1,0,119
Fulton,9/18/20,3,49,49,113,1079,88,1193,22,12139,106,7,1078,1,88,0,2,1,16,6,1184,9,106,1078,8,1,114,1079,0,1,0,13
Garland,9/18/20,48,51,51,1714,25381,1534,27091,132,98296,1697,17,25307,74,1524,10,43,5,130,2,27004,87,1697,25307,13,74,1710,25381,18,17,1,538
Grant,9/18/20,2,53,53,243,4318,216,4566,25,18086,235,8,4280,38,208,8,2,0,25,0,4515,51,235,4280,13,38,248,4318,2,3,0,60
Greene,9/18/20,7,55,55,764,11909,681,12676,76,44623,754,10,11832,77,676,5,7,0,71,5,12586,90,754,11832,13,77,767,11909,7,9,0,417
Hempstead,9/18/20,4,57,57,353,3861,338,4217,11,22018,347,6,3843,18,334,4,4,0,9,2,4190,27,347,3843,9,18,356,3861,5,0,0,51
HotSpring,9/18/20,25,59,59,1832,10639,1750,12469,57,33520,1826,6,10607,32,1747,3,23,2,56,1,12433,36,1826,10607,4,32,1830,10639,8,6,0,225
Howard,9/18/20,8,61,61,452,3404,431,3860,13,13389,448,4,3398,6,429,2,8,0,11,2,3846,14,448,3398,8,6,456,3404,2,0,0,16
Independence,9/18/20,13,63,63,986,9728,862,10723,111,37264,921,65,9693,35,818,44,12,1,91,20,10614,109,921,9693,74,35,995,9728,10,8,0,249
Izard,9/18/20,0,65,65,144,3079,126,3231,18,13559,139,5,3068,11,122,4,0,0,17,1,3207,24,139,3068,13,11,152,3079,3,4,0,36
Jackson,9/18/20,1,67,67,279,5690,222,5988,56,17225,246,33,5679,11,206,16,1,0,39,17,5925,63,246,5679,52,11,298,5690,5,9,0,83
Jefferson,9/18/20,61,69,69,2781,25573,2292,28358,428,70424,2744,37,25431,142,2270,22,55,6,419,9,28175,183,2744,25431,41,142,2785,25573,72,46,1,551
Johnson,9/18/20,5,71,71,814,6434,792,7251,17,26291,812,2,6411,23,791,1,5,0,16,1,7223,28,812,6411,5,23,817,6434,1,3,0,52
Lafayette,9/18/20,2,73,73,86,859,77,946,7,6915,86,0,857,2,77,0,2,0,7,0,943,3,86,857,1,2,87,859,1,-1,0,15
Lawrence,9/18/20,11,75,75,346,3666,285,4015,50,16669,316,30,3655,11,266,19,11,0,39,11,3971,44,316,3655,33,11,349,3666,6,7,0,47
Lee,9/18/20,18,77,77,1042,3568,1011,4610,13,9398,1040,2,3563,5,1010,1,17,1,13,0,4603,7,1040,3563,2,5,1042,3568,1,1,2,23
Lincoln,9/18/20,15,79,79,1886,6118,1748,8012,123,13695,1884,2,6107,11,1747,1,14,1,123,0,7991,21,1884,6107,10,11,1894,6118,82,105,0,181
LittleRiver,9/18/20,24,81,81,341,1605,302,1939,15,12417,328,13,1597,8,294,8,19,5,15,0,1925,14,328,1597,6,8,334,1605,4,1,0,37
Logan,9/18/20,1,83,83,386,5918,375,6306,10,21757,386,0,5910,8,375,0,1,0,10,0,6296,10,386,5910,2,8,388,5918,1,1,0,55
Lonoke,9/18/20,9,85,85,1001,16215,897,17258,95,72206,894,107,15370,845,813,84,7,2,74,21,16264,994,894,15370,149,845,1043,16215,20,13,0,381
Madison,9/18/20,2,87,87,328,3707,313,4037,13,16076,321,7,3693,14,309,4,2,0,10,3,4014,23,321,3693,9,14,330,3707,4,1,0,33
Marion,9/18/20,0,89,89,73,2041,56,2116,17,16438,70,3,2034,7,55,1,0,0,15,2,2104,12,70,2034,5,7,75,2041,2,1,0,38
Miller,9/18/20,11,91,91,761,5951,692,6712,58,43759,732,29,5916,35,666,26,10,1,56,2,6648,64,732,5916,29,35,761,5951,6,4,0,58
MissingCountyInfo,9/18/20,0,5,5,1621,28986,1021,30591,600,NA,1460,161,27713,1273,888,133,0,0,572,28,29173,1418,1460,27713,145,1273,1605,28986,86,30,0,-904
Mississippi,9/18/20,50,93,93,1564,10706,1422,12259,92,42831,1543,21,10699,7,1414,8,39,11,90,2,12242,17,1543,10699,10,7,1553,10706,4,8,1,80
Monroe,9/18/20,0,95,95,110,2031,101,2141,9,7249,110,0,2017,14,101,0,0,0,9,0,2127,14,110,2017,0,14,110,2031,0,1,0,15
Montgomery,9/18/20,4,97,97,136,1981,113,2117,19,8993,135,1,1966,15,112,1,4,0,19,0,2101,16,135,1966,1,15,136,1981,0,0,0,23
Nevada,9/18/20,13,99,99,195,2556,160,2749,22,8440,193,2,2548,8,159,1,12,1,22,0,2741,8,193,2548,0,8,193,2556,7,2,0,94
Newton,9/18/20,18,101,101,200,1543,145,1741,37,7848,195,5,1542,1,144,1,15,3,36,1,1737,4,195,1542,3,1,198,1543,5,5,0,66
Ouachita,9/18/20,6,103,103,238,4751,183,4994,49,24106,233,5,4730,21,180,3,6,0,47,2,4963,31,233,4730,10,21,243,4751,6,0,0,65
Perry,9/18/20,0,105,105,80,2631,69,2711,11,10322,76,4,2570,61,65,4,0,0,11,0,2646,65,76,2570,4,61,80,2631,1,1,0,22
Phillips,9/18/20,11,107,107,445,5678,414,6125,20,19034,443,2,5651,27,412,2,11,0,20,0,6094,31,443,5651,4,27,447,5678,1,1,0,17
Pike,9/18/20,3,109,109,215,1957,200,2171,12,10808,213,2,1940,17,199,1,2,1,12,0,2153,18,213,1940,1,17,214,1957,0,3,0,20
Poinsett,9/18/20,9,111,111,595,6783,529,7375,57,24054,587,8,6778,5,522,7,8,1,57,0,7365,10,587,6778,5,5,592,6783,2,4,0,73
Polk,9/18/20,4,113,113,252,3536,239,3788,9,20163,250,2,3534,2,238,1,4,0,8,1,3784,4,250,3534,2,2,252,3536,0,4,0,31
Pope,9/18/20,29,115,115,1988,18436,1887,20419,72,63644,1976,12,18323,113,1880,7,24,5,72,0,20299,120,1976,18323,7,113,1983,18436,6,10,1,165
Prairie,9/18/20,1,117,117,134,1818,128,1954,5,8244,129,5,1788,30,123,5,1,0,5,0,1917,37,129,1788,7,30,136,1818,0,0,0,18
Pulaski,9/18/20,135,119,119,8473,112987,7704,121515,634,393463,8265,208,111478,1509,7538,166,122,13,605,29,119743,1772,8265,111478,263,1509,8528,112987,65,79,0,1376
Randolph,9/18/20,22,121,121,374,4218,312,4592,40,17603,352,22,4196,22,305,7,18,4,29,11,4548,44,352,4196,22,22,374,4218,4,1,0,67
Saline,9/18/20,20,125,125,1913,25242,1758,27167,135,118009,1851,62,24890,352,1708,50,18,2,125,10,26741,426,1851,24890,74,352,1925,25242,12,16,0,455
Scott,9/18/20,1,127,127,94,1860,92,1954,1,10442,94,0,1860,0,92,0,1,0,1,0,1954,0,94,1860,0,0,94,1860,0,1,0,34
Searcy,9/18/20,0,129,129,138,1700,127,1837,11,7923,135,3,1685,15,124,3,0,0,11,0,1820,17,135,1685,2,15,137,1700,0,0,0,17
Sebastian,9/18/20,56,131,131,3378,37687,3048,41062,273,127461,3346,32,37677,10,3037,11,45,11,263,10,41023,39,3346,37677,29,10,3375,37687,33,25,0,725
Sevier,9/18/20,16,133,133,1188,6264,1159,7454,13,17193,1183,5,6248,16,1156,3,16,0,11,2,7431,23,1183,6248,7,16,1190,6264,0,3,0,76
Sharp,9/18/20,6,135,135,184,3364,151,3548,27,17043,180,4,3360,4,150,1,6,0,24,3,3540,8,180,3360,4,4,184,3364,6,3,0,102
St.Francis,9/18/20,4,123,123,1443,11095,1370,12540,69,26294,1443,0,11088,7,1370,0,4,0,69,0,12531,9,1443,11088,2,7,1445,11095,29,4,0,392
Stone,9/18/20,7,137,137,301,2966,245,3269,49,12446,295,6,2957,9,239,6,7,0,49,0,3252,17,295,2957,8,9,303,2966,5,16,-1,42
Union,9/18/20,31,139,139,836,7799,767,8635,37,39732,822,14,7769,30,762,5,26,5,33,4,8591,44,822,7769,14,30,836,7799,3,4,0,92
VanBuren,9/18/20,2,141,141,167,3450,146,3622,19,16684,167,0,3398,52,146,0,2,0,19,0,3565,57,167,3398,5,52,172,3450,3,1,0,50
Washington,9/18/20,106,143,143,8697,67597,8000,76352,591,228529,8401,296,66959,638,7809,191,90,16,502,89,75360,992,8401,66959,354,638,8755,67597,79,138,1,1067
White,9/18/20,19,145,145,692,12624,618,13329,55,78804,638,54,12293,331,576,42,15,4,47,8,12931,398,638,12293,67,331,705,12624,12,10,0,423
Woodruff,9/18/20,0,147,147,40,1503,34,1544,6,6660,36,4,1495,8,30,4,0,0,6,0,1531,13,36,1495,5,8,41,1503,1,1,0,38
Yell,9/18/20,29,149,149,1222,8790,1170,10009,23,21573,1216,6,8748,42,1167,3,26,3,23,0,9964,45,1216,8748,3,42,1219,8790,3,3,0,41
Arkansas_all_counties,9/17/20,1166,5630,0,73211,791094,65941,864549,6100,2990671,71614,1597,783707,7387,64866,1075,1018,148,5726,374,855321,9228,71614,783707,1841,7387,73455,791094,992,721,8,10881
Arkansas_county,9/17/20,4,1,0,334,4949,297,5292,33,18124,327,7,4755,194,293,4,4,0,30,3,5082,210,327,4755,16,194,343,4949,7,2,0,50
Ashley,9/17/20,8,3,0,414,4484,391,4900,15,20537,410,4,4466,18,389,2,8,0,13,2,4876,24,410,4466,6,18,416,4484,8,2,0,34
Baxter,9/17/20,1,5,0,243,3496,177,3741,65,41219,222,21,3481,15,159,18,1,0,62,3,3703,38,222,3481,23,15,245,3496,17,1,0,89
Benton,9/17/20,79,7,0,6030,65030,5678,71075,273,258980,5936,94,64807,223,5619,59,62,17,255,18,70743,332,5936,64807,109,223,6045,65030,47,75,0,483
Boone,9/17/20,8,9,0,584,8114,435,8696,141,37288,567,17,8101,13,426,9,6,2,135,6,8668,28,567,8101,15,13,582,8114,15,20,0,67
Bradley,9/17/20,7,11,0,329,3267,306,3595,16,10948,327,2,3264,3,306,0,6,1,15,1,3591,4,327,3264,1,3,328,3267,2,0,0,16
Calhoun,9/17/20,0,13,0,32,1376,25,1408,7,5202,31,1,1372,4,24,1,0,0,7,0,1403,5,31,1372,1,4,32,1376,1,0,0,7
Carroll,9/17/20,9,15,0,594,6358,512,6952,73,27887,592,2,6354,4,511,1,9,0,72,1,6946,6,592,6354,2,4,594,6358,12,7,0,68
Chicot,9/17/20,17,17,0,991,4474,965,5466,9,10826,983,8,4463,11,958,7,16,1,9,0,5446,20,983,4463,9,11,992,4474,5,6,0,11
Clark,9/17/20,4,19,0,294,5402,265,5696,25,22385,288,6,5375,27,262,3,4,0,22,3,5663,33,288,5375,6,27,294,5402,5,6,0,61
Clay,9/17/20,7,21,0,251,3457,205,3707,38,15061,246,5,3452,5,203,2,5,2,37,1,3698,9,246,3452,4,5,250,3457,7,2,0,37
Cleburne,9/17/20,7,23,0,302,5151,269,5454,26,25230,291,11,5074,77,260,9,7,0,24,2,5365,89,291,5074,12,77,303,5151,3,0,0,80
Cleveland,9/17/20,10,25,0,178,2332,137,2510,31,8226,175,3,2310,22,135,2,9,1,31,0,2485,25,175,2310,3,22,178,2332,13,4,0,101
Columbia,9/17/20,18,27,0,359,3938,309,4304,32,23892,349,10,3913,25,303,6,18,0,28,4,4262,42,349,3913,17,25,366,3938,5,3,0,17
Conway,9/17/20,3,29,0,238,5324,218,5562,17,20906,236,2,5253,71,216,2,3,0,17,0,5489,73,236,5253,2,71,238,5324,4,1,0,24
Craighead,9/17/20,20,31,0,2490,28164,2141,30659,328,105701,2437,53,28126,38,2104,37,17,3,315,13,30563,96,2437,28126,58,38,2495,28164,36,42,1,358
Crawford,9/17/20,15,33,0,1170,16270,1013,17441,142,62472,1153,17,16264,6,1003,10,12,3,138,4,17417,24,1153,16264,18,6,1171,16270,26,8,1,222
Crittenden,9/17/20,45,35,0,1848,12579,1711,14418,92,49013,1835,13,12575,4,1707,4,38,7,90,2,14410,8,1835,12575,4,4,1839,12579,15,15,0,77
Cross,9/17/20,7,37,0,387,3955,322,4338,58,16998,381,6,3944,11,318,4,5,2,58,0,4325,13,381,3944,2,11,383,3955,3,8,0,25
Dallas,9/17/20,2,39,0,152,1780,136,1932,14,7432,151,1,1771,9,135,1,2,0,14,0,1922,10,151,1771,1,9,152,1780,0,1,0,19
Desha,9/17/20,5,41,0,271,3350,248,3621,18,11887,270,1,3329,21,247,1,5,0,18,0,3599,22,270,3329,1,21,271,3350,3,2,0,16
Drew,9/17/20,6,43,0,346,4936,325,5285,15,18502,335,11,4898,38,316,9,5,1,14,1,5233,52,335,4898,14,38,349,4936,2,2,0,23
Faulkner,9/17/20,16,45,0,2138,32074,1876,34226,246,122416,2077,61,31438,636,1826,50,13,3,238,8,33515,711,2077,31438,75,636,2152,32074,35,17,1,272
Franklin,9/17/20,2,47,0,231,4860,193,5090,36,17780,228,3,4853,7,190,3,2,0,36,0,5081,9,228,4853,2,7,230,4860,6,3,0,101
Fulton,9/17/20,3,49,0,113,1066,87,1180,23,12139,105,8,1065,1,86,1,2,1,17,6,1170,10,105,1065,9,1,114,1066,2,3,1,19
Garland,9/17/20,47,51,0,1696,24861,1517,26552,132,98296,1680,16,24787,74,1508,9,42,5,130,2,26467,85,1680,24787,11,74,1691,24861,25,14,0,505
Grant,9/17/20,2,53,0,241,4260,213,4506,26,18086,233,8,4222,38,205,8,2,0,26,0,4455,51,233,4222,13,38,246,4260,15,1,0,123
Greene,9/17/20,7,55,0,757,11499,672,12260,78,44623,749,8,11430,69,669,3,7,0,73,5,12179,81,749,11430,12,69,761,11499,10,5,0,108
Hempstead,9/17/20,4,57,0,348,3815,338,4166,6,22018,344,4,3798,17,334,4,4,0,6,0,4142,24,344,3798,7,17,351,3815,1,1,0,26
HotSpring,9/17/20,25,59,0,1824,10422,1744,12244,55,33520,1819,5,10391,31,1741,3,23,2,55,0,12210,34,1819,10391,3,31,1822,10422,14,1,0,327
Howard,9/17/20,8,61,0,450,3390,431,3844,11,13389,447,3,3385,5,429,2,8,0,10,1,3832,12,447,3385,7,5,454,3390,0,2,0,7
Independence,9/17/20,13,63,0,976,9489,854,10474,109,37264,918,58,9454,35,812,42,12,1,94,15,10372,102,918,9454,67,35,985,9489,14,16,0,54
Izard,9/17/20,0,65,0,141,3046,122,3194,19,13559,135,6,3035,11,118,4,0,0,17,2,3170,24,135,3035,13,11,148,3046,3,5,0,19
Jackson,9/17/20,1,67,0,274,5612,213,5905,60,17225,241,33,5601,11,201,12,1,0,39,21,5842,63,241,5601,52,11,293,5612,7,7,0,52
Jefferson,9/17/20,60,69,0,2709,25094,2246,27807,403,70424,2672,37,24955,139,2226,20,55,5,391,12,27627,180,2672,24955,41,139,2713,25094,86,25,0,379
Johnson,9/17/20,5,71,0,813,6383,789,7197,19,26291,811,2,6360,23,788,1,5,0,18,1,7171,26,811,6360,3,23,814,6383,5,3,0,41
Lafayette,9/17/20,2,73,0,85,845,78,931,5,6915,85,0,843,2,78,0,2,0,5,0,928,3,85,843,1,2,86,845,1,0,0,2
Lawrence,9/17/20,11,75,0,340,3625,278,3968,51,16669,312,28,3614,11,262,16,11,0,39,12,3926,42,312,3614,31,11,343,3625,9,7,0,119
Lee,9/17/20,16,77,0,1041,3546,1010,4587,15,9398,1039,2,3541,5,1010,0,15,1,14,1,4580,7,1039,3541,2,5,1041,3546,0,2,0,15
Lincoln,9/17/20,15,79,0,1804,6019,1643,7831,146,13695,1802,2,6008,11,1642,1,14,1,146,0,7810,21,1802,6008,10,11,1812,6019,2,27,0,54
LittleRiver,9/17/20,24,81,0,337,1572,301,1902,12,12417,325,12,1564,8,294,7,19,5,12,0,1889,13,325,1564,5,8,330,1572,5,4,1,8
Logan,9/17/20,1,83,0,385,5864,374,6251,10,21757,385,0,5856,8,374,0,1,0,10,0,6241,10,385,5856,2,8,387,5864,2,2,0,48
Lonoke,9/17/20,9,85,0,981,15854,884,16877,88,72206,880,101,15011,843,804,80,7,2,69,19,15891,986,880,15011,143,843,1023,15854,16,19,0,291
Madison,9/17/20,2,87,0,324,3678,312,4004,10,16076,318,6,3667,11,308,4,2,0,8,2,3985,19,318,3667,8,11,326,3678,3,3,0,28
Marion,9/17/20,0,89,0,71,2005,55,2077,16,16438,68,3,1998,7,55,0,0,0,13,3,2066,11,68,1998,4,7,72,2005,4,1,0,27
Miller,9/17/20,11,91,0,755,5899,688,6655,56,43759,730,25,5864,35,665,23,10,1,55,1,6594,61,730,5864,26,35,756,5899,8,9,0,22
MissingCountyInfo,9/17/20,0,5,0,1535,29976,991,31494,544,NA,1383,152,28703,1273,872,119,0,0,511,33,30086,1408,1383,28703,135,1273,1518,29976,77,27,0,2613
Mississippi,9/17/20,49,93,0,1560,10630,1414,12179,97,42831,1540,20,10627,3,1406,8,38,11,96,1,12167,12,1540,10627,9,3,1549,10630,18,9,1,125
Monroe,9/17/20,0,95,0,110,2016,100,2126,10,7249,110,0,2002,14,100,0,0,0,10,0,2112,14,110,2002,0,14,110,2016,5,0,0,16
Montgomery,9/17/20,4,97,0,136,1958,113,2094,19,8993,135,1,1943,15,112,1,4,0,19,0,2078,16,135,1943,1,15,136,1958,13,2,0,155
Nevada,9/17/20,13,99,0,188,2469,158,2655,17,8440,186,2,2461,8,157,1,12,1,17,0,2647,8,186,2461,0,8,186,2469,1,0,0,26
Newton,9/17/20,18,101,0,195,1482,140,1674,37,7848,189,6,1481,1,138,2,15,3,36,1,1670,4,189,1481,3,1,192,1482,9,7,0,27
Ouachita,9/17/20,6,103,0,232,4692,183,4928,43,24106,227,5,4671,21,180,3,6,0,41,2,4898,30,227,4671,9,21,236,4692,7,1,0,19
Perry,9/17/20,0,105,0,79,2610,68,2689,11,10322,75,4,2552,58,64,4,0,0,11,0,2627,62,75,2552,4,58,79,2610,2,0,0,165
Phillips,9/17/20,11,107,0,444,5662,413,6108,20,19034,442,2,5635,27,411,2,11,0,20,0,6077,31,442,5635,4,27,446,5662,2,1,0,100
Pike,9/17/20,3,109,0,215,1937,197,2151,15,10808,213,2,1921,16,196,1,2,1,15,0,2134,17,213,1921,1,16,214,1937,0,4,0,13
Poinsett,9/17/20,9,111,0,593,6712,525,7302,59,24054,585,8,6707,5,518,7,8,1,59,0,7292,10,585,6707,5,5,590,6712,6,5,0,60
Polk,9/17/20,4,113,0,252,3505,235,3757,13,20163,250,2,3503,2,234,1,4,0,12,1,3753,4,250,3503,2,2,252,3505,3,1,0,24
Pope,9/17/20,28,115,0,1982,18277,1877,20253,77,63644,1970,12,18165,112,1870,7,23,5,77,0,20135,118,1970,18165,6,112,1976,18277,11,9,0,121
Prairie,9/17/20,1,117,0,134,1800,128,1936,5,8244,129,5,1770,30,123,5,1,0,5,0,1899,37,129,1770,7,30,136,1800,1,3,0,23
Pulaski,9/17/20,135,119,0,8408,111676,7625,120137,648,393463,8205,203,110204,1472,7468,157,122,13,615,33,118409,1728,8205,110204,256,1472,8461,111676,79,96,0,934
Randolph,9/17/20,22,121,0,370,4155,311,4525,37,17603,350,20,4132,23,304,7,18,4,28,9,4482,43,350,4132,20,23,370,4155,9,5,0,61
Saline,9/17/20,20,125,0,1901,24799,1742,26711,139,118009,1840,61,24456,343,1694,48,18,2,128,11,26296,415,1840,24456,72,343,1912,24799,18,16,1,451
Scott,9/17/20,1,127,0,94,1826,91,1920,2,10442,94,0,1826,0,91,0,1,0,2,0,1920,0,94,1826,0,0,94,1826,0,1,0,37
Searcy,9/17/20,0,129,0,138,1683,127,1820,11,7923,135,3,1668,15,124,3,0,0,11,0,1803,17,135,1668,2,15,137,1683,1,2,0,4
Sebastian,9/17/20,56,131,0,3345,36995,3023,40334,265,127461,3320,25,36985,10,3015,8,45,11,259,6,40305,29,3320,36985,19,10,3339,36995,68,23,0,478
Sevier,9/17/20,16,133,0,1188,6188,1156,7378,16,17193,1183,5,6174,14,1154,2,16,0,13,3,7357,21,1183,6174,7,14,1190,6188,2,2,0,27
Sharp,9/17/20,6,135,0,178,3268,148,3446,24,17043,176,2,3264,4,148,0,6,0,22,2,3440,6,176,3264,2,4,178,3268,5,2,0,26
St.Francis,9/17/20,4,123,0,1414,10732,1366,12147,44,26294,1414,0,10725,7,1366,0,4,0,44,0,12139,8,1414,10725,1,7,1415,10732,6,8,0,43
Stone,9/17/20,8,137,0,296,2929,229,3227,59,12446,289,7,2920,9,223,6,7,1,59,0,3209,18,289,2920,9,9,298,2929,3,-1,2,20
Union,9/17/20,31,139,0,833,7710,763,8542,38,39732,819,14,7680,30,758,5,26,5,34,4,8499,43,819,7680,13,30,832,7710,6,14,0,20
VanBuren,9/17/20,2,141,0,164,3403,145,3571,17,16684,164,0,3352,51,145,0,2,0,17,0,3516,55,164,3352,4,51,168,3403,1,1,0,8
Washington,9/17/20,105,143,0,8618,66609,7862,75285,651,228529,8367,251,66040,569,7711,151,89,16,567,84,74407,878,8367,66040,309,569,8676,66609,106,152,0,604
White,9/17/20,19,145,0,680,12213,608,12906,53,78804,631,49,11883,330,572,36,15,4,44,9,12514,392,631,11883,62,330,693,12213,17,17,0,156
Woodruff,9/17/20,0,147,0,39,1466,33,1506,6,6660,35,4,1458,8,29,4,0,0,6,0,1493,13,35,1458,5,8,40,1466,1,1,0,2
Yell,9/17/20,29,149,0,1219,8752,1167,9968,23,21573,1213,6,8712,40,1164,3,26,3,23,0,9925,43,1213,8712,3,40,1216,8752,6,2,0,110
Arkansas_all_counties,9/16/20,1157,5630,0,72219,781096,65147,853549,5911,2990671,70731,1488,773958,7138,64145,1002,1010,147,5572,339,844689,8860,70731,773958,1722,7138,72453,781096,862,730,7,-25996
Arkansas_county,9/16/20,4,1,0,327,4907,295,5242,28,18124,321,6,4711,196,291,4,4,0,26,2,5032,210,321,4711,14,196,335,4907,862,1,0,33
Ashley,9/16/20,8,3,0,406,4458,389,4866,9,20537,405,1,4440,18,388,1,8,0,9,0,4845,21,405,4440,3,18,408,4458,730,4,0,25
Baxter,9/16/20,1,5,0,226,3424,176,3652,49,41219,205,21,3409,15,158,18,1,0,46,3,3614,38,205,3409,23,15,228,3424,408,4,0,13
Benton,9/16/20,79,7,0,5983,64594,5603,70592,301,258980,5895,88,64422,172,5549,54,62,17,284,17,70317,275,5895,64422,103,172,5998,64594,509,38,0,457
Boone,9/16/20,8,9,0,569,8062,415,8629,146,37288,554,15,8049,13,406,9,6,2,142,4,8603,26,554,8049,13,13,567,8062,727,12,1,95
Bradley,9/16/20,7,11,0,327,3253,306,3579,14,10948,326,1,3250,3,306,0,6,1,14,0,3576,3,326,3250,0,3,326,3253,1180,2,0,20
Calhoun,9/16/20,0,13,0,31,1370,25,1401,6,5202,30,1,1366,4,24,1,0,0,6,0,1396,5,30,1366,1,4,31,1370,548,0,0,15
Carroll,9/16/20,9,15,0,582,6302,505,6884,68,27887,580,2,6299,3,504,1,9,0,67,1,6879,5,580,6299,2,3,582,6302,498,14,0,66
Chicot,9/16/20,17,17,0,986,4468,959,5455,10,10826,978,8,4457,11,952,7,16,1,10,0,5435,20,978,4457,9,11,987,4468,477,9,0,18
Clark,9/16/20,4,19,0,289,5346,259,5635,26,22385,285,4,5325,21,257,2,4,0,24,2,5610,25,285,5325,4,21,289,5346,356,3,0,57
Clay,9/16/20,7,21,0,244,3427,203,3670,33,15061,239,5,3422,5,201,2,5,2,32,1,3661,9,239,3422,4,5,243,3427,698,4,0,22
Cleburne,9/16/20,7,23,0,299,5074,269,5374,23,25230,289,10,4998,76,260,9,7,0,22,1,5287,87,289,4998,11,76,300,5074,548,1,0,46
Cleveland,9/16/20,10,25,0,165,2244,133,2409,22,8226,162,3,2223,21,131,2,9,1,22,0,2385,24,162,2223,3,21,165,2244,1174,2,0,13
Columbia,9/16/20,18,27,0,354,3925,306,4287,30,23892,346,8,3900,25,301,5,18,0,27,3,4246,41,346,3900,16,25,362,3925,1014,2,0,32
Conway,9/16/20,3,29,0,234,5304,217,5538,14,20906,232,2,5234,70,215,2,3,0,14,0,5466,72,232,5234,2,70,234,5304,1,0,0,32
Craighead,9/16/20,19,31,0,2454,27843,2099,30301,335,105701,2403,51,27807,36,2064,35,16,3,322,13,30210,91,2403,27807,55,36,2458,27843,37,51,0,276
Crawford,9/16/20,14,33,0,1144,16074,1005,17219,125,62472,1127,17,16067,7,995,10,11,3,121,4,17194,25,1127,16067,18,7,1145,16074,17,12,0,136
Crittenden,9/16/20,45,35,0,1833,12518,1696,14341,92,49013,1819,14,12514,4,1691,5,38,7,90,2,14333,8,1819,12514,4,4,1823,12518,17,19,0,59
Cross,9/16/20,7,37,0,384,3933,314,4313,63,16998,378,6,3923,10,310,4,5,2,63,0,4301,12,378,3923,2,10,380,3933,1,11,0,15
Dallas,9/16/20,2,39,0,152,1761,135,1913,15,7432,151,1,1752,9,134,1,2,0,15,0,1903,10,151,1752,1,9,152,1761,-2,2,0,12
Desha,9/16/20,5,41,0,268,3337,246,3605,17,11887,267,1,3316,21,245,1,5,0,17,0,3583,22,267,3316,1,21,268,3337,3,3,0,32
Drew,9/16/20,6,43,0,344,4915,323,5262,15,18502,333,11,4877,38,314,9,5,1,14,1,5210,52,333,4877,14,38,347,4915,8,6,0,37
Faulkner,9/16/20,15,45,0,2103,31839,1859,33954,229,122416,2042,61,31209,630,1809,50,12,3,221,8,33251,703,2042,31209,73,630,2115,31839,42,28,0,407
Franklin,9/16/20,2,47,0,225,4765,190,4989,33,17780,222,3,4757,8,187,3,2,0,33,0,4979,10,222,4757,2,8,224,4765,4,8,0,37
Fulton,9/16/20,2,49,0,111,1049,84,1161,25,12139,105,6,1048,1,83,1,1,1,21,4,1153,8,105,1048,7,1,112,1049,7,0,0,15
Garland,9/16/20,47,51,0,1671,24381,1503,26047,121,98296,1657,14,24307,74,1495,8,42,5,120,1,25964,83,1657,24307,9,74,1666,24381,13,17,2,394
Grant,9/16/20,2,53,0,226,4152,212,4383,12,18086,218,8,4114,38,204,8,2,0,12,0,4332,51,218,4114,13,38,231,4152,-1,1,0,42
Greene,9/16/20,7,55,0,747,11401,667,12152,73,44623,741,6,11341,60,664,3,7,0,70,3,12082,70,741,11341,10,60,751,11401,14,15,0,200
Hempstead,9/16/20,4,57,0,347,3790,337,4140,6,22018,343,4,3773,17,333,4,4,0,6,0,4116,24,343,3773,7,17,350,3790,3,1,0,14
HotSpring,9/16/20,25,59,0,1810,10109,1743,11917,42,33520,1805,5,10080,29,1740,3,23,2,42,0,11885,32,1805,10080,3,29,1808,10109,20,14,0,229
Howard,9/16/20,8,61,0,450,3383,429,3837,13,13389,447,3,3378,5,427,2,8,0,12,1,3825,12,447,3378,7,5,454,3383,0,2,0,6
Independence,9/16/20,13,63,0,962,9449,838,10420,111,37264,910,52,9416,33,801,37,12,1,97,14,10326,94,910,9416,61,33,971,9449,31,10,0,111
Izard,9/16/20,0,65,0,138,3030,117,3175,21,13559,133,5,3019,11,113,4,0,0,20,1,3152,23,133,3019,12,11,145,3030,5,0,0,20
Jackson,9/16/20,1,67,0,267,5567,206,5853,60,17225,237,30,5557,10,198,8,1,0,38,22,5794,59,237,5557,49,10,286,5567,19,3,0,47
Jefferson,9/16/20,60,69,0,2623,24802,2221,27428,342,70424,2591,32,24663,139,2203,18,55,5,333,9,27254,174,2591,24663,35,139,2626,24802,35,33,0,377
Johnson,9/16/20,5,71,0,808,6347,786,7156,17,26291,806,2,6324,23,785,1,5,0,16,1,7130,26,806,6324,3,23,809,6347,3,2,0,24
Lafayette,9/16/20,2,73,0,84,844,78,929,4,6915,84,0,842,2,78,0,2,0,4,0,926,3,84,842,1,2,85,844,4,2,0,6
Lawrence,9/16/20,11,75,0,331,3515,271,3849,49,16669,306,25,3504,11,258,13,11,0,37,12,3810,39,306,3504,28,11,334,3515,10,9,0,79
Lee,9/16/20,16,77,0,1041,3531,1008,4572,17,9398,1039,2,3526,5,1008,0,15,1,16,1,4565,7,1039,3526,2,5,1041,3531,14,13,0,60
Lincoln,9/16/20,15,79,0,1802,5967,1616,7777,171,13695,1800,2,5957,10,1615,1,14,1,171,0,7757,20,1800,5957,10,10,1810,5967,10,12,0,36
LittleRiver,9/16/20,23,81,0,332,1569,297,1894,12,12417,322,10,1561,8,292,5,18,5,12,0,1883,11,322,1561,3,8,325,1569,1,2,0,5
Logan,9/16/20,1,83,0,383,5818,372,6203,10,21757,383,0,5810,8,372,0,1,0,10,0,6193,10,383,5810,2,8,385,5818,0,1,0,32
Lonoke,9/16/20,9,85,0,965,15581,865,16586,91,72206,869,96,14755,826,788,77,7,2,74,17,15624,962,869,14755,136,826,1005,15581,18,19,0,324
Madison,9/16/20,2,87,0,321,3653,309,3976,10,16076,315,6,3642,11,305,4,2,0,8,2,3957,19,315,3642,8,11,323,3653,2,1,0,20
Marion,9/16/20,0,89,0,67,1982,54,2050,13,16438,64,3,1975,7,54,0,0,0,10,3,2039,11,64,1975,4,7,68,1982,3,0,0,14
Miller,9/16/20,11,91,0,747,5885,679,6633,57,43759,727,20,5853,32,660,19,10,1,57,0,6580,53,727,5853,21,32,748,5885,22,21,0,45
MissingCountyInfo,9/16/20,0,5,0,1458,27440,964,28881,494,NA,1306,152,26162,1278,851,113,0,0,455,39,27468,1413,1306,26162,135,1278,1441,27440,-137,-60,0,40
Mississippi,9/16/20,48,93,0,1542,10523,1405,12054,89,42831,1522,20,10519,4,1398,7,37,11,87,2,12041,13,1522,10519,9,4,1531,10523,22,20,0,91
Monroe,9/16/20,0,95,0,105,2005,100,2110,5,7249,105,0,1991,14,100,0,0,0,5,0,2096,14,105,1991,0,14,105,2005,0,1,0,9
Montgomery,9/16/20,4,97,0,123,1816,111,1939,8,8993,122,1,1801,15,110,1,4,0,8,0,1923,16,122,1801,1,15,123,1816,0,7,0,10
Nevada,9/16/20,13,99,0,187,2444,158,2629,16,8440,185,2,2436,8,157,1,12,1,16,0,2621,8,185,2436,0,8,185,2444,1,0,0,34
Newton,9/16/20,18,101,0,186,1464,133,1647,35,7848,181,5,1464,0,131,2,15,3,35,0,1645,2,181,1464,2,0,183,1464,2,12,0,15
Ouachita,9/16/20,6,103,0,225,4681,182,4909,37,24106,221,4,4660,21,179,3,6,0,36,1,4881,28,221,4660,7,21,228,4681,5,4,0,41
Perry,9/16/20,0,105,0,77,2447,68,2524,9,10322,73,4,2391,56,64,4,0,0,9,0,2464,60,73,2391,4,56,77,2447,4,0,0,27
Phillips,9/16/20,11,107,0,442,5564,412,6008,19,19034,440,2,5537,27,410,2,11,0,19,0,5977,31,440,5537,4,27,444,5564,5,2,0,61
Pike,9/16/20,3,109,0,215,1924,193,2138,19,10808,213,2,1908,16,192,1,2,1,19,0,2121,17,213,1908,1,16,214,1924,0,4,0,8
Poinsett,9/16/20,9,111,0,587,6658,520,7242,58,24054,579,8,6653,5,513,7,8,1,58,0,7232,10,579,6653,5,5,584,6658,8,8,1,141
Polk,9/16/20,4,113,0,249,3484,234,3733,11,20163,247,2,3482,2,233,1,4,0,10,1,3729,4,247,3482,2,2,249,3484,0,2,0,14
Pope,9/16/20,28,115,0,1971,18167,1868,20132,75,63644,1959,12,18054,113,1861,7,23,5,75,0,20013,119,1959,18054,6,113,1965,18167,8,12,0,85
Prairie,9/16/20,1,117,0,133,1778,125,1913,7,8244,128,5,1748,30,120,5,1,0,7,0,1876,37,128,1748,7,30,135,1778,0,2,0,30
Pulaski,9/16/20,135,119,0,8329,110820,7529,119203,665,393463,8132,197,109418,1402,7376,153,122,13,634,31,117550,1653,8132,109418,251,1402,8383,110820,98,103,0,1094
Randolph,9/16/20,22,121,0,361,4104,306,4464,33,17603,345,16,4083,21,301,5,18,4,26,7,4428,36,345,4083,15,21,360,4104,9,1,0,46
Saline,9/16/20,19,125,0,1883,24366,1726,26260,138,118009,1824,59,24040,326,1678,48,17,2,129,9,25864,396,1824,24040,70,326,1894,24366,27,32,0,564
Scott,9/16/20,1,127,0,94,1789,90,1883,3,10442,94,0,1789,0,90,0,1,0,3,0,1883,0,94,1789,0,0,94,1789,1,1,0,85
Searcy,9/16/20,0,129,0,137,1680,125,1816,12,7923,134,3,1665,15,122,3,0,0,12,0,1799,17,134,1665,2,15,136,1680,5,5,0,14
Sebastian,9/16/20,56,131,0,3277,36586,3000,39856,220,127461,3252,25,36576,10,2993,7,45,11,213,7,39828,28,3252,36576,18,10,3270,36586,24,29,1,395
Sevier,9/16/20,16,133,0,1186,6162,1154,7351,16,17193,1184,2,6148,14,1153,1,16,0,15,1,7332,19,1184,6148,5,14,1189,6162,1,0,0,6
Sharp,9/16/20,6,135,0,173,3247,146,3420,21,17043,171,2,3243,4,146,0,6,0,19,2,3414,6,171,3243,2,4,173,3247,3,1,0,51
St.Francis,9/16/20,4,123,0,1408,10696,1358,12104,46,26294,1408,0,10689,7,1358,0,4,0,46,0,12097,7,1408,10689,0,7,1408,10696,10,4,0,79
Stone,9/16/20,6,137,0,293,2912,230,3207,57,12446,286,7,2904,8,223,7,6,0,57,0,3190,17,286,2904,9,8,295,2912,10,4,1,50
Union,9/16/20,31,139,0,827,7696,749,8522,46,39732,814,13,7666,30,745,4,26,5,42,4,8480,42,814,7666,12,30,826,7696,11,16,0,24
VanBuren,9/16/20,2,141,0,163,3396,144,3563,17,16684,163,0,3350,46,144,0,2,0,17,0,3513,50,163,3350,4,46,167,3396,4,9,0,13
Washington,9/16/20,105,143,0,8512,66111,7710,74681,697,228529,8292,220,65587,524,7580,130,89,16,623,74,73879,802,8292,65587,278,524,8570,66111,116,155,0,550
White,9/16/20,19,145,0,663,12075,591,12750,53,78804,619,44,11759,316,558,33,15,4,46,7,12378,372,619,11759,56,316,675,12075,11,9,1,85
Woodruff,9/16/20,0,147,0,38,1465,32,1504,6,6660,34,4,1457,8,29,3,0,0,5,1,1491,13,34,1457,5,8,39,1465,2,1,0,8
Yell,9/16/20,29,149,0,1213,8648,1165,9858,19,21573,1207,6,8606,42,1162,3,26,3,19,0,9813,45,1207,8606,3,42,1210,8648,7,7,0,36
Arkansas_all_counties,9/15/20,1010,5630,0,71357,807698,64342,879417,6001,2990671,70125,1232,800759,6939,63415,927,1003,7,5703,298,870884,8533,70125,800759,1594,6939,71719,807698,730,675,17,44022
Arkansas_county,9/15/20,4,1,0,319,4886,294,5213,21,18124,313,6,4690,196,290,4,4,0,19,2,5003,210,313,4690,14,196,327,4886,3,2,0,90
Ashley,9/15/20,8,3,0,403,4444,385,4848,10,20537,403,0,4427,17,385,0,8,0,10,0,4830,18,403,4427,1,17,404,4444,0,1,0,46
Baxter,9/15/20,1,5,0,222,3414,172,3638,49,41219,201,21,3399,15,154,18,1,0,46,3,3600,38,201,3399,23,15,224,3414,10,10,0,81
Benton,9/15/20,62,7,0,5923,64227,5565,70183,296,258980,5856,67,64144,83,5516,49,62,0,278,18,70000,183,5856,64144,100,83,5956,64227,61,49,0,1085
Boone,9/15/20,5,9,0,553,7981,403,8535,145,37288,541,12,7968,13,395,8,5,0,141,4,8509,26,541,7968,13,13,554,7981,20,13,0,297
Bradley,9/15/20,6,11,0,323,3236,304,3559,13,10948,323,0,3233,3,304,0,6,0,13,0,3556,3,323,3233,0,3,323,3236,2,2,0,16
Calhoun,9/15/20,0,13,0,31,1356,25,1387,6,5202,30,1,1352,4,24,1,0,0,6,0,1382,5,30,1352,1,4,31,1356,2,1,0,19
Carroll,9/15/20,9,15,0,573,6245,491,6818,73,27887,571,2,6242,3,490,1,9,0,72,1,6813,5,571,6242,2,3,573,6245,18,11,0,115
Chicot,9/15/20,16,17,0,976,4472,950,5448,10,10826,975,1,4461,11,949,1,16,0,10,0,5436,12,975,4461,1,11,976,4472,0,0,0,53
Clark,9/15/20,4,19,0,286,5300,256,5586,26,22385,282,4,5280,20,254,2,4,0,24,2,5562,24,282,5280,4,20,286,5300,3,2,0,43
Clay,9/15/20,5,21,0,241,3416,199,3658,36,15061,238,3,3411,5,197,2,5,0,35,1,3649,9,238,3411,4,5,242,3416,5,4,0,52
Cleburne,9/15/20,7,23,0,299,5027,268,5328,24,25230,289,10,4954,73,259,9,7,0,23,1,5243,85,289,4954,12,73,301,5027,4,6,0,28
Cleveland,9/15/20,9,25,0,163,2232,131,2396,23,8226,161,2,2211,21,129,2,9,0,23,0,2372,24,161,2211,3,21,164,2232,2,2,0,24
Columbia,9/15/20,18,27,0,348,3928,304,4284,26,23892,341,7,3914,14,299,5,18,0,24,2,4255,29,341,3914,15,14,356,3928,3,7,0,66
Conway,9/15/20,3,29,0,233,5273,217,5506,13,20906,231,2,5203,70,215,2,3,0,13,0,5434,72,231,5203,2,70,233,5273,0,2,0,32
Craighead,9/15/20,16,31,0,2414,27748,2048,30169,349,105701,2375,39,27712,36,2022,26,16,0,336,13,30087,82,2375,27712,46,36,2421,27748,25,32,0,343
Crawford,9/15/20,11,33,0,1124,16001,993,17129,120,62472,1112,12,15994,7,984,9,11,0,117,3,17106,23,1112,15994,16,7,1128,16001,16,16,0,316
Crittenden,9/15/20,38,35,0,1809,12482,1677,14288,94,49013,1804,5,12478,4,1673,4,38,0,93,1,14282,6,1804,12478,2,4,1806,12482,7,17,1,73
Cross,9/15/20,5,37,0,381,3924,303,4303,73,16998,377,4,3914,10,299,4,5,0,73,0,4291,12,377,3914,2,10,379,3924,4,2,0,26
Dallas,9/15/20,2,39,0,154,1748,133,1902,19,7432,153,1,1739,9,132,1,2,0,19,0,1892,10,153,1739,1,9,154,1748,0,2,0,8
Desha,9/15/20,5,41,0,265,3312,243,3577,17,11887,264,1,3291,21,243,0,5,0,16,1,3555,22,264,3291,1,21,265,3312,5,2,0,75
Drew,9/15/20,5,43,0,335,4894,317,5232,13,18502,330,5,4856,38,313,4,5,0,12,1,5186,46,330,4856,8,38,338,4894,2,2,0,60
Faulkner,9/15/20,14,45,0,2060,31456,1831,33529,215,122416,2002,58,30828,628,1784,47,12,2,206,9,32830,699,2002,30828,71,628,2073,31456,29,27,2,300
Franklin,9/15/20,2,47,0,221,4741,182,4961,37,17780,218,3,4734,7,179,3,2,0,37,0,4952,9,218,4734,2,7,220,4741,8,2,0,61
Fulton,9/15/20,2,49,0,104,1042,84,1147,18,12139,101,3,1041,1,83,1,1,1,17,1,1142,5,101,1041,4,1,105,1042,6,1,1,19
Garland,9/15/20,40,51,0,1653,24018,1486,25671,127,98296,1645,8,23944,74,1478,8,40,0,127,0,25589,82,1645,23944,8,74,1653,24018,23,25,3,410
Grant,9/15/20,2,53,0,227,4104,211,4336,14,18086,218,9,4067,37,202,9,2,0,14,0,4285,51,218,4067,14,37,232,4104,5,3,1,32
Greene,9/15/20,7,55,0,733,11234,652,11971,74,44623,728,5,11196,38,649,3,7,0,72,2,11924,47,728,11196,9,38,737,11234,15,5,0,199
Hempstead,9/15/20,4,57,0,344,3787,336,4134,4,22018,340,4,3770,17,332,4,4,0,4,0,4110,24,340,3770,7,17,347,3787,0,0,0,42
HotSpring,9/15/20,23,59,0,1788,9918,1729,11706,36,33520,1785,3,9889,29,1726,3,23,0,36,0,11674,32,1785,9889,3,29,1788,9918,1,6,0,151
Howard,9/15/20,8,61,0,450,3404,427,3858,15,13389,447,3,3399,5,425,2,8,0,14,1,3846,12,447,3399,7,5,454,3404,2,1,0,36
Independence,9/15/20,12,63,0,930,9385,828,10324,90,37264,893,37,9361,24,795,33,12,0,86,4,10254,70,893,9361,46,24,939,9385,19,9,0,345
Izard,9/15/20,0,65,0,133,3017,117,3157,16,13559,129,4,3006,11,113,4,0,0,16,0,3135,22,129,3006,11,11,140,3017,3,3,0,31
Jackson,9/15/20,1,67,0,248,5547,203,5810,44,17225,236,12,5537,10,197,6,1,0,38,6,5773,37,236,5537,27,10,263,5547,5,4,0,19
Jefferson,9/15/20,55,69,0,2583,24476,2188,27067,340,70424,2561,22,24338,138,2170,18,55,0,336,4,26899,168,2561,24338,30,138,2591,24476,28,33,0,383
Johnson,9/15/20,5,71,0,805,6333,784,7139,16,26291,803,2,6310,23,782,2,5,0,16,0,7113,26,803,6310,3,23,806,6333,4,2,1,56
Lafayette,9/15/20,2,73,0,80,850,76,931,2,6915,80,0,848,2,76,0,2,0,2,0,928,3,80,848,1,2,81,850,0,1,0,17
Lawrence,9/15/20,11,75,0,321,3454,262,3778,48,16669,300,21,3444,10,251,11,11,0,38,10,3744,34,300,3444,24,10,324,3454,8,5,0,96
Lee,9/15/20,15,77,0,1026,3486,995,4512,16,9398,1025,1,3481,5,995,0,15,0,15,1,4506,6,1025,3481,1,5,1026,3486,2,-1,0,6
Lincoln,9/15/20,14,79,0,1791,5951,1604,7745,173,13695,1791,0,5941,10,1604,0,14,0,173,0,7732,13,1791,5941,3,10,1794,5951,6,7,1,34
LittleRiver,9/15/20,18,81,0,326,1565,295,1889,13,12417,321,5,1557,8,290,5,18,0,13,0,1878,11,321,1557,3,8,324,1565,3,2,0,12
Logan,9/15/20,1,83,0,383,5829,371,6214,11,21757,383,0,5821,8,371,0,1,0,11,0,6204,10,383,5821,2,8,385,5829,2,4,0,124
Lonoke,9/15/20,7,85,0,945,15284,846,16271,92,72206,853,92,14462,822,771,75,7,0,75,17,15315,956,853,14462,134,822,987,15284,15,18,0,325
Madison,9/15/20,2,87,0,319,3636,308,3957,9,16076,313,6,3625,11,304,4,2,0,7,2,3938,19,313,3625,8,11,321,3636,0,2,0,24
Marion,9/15/20,0,89,0,64,1971,54,2036,10,16438,61,3,1964,7,54,0,0,0,7,3,2025,11,61,1964,4,7,65,1971,2,5,0,45
Miller,9/15/20,10,91,0,724,5872,658,6598,56,43759,705,19,5840,32,639,19,10,0,56,0,6545,53,705,5840,21,32,726,5872,2,10,0,24
MissingCountyInfo,9/15/20,0,5,0,1595,59739,1024,61320,571,NA,1442,153,58461,1278,911,113,0,0,531,40,59903,1417,1442,58461,139,1278,1581,59739,-33,-13,0,32866
Mississippi,9/15/20,37,93,0,1509,10461,1385,11970,87,42831,1501,8,10458,3,1379,6,37,0,85,2,11959,11,1501,10458,8,3,1509,10461,3,7,0,80
Monroe,9/15/20,0,95,0,105,1995,99,2100,6,7249,105,0,1981,14,99,0,0,0,6,0,2086,14,105,1981,0,14,105,1995,2,2,0,20
Montgomery,9/15/20,4,97,0,123,1808,104,1931,15,8993,122,1,1793,15,103,1,4,0,15,0,1915,16,122,1793,1,15,123,1808,0,1,0,5
Nevada,9/15/20,12,99,0,185,2413,158,2597,15,8440,184,1,2405,8,157,1,12,0,15,0,2589,8,184,2405,0,8,184,2413,3,2,0,61
Newton,9/15/20,16,101,0,182,1451,121,1632,45,7848,179,3,1451,0,119,2,15,1,45,0,1630,2,179,1451,2,0,181,1451,7,4,0,14
Ouachita,9/15/20,6,103,0,220,4658,178,4880,36,24106,216,4,4637,21,175,3,6,0,35,1,4853,27,216,4637,6,21,222,4658,6,7,1,58
Perry,9/15/20,0,105,0,73,2417,68,2490,5,10322,69,4,2359,58,64,4,0,0,5,0,2428,62,69,2359,4,58,73,2417,0,0,0,7
Phillips,9/15/20,11,107,0,437,5515,410,5954,16,19034,435,2,5488,27,408,2,11,0,16,0,5923,31,435,5488,4,27,439,5515,3,1,0,31
Pike,9/15/20,2,109,0,214,1915,189,2129,23,10808,213,1,1899,16,188,1,2,0,23,0,2112,17,213,1899,1,16,214,1915,2,1,0,24
Poinsett,9/15/20,7,111,0,578,6550,512,7126,59,24054,571,7,6545,5,505,7,7,0,59,0,7116,10,571,6545,5,5,576,6550,9,2,0,110
Polk,9/15/20,4,113,0,249,3485,232,3734,13,20163,247,2,3483,2,231,1,4,0,12,1,3730,4,247,3483,2,2,249,3485,1,1,0,76
Pope,9/15/20,24,115,0,1959,18070,1856,20027,79,63644,1951,8,17960,110,1849,7,23,1,79,0,19911,116,1951,17960,6,110,1957,18070,12,22,0,188
Prairie,9/15/20,1,117,0,133,1747,123,1882,9,8244,128,5,1717,30,118,5,1,0,9,0,1845,37,128,1717,7,30,135,1747,2,1,0,7
Pulaski,9/15/20,123,119,0,8219,110068,7426,118354,670,393463,8041,178,108689,1379,7286,140,122,1,633,37,116730,1624,8041,108689,245,1379,8286,110068,89,98,2,1644
Randolph,9/15/20,18,121,0,348,4076,305,4427,25,17603,341,7,4058,18,301,4,18,0,22,3,4399,28,341,4058,10,18,351,4076,7,2,0,97
Saline,9/15/20,18,125,0,1855,23903,1694,25770,143,118009,1802,53,23588,315,1649,45,17,1,136,7,25390,380,1802,23588,65,315,1867,23903,13,11,1,267
Scott,9/15/20,1,127,0,93,1708,89,1801,3,10442,93,0,1708,0,89,0,1,0,3,0,1801,0,93,1708,0,0,93,1708,0,0,0,95
Searcy,9/15/20,0,129,0,132,1675,120,1806,12,7923,129,3,1660,15,117,3,0,0,12,0,1789,17,129,1660,2,15,131,1675,4,1,0,33
Sebastian,9/15/20,44,131,0,3242,36331,2971,39577,226,127461,3231,11,36321,10,2964,7,44,0,222,4,39552,25,3231,36321,15,10,3246,36331,50,36,3,824
Sevier,9/15/20,16,133,0,1185,6157,1154,7345,15,17193,1183,2,6144,13,1152,2,16,0,15,0,7327,18,1183,6144,5,13,1188,6157,2,4,0,91
Sharp,9/15/20,6,135,0,170,3202,145,3372,19,17043,169,1,3199,3,145,0,6,0,18,1,3368,4,169,3199,1,3,170,3202,3,1,0,39
St.Francis,9/15/20,4,123,0,1398,10629,1354,12027,40,26294,1398,0,10622,7,1354,0,4,0,40,0,12020,7,1398,10622,0,7,1398,10629,10,3,0,205
Stone,9/15/20,5,137,0,283,2872,226,3157,52,12446,276,7,2863,9,219,7,5,0,52,0,3139,18,276,2863,9,9,285,2872,1,4,0,30
Union,9/15/20,26,139,0,811,7729,733,8544,51,39732,804,7,7699,30,729,4,26,0,48,3,8503,41,804,7699,11,30,815,7729,10,16,1,96
VanBuren,9/15/20,2,141,0,159,3396,135,3558,22,16684,159,0,3345,51,135,0,2,0,22,0,3504,54,159,3345,3,51,162,3396,2,3,0,96
Washington,9/15/20,89,143,0,8380,65811,7555,74264,736,228529,8185,195,65289,522,7440,115,89,0,656,80,73474,790,8185,65289,268,522,8453,65811,136,148,0,1059
White,9/15/20,14,145,0,648,12043,582,12707,52,78804,609,39,11741,302,549,33,14,0,46,6,12350,357,609,11741,55,302,664,12043,5,12,0,253
Woodruff,9/15/20,0,147,0,36,1462,31,1499,5,6660,33,3,1454,8,28,3,0,0,5,0,1487,12,33,1454,4,8,37,1462,0,0,0,18
Yell,9/15/20,26,149,0,1203,8506,1158,9709,19,21573,1201,2,8466,40,1156,2,26,0,19,0,9667,42,1201,8466,2,40,1203,8506,1,5,0,-51
Arkansas_all_counties,9/14/20,992,5630,0,70627,764352,63601,835335,6030,2990671,69449,1178,757640,6712,62740,861,986,6,5719,311,827089,8246,69449,757640,1534,6712,70983,764352,408,497,10,6240
Arkansas_county,9/14/20,4,1,0,316,4799,292,5123,20,18124,310,6,4603,196,288,4,4,0,18,2,4913,210,310,4603,14,196,324,4799,2,3,0,120
Ashley,9/14/20,8,3,0,403,4398,384,4802,11,20537,403,0,4381,17,384,0,8,0,11,0,4784,18,403,4381,1,17,404,4398,3,1,0,60
Baxter,9/14/20,1,5,0,212,3343,162,3557,49,41219,192,20,3336,7,145,17,1,0,46,3,3528,29,192,3336,22,7,214,3343,5,3,0,20
Benton,9/14/20,62,7,0,5862,63203,5516,69098,284,258980,5806,56,63120,83,5475,41,62,0,269,15,68926,172,5806,63120,89,83,5895,63203,13,26,0,203
Boone,9/14/20,5,9,0,533,7704,390,8238,138,37288,521,12,7691,13,383,7,5,0,133,5,8212,26,521,7691,13,13,534,7704,2,11,0,167
Bradley,9/14/20,6,11,0,321,3222,302,3543,13,10948,321,0,3220,2,302,0,6,0,13,0,3541,2,321,3220,0,2,321,3222,0,4,0,21
Calhoun,9/14/20,0,13,0,29,1339,24,1368,5,5202,28,1,1335,4,23,1,0,0,5,0,1363,5,28,1335,1,4,29,1339,1,0,0,12
Carroll,9/14/20,9,15,0,555,6148,480,6703,66,27887,553,2,6145,3,479,1,9,0,65,1,6698,5,553,6145,2,3,555,6148,9,6,0,68
Chicot,9/14/20,16,17,0,976,4419,950,5395,10,10826,975,1,4408,11,949,1,16,0,10,0,5383,12,975,4408,1,11,976,4419,0,-1,2,14
Clark,9/14/20,4,19,0,283,5260,254,5543,25,22385,279,4,5241,19,252,2,4,0,23,2,5520,23,279,5241,4,19,283,5260,6,5,0,36
Clay,9/14/20,5,21,0,236,3370,195,3606,35,15061,233,3,3367,3,193,2,5,0,34,1,3600,6,233,3367,3,3,236,3370,7,8,0,26
Cleburne,9/14/20,7,23,0,295,5004,262,5300,26,25230,286,9,4932,72,255,7,7,0,24,2,5218,82,286,4932,10,72,296,5004,2,2,0,37
Cleveland,9/14/20,9,25,0,161,2210,129,2372,23,8226,159,2,2192,18,128,1,9,0,22,1,2351,21,159,2192,3,18,162,2210,2,0,0,16
Columbia,9/14/20,18,27,0,345,3865,297,4218,30,23892,339,6,3851,14,292,5,18,0,29,1,4190,28,339,3851,14,14,353,3865,6,2,1,33
Conway,9/14/20,3,29,0,233,5241,215,5474,15,20906,231,2,5170,71,213,2,3,0,15,0,5401,73,231,5170,2,71,233,5241,2,0,0,47
Craighead,9/14/20,16,31,0,2389,27431,2016,29826,356,105701,2352,37,27396,35,1993,23,16,0,342,14,29748,78,2352,27396,43,35,2395,27431,29,47,0,349
Crawford,9/14/20,11,33,0,1108,15701,977,16813,120,62472,1096,12,15694,7,968,9,11,0,117,3,16790,23,1096,15694,16,7,1112,15701,20,13,1,206
Crittenden,9/14/20,37,35,0,1802,12415,1660,14215,105,49013,1800,2,12411,4,1658,2,37,0,105,0,14211,4,1800,12411,0,4,1800,12415,1,8,1,30
Cross,9/14/20,5,37,0,377,3902,301,4277,71,16998,373,4,3892,10,297,4,5,0,71,0,4265,12,373,3892,2,10,375,3902,10,3,0,114
Dallas,9/14/20,2,39,0,154,1740,131,1894,21,7432,153,1,1732,8,130,1,2,0,21,0,1885,9,153,1732,1,8,154,1740,0,0,0,14
Desha,9/14/20,5,41,0,260,3242,241,3502,14,11887,259,1,3224,18,241,0,5,0,13,1,3483,19,259,3224,1,18,260,3242,0,2,0,15
Drew,9/14/20,5,43,0,333,4836,315,5172,13,18502,329,4,4800,36,312,3,5,0,12,1,5129,43,329,4800,7,36,336,4836,1,2,0,25
Faulkner,9/14/20,12,45,0,2031,31187,1804,33229,215,122416,1978,53,30593,594,1762,42,10,2,206,9,32571,658,1978,30593,64,594,2042,31187,19,22,0,235
Franklin,9/14/20,2,47,0,213,4688,180,4900,31,17780,210,3,4681,7,177,3,2,0,31,0,4891,9,210,4681,2,7,212,4688,1,2,0,104
Fulton,9/14/20,1,49,0,98,1029,83,1128,14,12139,95,3,1028,1,81,2,1,0,13,1,1123,5,95,1028,4,1,99,1029,0,3,0,7
Garland,9/14/20,37,51,0,1630,23631,1461,25261,132,98296,1623,7,23561,70,1456,5,37,0,130,2,25184,77,1623,23561,7,70,1630,23631,6,12,1,200
Grant,9/14/20,1,53,0,222,4077,208,4304,13,18086,215,7,4040,37,201,7,1,0,13,0,4255,49,215,4040,12,37,227,4077,0,3,0,46
Greene,9/14/20,7,55,0,718,11050,647,11772,64,44623,714,4,11037,13,645,2,7,0,62,2,11751,21,714,11037,8,13,722,11050,3,7,0,84
Hempstead,9/14/20,4,57,0,344,3745,336,4092,4,22018,340,4,3729,16,332,4,4,0,4,0,4069,23,340,3729,7,16,347,3745,0,1,0,59
HotSpring,9/14/20,23,59,0,1787,9768,1723,11555,41,33520,1784,3,9740,28,1720,3,23,0,41,0,11524,31,1784,9740,3,28,1787,9768,4,2,0,106
Howard,9/14/20,8,61,0,448,3370,426,3822,14,13389,446,2,3365,5,424,2,8,0,14,0,3811,11,446,3365,6,5,452,3370,0,1,0,11
Independence,9/14/20,12,63,0,911,9059,819,9979,80,37264,874,37,9040,19,786,33,12,0,76,4,9914,65,874,9040,46,19,920,9059,5,7,0,68
Izard,9/14/20,0,65,0,130,2989,114,3126,16,13559,127,3,2983,6,111,3,0,0,16,0,3110,16,127,2983,10,6,137,2989,2,3,0,19
Jackson,9/14/20,1,67,0,243,5533,199,5791,43,17225,233,10,5523,10,193,6,1,0,39,4,5756,35,233,5523,25,10,258,5533,0,1,0,24
Jefferson,9/14/20,55,69,0,2555,24121,2155,26684,345,70424,2534,21,23987,134,2138,17,55,0,341,4,26521,163,2534,23987,29,134,2563,24121,41,20,0,482
Johnson,9/14/20,4,71,0,801,6281,782,7083,15,26291,800,1,6258,23,781,1,4,0,15,0,7058,25,800,6258,2,23,802,6281,2,4,0,45
Lafayette,9/14/20,2,73,0,80,833,75,914,3,6915,80,0,832,1,75,0,2,0,3,0,912,2,80,832,1,1,81,833,0,2,0,4
Lawrence,9/14/20,11,75,0,313,3367,257,3682,45,16669,294,19,3360,7,246,11,11,0,37,8,3654,28,294,3360,21,7,315,3367,0,4,0,27
Lee,9/14/20,15,77,0,1024,3482,996,4506,13,9398,1023,1,3477,5,996,0,15,0,12,1,4500,6,1023,3477,1,5,1024,3482,3,4,0,23
Lincoln,9/14/20,13,79,0,1785,5923,1597,7711,175,13695,1785,0,5914,9,1597,0,13,0,175,0,7699,12,1785,5914,3,9,1788,5923,5,2,0,28
LittleRiver,9/14/20,18,81,0,323,1556,293,1877,12,12417,318,5,1549,7,288,5,18,0,12,0,1867,10,318,1549,3,7,321,1556,0,0,0,10
Logan,9/14/20,1,83,0,381,5707,367,6090,13,21757,381,0,5699,8,367,0,1,0,13,0,6080,10,381,5699,2,8,383,5707,0,1,0,67
Lonoke,9/14/20,7,85,0,930,14975,828,15946,95,72206,846,84,14162,813,763,65,7,0,76,19,15008,938,846,14162,125,813,971,14975,10,8,0,162
Madison,9/14/20,2,87,0,319,3612,306,3933,11,16076,313,6,3601,11,302,4,2,0,9,2,3914,19,313,3601,8,11,321,3612,0,1,0,9
Marion,9/14/20,0,89,0,62,1928,49,1991,13,16438,59,3,1924,4,49,0,0,0,10,3,1983,8,59,1924,4,4,63,1928,2,0,0,12
Miller,9/14/20,10,91,0,722,5850,648,6574,64,43759,705,17,5821,29,631,17,10,0,64,0,6526,48,705,5821,19,29,724,5850,5,5,0,65
MissingCountyInfo,9/14/20,0,5,0,1628,26840,1037,28454,591,NA,1450,178,25561,1279,898,139,0,0,552,39,27011,1443,1450,25561,164,1279,1614,26840,-13,6,0,-970
Mississippi,9/14/20,37,93,0,1506,10384,1378,11890,91,42831,1498,8,10381,3,1372,6,37,0,89,2,11879,11,1498,10381,8,3,1506,10384,7,12,0,48
Monroe,9/14/20,0,95,0,103,1977,97,2080,6,7249,103,0,1963,14,97,0,0,0,6,0,2066,14,103,1963,0,14,103,1977,1,1,0,13
Montgomery,9/14/20,4,97,0,123,1803,103,1926,16,8993,122,1,1788,15,102,1,4,0,16,0,1910,16,122,1788,1,15,123,1803,2,0,0,22
Nevada,9/14/20,12,99,0,182,2355,156,2536,14,8440,181,1,2347,8,156,0,12,0,13,1,2528,8,181,2347,0,8,181,2355,5,1,0,11
Newton,9/14/20,16,101,0,175,1444,117,1618,42,7848,172,3,1444,0,116,1,15,1,41,1,1616,2,172,1444,2,0,174,1444,3,2,0,23
Ouachita,9/14/20,5,103,0,214,4606,171,4822,38,24106,211,3,4587,19,169,2,5,0,37,1,4798,24,211,4587,5,19,216,4606,2,3,0,65
Perry,9/14/20,0,105,0,73,2410,68,2483,5,10322,69,4,2357,53,64,4,0,0,5,0,2426,57,69,2357,4,53,73,2410,1,0,0,20
Phillips,9/14/20,11,107,0,434,5487,409,5923,14,19034,432,2,5460,27,407,2,11,0,14,0,5892,31,432,5460,4,27,436,5487,2,0,1,34
Pike,9/14/20,2,109,0,212,1893,188,2105,22,10808,211,1,1878,15,187,1,2,0,22,0,2089,16,211,1878,1,15,212,1893,0,3,0,8
Poinsett,9/14/20,7,111,0,569,6449,510,7016,52,24054,562,7,6444,5,503,7,7,0,52,0,7006,10,562,6444,5,5,567,6449,5,5,0,74
Polk,9/14/20,4,113,0,248,3410,231,3658,13,20163,246,2,3408,2,230,1,4,0,12,1,3654,4,246,3408,2,2,248,3410,1,0,0,31
Pope,9/14/20,24,115,0,1947,17894,1834,19839,89,63644,1939,8,17785,109,1827,7,23,1,89,0,19724,115,1939,17785,6,109,1945,17894,4,12,1,62
Prairie,9/14/20,1,117,0,131,1742,122,1875,8,8244,127,4,1712,30,118,4,1,0,8,0,1839,36,127,1712,6,30,133,1742,0,3,0,18
Pulaski,9/14/20,121,119,0,8130,108512,7328,116710,681,393463,7962,168,107155,1357,7202,126,120,1,640,41,115117,1593,7962,107155,236,1357,8198,108512,63,54,0,1607
Randolph,9/14/20,18,121,0,341,3986,303,4330,20,17603,335,6,3973,13,300,3,18,0,17,3,4308,22,335,3973,9,13,344,3986,2,1,0,35
Saline,9/14/20,17,125,0,1842,23649,1683,25503,142,118009,1790,52,23337,312,1641,42,16,1,133,9,25127,376,1790,23337,64,312,1854,23649,9,21,0,359
Scott,9/14/20,1,127,0,93,1613,89,1706,3,10442,93,0,1613,0,89,0,1,0,3,0,1706,0,93,1613,0,0,93,1613,1,1,0,13
Searcy,9/14/20,0,129,0,128,1646,119,1773,9,7923,125,3,1630,16,116,3,0,0,9,0,1755,18,125,1630,2,16,127,1646,1,6,0,12
Sebastian,9/14/20,41,131,0,3192,35557,2935,38753,215,127461,3181,11,35547,10,2928,7,41,0,211,4,38728,25,3181,35547,15,10,3196,35557,17,14,1,404
Sevier,9/14/20,16,133,0,1183,6068,1150,7254,17,17193,1182,1,6058,10,1149,1,16,0,17,0,7240,14,1182,6058,4,10,1186,6068,1,1,0,58
Sharp,9/14/20,6,135,0,167,3166,144,3333,17,17043,166,1,3163,3,144,0,6,0,16,1,3329,4,166,3163,1,3,167,3166,1,0,0,34
St.Francis,9/14/20,4,123,0,1388,10434,1351,11822,33,26294,1388,0,10427,7,1351,0,4,0,33,0,11815,7,1388,10427,0,7,1388,10434,2,1,0,47
Stone,9/14/20,5,137,0,282,2843,222,3127,55,12446,275,7,2836,7,215,7,5,0,55,0,3111,16,275,2836,9,7,284,2843,16,4,0,73
Union,9/14/20,25,139,0,801,7643,717,8448,58,39732,795,6,7613,30,716,1,25,0,53,5,8408,40,795,7613,10,30,805,7643,5,7,0,30
VanBuren,9/14/20,2,141,0,157,3302,132,3462,23,16684,157,0,3253,49,132,0,2,0,23,0,3410,52,157,3253,3,49,160,3302,0,1,0,17
Washington,9/14/20,89,143,0,8244,64889,7407,73205,748,228529,8061,183,64421,468,7310,97,89,0,662,86,72482,723,8061,64421,255,468,8316,64889,32,109,2,398
White,9/14/20,14,145,0,643,11795,570,12454,59,78804,608,35,11501,294,541,29,14,0,53,6,12109,345,608,11501,51,294,659,11795,5,8,0,117
Woodruff,9/14/20,0,147,0,36,1444,31,1481,5,6660,33,3,1436,8,28,3,0,0,5,0,1469,12,33,1436,4,8,37,1444,4,0,0,18
Yell,9/14/20,26,149,0,1202,8558,1153,9760,23,21573,1200,2,8517,41,1151,2,26,0,23,0,9717,43,1200,8517,2,41,1202,8558,0,2,0,37
Arkansas_all_counties,9/13/20,981,5630,0,70219,758511,63063,829087,6171,2990671,69050,1169,751849,6662,62243,820,976,5,5827,344,820899,8188,69050,751849,1526,6662,70576,758511,509,424,12,8729
Arkansas_county,9/13/20,4,1,0,314,4681,289,5003,21,18124,308,6,4486,195,285,4,4,0,19,2,4794,209,308,4486,14,195,322,4681,3,2,0,119
Ashley,9/13/20,8,3,0,400,4341,383,4742,9,20537,400,0,4324,17,383,0,8,0,9,0,4724,18,400,4324,1,17,401,4341,2,1,0,15
Baxter,9/13/20,1,5,0,207,3328,159,3537,47,41219,187,20,3321,7,143,16,1,0,43,4,3508,29,187,3321,22,7,209,3328,8,2,0,63
Benton,9/13/20,62,7,0,5849,63013,5490,68895,297,258980,5793,56,62930,83,5450,40,62,0,281,16,68723,172,5793,62930,89,83,5882,63013,17,31,1,158
Boone,9/13/20,5,9,0,531,7539,379,8071,147,37288,519,12,7526,13,375,4,5,0,139,8,8045,26,519,7526,13,13,532,7539,54,18,0,319
Bradley,9/13/20,6,11,0,321,3201,298,3522,17,10948,321,0,3199,2,298,0,6,0,17,0,3520,2,321,3199,0,2,321,3201,1,1,0,4
Calhoun,9/13/20,0,13,0,28,1328,24,1356,4,5202,27,1,1324,4,23,1,0,0,4,0,1351,5,27,1324,1,4,28,1328,0,0,0,0
Carroll,9/13/20,9,15,0,546,6088,474,6635,63,27887,545,1,6085,3,473,1,9,0,63,0,6630,5,545,6085,2,3,547,6088,3,3,1,37
Chicot,9/13/20,14,17,0,976,4405,951,5381,11,10826,975,1,4395,10,950,1,14,0,11,0,5370,11,975,4395,1,10,976,4405,0,-1,3,0
Clark,9/13/20,4,19,0,277,5230,249,5507,24,22385,273,4,5213,17,247,2,4,0,22,2,5486,21,273,5213,4,17,277,5230,2,5,0,45
Clay,9/13/20,5,21,0,229,3350,187,3580,36,15061,227,2,3347,3,185,2,5,0,36,0,3574,6,227,3347,3,3,230,3350,0,0,0,13
Cleburne,9/13/20,7,23,0,293,4970,260,5263,26,25230,285,8,4901,69,253,7,7,0,25,1,5186,77,285,4901,8,69,293,4970,0,1,0,51
Cleveland,9/13/20,9,25,0,159,2196,129,2356,21,8226,157,2,2179,17,128,1,9,0,20,1,2336,20,157,2179,3,17,160,2196,2,0,0,13
Columbia,9/13/20,17,27,0,339,3838,295,4185,27,23892,333,6,3824,14,290,5,17,0,26,1,4157,28,333,3824,14,14,347,3838,2,1,0,20
Conway,9/13/20,3,29,0,231,5196,215,5427,13,20906,229,2,5127,69,213,2,3,0,13,0,5356,71,229,5127,2,69,231,5196,0,2,0,67
Craighead,9/13/20,16,31,0,2360,27112,1969,29477,374,105701,2322,38,27077,35,1950,19,16,0,355,19,29399,78,2322,27077,43,35,2365,27112,23,30,0,283
Crawford,9/13/20,10,33,0,1088,15516,964,16607,114,62472,1075,13,15509,7,955,9,10,0,110,4,16584,23,1075,15509,16,7,1091,15516,10,5,0,121
Crittenden,9/13/20,36,35,0,1801,12386,1652,14185,113,49013,1799,2,12382,4,1650,2,36,0,113,0,14181,4,1799,12382,0,4,1799,12386,2,6,0,38
Cross,9/13/20,5,37,0,367,3798,298,4163,64,16998,363,4,3788,10,294,4,5,0,64,0,4151,12,363,3788,2,10,365,3798,6,7,0,102
Dallas,9/13/20,2,39,0,154,1726,131,1880,21,7432,153,1,1718,8,130,1,2,0,21,0,1871,9,153,1718,1,8,154,1726,1,12,0,6
Desha,9/13/20,5,41,0,260,3227,239,3487,16,11887,259,1,3209,18,239,0,5,0,15,1,3468,19,259,3209,1,18,260,3227,0,1,0,18
Drew,9/13/20,5,43,0,332,4812,313,5147,14,18502,328,4,4781,31,310,3,5,0,13,1,5109,38,328,4781,7,31,335,4812,1,5,0,8
Faulkner,9/13/20,12,45,0,2012,30971,1782,32994,218,122416,1959,53,30368,603,1742,40,10,2,207,11,32327,667,1959,30368,64,603,2023,30971,50,9,0,600
Franklin,9/13/20,2,47,0,212,4585,178,4796,32,17780,209,3,4578,7,175,3,2,0,32,0,4787,9,209,4578,2,7,211,4585,4,1,0,26
Fulton,9/13/20,1,49,0,98,1022,80,1121,17,12139,95,3,1021,1,78,2,1,0,16,1,1116,5,95,1021,4,1,99,1022,0,1,0,9
Garland,9/13/20,36,51,0,1624,23437,1449,25061,139,98296,1617,7,23368,69,1444,5,36,0,137,2,24985,76,1617,23368,7,69,1624,23437,14,18,0,145
Grant,9/13/20,1,53,0,222,4031,205,4258,16,18086,215,7,3994,37,198,7,1,0,16,0,4209,49,215,3994,12,37,227,4031,1,4,0,29
Greene,9/13/20,7,55,0,715,10969,640,11688,68,44623,712,3,10957,12,638,2,7,0,67,1,11669,19,712,10957,7,12,719,10969,2,0,0,58
Hempstead,9/13/20,4,57,0,344,3686,335,4033,5,22018,340,4,3670,16,331,4,4,0,5,0,4010,23,340,3670,7,16,347,3686,0,0,0,7
HotSpring,9/13/20,23,59,0,1783,9666,1721,11449,39,33520,1780,3,9638,28,1718,3,23,0,39,0,11418,31,1780,9638,3,28,1783,9666,1,5,0,129
Howard,9/13/20,8,61,0,448,3359,425,3811,15,13389,446,2,3354,5,423,2,8,0,15,0,3800,11,446,3354,6,5,452,3359,0,3,0,3
Independence,9/13/20,12,63,0,906,8996,812,9911,82,37264,869,37,8977,19,780,32,12,0,77,5,9846,65,869,8977,46,19,915,8996,1,5,0,32
Izard,9/13/20,0,65,0,128,2972,111,3107,17,13559,127,1,2966,6,110,1,0,0,17,0,3093,14,127,2966,8,6,135,2972,0,0,0,8
Jackson,9/13/20,1,67,0,243,5509,198,5767,44,17225,233,10,5499,10,192,6,1,0,40,4,5732,35,233,5499,25,10,258,5509,0,0,0,18
Jefferson,9/13/20,55,69,0,2514,23680,2135,26202,324,70424,2493,21,23547,133,2120,15,55,0,318,6,26040,162,2493,23547,29,133,2522,23680,39,15,0,141
Johnson,9/13/20,4,71,0,799,6238,778,7038,17,26291,798,1,6215,23,777,1,4,0,17,0,7013,25,798,6215,2,23,800,6238,0,1,0,43
Lafayette,9/13/20,2,73,0,80,829,73,910,5,6915,80,0,828,1,73,0,2,0,5,0,908,2,80,828,1,1,81,829,0,1,0,1
Lawrence,9/13/20,11,75,0,313,3340,253,3655,49,16669,294,19,3333,7,242,11,11,0,41,8,3627,28,294,3333,21,7,315,3340,4,0,0,39
Lee,9/13/20,15,77,0,1021,3462,992,4483,14,9398,1020,1,3457,5,992,0,15,0,13,1,4477,6,1020,3457,1,5,1021,3462,0,-1,1,53
Lincoln,9/13/20,13,79,0,1780,5900,1595,7683,172,13695,1780,0,5891,9,1595,0,13,0,172,0,7671,12,1780,5891,3,9,1783,5900,5,1,0,126
LittleRiver,9/13/20,18,81,0,323,1546,293,1867,12,12417,318,5,1539,7,288,5,18,0,12,0,1857,10,318,1539,3,7,321,1546,0,4,0,6
Logan,9/13/20,1,83,0,381,5640,366,6023,14,21757,381,0,5632,8,366,0,1,0,14,0,6013,10,381,5632,2,8,383,5640,1,0,0,15
Lonoke,9/13/20,7,85,0,920,14823,820,15784,93,72206,837,83,14014,809,759,61,7,0,71,22,14851,933,837,14014,124,809,961,14823,10,12,0,132
Madison,9/13/20,2,87,0,319,3603,305,3924,12,16076,313,6,3592,11,301,4,2,0,10,2,3905,19,313,3592,8,11,321,3603,0,1,0,25
Marion,9/13/20,0,89,0,60,1918,49,1979,11,16438,57,3,1914,4,49,0,0,0,8,3,1971,8,57,1914,4,4,61,1918,0,1,0,14
Miller,9/13/20,10,91,0,717,5790,643,6509,64,43759,700,17,5761,29,626,17,10,0,64,0,6461,48,700,5761,19,29,719,5790,5,6,0,18
MissingCountyInfo,9/13/20,0,5,0,1641,27797,1031,29424,610,NA,1459,182,26518,1279,891,140,0,0,568,42,27977,1447,1459,26518,168,1279,1627,27797,97,13,0,1883
Mississippi,9/13/20,37,93,0,1499,10343,1366,11842,96,42831,1492,7,10340,3,1361,5,37,0,94,2,11832,10,1492,10340,7,3,1499,10343,8,2,1,50
Monroe,9/13/20,0,95,0,102,1965,96,2067,6,7249,102,0,1951,14,96,0,0,0,6,0,2053,14,102,1951,0,14,102,1965,0,1,0,8
Montgomery,9/13/20,4,97,0,121,1783,103,1904,14,8993,120,1,1768,15,102,1,4,0,14,0,1888,16,120,1768,1,15,121,1783,0,0,0,4
Nevada,9/13/20,12,99,0,177,2348,155,2525,10,8440,177,0,2340,8,155,0,12,0,10,0,2517,8,177,2340,0,8,177,2348,1,0,0,12
Newton,9/13/20,16,101,0,172,1424,115,1595,41,7848,169,3,1424,0,114,1,15,1,40,1,1593,2,169,1424,2,0,171,1424,0,1,0,11
Ouachita,9/13/20,5,103,0,212,4543,168,4757,39,24106,209,3,4524,19,166,2,5,0,38,1,4733,24,209,4524,5,19,214,4543,0,7,0,5
Perry,9/13/20,0,105,0,72,2391,68,2463,4,10322,68,4,2334,57,64,4,0,0,4,0,2402,61,68,2334,4,57,72,2391,0,0,0,32
Phillips,9/13/20,10,107,0,432,5455,409,5889,13,19034,430,2,5428,27,407,2,10,0,13,0,5858,31,430,5428,4,27,434,5455,2,1,0,114
Pike,9/13/20,2,109,0,212,1885,185,2097,25,10808,211,1,1870,15,184,1,2,0,25,0,2081,16,211,1870,1,15,212,1885,0,-1,1,7
Poinsett,9/13/20,7,111,0,564,6380,505,6942,52,24054,557,7,6375,5,498,7,7,0,52,0,6932,10,557,6375,5,5,562,6380,3,7,0,43
Polk,9/13/20,4,113,0,247,3380,231,3627,12,20163,245,2,3378,2,230,1,4,0,11,1,3623,4,245,3378,2,2,247,3380,0,4,0,8
Pope,9/13/20,23,115,0,1943,17836,1822,19777,98,63644,1935,8,17732,104,1816,6,23,0,96,2,19667,110,1935,17732,6,104,1941,17836,1,17,0,87
Prairie,9/13/20,1,117,0,131,1724,119,1857,11,8244,127,4,1694,30,116,3,1,0,10,1,1821,36,127,1694,6,30,133,1724,1,1,0,18
Pulaski,9/13/20,121,119,0,8067,106968,7274,115103,672,393463,7900,167,105642,1326,7153,121,120,1,627,45,113542,1561,7900,105642,235,1326,8135,106968,57,44,1,1575
Randolph,9/13/20,18,121,0,339,3953,302,4295,19,17603,333,6,3940,13,299,3,18,0,16,3,4273,22,333,3940,9,13,342,3953,0,3,0,24
Saline,9/13/20,17,125,0,1833,23299,1662,25144,154,118009,1782,51,22990,309,1625,37,16,1,141,13,24772,372,1782,22990,63,309,1845,23299,14,10,0,445
Scott,9/13/20,1,127,0,92,1601,88,1693,3,10442,92,0,1601,0,88,0,1,0,3,0,1693,0,92,1601,0,0,92,1601,0,0,0,1
Searcy,9/13/20,0,129,0,127,1635,113,1761,14,7923,124,3,1620,15,110,3,0,0,14,0,1744,17,124,1620,2,15,126,1635,0,3,0,8
Sebastian,9/13/20,40,131,0,3175,35170,2921,38349,213,127461,3164,11,35160,10,2914,7,40,0,209,4,38324,25,3164,35160,15,10,3179,35170,12,20,1,190
Sevier,9/13/20,16,133,0,1182,6011,1149,7196,17,17193,1181,1,6001,10,1148,1,16,0,17,0,7182,14,1181,6001,4,10,1185,6011,1,0,0,30
Sharp,9/13/20,6,135,0,166,3133,144,3299,16,17043,165,1,3130,3,144,0,6,0,15,1,3295,4,165,3130,1,3,166,3133,1,0,0,8
St.Francis,9/13/20,4,123,0,1386,10389,1350,11775,32,26294,1386,0,10382,7,1350,0,4,0,32,0,11768,7,1386,10382,0,7,1386,10389,0,1,0,60
Stone,9/13/20,5,137,0,266,2786,218,3054,43,12446,259,7,2778,8,211,7,5,0,43,0,3037,17,259,2778,9,8,268,2786,0,2,0,12
Union,9/13/20,25,139,0,796,7618,710,8418,60,39732,791,5,7588,30,709,1,25,0,56,4,8379,39,791,7588,9,30,800,7618,11,4,0,17
VanBuren,9/13/20,2,141,0,157,3285,131,3445,24,16684,157,0,3235,50,131,0,2,0,24,0,3392,53,157,3235,3,50,160,3285,2,0,0,35
Washington,9/13/20,87,143,0,8212,64522,7298,72807,827,228529,8032,180,64053,469,7209,89,87,0,736,91,72085,722,8032,64053,253,469,8285,64522,18,74,2,583
White,9/13/20,14,145,0,638,11683,562,12337,62,78804,603,35,11390,293,534,28,14,0,55,7,11993,344,603,11390,51,293,654,11683,5,8,0,183
Woodruff,9/13/20,0,147,0,32,1430,31,1463,1,6660,29,3,1422,8,28,3,0,0,1,0,1451,12,29,1422,4,8,33,1430,0,0,0,6
Yell,9/13/20,26,149,0,1202,8521,1151,9723,25,21573,1200,2,8483,38,1149,2,26,0,25,0,9683,40,1200,8483,2,38,1202,8521,1,0,0,97
Arkansas_all_counties,9/12/20,0,0,0,69710,0,0,0,0,2990671,68542,1168,750290,0,61819,0,964,0,5755,0,818832,0,0,0,0,0,0,0,727,574,11,13723
Arkansas_county,9/12/20,0,0,0,0,0,0,0,0,0,311,0,4565,0,287,0,4,0,20,0,4884,0,0,0,0,0,0,0,9,8,0,224
Ashley,9/12/20,0,0,0,0,0,0,0,0,0,398,0,4328,0,382,0,8,0,8,0,4727,0,0,0,0,0,0,0,1,0,0,41
Baxter,9/12/20,0,0,0,0,0,0,0,0,0,199,0,3273,0,157,0,1,0,41,0,3474,0,0,0,0,0,0,0,22,19,0,44
Benton,9/12/20,0,0,0,0,0,0,0,0,0,5832,0,62872,0,5459,0,61,0,312,0,68737,0,0,0,0,0,0,0,80,68,0,528
Boone,9/12/20,0,0,0,0,0,0,0,0,0,477,0,7274,0,361,0,5,0,111,0,7752,0,0,0,0,0,0,0,21,26,0,69
Bradley,9/12/20,0,0,0,0,0,0,0,0,0,320,0,3198,0,297,0,6,0,17,0,3518,0,0,0,0,0,0,0,3,2,0,31
Calhoun,9/12/20,0,0,0,0,0,0,0,0,0,28,0,1328,0,24,0,0,0,4,0,1356,0,0,0,0,0,0,0,2,1,0,20
Carroll,9/12/20,0,0,0,0,0,0,0,0,0,543,0,6054,0,471,0,8,0,64,0,6598,0,0,0,0,0,0,0,5,6,0,30
Chicot,9/12/20,0,0,0,0,0,0,0,0,0,976,0,4405,0,952,0,11,0,13,0,5381,0,0,0,0,0,0,0,3,2,0,31
Clark,9/12/20,0,0,0,0,0,0,0,0,0,275,0,5187,0,244,0,4,0,27,0,5462,0,0,0,0,0,0,0,5,5,0,60
Clay,9/12/20,0,0,0,0,0,0,0,0,0,229,0,3337,0,187,0,5,0,36,0,3567,0,0,0,0,0,0,0,8,4,0,54
Cleburne,9/12/20,0,0,0,0,0,0,0,0,0,293,0,4919,0,259,0,7,0,27,0,5212,0,0,0,0,0,0,0,10,9,0,135
Cleveland,9/12/20,0,0,0,0,0,0,0,0,0,157,0,2185,0,129,0,9,0,19,0,2343,0,0,0,0,0,0,0,5,0,2,30
Columbia,9/12/20,0,0,0,0,0,0,0,0,0,337,0,3820,0,294,0,17,0,26,0,4165,0,0,0,0,0,0,0,6,6,1,40
Conway,9/12/20,0,0,0,0,0,0,0,0,0,231,0,5129,0,213,0,3,0,15,0,5360,0,0,0,0,0,0,0,5,3,0,105
Craighead,9/12/20,0,0,0,0,0,0,0,0,0,2337,0,26851,0,1939,0,16,0,381,0,29194,0,0,0,0,0,0,0,61,74,0,401
Crawford,9/12/20,0,0,0,0,0,0,0,0,0,1078,0,15405,0,959,0,10,0,109,0,16486,0,0,0,0,0,0,0,34,19,0,247
Crittenden,9/12/20,0,0,0,0,0,0,0,0,0,1799,0,12350,0,1646,0,36,0,117,0,14147,0,0,0,0,0,0,0,14,8,0,97
Cross,9/12/20,0,0,0,0,0,0,0,0,0,361,0,3702,0,291,0,5,0,65,0,4061,0,0,0,0,0,0,0,11,12,0,58
Dallas,9/12/20,0,0,0,0,0,0,0,0,0,153,0,1721,0,119,0,2,0,32,0,1874,0,0,0,0,0,0,0,5,1,0,115
Desha,9/12/20,0,0,0,0,0,0,0,0,0,260,0,3209,0,238,0,5,0,17,0,3469,0,0,0,0,0,0,0,3,0,0,62
Drew,9/12/20,0,0,0,0,0,0,0,0,0,331,0,4805,0,308,0,5,0,18,0,5139,0,0,0,0,0,0,0,5,5,0,74
Faulkner,9/12/20,0,0,0,0,0,0,0,0,0,1962,0,30421,0,1773,0,12,0,177,0,32394,0,0,0,0,0,0,0,89,63,2,1295
Franklin,9/12/20,0,0,0,0,0,0,0,0,0,208,0,4563,0,177,0,2,0,29,0,4770,0,0,0,0,0,0,0,9,6,0,42
Fulton,9/12/20,0,0,0,0,0,0,0,0,0,98,0,1013,0,79,0,1,0,18,0,1112,0,0,0,0,0,0,0,4,2,0,23
Garland,9/12/20,0,0,0,0,0,0,0,0,0,1610,0,23306,0,1431,0,36,0,143,0,24916,0,0,0,0,0,0,0,21,14,0,255
Grant,9/12/20,0,0,0,0,0,0,0,0,0,221,0,4003,0,201,0,1,0,19,0,4229,0,0,0,0,0,0,0,8,11,0,148
Greene,9/12/20,0,0,0,0,0,0,0,0,0,713,0,10913,0,640,0,7,0,66,0,11630,0,0,0,0,0,0,0,13,3,0,230
Hempstead,9/12/20,0,0,0,0,0,0,0,0,0,344,0,3679,0,335,0,4,0,5,0,4026,0,0,0,0,0,0,0,7,5,0,48
HotSpring,9/12/20,0,0,0,0,0,0,0,0,0,1782,0,9538,0,1716,0,23,0,43,0,11320,0,0,0,0,0,0,0,10,10,0,217
Howard,9/12/20,0,0,0,0,0,0,0,0,0,448,0,3356,0,422,0,8,0,18,0,3808,0,0,0,0,0,0,0,8,3,0,43
Independence,9/12/20,0,0,0,0,0,0,0,0,0,905,0,8965,0,807,0,12,0,86,0,9879,0,0,0,0,0,0,0,42,35,0,265
Izard,9/12/20,0,0,0,0,0,0,0,0,0,128,0,2964,0,111,0,0,0,17,0,3099,0,0,0,0,0,0,0,5,2,0,38
Jackson,9/12/20,0,0,0,0,0,0,0,0,0,243,0,5491,0,198,0,1,0,44,0,5749,0,0,0,0,0,0,0,16,7,0,53
Jefferson,9/12/20,0,0,0,0,0,0,0,0,0,2475,0,23578,0,2120,0,55,0,300,0,26061,0,0,0,0,0,0,0,44,33,0,345
Johnson,9/12/20,0,0,0,0,0,0,0,0,0,799,0,6195,0,777,0,4,0,18,0,6995,0,0,0,0,0,0,0,4,3,0,49
Lafayette,9/12/20,0,0,0,0,0,0,0,0,0,80,0,828,0,72,0,2,0,6,0,909,0,0,0,0,0,0,0,1,1,0,4
Lawrence,9/12/20,0,0,0,0,0,0,0,0,0,309,0,3305,0,253,0,11,0,45,0,3616,0,0,0,0,0,0,0,26,12,0,80
Lee,9/12/20,0,0,0,0,0,0,0,0,0,1021,0,3409,0,993,0,14,0,14,0,4430,0,0,0,0,0,0,0,3,1,0,22
Lincoln,9/12/20,0,0,0,0,0,0,0,0,0,1775,0,5779,0,1594,0,13,0,168,0,7557,0,0,0,0,0,0,0,1,58,0,81
LittleRiver,9/12/20,0,0,0,0,0,0,0,0,0,323,0,1540,0,289,0,18,0,16,0,1861,0,0,0,0,0,0,0,5,4,0,29
Logan,9/12/20,0,0,0,0,0,0,0,0,0,380,0,5626,0,366,0,1,0,13,0,6008,0,0,0,0,0,0,0,4,1,0,46
Lonoke,9/12/20,0,0,0,0,0,0,0,0,0,910,0,14702,0,808,0,7,0,95,0,15652,0,0,0,0,0,0,0,91,68,2,1083
Madison,9/12/20,0,0,0,0,0,0,0,0,0,319,0,3578,0,304,0,2,0,13,0,3899,0,0,0,0,0,0,0,6,5,0,32
Marion,9/12/20,0,0,0,0,0,0,0,0,0,60,0,1904,0,48,0,0,0,12,0,1965,0,0,0,0,0,0,0,3,1,0,27
Miller,9/12/20,0,0,0,0,0,0,0,0,0,712,0,5777,0,637,0,10,0,65,0,6491,0,0,0,0,0,0,0,28,20,0,98
MissingCountyInfo,9/12/20,0,0,0,0,0,0,0,0,0,1544,0,26011,0,1018,0,0,0,526,0,27541,0,0,0,0,0,0,0,257,144,0,1303
Mississippi,9/12/20,0,0,0,0,0,0,0,0,0,1491,0,10301,0,1364,0,36,0,91,0,11792,0,0,0,0,0,0,0,14,11,1,102
Monroe,9/12/20,0,0,0,0,0,0,0,0,0,102,0,1957,0,95,0,0,0,7,0,2059,0,0,0,0,0,0,0,0,2,0,32
Montgomery,9/12/20,0,0,0,0,0,0,0,0,0,121,0,1779,0,103,0,4,0,14,0,1900,0,0,0,0,0,0,0,1,3,0,25
Nevada,9/12/20,0,0,0,0,0,0,0,0,0,176,0,2337,0,155,0,12,0,9,0,2513,0,0,0,0,0,0,0,4,1,0,24
Newton,9/12/20,0,0,0,0,0,0,0,0,0,172,0,1413,0,114,0,16,0,42,0,1584,0,0,0,0,0,0,0,11,3,1,43
Ouachita,9/12/20,0,0,0,0,0,0,0,0,0,212,0,4538,0,161,0,5,0,46,0,4752,0,0,0,0,0,0,0,6,6,0,45
Perry,9/12/20,0,0,0,0,0,0,0,0,0,72,0,2359,0,68,0,0,0,4,0,2431,0,0,0,0,0,0,0,5,5,0,90
Phillips,9/12/20,0,0,0,0,0,0,0,0,0,430,0,5343,0,408,0,10,0,12,0,5775,0,0,0,0,0,0,0,3,4,0,53
Pike,9/12/20,0,0,0,0,0,0,0,0,0,212,0,1878,0,186,0,1,0,25,0,2090,0,0,0,0,0,0,0,3,2,0,23
Poinsett,9/12/20,0,0,0,0,0,0,0,0,0,561,0,6340,0,498,0,7,0,56,0,6899,0,0,0,0,0,0,0,12,12,1,74
Polk,9/12/20,0,0,0,0,0,0,0,0,0,247,0,3373,0,227,0,4,0,16,0,3619,0,0,0,0,0,0,0,3,3,0,34
Pope,9/12/20,0,0,0,0,0,0,0,0,0,1942,0,17750,0,1805,0,23,0,114,0,19690,0,0,0,0,0,0,0,23,18,1,295
Prairie,9/12/20,0,0,0,0,0,0,0,0,0,130,0,1707,0,118,0,1,0,11,0,1839,0,0,0,0,0,0,0,6,3,0,51
Pulaski,9/12/20,0,0,0,0,0,0,0,0,0,8010,0,105450,0,7230,0,120,0,660,0,113528,0,0,0,0,0,0,0,215,174,2,2538
Randolph,9/12/20,0,0,0,0,0,0,0,0,0,339,0,3929,0,299,0,18,0,22,0,4271,0,0,0,0,0,0,0,6,3,0,30
Saline,9/12/20,0,0,0,0,0,0,0,0,0,1819,0,22868,0,1652,0,17,0,150,0,24699,0,0,0,0,0,0,0,72,52,1,833
Scott,9/12/20,0,0,0,0,0,0,0,0,0,92,0,1600,0,88,0,1,0,3,0,1692,0,0,0,0,0,0,0,1,0,0,77
Searcy,9/12/20,0,0,0,0,0,0,0,0,0,127,0,1627,0,110,0,0,0,17,0,1753,0,0,0,0,0,0,0,5,6,0,24
Sebastian,9/12/20,0,0,0,0,0,0,0,0,0,3163,0,34992,0,2901,0,39,0,222,0,38159,0,0,0,0,0,0,0,35,34,0,414
Sevier,9/12/20,0,0,0,0,0,0,0,0,0,1181,0,5982,0,1149,0,16,0,16,0,7166,0,0,0,0,0,0,0,5,2,0,126
Sharp,9/12/20,0,0,0,0,0,0,0,0,0,165,0,3126,0,144,0,6,0,15,0,3291,0,0,0,0,0,0,0,3,1,0,80
St.Francis,9/12/20,0,0,0,0,0,0,0,0,0,1386,0,10329,0,1349,0,4,0,33,0,11715,0,0,0,0,0,0,0,2,5,0,62
Stone,9/12/20,0,0,0,0,0,0,0,0,0,266,0,2774,0,216,0,5,0,45,0,3042,0,0,0,0,0,0,0,7,10,0,53
Union,9/12/20,0,0,0,0,0,0,0,0,0,785,0,7612,0,706,0,25,0,53,0,8401,0,0,0,0,0,0,0,16,5,0,80
VanBuren,9/12/20,0,0,0,0,0,0,0,0,0,155,0,3252,0,131,0,2,0,22,0,3410,0,0,0,0,0,0,0,2,3,0,67
Washington,9/12/20,0,0,0,0,0,0,0,0,0,8194,0,63959,0,7224,0,85,0,885,0,72224,0,0,0,0,0,0,0,259,176,1,891
White,9/12/20,0,0,0,0,0,0,0,0,0,633,0,11505,0,554,0,14,0,65,0,12154,0,0,0,0,0,0,0,46,33,0,553
Woodruff,9/12/20,0,0,0,0,0,0,0,0,0,32,0,1424,0,31,0,0,0,1,0,1457,0,0,0,0,0,0,0,3,4,0,24
Yell,9/12/20,0,0,0,0,0,0,0,0,0,1201,0,8425,0,1151,0,26,0,24,0,9626,0,0,0,0,0,0,0,8,6,1,150
Arkansas_all_counties,9/11/20,0,0,0,68983,0,0,0,0,2990671,67911,1072,737198,0,61245,0,953,0,5713,0,805109,0,0,0,0,0,0,0,1180,577,13,8930
Arkansas_county,9/11/20,0,0,0,0,0,0,0,0,0,302,0,4358,0,279,0,4,0,19,0,4660,0,0,0,0,0,0,0,0,2,0,36
Ashley,9/11/20,0,0,0,0,0,0,0,0,0,397,0,4289,0,382,0,8,0,7,0,4686,0,0,0,0,0,0,0,2,1,0,62
Baxter,9/11/20,0,0,0,0,0,0,0,0,0,177,0,3253,0,138,0,1,0,38,0,3430,0,0,0,0,0,0,0,4,2,0,70
Benton,9/11/20,0,0,0,0,0,0,0,0,0,5752,0,62457,0,5391,0,61,0,300,0,68209,0,0,0,0,0,0,0,53,35,1,472
Boone,9/11/20,0,0,0,0,0,0,0,0,0,456,0,7227,0,335,0,5,0,116,0,7683,0,0,0,0,0,0,0,15,9,1,133
Bradley,9/11/20,0,0,0,0,0,0,0,0,0,317,0,3170,0,295,0,6,0,16,0,3487,0,0,0,0,0,0,0,2,5,0,30
Calhoun,9/11/20,0,0,0,0,0,0,0,0,0,26,0,1310,0,23,0,0,0,3,0,1336,0,0,0,0,0,0,0,0,0,0,15
Carroll,9/11/20,0,0,0,0,0,0,0,0,0,538,0,6030,0,465,0,8,0,65,0,6568,0,0,0,0,0,0,0,20,0,0,73
Chicot,9/11/20,0,0,0,0,0,0,0,0,0,973,0,4377,0,950,0,11,0,12,0,5350,0,0,0,0,0,0,0,3,1,0,21
Clark,9/11/20,0,0,0,0,0,0,0,0,0,270,0,5132,0,239,0,4,0,27,0,5402,0,0,0,0,0,0,0,2,7,0,58
Clay,9/11/20,0,0,0,0,0,0,0,0,0,221,0,3292,0,183,0,5,0,33,0,3513,0,0,0,0,0,0,0,5,3,0,51
Cleburne,9/11/20,0,0,0,0,0,0,0,0,0,283,0,4794,0,250,0,7,0,26,0,5077,0,0,0,0,0,0,0,9,0,0,83
Cleveland,9/11/20,0,0,0,0,0,0,0,0,0,152,0,2161,0,129,0,7,0,16,0,2313,0,0,0,0,0,0,0,7,0,0,114
Columbia,9/11/20,0,0,0,0,0,0,0,0,0,331,0,3794,0,288,0,16,0,27,0,4125,0,0,0,0,0,0,0,8,2,0,21
Conway,9/11/20,0,0,0,0,0,0,0,0,0,226,0,5029,0,210,0,3,0,13,0,5255,0,0,0,0,0,0,0,4,4,0,52
Craighead,9/11/20,0,0,0,0,0,0,0,0,0,2276,0,26517,0,1865,0,16,0,395,0,28793,0,0,0,0,0,0,0,63,28,0,417
Crawford,9/11/20,0,0,0,0,0,0,0,0,0,1044,0,15195,0,940,0,10,0,94,0,16239,0,0,0,0,0,0,0,35,10,0,287
Crittenden,9/11/20,0,0,0,0,0,0,0,0,0,1785,0,12265,0,1638,0,36,0,111,0,14050,0,0,0,0,0,0,0,18,12,0,82
Cross,9/11/20,0,0,0,0,0,0,0,0,0,350,0,3653,0,279,0,5,0,66,0,4003,0,0,0,0,0,0,0,5,2,0,40
Dallas,9/11/20,0,0,0,0,0,0,0,0,0,148,0,1611,0,118,0,2,0,28,0,1759,0,0,0,0,0,0,0,7,2,0,34
Desha,9/11/20,0,0,0,0,0,0,0,0,0,257,0,3150,0,238,0,5,0,14,0,3407,0,0,0,0,0,0,0,1,4,0,37
Drew,9/11/20,0,0,0,0,0,0,0,0,0,326,0,4739,0,303,0,5,0,18,0,5065,0,0,0,0,0,0,0,4,4,0,25
Faulkner,9/11/20,0,0,0,0,0,0,0,0,0,1873,0,29226,0,1710,0,10,0,153,0,31099,0,0,0,0,0,0,0,33,26,0,332
Franklin,9/11/20,0,0,0,0,0,0,0,0,0,199,0,4529,0,171,0,2,0,26,0,4728,0,0,0,0,0,0,0,4,2,0,52
Fulton,9/11/20,0,0,0,0,0,0,0,0,0,94,0,995,0,77,0,1,0,16,0,1089,0,0,0,0,0,0,0,6,3,0,27
Garland,9/11/20,0,0,0,0,0,0,0,0,0,1589,0,23072,0,1417,0,36,0,136,0,24661,0,0,0,0,0,0,0,26,13,2,407
Grant,9/11/20,0,0,0,0,0,0,0,0,0,213,0,3868,0,190,0,1,0,22,0,4081,0,0,0,0,0,0,0,1,3,0,38
Greene,9/11/20,0,0,0,0,0,0,0,0,0,700,0,10700,0,637,0,7,0,56,0,11400,0,0,0,0,0,0,0,18,7,0,214
Hempstead,9/11/20,0,0,0,0,0,0,0,0,0,337,0,3641,0,330,0,4,0,3,0,3978,0,0,0,0,0,0,0,0,0,0,32
HotSpring,9/11/20,0,0,0,0,0,0,0,0,0,1772,0,9331,0,1706,0,23,0,43,0,11103,0,0,0,0,0,0,0,10,7,0,168
Howard,9/11/20,0,0,0,0,0,0,0,0,0,440,0,3325,0,419,0,8,0,13,0,3765,0,0,0,0,0,0,0,1,1,0,22
Independence,9/11/20,0,0,0,0,0,0,0,0,0,863,0,8751,0,772,0,12,0,79,0,9614,0,0,0,0,0,0,0,19,6,0,255
Izard,9/11/20,0,0,0,0,0,0,0,0,0,123,0,2938,0,109,0,0,0,14,0,3061,0,0,0,0,0,0,0,4,3,0,25
Jackson,9/11/20,0,0,0,0,0,0,0,0,0,227,0,5469,0,191,0,1,0,35,0,5696,0,0,0,0,0,0,0,10,3,0,204
Jefferson,9/11/20,0,0,0,0,0,0,0,0,0,2431,0,23285,0,2087,0,55,0,289,0,25716,0,0,0,0,0,0,0,59,22,1,354
Johnson,9/11/20,0,0,0,0,0,0,0,0,0,795,0,6151,0,774,0,4,0,17,0,6946,0,0,0,0,0,0,0,3,10,0,66
Lafayette,9/11/20,0,0,0,0,0,0,0,0,0,79,0,826,0,71,0,2,0,6,0,905,0,0,0,0,0,0,0,1,0,0,6
Lawrence,9/11/20,0,0,0,0,0,0,0,0,0,283,0,3253,0,241,0,11,0,31,0,3536,0,0,0,0,0,0,0,7,1,0,138
Lee,9/11/20,0,0,0,0,0,0,0,0,0,1018,0,3390,0,992,0,14,0,12,0,4408,0,0,0,0,0,0,0,3,3,2,12
Lincoln,9/11/20,0,0,0,0,0,0,0,0,0,1774,0,5702,0,1536,0,13,0,225,0,7476,0,0,0,0,0,0,0,5,15,0,29
LittleRiver,9/11/20,0,0,0,0,0,0,0,0,0,318,0,1514,0,285,0,18,0,15,0,1832,0,0,0,0,0,0,0,5,9,0,18
Logan,9/11/20,0,0,0,0,0,0,0,0,0,376,0,5586,0,365,0,1,0,10,0,5962,0,0,0,0,0,0,0,1,0,0,22
Lonoke,9/11/20,0,0,0,0,0,0,0,0,0,819,0,13750,0,740,0,5,0,74,0,14569,0,0,0,0,0,0,0,15,17,0,209
Madison,9/11/20,0,0,0,0,0,0,0,0,0,313,0,3554,0,299,0,2,0,12,0,3867,0,0,0,0,0,0,0,3,1,0,32
Marion,9/11/20,0,0,0,0,0,0,0,0,0,57,0,1881,0,47,0,0,0,10,0,1938,0,0,0,0,0,0,0,0,1,0,36
Miller,9/11/20,0,0,0,0,0,0,0,0,0,684,0,5709,0,617,0,10,0,57,0,6393,0,0,0,0,0,0,0,10,4,0,145
MissingCountyInfo,9/11/20,0,0,0,0,0,0,0,0,0,1287,0,24951,0,874,0,0,0,413,0,26238,0,0,0,0,0,0,0,170,-22,0,-454
Mississippi,9/11/20,0,0,0,0,0,0,0,0,0,1477,0,10213,0,1353,0,35,0,89,0,11690,0,0,0,0,0,0,0,21,18,1,137
Monroe,9/11/20,0,0,0,0,0,0,0,0,0,102,0,1925,0,93,0,0,0,9,0,2027,0,0,0,0,0,0,0,1,1,0,22
Montgomery,9/11/20,0,0,0,0,0,0,0,0,0,120,0,1755,0,100,0,4,0,16,0,1875,0,0,0,0,0,0,0,1,17,0,76
Nevada,9/11/20,0,0,0,0,0,0,0,0,0,172,0,2317,0,154,0,12,0,6,0,2489,0,0,0,0,0,0,0,1,1,0,16
Newton,9/11/20,0,0,0,0,0,0,0,0,0,161,0,1380,0,111,0,15,0,35,0,1541,0,0,0,0,0,0,0,7,4,0,32
Ouachita,9/11/20,0,0,0,0,0,0,0,0,0,206,0,4501,0,155,0,5,0,46,0,4707,0,0,0,0,0,0,0,17,3,0,80
Perry,9/11/20,0,0,0,0,0,0,0,0,0,67,0,2274,0,63,0,0,0,4,0,2341,0,0,0,0,0,0,0,2,0,0,40
Phillips,9/11/20,0,0,0,0,0,0,0,0,0,427,0,5295,0,404,0,10,0,13,0,5722,0,0,0,0,0,0,0,3,2,0,35
Pike,9/11/20,0,0,0,0,0,0,0,0,0,209,0,1858,0,184,0,1,0,24,0,2067,0,0,0,0,0,0,0,5,1,0,16
Poinsett,9/11/20,0,0,0,0,0,0,0,0,0,549,0,6276,0,486,0,6,0,57,0,6825,0,0,0,0,0,0,0,12,10,0,226
Polk,9/11/20,0,0,0,0,0,0,0,0,0,244,0,3341,0,224,0,4,0,16,0,3585,0,0,0,0,0,0,0,3,2,0,31
Pope,9/11/20,0,0,0,0,0,0,0,0,0,1919,0,17476,0,1787,0,22,0,110,0,19395,0,0,0,0,0,0,0,11,15,0,206
Prairie,9/11/20,0,0,0,0,0,0,0,0,0,124,0,1664,0,115,0,1,0,8,0,1788,0,0,0,0,0,0,0,0,0,0,15
Pulaski,9/11/20,0,0,0,0,0,0,0,0,0,7795,0,103195,0,7056,0,118,0,621,0,110990,0,0,0,0,0,0,0,112,62,2,1195
Randolph,9/11/20,0,0,0,0,0,0,0,0,0,333,0,3908,0,296,0,18,0,19,0,4241,0,0,0,0,0,0,0,4,1,0,42
Saline,9/11/20,0,0,0,0,0,0,0,0,0,1747,0,22119,0,1600,0,16,0,131,0,23866,0,0,0,0,0,0,0,11,16,1,268
Scott,9/11/20,0,0,0,0,0,0,0,0,0,91,0,1524,0,88,0,1,0,2,0,1615,0,0,0,0,0,0,0,1,0,0,12
Searcy,9/11/20,0,0,0,0,0,0,0,0,0,122,0,1607,0,104,0,0,0,18,0,1729,0,0,0,0,0,0,0,4,1,0,20
Sebastian,9/11/20,0,0,0,0,0,0,0,0,0,3128,0,34617,0,2867,0,39,0,222,0,37745,0,0,0,0,0,0,0,53,35,0,543
Sevier,9/11/20,0,0,0,0,0,0,0,0,0,1176,0,5864,0,1147,0,16,0,13,0,7040,0,0,0,0,0,0,0,1,1,0,23
Sharp,9/11/20,0,0,0,0,0,0,0,0,0,162,0,3049,0,143,0,6,0,13,0,3211,0,0,0,0,0,0,0,6,1,0,46
St.Francis,9/11/20,0,0,0,0,0,0,0,0,0,1384,0,10269,0,1344,0,4,0,36,0,11653,0,0,0,0,0,0,0,5,21,0,38
Stone,9/11/20,0,0,0,0,0,0,0,0,0,259,0,2730,0,206,0,5,0,48,0,2989,0,0,0,0,0,0,0,2,8,0,44
Union,9/11/20,0,0,0,0,0,0,0,0,0,769,0,7552,0,701,0,25,0,43,0,8321,0,0,0,0,0,0,0,14,11,0,42
VanBuren,9/11/20,0,0,0,0,0,0,0,0,0,153,0,3190,0,128,0,2,0,23,0,3343,0,0,0,0,0,0,0,5,4,0,46
Washington,9/11/20,0,0,0,0,0,0,0,0,0,7935,0,63398,0,7048,0,84,0,803,0,71333,0,0,0,0,0,0,0,113,69,2,811
White,9/11/20,0,0,0,0,0,0,0,0,0,587,0,11014,0,521,0,14,0,52,0,11601,0,0,0,0,0,0,0,10,5,0,118
Woodruff,9/11/20,0,0,0,0,0,0,0,0,0,29,0,1404,0,27,0,0,0,2,0,1433,0,0,0,0,0,0,0,0,0,0,16
Yell,9/11/20,0,0,0,0,0,0,0,0,0,1193,0,8283,0,1145,0,25,0,23,0,9476,0,0,0,0,0,0,0,1,0,0,132
Arkansas_all_counties,9/10/20,0,0,0,67803,0,0,0,0,2990671,66804,999,729375,0,60668,0,940,0,5196,0,796179,0,0,0,0,0,0,0,548,748,12,7593
Arkansas_county,9/10/20,0,0,0,0,0,0,0,0,0,302,0,4322,0,277,0,4,0,21,0,4624,0,0,0,0,0,0,0,1,1,0,32
Ashley,9/10/20,0,0,0,0,0,0,0,0,0,395,0,4229,0,381,0,8,0,6,0,4624,0,0,0,0,0,0,0,2,2,1,17
Baxter,9/10/20,0,0,0,0,0,0,0,0,0,173,0,3187,0,136,0,1,0,36,0,3360,0,0,0,0,0,0,0,10,3,0,200
Benton,9/10/20,0,0,0,0,0,0,0,0,0,5699,0,62038,0,5356,0,60,0,283,0,67737,0,0,0,0,0,0,0,12,34,0,247
Boone,9/10/20,0,0,0,0,0,0,0,0,0,441,0,7109,0,326,0,4,0,111,0,7550,0,0,0,0,0,0,0,12,10,0,27
Bradley,9/10/20,0,0,0,0,0,0,0,0,0,315,0,3142,0,290,0,6,0,19,0,3457,0,0,0,0,0,0,0,0,5,0,16
Calhoun,9/10/20,0,0,0,0,0,0,0,0,0,26,0,1295,0,23,0,0,0,3,0,1321,0,0,0,0,0,0,0,1,0,0,4
Carroll,9/10/20,0,0,0,0,0,0,0,0,0,518,0,5977,0,465,0,8,0,45,0,6495,0,0,0,0,0,0,0,3,2,0,22
Chicot,9/10/20,0,0,0,0,0,0,0,0,0,970,0,4359,0,949,0,11,0,10,0,5329,0,0,0,0,0,0,0,0,10,0,7
Clark,9/10/20,0,0,0,0,0,0,0,0,0,268,0,5076,0,232,0,4,0,32,0,5344,0,0,0,0,0,0,0,-4,3,0,34
Clay,9/10/20,0,0,0,0,0,0,0,0,0,216,0,3246,0,180,0,5,0,31,0,3462,0,0,0,0,0,0,0,2,4,0,23
Cleburne,9/10/20,0,0,0,0,0,0,0,0,0,274,0,4720,0,250,0,7,0,17,0,4994,0,0,0,0,0,0,0,3,0,0,65
Cleveland,9/10/20,0,0,0,0,0,0,0,0,0,145,0,2054,0,129,0,7,0,9,0,2199,0,0,0,0,0,0,0,2,1,0,16
Columbia,9/10/20,0,0,0,0,0,0,0,0,0,323,0,3781,0,286,0,16,0,21,0,4104,0,0,0,0,0,0,0,2,2,0,17
Conway,9/10/20,0,0,0,0,0,0,0,0,0,222,0,4981,0,206,0,3,0,13,0,5203,0,0,0,0,0,0,0,0,2,0,26
Craighead,9/10/20,0,0,0,0,0,0,0,0,0,2213,0,26163,0,1837,0,16,0,360,0,28376,0,0,0,0,0,0,0,35,31,0,248
Crawford,9/10/20,0,0,0,0,0,0,0,0,0,1009,0,14943,0,930,0,10,0,69,0,15952,0,0,0,0,0,0,0,7,17,0,209
Crittenden,9/10/20,0,0,0,0,0,0,0,0,0,1767,0,12201,0,1626,0,36,0,105,0,13968,0,0,0,0,0,0,0,10,9,0,44
Cross,9/10/20,0,0,0,0,0,0,0,0,0,345,0,3618,0,277,0,5,0,63,0,3963,0,0,0,0,0,0,0,4,4,0,23
Dallas,9/10/20,0,0,0,0,0,0,0,0,0,141,0,1584,0,116,0,2,0,23,0,1725,0,0,0,0,0,0,0,2,1,0,27
Desha,9/10/20,0,0,0,0,0,0,0,0,0,256,0,3114,0,234,0,5,0,17,0,3370,0,0,0,0,0,0,0,1,2,0,14
Drew,9/10/20,0,0,0,0,0,0,0,0,0,322,0,4718,0,299,0,5,0,18,0,5040,0,0,0,0,0,0,0,0,4,0,14
Faulkner,9/10/20,0,0,0,0,0,0,0,0,0,1840,0,28927,0,1684,0,10,0,146,0,30767,0,0,0,0,0,0,0,13,25,1,130
Franklin,9/10/20,0,0,0,0,0,0,0,0,0,195,0,4481,0,169,0,2,0,24,0,4676,0,0,0,0,0,0,0,2,5,0,17
Fulton,9/10/20,0,0,0,0,0,0,0,0,0,88,0,974,0,74,0,1,0,13,0,1062,0,0,0,0,0,0,0,1,5,0,20
Garland,9/10/20,0,0,0,0,0,0,0,0,0,1563,0,22691,0,1404,0,34,0,125,0,24254,0,0,0,0,0,0,0,11,13,0,406
Grant,9/10/20,0,0,0,0,0,0,0,0,0,212,0,3831,0,187,0,1,0,24,0,4043,0,0,0,0,0,0,0,1,-1,0,59
Greene,9/10/20,0,0,0,0,0,0,0,0,0,682,0,10504,0,630,0,7,0,45,0,11186,0,0,0,0,0,0,0,5,7,0,69
Hempstead,9/10/20,0,0,0,0,0,0,0,0,0,337,0,3609,0,330,0,4,0,3,0,3946,0,0,0,0,0,0,0,0,-1,1,14
HotSpring,9/10/20,0,0,0,0,0,0,0,0,0,1762,0,9173,0,1699,0,23,0,40,0,10935,0,0,0,0,0,0,0,3,19,0,227
Howard,9/10/20,0,0,0,0,0,0,0,0,0,439,0,3304,0,418,0,8,0,13,0,3743,0,0,0,0,0,0,0,2,7,0,10
Independence,9/10/20,0,0,0,0,0,0,0,0,0,844,0,8515,0,766,0,12,0,66,0,9359,0,0,0,0,0,0,0,7,16,0,104
Izard,9/10/20,0,0,0,0,0,0,0,0,0,119,0,2917,0,106,0,0,0,13,0,3036,0,0,0,0,0,0,0,5,8,0,31
Jackson,9/10/20,0,0,0,0,0,0,0,0,0,217,0,5275,0,188,0,1,0,28,0,5492,0,0,0,0,0,0,0,3,4,0,27
Jefferson,9/10/20,0,0,0,0,0,0,0,0,0,2372,0,22990,0,2065,0,54,0,253,0,25362,0,0,0,0,0,0,0,34,52,1,535
Johnson,9/10/20,0,0,0,0,0,0,0,0,0,792,0,6088,0,764,0,4,0,24,0,6880,0,0,0,0,0,0,0,3,7,0,37
Lafayette,9/10/20,0,0,0,0,0,0,0,0,0,78,0,821,0,71,0,2,0,5,0,899,0,0,0,0,0,0,0,1,1,0,5
Lawrence,9/10/20,0,0,0,0,0,0,0,0,0,276,0,3122,0,240,0,11,0,25,0,3398,0,0,0,0,0,0,0,1,7,0,35
Lee,9/10/20,0,0,0,0,0,0,0,0,0,1015,0,3381,0,989,0,12,0,14,0,4396,0,0,0,0,0,0,0,0,-1,1,10
Lincoln,9/10/20,0,0,0,0,0,0,0,0,0,1769,0,5678,0,1521,0,13,0,235,0,7447,0,0,0,0,0,0,0,2,122,0,14
LittleRiver,9/10/20,0,0,0,0,0,0,0,0,0,313,0,1501,0,276,0,18,0,19,0,1814,0,0,0,0,0,0,0,2,10,0,3
Logan,9/10/20,0,0,0,0,0,0,0,0,0,375,0,5565,0,365,0,1,0,9,0,5940,0,0,0,0,0,0,0,3,2,0,35
Lonoke,9/10/20,0,0,0,0,0,0,0,0,0,804,0,13556,0,723,0,5,0,76,0,14360,0,0,0,0,0,0,0,0,9,0,98
Madison,9/10/20,0,0,0,0,0,0,0,0,0,310,0,3525,0,298,0,2,0,10,0,3835,0,0,0,0,0,0,0,0,-1,0,13
Marion,9/10/20,0,0,0,0,0,0,0,0,0,57,0,1845,0,46,0,0,0,11,0,1902,0,0,0,0,0,0,0,0,0,0,44
Miller,9/10/20,0,0,0,0,0,0,0,0,0,674,0,5574,0,613,0,10,0,51,0,6248,0,0,0,0,0,0,0,1,12,0,49
MissingCountyInfo,9/10/20,0,0,0,0,0,0,0,0,0,1117,0,25575,0,896,0,0,0,221,0,26692,0,0,0,0,0,0,0,-40,-19,0,1485
Mississippi,9/10/20,0,0,0,0,0,0,0,0,0,1456,0,10097,0,1335,0,34,0,87,0,11553,0,0,0,0,0,0,0,8,13,0,45
Monroe,9/10/20,0,0,0,0,0,0,0,0,0,101,0,1904,0,92,0,0,0,9,0,2005,0,0,0,0,0,0,0,0,0,0,20
Montgomery,9/10/20,0,0,0,0,0,0,0,0,0,119,0,1680,0,83,0,4,0,32,0,1799,0,0,0,0,0,0,0,1,3,0,92
Nevada,9/10/20,0,0,0,0,0,0,0,0,0,171,0,2302,0,153,0,12,0,6,0,2473,0,0,0,0,0,0,0,1,0,0,25
Newton,9/10/20,0,0,0,0,0,0,0,0,0,154,0,1355,0,107,0,15,0,32,0,1509,0,0,0,0,0,0,0,4,3,0,10
Ouachita,9/10/20,0,0,0,0,0,0,0,0,0,189,0,4438,0,152,0,5,0,32,0,4627,0,0,0,0,0,0,0,3,2,0,17
Perry,9/10/20,0,0,0,0,0,0,0,0,0,65,0,2236,0,63,0,0,0,2,0,2301,0,0,0,0,0,0,0,0,2,0,5
Phillips,9/10/20,0,0,0,0,0,0,0,0,0,424,0,5263,0,402,0,10,0,12,0,5687,0,0,0,0,0,0,0,0,2,0,19
Pike,9/10/20,0,0,0,0,0,0,0,0,0,204,0,1847,0,183,0,1,0,20,0,2051,0,0,0,0,0,0,0,13,3,0,26
Poinsett,9/10/20,0,0,0,0,0,0,0,0,0,537,0,6062,0,476,0,6,0,55,0,6599,0,0,0,0,0,0,0,3,10,0,54
Polk,9/10/20,0,0,0,0,0,0,0,0,0,241,0,3313,0,222,0,4,0,15,0,3554,0,0,0,0,0,0,0,1,1,0,24
Pope,9/10/20,0,0,0,0,0,0,0,0,0,1908,0,17281,0,1772,0,22,0,114,0,19189,0,0,0,0,0,0,0,12,23,1,130
Prairie,9/10/20,0,0,0,0,0,0,0,0,0,124,0,1649,0,115,0,1,0,8,0,1773,0,0,0,0,0,0,0,0,0,0,21
Pulaski,9/10/20,0,0,0,0,0,0,0,0,0,7683,0,102112,0,6994,0,116,0,573,0,109795,0,0,0,0,0,0,0,71,95,1,1043
Randolph,9/10/20,0,0,0,0,0,0,0,0,0,329,0,3870,0,295,0,18,0,16,0,4199,0,0,0,0,0,0,0,2,0,0,17
Saline,9/10/20,0,0,0,0,0,0,0,0,0,1736,0,21862,0,1584,0,15,0,137,0,23598,0,0,0,0,0,0,0,24,14,0,265
Scott,9/10/20,0,0,0,0,0,0,0,0,0,90,0,1513,0,88,0,1,0,1,0,1603,0,0,0,0,0,0,0,0,0,1,12
Searcy,9/10/20,0,0,0,0,0,0,0,0,0,118,0,1591,0,103,0,0,0,15,0,1709,0,0,0,0,0,0,0,1,2,0,8
Sebastian,9/10/20,0,0,0,0,0,0,0,0,0,3075,0,34127,0,2832,0,39,0,204,0,37202,0,0,0,0,0,0,0,22,14,1,398
Sevier,9/10/20,0,0,0,0,0,0,0,0,0,1175,0,5842,0,1146,0,16,0,13,0,7017,0,0,0,0,0,0,0,1,1,0,18
Sharp,9/10/20,0,0,0,0,0,0,0,0,0,156,0,3009,0,142,0,6,0,8,0,3165,0,0,0,0,0,0,0,1,1,0,15
St.Francis,9/10/20,0,0,0,0,0,0,0,0,0,1379,0,10236,0,1323,0,4,0,52,0,11615,0,0,0,0,0,0,0,1,13,0,30
Stone,9/10/20,0,0,0,0,0,0,0,0,0,257,0,2688,0,198,0,5,0,54,0,2945,0,0,0,0,0,0,0,2,4,1,30
Union,9/10/20,0,0,0,0,0,0,0,0,0,755,0,7524,0,690,0,25,0,40,0,8279,0,0,0,0,0,0,0,7,9,0,16
VanBuren,9/10/20,0,0,0,0,0,0,0,0,0,148,0,3149,0,124,0,2,0,22,0,3297,0,0,0,0,0,0,0,0,4,0,12
Washington,9/10/20,0,0,0,0,0,0,0,0,0,7822,0,62700,0,6979,0,82,0,761,0,70522,0,0,0,0,0,0,0,53,63,2,275
White,9/10/20,0,0,0,0,0,0,0,0,0,577,0,10906,0,516,0,14,0,47,0,11483,0,0,0,0,0,0,0,1,8,0,41
Woodruff,9/10/20,0,0,0,0,0,0,0,0,0,29,0,1388,0,27,0,0,0,2,0,1417,0,0,0,0,0,0,0,0,0,0,5
Yell,9/10/20,0,0,0,0,0,0,0,0,0,1192,0,8152,0,1145,0,25,0,22,0,9344,0,0,0,0,0,0,0,1,3,0,111
Arkansas_all_counties,9/9/20,0,0,0,67255,0,0,0,0,2990671,66406,849,722180,0,59920,0,928,0,5558,0,788586,0,0,0,0,0,0,0,498,660,11,5592
Arkansas_county,9/9/20,0,0,0,0,0,0,0,0,0,301,0,4291,0,276,0,4,0,21,0,4592,0,0,0,0,0,0,0,1,2,0,76
Ashley,9/9/20,0,0,0,0,0,0,0,0,0,393,0,4214,0,379,0,7,0,7,0,4607,0,0,0,0,0,0,0,0,0,0,45
Baxter,9/9/20,0,0,0,0,0,0,0,0,0,163,0,2997,0,133,0,1,0,29,0,3160,0,0,0,0,0,0,0,2,3,0,49
Benton,9/9/20,0,0,0,0,0,0,0,0,0,5687,0,61803,0,5322,0,60,0,305,0,67490,0,0,0,0,0,0,0,25,42,0,1010
Boone,9/9/20,0,0,0,0,0,0,0,0,0,429,0,7094,0,316,0,4,0,109,0,7523,0,0,0,0,0,0,0,7,15,0,144
Bradley,9/9/20,0,0,0,0,0,0,0,0,0,315,0,3126,0,285,0,6,0,24,0,3441,0,0,0,0,0,0,0,0,2,0,29
Calhoun,9/9/20,0,0,0,0,0,0,0,0,0,25,0,1292,0,23,0,0,0,2,0,1317,0,0,0,0,0,0,0,0,0,0,21
Carroll,9/9/20,0,0,0,0,0,0,0,0,0,515,0,5958,0,463,0,8,0,44,0,6473,0,0,0,0,0,0,0,9,10,0,97
Chicot,9/9/20,0,0,0,0,0,0,0,0,0,970,0,4352,0,939,0,11,0,20,0,5322,0,0,0,0,0,0,0,0,0,0,38
Clark,9/9/20,0,0,0,0,0,0,0,0,0,272,0,5038,0,229,0,4,0,39,0,5310,0,0,0,0,0,0,0,4,1,0,43
Clay,9/9/20,0,0,0,0,0,0,0,0,0,214,0,3225,0,176,0,5,0,33,0,3439,0,0,0,0,0,0,0,0,2,0,35
Cleburne,9/9/20,0,0,0,0,0,0,0,0,0,271,0,4658,0,250,0,7,0,14,0,4929,0,0,0,0,0,0,0,1,2,0,29
Cleveland,9/9/20,0,0,0,0,0,0,0,0,0,143,0,2040,0,128,0,7,0,8,0,2183,0,0,0,0,0,0,0,0,0,0,16
Columbia,9/9/20,0,0,0,0,0,0,0,0,0,321,0,3766,0,284,0,16,0,21,0,4087,0,0,0,0,0,0,0,1,3,0,55
Conway,9/9/20,0,0,0,0,0,0,0,0,0,222,0,4955,0,204,0,3,0,15,0,5177,0,0,0,0,0,0,0,0,5,0,67
Craighead,9/9/20,0,0,0,0,0,0,0,0,0,2178,0,25950,0,1806,0,16,0,356,0,28128,0,0,0,0,0,0,0,39,29,1,413
Crawford,9/9/20,0,0,0,0,0,0,0,0,0,1002,0,14741,0,913,0,10,0,79,0,15743,0,0,0,0,0,0,0,2,21,0,128
Crittenden,9/9/20,0,0,0,0,0,0,0,0,0,1757,0,12167,0,1617,0,36,0,104,0,13924,0,0,0,0,0,0,0,9,8,0,90
Cross,9/9/20,0,0,0,0,0,0,0,0,0,341,0,3599,0,273,0,5,0,63,0,3940,0,0,0,0,0,0,0,4,4,0,80
Dallas,9/9/20,0,0,0,0,0,0,0,0,0,139,0,1559,0,115,0,2,0,22,0,1698,0,0,0,0,0,0,0,2,6,0,18
Desha,9/9/20,0,0,0,0,0,0,0,0,0,255,0,3101,0,232,0,5,0,18,0,3356,0,0,0,0,0,0,0,1,2,0,27
Drew,9/9/20,0,0,0,0,0,0,0,0,0,322,0,4704,0,295,0,5,0,22,0,5026,0,0,0,0,0,0,0,0,1,0,46
Faulkner,9/9/20,0,0,0,0,0,0,0,0,0,1827,0,28810,0,1659,0,9,0,159,0,30637,0,0,0,0,0,0,0,18,18,0,300
Franklin,9/9/20,0,0,0,0,0,0,0,0,0,193,0,4466,0,164,0,2,0,27,0,4659,0,0,0,0,0,0,0,2,3,0,62
Fulton,9/9/20,0,0,0,0,0,0,0,0,0,87,0,955,0,69,0,1,0,17,0,1042,0,0,0,0,0,0,0,2,1,0,14
Garland,9/9/20,0,0,0,0,0,0,0,0,0,1552,0,22296,0,1391,0,34,0,127,0,23848,0,0,0,0,0,0,0,15,29,0,348
Grant,9/9/20,0,0,0,0,0,0,0,0,0,211,0,3773,0,188,0,1,0,22,0,3984,0,0,0,0,0,0,0,3,5,0,36
Greene,9/9/20,0,0,0,0,0,0,0,0,0,677,0,10440,0,623,0,7,0,47,0,11117,0,0,0,0,0,0,0,3,7,1,160
Hempstead,9/9/20,0,0,0,0,0,0,0,0,0,337,0,3595,0,331,0,3,0,3,0,3932,0,0,0,0,0,0,0,0,2,0,42
HotSpring,9/9/20,0,0,0,0,0,0,0,0,0,1759,0,8949,0,1680,0,23,0,56,0,10708,0,0,0,0,0,0,0,9,1,0,244
Howard,9/9/20,0,0,0,0,0,0,0,0,0,437,0,3296,0,411,0,8,0,18,0,3733,0,0,0,0,0,0,0,0,12,0,21
Independence,9/9/20,0,0,0,0,0,0,0,0,0,837,0,8418,0,750,0,12,0,75,0,9255,0,0,0,0,0,0,0,14,12,0,225
Izard,9/9/20,0,0,0,0,0,0,0,0,0,114,0,2891,0,98,0,0,0,16,0,3005,0,0,0,0,0,0,0,2,0,0,28
Jackson,9/9/20,0,0,0,0,0,0,0,0,0,214,0,5251,0,184,0,1,0,29,0,5465,0,0,0,0,0,0,0,19,7,0,65
Jefferson,9/9/20,0,0,0,0,0,0,0,0,0,2338,0,22489,0,2013,0,53,0,272,0,24827,0,0,0,0,0,0,0,24,49,0,324
Johnson,9/9/20,0,0,0,0,0,0,0,0,0,789,0,6054,0,757,0,4,0,28,0,6843,0,0,0,0,0,0,0,0,0,0,83
Lafayette,9/9/20,0,0,0,0,0,0,0,0,0,77,0,817,0,70,0,2,0,5,0,894,0,0,0,0,0,0,0,1,1,0,8
Lawrence,9/9/20,0,0,0,0,0,0,0,0,0,275,0,3088,0,233,0,11,0,31,0,3363,0,0,0,0,0,0,0,4,0,0,39
Lee,9/9/20,0,0,0,0,0,0,0,0,0,1015,0,3371,0,990,0,11,0,14,0,4386,0,0,0,0,0,0,0,1,1,0,29
Lincoln,9/9/20,0,0,0,0,0,0,0,0,0,1767,0,5666,0,1399,0,13,0,355,0,7433,0,0,0,0,0,0,0,0,4,0,29
LittleRiver,9/9/20,0,0,0,0,0,0,0,0,0,311,0,1500,0,266,0,18,0,27,0,1811,0,0,0,0,0,0,0,4,3,1,21
Logan,9/9/20,0,0,0,0,0,0,0,0,0,372,0,5533,0,363,0,1,0,8,0,5905,0,0,0,0,0,0,0,2,5,0,64
Lonoke,9/9/20,0,0,0,0,0,0,0,0,0,804,0,13458,0,714,0,5,0,85,0,14262,0,0,0,0,0,0,0,8,14,0,165
Madison,9/9/20,0,0,0,0,0,0,0,0,0,310,0,3512,0,299,0,2,0,9,0,3822,0,0,0,0,0,0,0,0,3,0,34
Marion,9/9/20,0,0,0,0,0,0,0,0,0,57,0,1801,0,46,0,0,0,11,0,1858,0,0,0,0,0,0,0,4,1,0,31
Miller,9/9/20,0,0,0,0,0,0,0,0,0,673,0,5526,0,601,0,10,0,62,0,6199,0,0,0,0,0,0,0,3,7,0,62
MissingCountyInfo,9/9/20,0,0,0,0,0,0,0,0,0,1157,0,24050,0,915,0,0,0,242,0,25207,0,0,0,0,0,0,0,-52,-35,0,-3541
Mississippi,9/9/20,0,0,0,0,0,0,0,0,0,1448,0,10060,0,1322,0,34,0,92,0,11508,0,0,0,0,0,0,0,6,10,0,67
Monroe,9/9/20,0,0,0,0,0,0,0,0,0,101,0,1884,0,92,0,0,0,9,0,1985,0,0,0,0,0,0,0,0,1,0,13
Montgomery,9/9/20,0,0,0,0,0,0,0,0,0,118,0,1589,0,80,0,4,0,34,0,1707,0,0,0,0,0,0,0,0,2,0,25
Nevada,9/9/20,0,0,0,0,0,0,0,0,0,170,0,2278,0,153,0,12,0,5,0,2448,0,0,0,0,0,0,0,4,3,0,18
Newton,9/9/20,0,0,0,0,0,0,0,0,0,150,0,1349,0,104,0,15,0,31,0,1499,0,0,0,0,0,0,0,4,3,0,28
Ouachita,9/9/20,0,0,0,0,0,0,0,0,0,186,0,4424,0,150,0,5,0,31,0,4610,0,0,0,0,0,0,0,2,6,0,76
Perry,9/9/20,0,0,0,0,0,0,0,0,0,65,0,2231,0,61,0,0,0,4,0,2296,0,0,0,0,0,0,0,2,1,0,27
Phillips,9/9/20,0,0,0,0,0,0,0,0,0,424,0,5244,0,400,0,10,0,14,0,5668,0,0,0,0,0,0,0,2,9,0,34
Pike,9/9/20,0,0,0,0,0,0,0,0,0,191,0,1834,0,180,0,1,0,10,0,2025,0,0,0,0,0,0,0,2,1,0,14
Poinsett,9/9/20,0,0,0,0,0,0,0,0,0,534,0,6011,0,466,0,6,0,62,0,6545,0,0,0,0,0,0,0,4,7,0,40
Polk,9/9/20,0,0,0,0,0,0,0,0,0,240,0,3290,0,221,0,4,0,15,0,3530,0,0,0,0,0,0,0,0,2,0,44
Pope,9/9/20,0,0,0,0,0,0,0,0,0,1896,0,17163,0,1749,0,21,0,126,0,19059,0,0,0,0,0,0,0,10,24,1,215
Prairie,9/9/20,0,0,0,0,0,0,0,0,0,124,0,1628,0,115,0,1,0,8,0,1752,0,0,0,0,0,0,0,2,0,0,15
Pulaski,9/9/20,0,0,0,0,0,0,0,0,0,7612,0,101140,0,6899,0,115,0,598,0,108752,0,0,0,0,0,0,0,46,107,1,966
Randolph,9/9/20,0,0,0,0,0,0,0,0,0,327,0,3855,0,295,0,18,0,14,0,4182,0,0,0,0,0,0,0,2,2,0,44
Saline,9/9/20,0,0,0,0,0,0,0,0,0,1712,0,21621,0,1570,0,15,0,127,0,23333,0,0,0,0,0,0,0,11,19,0,296
Scott,9/9/20,0,0,0,0,0,0,0,0,0,90,0,1501,0,88,0,0,0,2,0,1591,0,0,0,0,0,0,0,0,0,0,11
Searcy,9/9/20,0,0,0,0,0,0,0,0,0,117,0,1584,0,101,0,0,0,16,0,1701,0,0,0,0,0,0,0,2,2,0,10
Sebastian,9/9/20,0,0,0,0,0,0,0,0,0,3053,0,33751,0,2818,0,38,0,197,0,36804,0,0,0,0,0,0,0,11,29,0,365
Sevier,9/9/20,0,0,0,0,0,0,0,0,0,1174,0,5825,0,1145,0,16,0,13,0,6999,0,0,0,0,0,0,0,1,2,0,114
Sharp,9/9/20,0,0,0,0,0,0,0,0,0,155,0,2995,0,141,0,6,0,8,0,3150,0,0,0,0,0,0,0,-2,0,1,34
St.Francis,9/9/20,0,0,0,0,0,0,0,0,0,1378,0,10207,0,1310,0,4,0,64,0,11585,0,0,0,0,0,0,0,1,17,0,89
Stone,9/9/20,0,0,0,0,0,0,0,0,0,255,0,2660,0,194,0,4,0,57,0,2915,0,0,0,0,0,0,0,5,9,0,35
Union,9/9/20,0,0,0,0,0,0,0,0,0,748,0,7515,0,681,0,25,0,42,0,8263,0,0,0,0,0,0,0,8,4,3,63
VanBuren,9/9/20,0,0,0,0,0,0,0,0,0,148,0,3137,0,120,0,2,0,26,0,3285,0,0,0,0,0,0,0,3,1,0,137
Washington,9/9/20,0,0,0,0,0,0,0,0,0,7769,0,62478,0,6916,0,80,0,773,0,70247,0,0,0,0,0,0,0,66,73,0,1003
White,9/9/20,0,0,0,0,0,0,0,0,0,576,0,10866,0,508,0,14,0,54,0,11442,0,0,0,0,0,0,0,0,16,2,277
Woodruff,9/9/20,0,0,0,0,0,0,0,0,0,29,0,1383,0,27,0,0,0,2,0,1412,0,0,0,0,0,0,0,0,0,0,16
Yell,9/9/20,0,0,0,0,0,0,0,0,0,1191,0,8042,0,1142,0,25,0,24,0,9233,0,0,0,0,0,0,0,0,2,0,67
Arkansas_all_counties,9/8/20,0,0,0,66757,0,0,0,0,2990671,66021,736,716973,0,59260,0,917,0,5844,0,782994,0,0,0,0,0,0,0,477,503,9,5334
Arkansas_county,9/8/20,0,0,0,0,0,0,0,0,0,300,0,4216,0,274,0,4,0,22,0,4516,0,0,0,0,0,0,0,1,3,0,11
Ashley,9/8/20,0,0,0,0,0,0,0,0,0,393,0,4169,0,379,0,7,0,7,0,4562,0,0,0,0,0,0,0,3,2,0,8
Baxter,9/8/20,0,0,0,0,0,0,0,0,0,161,0,2950,0,130,0,1,0,30,0,3111,0,0,0,0,0,0,0,6,3,0,25
Benton,9/8/20,0,0,0,0,0,0,0,0,0,5662,0,60818,0,5280,0,60,0,322,0,66480,0,0,0,0,0,0,0,17,22,1,138
Boone,9/8/20,0,0,0,0,0,0,0,0,0,422,0,6957,0,301,0,4,0,117,0,7379,0,0,0,0,0,0,0,8,5,0,158
Bradley,9/8/20,0,0,0,0,0,0,0,0,0,315,0,3097,0,283,0,6,0,26,0,3412,0,0,0,0,0,0,0,1,3,0,11
Calhoun,9/8/20,0,0,0,0,0,0,0,0,0,25,0,1271,0,23,0,0,0,2,0,1296,0,0,0,0,0,0,0,0,0,0,2
Carroll,9/8/20,0,0,0,0,0,0,0,0,0,506,0,5870,0,453,0,8,0,45,0,6376,0,0,0,0,0,0,0,3,5,0,17
Chicot,9/8/20,0,0,0,0,0,0,0,0,0,970,0,4314,0,939,0,11,0,20,0,5284,0,0,0,0,0,0,0,1,2,0,4
Clark,9/8/20,0,0,0,0,0,0,0,0,0,268,0,4999,0,228,0,4,0,36,0,5267,0,0,0,0,0,0,0,2,6,0,11
Clay,9/8/20,0,0,0,0,0,0,0,0,0,214,0,3190,0,174,0,5,0,35,0,3404,0,0,0,0,0,0,0,3,4,0,22
Cleburne,9/8/20,0,0,0,0,0,0,0,0,0,270,0,4630,0,248,0,7,0,15,0,4900,0,0,0,0,0,0,0,0,3,0,24
Cleveland,9/8/20,0,0,0,0,0,0,0,0,0,143,0,2024,0,128,0,7,0,8,0,2167,0,0,0,0,0,0,0,1,0,0,27
Columbia,9/8/20,0,0,0,0,0,0,0,0,0,320,0,3712,0,281,0,16,0,23,0,4032,0,0,0,0,0,0,0,1,1,0,6
Conway,9/8/20,0,0,0,0,0,0,0,0,0,222,0,4888,0,199,0,3,0,20,0,5110,0,0,0,0,0,0,0,2,2,0,19
Craighead,9/8/20,0,0,0,0,0,0,0,0,0,2139,0,25576,0,1777,0,15,0,347,0,27715,0,0,0,0,0,0,0,15,19,0,248
Crawford,9/8/20,0,0,0,0,0,0,0,0,0,1000,0,14615,0,892,0,10,0,98,0,15615,0,0,0,0,0,0,0,7,12,1,135
Crittenden,9/8/20,0,0,0,0,0,0,0,0,0,1748,0,12086,0,1609,0,36,0,103,0,13834,0,0,0,0,0,0,0,10,4,1,34
Cross,9/8/20,0,0,0,0,0,0,0,0,0,337,0,3523,0,269,0,5,0,63,0,3860,0,0,0,0,0,0,0,30,12,0,108
Dallas,9/8/20,0,0,0,0,0,0,0,0,0,137,0,1543,0,109,0,2,0,26,0,1680,0,0,0,0,0,0,0,1,3,0,9
Desha,9/8/20,0,0,0,0,0,0,0,0,0,254,0,3075,0,230,0,5,0,19,0,3329,0,0,0,0,0,0,0,1,2,0,6
Drew,9/8/20,0,0,0,0,0,0,0,0,0,322,0,4658,0,294,0,5,0,23,0,4980,0,0,0,0,0,0,0,1,1,0,6
Faulkner,9/8/20,0,0,0,0,0,0,0,0,0,1809,0,28528,0,1641,0,9,0,159,0,30337,0,0,0,0,0,0,0,11,17,0,62
Franklin,9/8/20,0,0,0,0,0,0,0,0,0,191,0,4406,0,161,0,2,0,28,0,4597,0,0,0,0,0,0,0,2,2,0,32
Fulton,9/8/20,0,0,0,0,0,0,0,0,0,85,0,943,0,68,0,1,0,16,0,1028,0,0,0,0,0,0,0,0,0,0,3
Garland,9/8/20,0,0,0,0,0,0,0,0,0,1537,0,21963,0,1362,0,34,0,141,0,23500,0,0,0,0,0,0,0,4,20,1,69
Grant,9/8/20,0,0,0,0,0,0,0,0,0,208,0,3740,0,183,0,1,0,24,0,3948,0,0,0,0,0,0,0,4,4,0,24
Greene,9/8/20,0,0,0,0,0,0,0,0,0,674,0,10283,0,616,0,6,0,52,0,10957,0,0,0,0,0,0,0,2,8,1,76
Hempstead,9/8/20,0,0,0,0,0,0,0,0,0,337,0,3553,0,329,0,3,0,5,0,3890,0,0,0,0,0,0,0,2,1,0,8
HotSpring,9/8/20,0,0,0,0,0,0,0,0,0,1750,0,8714,0,1679,0,23,0,48,0,10464,0,0,0,0,0,0,0,3,6,0,35
Howard,9/8/20,0,0,0,0,0,0,0,0,0,437,0,3275,0,399,0,8,0,30,0,3712,0,0,0,0,0,0,0,0,1,0,10
Independence,9/8/20,0,0,0,0,0,0,0,0,0,823,0,8207,0,738,0,12,0,73,0,9030,0,0,0,0,0,0,0,7,11,0,42
Izard,9/8/20,0,0,0,0,0,0,0,0,0,112,0,2865,0,98,0,0,0,14,0,2977,0,0,0,0,0,0,0,1,1,0,8
Jackson,9/8/20,0,0,0,0,0,0,0,0,0,195,0,5205,0,177,0,1,0,17,0,5400,0,0,0,0,0,0,0,0,0,0,12
Jefferson,9/8/20,0,0,0,0,0,0,0,0,0,2314,0,22189,0,1964,0,53,0,297,0,24503,0,0,0,0,0,0,0,10,35,0,52
Johnson,9/8/20,0,0,0,0,0,0,0,0,0,789,0,5971,0,757,0,4,0,28,0,6760,0,0,0,0,0,0,0,2,-1,0,26
Lafayette,9/8/20,0,0,0,0,0,0,0,0,0,76,0,810,0,69,0,2,0,5,0,886,0,0,0,0,0,0,0,0,0,0,1
Lawrence,9/8/20,0,0,0,0,0,0,0,0,0,271,0,3053,0,233,0,11,0,27,0,3324,0,0,0,0,0,0,0,0,2,0,64
Lee,9/8/20,0,0,0,0,0,0,0,0,0,1014,0,3343,0,989,0,11,0,14,0,4357,0,0,0,0,0,0,0,1,3,0,4
Lincoln,9/8/20,0,0,0,0,0,0,0,0,0,1767,0,5637,0,1395,0,13,0,359,0,7404,0,0,0,0,0,0,0,5,10,0,11
LittleRiver,9/8/20,0,0,0,0,0,0,0,0,0,307,0,1483,0,263,0,17,0,27,0,1790,0,0,0,0,0,0,0,1,1,0,3
Logan,9/8/20,0,0,0,0,0,0,0,0,0,370,0,5471,0,358,0,1,0,11,0,5841,0,0,0,0,0,0,0,0,1,0,24
Lonoke,9/8/20,0,0,0,0,0,0,0,0,0,796,0,13301,0,700,0,5,0,91,0,14097,0,0,0,0,0,0,0,11,9,0,78
Madison,9/8/20,0,0,0,0,0,0,0,0,0,310,0,3478,0,296,0,2,0,12,0,3788,0,0,0,0,0,0,0,0,0,0,-1
Marion,9/8/20,0,0,0,0,0,0,0,0,0,53,0,1774,0,45,0,0,0,8,0,1827,0,0,0,0,0,0,0,1,2,0,10
Miller,9/8/20,0,0,0,0,0,0,0,0,0,670,0,5467,0,594,0,10,0,66,0,6137,0,0,0,0,0,0,0,8,3,0,144
MissingCountyInfo,9/8/20,0,0,0,0,0,0,0,0,0,1209,0,27539,0,950,0,0,0,259,0,28748,0,0,0,0,0,0,0,-18,0,0,1202
Mississippi,9/8/20,0,0,0,0,0,0,0,0,0,1442,0,9999,0,1312,0,34,0,96,0,11441,0,0,0,0,0,0,0,3,9,0,151
Monroe,9/8/20,0,0,0,0,0,0,0,0,0,101,0,1871,0,91,0,0,0,10,0,1972,0,0,0,0,0,0,0,1,0,0,6
Montgomery,9/8/20,0,0,0,0,0,0,0,0,0,118,0,1564,0,78,0,4,0,36,0,1682,0,0,0,0,0,0,0,-1,5,0,115
Nevada,9/8/20,0,0,0,0,0,0,0,0,0,166,0,2264,0,150,0,12,0,4,0,2430,0,0,0,0,0,0,0,-1,1,0,7
Newton,9/8/20,0,0,0,0,0,0,0,0,0,146,0,1325,0,101,0,15,0,30,0,1471,0,0,0,0,0,0,0,0,1,0,5
Ouachita,9/8/20,0,0,0,0,0,0,0,0,0,184,0,4350,0,144,0,5,0,35,0,4534,0,0,0,0,0,0,0,0,1,0,15
Perry,9/8/20,0,0,0,0,0,0,0,0,0,63,0,2206,0,60,0,0,0,3,0,2269,0,0,0,0,0,0,0,0,0,0,9
Phillips,9/8/20,0,0,0,0,0,0,0,0,0,422,0,5212,0,391,0,10,0,21,0,5634,0,0,0,0,0,0,0,2,0,0,11
Pike,9/8/20,0,0,0,0,0,0,0,0,0,189,0,1822,0,179,0,1,0,9,0,2011,0,0,0,0,0,0,0,0,0,0,7
Poinsett,9/8/20,0,0,0,0,0,0,0,0,0,530,0,5975,0,459,0,6,0,65,0,6505,0,0,0,0,0,0,0,1,12,0,32
Polk,9/8/20,0,0,0,0,0,0,0,0,0,240,0,3246,0,219,0,4,0,17,0,3486,0,0,0,0,0,0,0,2,1,0,13
Pope,9/8/20,0,0,0,0,0,0,0,0,0,1886,0,16958,0,1725,0,20,0,141,0,18844,0,0,0,0,0,0,0,5,15,0,111
Prairie,9/8/20,0,0,0,0,0,0,0,0,0,122,0,1615,0,115,0,1,0,6,0,1737,0,0,0,0,0,0,0,1,0,0,5
Pulaski,9/8/20,0,0,0,0,0,0,0,0,0,7566,0,100220,0,6792,0,114,0,660,0,107786,0,0,0,0,0,0,0,23,50,1,627
Randolph,9/8/20,0,0,0,0,0,0,0,0,0,325,0,3813,0,293,0,18,0,14,0,4138,0,0,0,0,0,0,0,2,1,0,62
Saline,9/8/20,0,0,0,0,0,0,0,0,0,1701,0,21336,0,1551,0,15,0,135,0,23037,0,0,0,0,0,0,0,11,66,1,308
Scott,9/8/20,0,0,0,0,0,0,0,0,0,90,0,1490,0,88,0,0,0,2,0,1580,0,0,0,0,0,0,0,0,0,0,1
Searcy,9/8/20,0,0,0,0,0,0,0,0,0,115,0,1576,0,99,0,0,0,16,0,1691,0,0,0,0,0,0,0,0,7,0,10
Sebastian,9/8/20,0,0,0,0,0,0,0,0,0,3042,0,33397,0,2789,0,38,0,215,0,36439,0,0,0,0,0,0,0,12,21,2,134
Sevier,9/8/20,0,0,0,0,0,0,0,0,0,1173,0,5712,0,1143,0,16,0,14,0,6885,0,0,0,0,0,0,0,0,2,0,4
Sharp,9/8/20,0,0,0,0,0,0,0,0,0,157,0,2959,0,141,0,5,0,11,0,3116,0,0,0,0,0,0,0,1,0,0,13
St.Francis,9/8/20,0,0,0,0,0,0,0,0,0,1377,0,10119,0,1293,0,4,0,80,0,11496,0,0,0,0,0,0,0,4,1,0,80
Stone,9/8/20,0,0,0,0,0,0,0,0,0,250,0,2630,0,185,0,4,0,61,0,2880,0,0,0,0,0,0,0,0,5,0,17
Union,9/8/20,0,0,0,0,0,0,0,0,0,740,0,7460,0,677,0,22,0,41,0,8200,0,0,0,0,0,0,0,9,7,0,27
VanBuren,9/8/20,0,0,0,0,0,0,0,0,0,145,0,3003,0,119,0,2,0,24,0,3148,0,0,0,0,0,0,0,3,5,0,51
Washington,9/8/20,0,0,0,0,0,0,0,0,0,7703,0,61541,0,6843,0,80,0,780,0,69244,0,0,0,0,0,0,0,37,32,0,178
White,9/8/20,0,0,0,0,0,0,0,0,0,576,0,10589,0,492,0,12,0,72,0,11165,0,0,0,0,0,0,0,5,5,0,246
Woodruff,9/8/20,0,0,0,0,0,0,0,0,0,29,0,1367,0,27,0,0,0,2,0,1396,0,0,0,0,0,0,0,1,0,0,15
Yell,9/8/20,0,0,0,0,0,0,0,0,0,1191,0,7975,0,1140,0,25,0,26,0,9166,0,0,0,0,0,0,0,2,6,0,46
Arkansas_all_counties,9/7/20,0,0,0,66280,0,0,0,0,2990671,65727,553,711933,0,58757,0,908,0,6062,0,777660,0,0,0,0,0,0,0,356,462,14,5750
Arkansas_county,9/7/20,0,0,0,0,0,0,0,0,0,299,0,4206,0,271,0,4,0,24,0,4505,0,0,0,0,0,0,0,1,4,0,28
Ashley,9/7/20,0,0,0,0,0,0,0,0,0,390,0,4164,0,377,0,7,0,6,0,4554,0,0,0,0,0,0,0,0,2,0,7
Baxter,9/7/20,0,0,0,0,0,0,0,0,0,155,0,2931,0,127,0,1,0,27,0,3086,0,0,0,0,0,0,0,6,1,0,109
Benton,9/7/20,0,0,0,0,0,0,0,0,0,5645,0,60697,0,5258,0,59,0,328,0,66342,0,0,0,0,0,0,0,13,27,0,357
Boone,9/7/20,0,0,0,0,0,0,0,0,0,414,0,6807,0,296,0,4,0,114,0,7221,0,0,0,0,0,0,0,6,6,0,57
Bradley,9/7/20,0,0,0,0,0,0,0,0,0,314,0,3087,0,280,0,6,0,28,0,3401,0,0,0,0,0,0,0,3,1,0,11
Calhoun,9/7/20,0,0,0,0,0,0,0,0,0,25,0,1269,0,23,0,0,0,2,0,1294,0,0,0,0,0,0,0,1,0,0,0
Carroll,9/7/20,0,0,0,0,0,0,0,0,0,503,0,5856,0,448,0,8,0,47,0,6359,0,0,0,0,0,0,0,2,6,0,26
Chicot,9/7/20,0,0,0,0,0,0,0,0,0,969,0,4311,0,937,0,11,0,21,0,5280,0,0,0,0,0,0,0,0,3,0,1
Clark,9/7/20,0,0,0,0,0,0,0,0,0,266,0,4990,0,222,0,4,0,40,0,5256,0,0,0,0,0,0,0,3,2,0,166
Clay,9/7/20,0,0,0,0,0,0,0,0,0,211,0,3171,0,170,0,5,0,36,0,3382,0,0,0,0,0,0,0,2,3,0,26
Cleburne,9/7/20,0,0,0,0,0,0,0,0,0,270,0,4606,0,245,0,7,0,18,0,4876,0,0,0,0,0,0,0,3,1,0,19
Cleveland,9/7/20,0,0,0,0,0,0,0,0,0,142,0,1998,0,128,0,7,0,7,0,2140,0,0,0,0,0,0,0,0,0,0,11
Columbia,9/7/20,0,0,0,0,0,0,0,0,0,319,0,3707,0,280,0,16,0,23,0,4026,0,0,0,0,0,0,0,2,4,1,11
Conway,9/7/20,0,0,0,0,0,0,0,0,0,220,0,4871,0,197,0,3,0,20,0,5091,0,0,0,0,0,0,0,1,1,0,24
Craighead,9/7/20,0,0,0,0,0,0,0,0,0,2124,0,25343,0,1758,0,15,0,351,0,27467,0,0,0,0,0,0,0,45,18,-1,287
Crawford,9/7/20,0,0,0,0,0,0,0,0,0,993,0,14487,0,880,0,9,0,104,0,15480,0,0,0,0,0,0,0,1,11,0,135
Crittenden,9/7/20,0,0,0,0,0,0,0,0,0,1738,0,12062,0,1605,0,35,0,98,0,13800,0,0,0,0,0,0,0,25,4,0,83
Cross,9/7/20,0,0,0,0,0,0,0,0,0,307,0,3445,0,257,0,5,0,45,0,3752,0,0,0,0,0,0,0,3,5,0,11
Dallas,9/7/20,0,0,0,0,0,0,0,0,0,136,0,1535,0,106,0,2,0,28,0,1671,0,0,0,0,0,0,0,1,9,0,14
Desha,9/7/20,0,0,0,0,0,0,0,0,0,253,0,3070,0,228,0,5,0,20,0,3323,0,0,0,0,0,0,0,0,4,0,9
Drew,9/7/20,0,0,0,0,0,0,0,0,0,321,0,4653,0,293,0,5,0,23,0,4974,0,0,0,0,0,0,0,2,1,0,9
Faulkner,9/7/20,0,0,0,0,0,0,0,0,0,1798,0,28477,0,1624,0,9,0,165,0,30275,0,0,0,0,0,0,0,8,36,0,213
Franklin,9/7/20,0,0,0,0,0,0,0,0,0,189,0,4376,0,159,0,2,0,28,0,4565,0,0,0,0,0,0,0,2,2,0,23
Fulton,9/7/20,0,0,0,0,0,0,0,0,0,85,0,940,0,68,0,1,0,16,0,1025,0,0,0,0,0,0,0,1,1,0,3
Garland,9/7/20,0,0,0,0,0,0,0,0,0,1533,0,21898,0,1342,0,33,0,158,0,23431,0,0,0,0,0,0,0,15,7,1,85
Grant,9/7/20,0,0,0,0,0,0,0,0,0,204,0,3720,0,179,0,1,0,24,0,3924,0,0,0,0,0,0,0,0,2,0,21
Greene,9/7/20,0,0,0,0,0,0,0,0,0,672,0,10209,0,608,0,5,0,59,0,10881,0,0,0,0,0,0,0,3,2,0,169
Hempstead,9/7/20,0,0,0,0,0,0,0,0,0,335,0,3547,0,328,0,3,0,4,0,3882,0,0,0,0,0,0,0,0,2,0,16
HotSpring,9/7/20,0,0,0,0,0,0,0,0,0,1747,0,8682,0,1673,0,23,0,51,0,10429,0,0,0,0,0,0,0,1,1,0,14
Howard,9/7/20,0,0,0,0,0,0,0,0,0,437,0,3265,0,398,0,8,0,31,0,3702,0,0,0,0,0,0,0,2,2,1,20
Independence,9/7/20,0,0,0,0,0,0,0,0,0,816,0,8172,0,727,0,12,0,77,0,8988,0,0,0,0,0,0,0,3,5,4,26
Izard,9/7/20,0,0,0,0,0,0,0,0,0,111,0,2858,0,97,0,0,0,14,0,2969,0,0,0,0,0,0,0,0,2,0,3
Jackson,9/7/20,0,0,0,0,0,0,0,0,0,195,0,5193,0,177,0,1,0,17,0,5388,0,0,0,0,0,0,0,1,0,0,12
Jefferson,9/7/20,0,0,0,0,0,0,0,0,0,2304,0,22147,0,1929,0,53,0,322,0,24451,0,0,0,0,0,0,0,19,19,1,184
Johnson,9/7/20,0,0,0,0,0,0,0,0,0,787,0,5947,0,758,0,4,0,25,0,6734,0,0,0,0,0,0,0,2,0,0,127
Lafayette,9/7/20,0,0,0,0,0,0,0,0,0,76,0,809,0,69,0,2,0,5,0,885,0,0,0,0,0,0,0,0,0,0,0
Lawrence,9/7/20,0,0,0,0,0,0,0,0,0,271,0,2989,0,231,0,11,0,29,0,3260,0,0,0,0,0,0,0,3,0,0,16
Lee,9/7/20,0,0,0,0,0,0,0,0,0,1013,0,3340,0,986,0,11,0,16,0,4353,0,0,0,0,0,0,0,0,2,0,11
Lincoln,9/7/20,0,0,0,0,0,0,0,0,0,1762,0,5631,0,1385,0,13,0,364,0,7393,0,0,0,0,0,0,0,3,4,0,11
LittleRiver,9/7/20,0,0,0,0,0,0,0,0,0,306,0,1481,0,262,0,17,0,27,0,1787,0,0,0,0,0,0,0,2,0,1,8
Logan,9/7/20,0,0,0,0,0,0,0,0,0,370,0,5447,0,357,0,1,0,12,0,5817,0,0,0,0,0,0,0,1,3,0,11
Lonoke,9/7/20,0,0,0,0,0,0,0,0,0,785,0,13234,0,691,0,5,0,89,0,14019,0,0,0,0,0,0,0,9,13,0,72
Madison,9/7/20,0,0,0,0,0,0,0,0,0,310,0,3479,0,296,0,2,0,12,0,3789,0,0,0,0,0,0,0,2,1,0,12
Marion,9/7/20,0,0,0,0,0,0,0,0,0,52,0,1765,0,43,0,0,0,9,0,1817,0,0,0,0,0,0,0,1,1,0,19
Miller,9/7/20,0,0,0,0,0,0,0,0,0,662,0,5331,0,591,0,10,0,61,0,5993,0,0,0,0,0,0,0,6,1,0,15
MissingCountyInfo,9/7/20,0,0,0,0,0,0,0,0,0,1227,0,26319,0,950,0,0,0,277,0,27546,0,0,0,0,0,0,0,0,10,0,1063
Mississippi,9/7/20,0,0,0,0,0,0,0,0,0,1439,0,9851,0,1303,0,34,0,102,0,11290,0,0,0,0,0,0,0,6,7,2,68
Monroe,9/7/20,0,0,0,0,0,0,0,0,0,100,0,1866,0,91,0,0,0,9,0,1966,0,0,0,0,0,0,0,0,1,0,16
Montgomery,9/7/20,0,0,0,0,0,0,0,0,0,119,0,1448,0,73,0,4,0,42,0,1567,0,0,0,0,0,0,0,1,0,0,2
Nevada,9/7/20,0,0,0,0,0,0,0,0,0,167,0,2256,0,149,0,12,0,6,0,2423,0,0,0,0,0,0,0,1,0,0,12
Newton,9/7/20,0,0,0,0,0,0,0,0,0,146,0,1320,0,100,0,15,0,31,0,1466,0,0,0,0,0,0,0,2,2,0,7
Ouachita,9/7/20,0,0,0,0,0,0,0,0,0,184,0,4335,0,143,0,5,0,36,0,4519,0,0,0,0,0,0,0,5,4,0,11
Perry,9/7/20,0,0,0,0,0,0,0,0,0,63,0,2197,0,60,0,0,0,3,0,2260,0,0,0,0,0,0,0,0,1,0,30
Phillips,9/7/20,0,0,0,0,0,0,0,0,0,420,0,5203,0,391,0,10,0,19,0,5623,0,0,0,0,0,0,0,5,1,0,33
Pike,9/7/20,0,0,0,0,0,0,0,0,0,189,0,1815,0,179,0,1,0,9,0,2004,0,0,0,0,0,0,0,3,2,0,11
Poinsett,9/7/20,0,0,0,0,0,0,0,0,0,529,0,5944,0,447,0,6,0,76,0,6473,0,0,0,0,0,0,0,12,5,0,55
Polk,9/7/20,0,0,0,0,0,0,0,0,0,238,0,3235,0,218,0,4,0,16,0,3473,0,0,0,0,0,0,0,0,3,0,8
Pope,9/7/20,0,0,0,0,0,0,0,0,0,1881,0,16852,0,1710,0,20,0,151,0,18733,0,0,0,0,0,0,0,10,14,0,85
Prairie,9/7/20,0,0,0,0,0,0,0,0,0,121,0,1611,0,115,0,1,0,5,0,1732,0,0,0,0,0,0,0,0,0,0,4
Pulaski,9/7/20,0,0,0,0,0,0,0,0,0,7543,0,99616,0,6742,0,113,0,688,0,107159,0,0,0,0,0,0,0,42,72,0,775
Randolph,9/7/20,0,0,0,0,0,0,0,0,0,323,0,3753,0,292,0,18,0,13,0,4076,0,0,0,0,0,0,0,1,-1,0,12
Saline,9/7/20,0,0,0,0,0,0,0,0,0,1690,0,21039,0,1485,0,14,0,191,0,22729,0,0,0,0,0,0,0,3,28,0,159
Scott,9/7/20,0,0,0,0,0,0,0,0,0,90,0,1489,0,88,0,0,0,2,0,1579,0,0,0,0,0,0,0,0,0,0,7
Searcy,9/7/20,0,0,0,0,0,0,0,0,0,115,0,1566,0,92,0,0,0,23,0,1681,0,0,0,0,0,0,0,0,8,0,6
Sebastian,9/7/20,0,0,0,0,0,0,0,0,0,3030,0,33275,0,2768,0,36,0,226,0,36305,0,0,0,0,0,0,0,9,19,1,214
Sevier,9/7/20,0,0,0,0,0,0,0,0,0,1173,0,5708,0,1141,0,16,0,16,0,6881,0,0,0,0,0,0,0,0,-2,2,21
Sharp,9/7/20,0,0,0,0,0,0,0,0,0,156,0,2947,0,141,0,5,0,10,0,3103,0,0,0,0,0,0,0,1,0,0,7
St.Francis,9/7/20,0,0,0,0,0,0,0,0,0,1373,0,10043,0,1292,0,4,0,77,0,11416,0,0,0,0,0,0,0,1,4,0,45
Stone,9/7/20,0,0,0,0,0,0,0,0,0,250,0,2613,0,180,0,4,0,66,0,2863,0,0,0,0,0,0,0,9,7,0,67
Union,9/7/20,0,0,0,0,0,0,0,0,0,731,0,7442,0,670,0,22,0,39,0,8173,0,0,0,0,0,0,0,6,21,0,140
VanBuren,9/7/20,0,0,0,0,0,0,0,0,0,142,0,2955,0,114,0,2,0,26,0,3097,0,0,0,0,0,0,0,1,4,0,65
Washington,9/7/20,0,0,0,0,0,0,0,0,0,7666,0,61400,0,6811,0,80,0,775,0,69066,0,0,0,0,0,0,0,27,22,1,229
White,9/7/20,0,0,0,0,0,0,0,0,0,571,0,10348,0,487,0,12,0,72,0,10919,0,0,0,0,0,0,0,1,5,0,34
Woodruff,9/7/20,0,0,0,0,0,0,0,0,0,28,0,1353,0,27,0,0,0,1,0,1381,0,0,0,0,0,0,0,0,0,0,2
Yell,9/7/20,0,0,0,0,0,0,0,0,0,1189,0,7931,0,1134,0,25,0,30,0,9120,0,0,0,0,0,0,0,0,6,0,70
Arkansas_all_counties,9/6/20,0,0,0,65924,0,0,0,0,2990671,65377,547,706533,0,58295,0,894,0,6188,0,771910,0,0,0,0,0,0,0,698,327,12,6499
Arkansas_county,9/6/20,0,0,0,0,0,0,0,0,0,298,0,4179,0,267,0,4,0,27,0,4477,0,0,0,0,0,0,0,4,1,1,21
Ashley,9/6/20,0,0,0,0,0,0,0,0,0,390,0,4157,0,375,0,7,0,8,0,4547,0,0,0,0,0,0,0,1,0,0,5
Baxter,9/6/20,0,0,0,0,0,0,0,0,0,149,0,2828,0,126,0,1,0,22,0,2977,0,0,0,0,0,0,0,2,2,0,34
Benton,9/6/20,0,0,0,0,0,0,0,0,0,5632,0,60353,0,5231,0,59,0,342,0,65985,0,0,0,0,0,0,0,33,17,0,345
Boone,9/6/20,0,0,0,0,0,0,0,0,0,408,0,6756,0,290,0,4,0,114,0,7164,0,0,0,0,0,0,0,15,9,0,55
Bradley,9/6/20,0,0,0,0,0,0,0,0,0,311,0,3079,0,279,0,6,0,26,0,3390,0,0,0,0,0,0,0,8,3,0,13
Calhoun,9/6/20,0,0,0,0,0,0,0,0,0,24,0,1270,0,23,0,0,0,1,0,1294,0,0,0,0,0,0,0,1,0,0,2
Carroll,9/6/20,0,0,0,0,0,0,0,0,0,501,0,5832,0,442,0,8,0,51,0,6333,0,0,0,0,0,0,0,15,2,0,50
Chicot,9/6/20,0,0,0,0,0,0,0,0,0,969,0,4310,0,934,0,11,0,24,0,5279,0,0,0,0,0,0,0,0,1,0,6
Clark,9/6/20,0,0,0,0,0,0,0,0,0,263,0,4827,0,220,0,4,0,39,0,5090,0,0,0,0,0,0,0,8,3,0,52
Clay,9/6/20,0,0,0,0,0,0,0,0,0,209,0,3147,0,167,0,5,0,37,0,3356,0,0,0,0,0,0,0,6,4,0,50
Cleburne,9/6/20,0,0,0,0,0,0,0,0,0,267,0,4590,0,244,0,7,0,16,0,4857,0,0,0,0,0,0,0,3,0,0,41
Cleveland,9/6/20,0,0,0,0,0,0,0,0,0,142,0,1987,0,128,0,7,0,7,0,2129,0,0,0,0,0,0,0,1,1,1,9
Columbia,9/6/20,0,0,0,0,0,0,0,0,0,317,0,3698,0,276,0,15,0,26,0,4015,0,0,0,0,0,0,0,2,1,0,17
Conway,9/6/20,0,0,0,0,0,0,0,0,0,219,0,4848,0,196,0,3,0,20,0,5067,0,0,0,0,0,0,0,3,1,0,23
Craighead,9/6/20,0,0,0,0,0,0,0,0,0,2079,0,25101,0,1740,0,16,0,323,0,27180,0,0,0,0,0,0,0,57,14,0,319
Crawford,9/6/20,0,0,0,0,0,0,0,0,0,992,0,14353,0,869,0,9,0,114,0,15345,0,0,0,0,0,0,0,21,10,0,108
Crittenden,9/6/20,0,0,0,0,0,0,0,0,0,1713,0,12004,0,1601,0,35,0,77,0,13717,0,0,0,0,0,0,0,10,6,0,56
Cross,9/6/20,0,0,0,0,0,0,0,0,0,304,0,3437,0,252,0,5,0,47,0,3741,0,0,0,0,0,0,0,1,3,0,16
Dallas,9/6/20,0,0,0,0,0,0,0,0,0,135,0,1522,0,97,0,2,0,36,0,1657,0,0,0,0,0,0,0,0,4,0,2
Desha,9/6/20,0,0,0,0,0,0,0,0,0,253,0,3061,0,224,0,5,0,24,0,3314,0,0,0,0,0,0,0,1,1,0,5
Drew,9/6/20,0,0,0,0,0,0,0,0,0,319,0,4646,0,292,0,5,0,22,0,4965,0,0,0,0,0,0,0,10,1,0,17
Faulkner,9/6/20,0,0,0,0,0,0,0,0,0,1790,0,28272,0,1588,0,9,0,193,0,30062,0,0,0,0,0,0,0,20,10,0,246
Franklin,9/6/20,0,0,0,0,0,0,0,0,0,187,0,4355,0,157,0,2,0,28,0,4542,0,0,0,0,0,0,0,5,1,0,147
Fulton,9/6/20,0,0,0,0,0,0,0,0,0,84,0,938,0,67,0,1,0,16,0,1022,0,0,0,0,0,0,0,0,0,0,4
Garland,9/6/20,0,0,0,0,0,0,0,0,0,1518,0,21828,0,1335,0,32,0,151,0,23346,0,0,0,0,0,0,0,17,10,1,101
Grant,9/6/20,0,0,0,0,0,0,0,0,0,204,0,3699,0,177,0,1,0,26,0,3903,0,0,0,0,0,0,0,2,3,0,18
Greene,9/6/20,0,0,0,0,0,0,0,0,0,669,0,10043,0,606,0,5,0,58,0,10712,0,0,0,0,0,0,0,9,1,0,141
Hempstead,9/6/20,0,0,0,0,0,0,0,0,0,335,0,3531,0,326,0,3,0,6,0,3866,0,0,0,0,0,0,0,0,0,0,14
HotSpring,9/6/20,0,0,0,0,0,0,0,0,0,1746,0,8669,0,1672,0,23,0,51,0,10415,0,0,0,0,0,0,0,5,1,2,37
Howard,9/6/20,0,0,0,0,0,0,0,0,0,435,0,3247,0,396,0,7,0,32,0,3682,0,0,0,0,0,0,0,0,1,2,15
Independence,9/6/20,0,0,0,0,0,0,0,0,0,813,0,8149,0,722,0,8,0,83,0,8962,0,0,0,0,0,0,0,7,8,0,21
Izard,9/6/20,0,0,0,0,0,0,0,0,0,111,0,2855,0,95,0,0,0,16,0,2966,0,0,0,0,0,0,0,2,3,0,22
Jackson,9/6/20,0,0,0,0,0,0,0,0,0,194,0,5182,0,177,0,1,0,16,0,5376,0,0,0,0,0,0,0,0,3,0,34
Jefferson,9/6/20,0,0,0,0,0,0,0,0,0,2285,0,21982,0,1910,0,52,0,323,0,24267,0,0,0,0,0,0,0,44,14,1,174
Johnson,9/6/20,0,0,0,0,0,0,0,0,0,785,0,5822,0,758,0,4,0,23,0,6607,0,0,0,0,0,0,0,8,1,0,102
Lafayette,9/6/20,0,0,0,0,0,0,0,0,0,76,0,809,0,69,0,2,0,5,0,885,0,0,0,0,0,0,0,2,1,0,7
Lawrence,9/6/20,0,0,0,0,0,0,0,0,0,268,0,2976,0,231,0,11,0,26,0,3244,0,0,0,0,0,0,0,5,0,0,58
Lee,9/6/20,0,0,0,0,0,0,0,0,0,1013,0,3329,0,984,0,11,0,18,0,4342,0,0,0,0,0,0,0,3,1,0,9
Lincoln,9/6/20,0,0,0,0,0,0,0,0,0,1759,0,5623,0,1381,0,13,0,365,0,7382,0,0,0,0,0,0,0,5,1,0,16
LittleRiver,9/6/20,0,0,0,0,0,0,0,0,0,304,0,1475,0,262,0,16,0,26,0,1779,0,0,0,0,0,0,0,4,0,1,8
Logan,9/6/20,0,0,0,0,0,0,0,0,0,369,0,5437,0,354,0,1,0,14,0,5806,0,0,0,0,0,0,0,2,1,0,23
Lonoke,9/6/20,0,0,0,0,0,0,0,0,0,776,0,13171,0,678,0,5,0,93,0,13947,0,0,0,0,0,0,0,9,5,0,90
Madison,9/6/20,0,0,0,0,0,0,0,0,0,308,0,3469,0,295,0,2,0,11,0,3777,0,0,0,0,0,0,0,0,-1,0,19
Marion,9/6/20,0,0,0,0,0,0,0,0,0,51,0,1747,0,42,0,0,0,9,0,1798,0,0,0,0,0,0,0,0,0,0,9
Miller,9/6/20,0,0,0,0,0,0,0,0,0,656,0,5322,0,590,0,10,0,56,0,5978,0,0,0,0,0,0,0,10,1,0,33
MissingCountyInfo,9/6/20,0,0,0,0,0,0,0,0,0,1227,0,25256,0,940,0,0,0,287,0,26483,0,0,0,0,0,0,0,13,1,0,1566
Mississippi,9/6/20,0,0,0,0,0,0,0,0,0,1433,0,9789,0,1296,0,32,0,105,0,11222,0,0,0,0,0,0,0,28,13,0,146
Monroe,9/6/20,0,0,0,0,0,0,0,0,0,100,0,1850,0,90,0,0,0,10,0,1950,0,0,0,0,0,0,0,0,0,0,11
Montgomery,9/6/20,0,0,0,0,0,0,0,0,0,118,0,1447,0,73,0,4,0,41,0,1565,0,0,0,0,0,0,0,0,3,0,48
Nevada,9/6/20,0,0,0,0,0,0,0,0,0,166,0,2245,0,149,0,12,0,5,0,2411,0,0,0,0,0,0,0,1,2,0,7
Newton,9/6/20,0,0,0,0,0,0,0,0,0,144,0,1315,0,98,0,15,0,31,0,1459,0,0,0,0,0,0,0,6,0,0,21
Ouachita,9/6/20,0,0,0,0,0,0,0,0,0,179,0,4329,0,139,0,5,0,35,0,4508,0,0,0,0,0,0,0,4,4,0,9
Perry,9/6/20,0,0,0,0,0,0,0,0,0,63,0,2167,0,59,0,0,0,4,0,2230,0,0,0,0,0,0,0,0,0,0,9
Phillips,9/6/20,0,0,0,0,0,0,0,0,0,415,0,5175,0,390,0,10,0,15,0,5590,0,0,0,0,0,0,0,1,3,0,15
Pike,9/6/20,0,0,0,0,0,0,0,0,0,186,0,1807,0,177,0,1,0,8,0,1993,0,0,0,0,0,0,0,3,2,0,7
Poinsett,9/6/20,0,0,0,0,0,0,0,0,0,517,0,5901,0,442,0,6,0,69,0,6418,0,0,0,0,0,0,0,6,10,0,47
Polk,9/6/20,0,0,0,0,0,0,0,0,0,238,0,3227,0,215,0,4,0,19,0,3465,0,0,0,0,0,0,0,4,1,0,30
Pope,9/6/20,0,0,0,0,0,0,0,0,0,1871,0,16777,0,1696,0,20,0,155,0,18648,0,0,0,0,0,0,0,39,6,0,116
Prairie,9/6/20,0,0,0,0,0,0,0,0,0,121,0,1607,0,115,0,1,0,5,0,1728,0,0,0,0,0,0,0,0,0,0,5
Pulaski,9/6/20,0,0,0,0,0,0,0,0,0,7501,0,98883,0,6670,0,113,0,718,0,106384,0,0,0,0,0,0,0,60,64,0,932
Randolph,9/6/20,0,0,0,0,0,0,0,0,0,322,0,3742,0,293,0,18,0,11,0,4064,0,0,0,0,0,0,0,3,-1,1,24
Saline,9/6/20,0,0,0,0,0,0,0,0,0,1687,0,20883,0,1457,0,14,0,216,0,22570,0,0,0,0,0,0,0,11,18,0,122
Scott,9/6/20,0,0,0,0,0,0,0,0,0,90,0,1482,0,88,0,0,0,2,0,1572,0,0,0,0,0,0,0,1,0,0,11
Searcy,9/6/20,0,0,0,0,0,0,0,0,0,115,0,1560,0,84,0,0,0,31,0,1675,0,0,0,0,0,0,0,1,3,0,9
Sebastian,9/6/20,0,0,0,0,0,0,0,0,0,3021,0,33070,0,2749,0,35,0,237,0,36091,0,0,0,0,0,0,0,38,11,0,201
Sevier,9/6/20,0,0,0,0,0,0,0,0,0,1173,0,5687,0,1143,0,14,0,16,0,6860,0,0,0,0,0,0,0,6,0,0,15
Sharp,9/6/20,0,0,0,0,0,0,0,0,0,155,0,2941,0,141,0,5,0,9,0,3096,0,0,0,0,0,0,0,1,0,0,13
St.Francis,9/6/20,0,0,0,0,0,0,0,0,0,1372,0,9999,0,1288,0,4,0,80,0,11371,0,0,0,0,0,0,0,8,5,0,62
Stone,9/6/20,0,0,0,0,0,0,0,0,0,241,0,2555,0,173,0,4,0,64,0,2796,0,0,0,0,0,0,0,10,2,0,54
Union,9/6/20,0,0,0,0,0,0,0,0,0,725,0,7308,0,649,0,22,0,54,0,8033,0,0,0,0,0,0,0,1,3,1,74
VanBuren,9/6/20,0,0,0,0,0,0,0,0,0,141,0,2891,0,110,0,2,0,29,0,3032,0,0,0,0,0,0,0,1,1,0,17
Washington,9/6/20,0,0,0,0,0,0,0,0,0,7639,0,61198,0,6789,0,79,0,771,0,68837,0,0,0,0,0,0,0,62,20,1,205
White,9/6/20,0,0,0,0,0,0,0,0,0,570,0,10315,0,482,0,12,0,76,0,10885,0,0,0,0,0,0,0,6,3,0,29
Woodruff,9/6/20,0,0,0,0,0,0,0,0,0,28,0,1351,0,27,0,0,0,1,0,1379,0,0,0,0,0,0,0,0,0,0,3
Yell,9/6/20,0,0,0,0,0,0,0,0,0,1189,0,7861,0,1128,0,25,0,36,0,9050,0,0,0,0,0,0,0,12,4,0,97
Arkansas_all_counties,9/5/20,0,0,0,65226,0,0,0,0,2990671,64690,536,700721,0,57968,0,882,0,5840,0,765411,0,0,0,0,0,0,0,548,421,9,6916
Arkansas_county,9/5/20,0,0,0,0,0,0,0,0,0,294,0,4162,0,266,0,3,0,25,0,4456,0,0,0,0,0,0,0,1,1,0,28
Ashley,9/5/20,0,0,0,0,0,0,0,0,0,389,0,4153,0,375,0,7,0,7,0,4542,0,0,0,0,0,0,0,0,2,0,23
Baxter,9/5/20,0,0,0,0,0,0,0,0,0,147,0,2796,0,124,0,1,0,22,0,2943,0,0,0,0,0,0,0,0,3,0,5
Benton,9/5/20,0,0,0,0,0,0,0,0,0,5599,0,60041,0,5214,0,59,0,326,0,65640,0,0,0,0,0,0,0,35,29,1,548
Boone,9/5/20,0,0,0,0,0,0,0,0,0,393,0,6716,0,281,0,4,0,108,0,7109,0,0,0,0,0,0,0,1,4,1,23
Bradley,9/5/20,0,0,0,0,0,0,0,0,0,303,0,3074,0,276,0,6,0,21,0,3377,0,0,0,0,0,0,0,3,7,0,11
Calhoun,9/5/20,0,0,0,0,0,0,0,0,0,23,0,1269,0,23,0,0,0,0,0,1292,0,0,0,0,0,0,0,0,0,0,2
Carroll,9/5/20,0,0,0,0,0,0,0,0,0,486,0,5797,0,440,0,8,0,38,0,6283,0,0,0,0,0,0,0,4,3,0,42
Chicot,9/5/20,0,0,0,0,0,0,0,0,0,969,0,4304,0,933,0,11,0,25,0,5273,0,0,0,0,0,0,0,1,4,0,18
Clark,9/5/20,0,0,0,0,0,0,0,0,0,255,0,4783,0,217,0,4,0,34,0,5038,0,0,0,0,0,0,0,2,3,0,22
Clay,9/5/20,0,0,0,0,0,0,0,0,0,203,0,3103,0,163,0,5,0,35,0,3306,0,0,0,0,0,0,0,5,1,0,24
Cleburne,9/5/20,0,0,0,0,0,0,0,0,0,264,0,4552,0,244,0,7,0,13,0,4816,0,0,0,0,0,0,0,4,1,0,42
Cleveland,9/5/20,0,0,0,0,0,0,0,0,0,141,0,1979,0,127,0,6,0,8,0,2120,0,0,0,0,0,0,0,1,1,0,10
Columbia,9/5/20,0,0,0,0,0,0,0,0,0,315,0,3683,0,275,0,15,0,25,0,3998,0,0,0,0,0,0,0,3,0,0,7
Conway,9/5/20,0,0,0,0,0,0,0,0,0,216,0,4828,0,195,0,3,0,18,0,5044,0,0,0,0,0,0,0,3,1,0,24
Craighead,9/5/20,0,0,0,0,0,0,0,0,0,2022,0,24839,0,1726,0,16,0,280,0,26861,0,0,0,0,0,0,0,13,19,0,234
Crawford,9/5/20,0,0,0,0,0,0,0,0,0,971,0,14266,0,859,0,9,0,103,0,15237,0,0,0,0,0,0,0,5,6,0,133
Crittenden,9/5/20,0,0,0,0,0,0,0,0,0,1703,0,11958,0,1595,0,35,0,73,0,13661,0,0,0,0,0,0,0,10,6,0,54
Cross,9/5/20,0,0,0,0,0,0,0,0,0,303,0,3422,0,249,0,5,0,49,0,3725,0,0,0,0,0,0,0,7,5,0,58
Dallas,9/5/20,0,0,0,0,0,0,0,0,0,135,0,1520,0,93,0,2,0,40,0,1655,0,0,0,0,0,0,0,3,1,0,14
Desha,9/5/20,0,0,0,0,0,0,0,0,0,252,0,3057,0,223,0,5,0,24,0,3309,0,0,0,0,0,0,0,0,2,0,3
Drew,9/5/20,0,0,0,0,0,0,0,0,0,309,0,4639,0,291,0,5,0,13,0,4948,0,0,0,0,0,0,0,0,1,0,8
Faulkner,9/5/20,0,0,0,0,0,0,0,0,0,1770,0,28046,0,1578,0,9,0,183,0,29816,0,0,0,0,0,0,0,12,11,0,284
Franklin,9/5/20,0,0,0,0,0,0,0,0,0,182,0,4213,0,156,0,2,0,24,0,4395,0,0,0,0,0,0,0,0,2,0,36
Fulton,9/5/20,0,0,0,0,0,0,0,0,0,84,0,934,0,67,0,1,0,16,0,1018,0,0,0,0,0,0,0,4,3,0,9
Garland,9/5/20,0,0,0,0,0,0,0,0,0,1501,0,21744,0,1325,0,31,0,145,0,23245,0,0,0,0,0,0,0,2,11,0,72
Grant,9/5/20,0,0,0,0,0,0,0,0,0,202,0,3683,0,174,0,1,0,27,0,3885,0,0,0,0,0,0,0,3,1,0,41
Greene,9/5/20,0,0,0,0,0,0,0,0,0,660,0,9911,0,605,0,5,0,50,0,10571,0,0,0,0,0,0,0,2,10,0,46
Hempstead,9/5/20,0,0,0,0,0,0,0,0,0,335,0,3517,0,326,0,3,0,6,0,3852,0,0,0,0,0,0,0,0,4,0,17
HotSpring,9/5/20,0,0,0,0,0,0,0,0,0,1741,0,8637,0,1671,0,21,0,49,0,10378,0,0,0,0,0,0,0,5,1,0,43
Howard,9/5/20,0,0,0,0,0,0,0,0,0,435,0,3232,0,395,0,5,0,35,0,3667,0,0,0,0,0,0,0,4,2,0,21
Independence,9/5/20,0,0,0,0,0,0,0,0,0,806,0,8135,0,714,0,8,0,84,0,8941,0,0,0,0,0,0,0,3,7,0,24
Izard,9/5/20,0,0,0,0,0,0,0,0,0,109,0,2835,0,92,0,0,0,17,0,2944,0,0,0,0,0,0,0,0,3,0,8
Jackson,9/5/20,0,0,0,0,0,0,0,0,0,194,0,5148,0,174,0,1,0,19,0,5342,0,0,0,0,0,0,0,0,4,0,41
Jefferson,9/5/20,0,0,0,0,0,0,0,0,0,2241,0,21852,0,1896,0,51,0,294,0,24093,0,0,0,0,0,0,0,50,17,0,324
Johnson,9/5/20,0,0,0,0,0,0,0,0,0,777,0,5728,0,757,0,4,0,16,0,6505,0,0,0,0,0,0,0,2,2,0,32
Lafayette,9/5/20,0,0,0,0,0,0,0,0,0,74,0,804,0,68,0,2,0,4,0,878,0,0,0,0,0,0,0,0,0,0,2
Lawrence,9/5/20,0,0,0,0,0,0,0,0,0,263,0,2923,0,231,0,11,0,21,0,3186,0,0,0,0,0,0,0,1,0,0,124
Lee,9/5/20,0,0,0,0,0,0,0,0,0,1010,0,3323,0,983,0,11,0,16,0,4333,0,0,0,0,0,0,0,1,2,0,10
Lincoln,9/5/20,0,0,0,0,0,0,0,0,0,1754,0,5612,0,1380,0,13,0,361,0,7366,0,0,0,0,0,0,0,17,4,0,121
LittleRiver,9/5/20,0,0,0,0,0,0,0,0,0,300,0,1471,0,262,0,15,0,23,0,1771,0,0,0,0,0,0,0,1,0,0,6
Logan,9/5/20,0,0,0,0,0,0,0,0,0,367,0,5416,0,353,0,1,0,13,0,5783,0,0,0,0,0,0,0,0,1,0,12
Lonoke,9/5/20,0,0,0,0,0,0,0,0,0,767,0,13090,0,673,0,5,0,89,0,13857,0,0,0,0,0,0,0,5,7,1,93
Madison,9/5/20,0,0,0,0,0,0,0,0,0,308,0,3450,0,296,0,2,0,10,0,3758,0,0,0,0,0,0,0,0,-1,0,11
Marion,9/5/20,0,0,0,0,0,0,0,0,0,51,0,1738,0,42,0,0,0,9,0,1789,0,0,0,0,0,0,0,0,1,0,4
Miller,9/5/20,0,0,0,0,0,0,0,0,0,646,0,5299,0,589,0,10,0,47,0,5945,0,0,0,0,0,0,0,4,2,1,42
MissingCountyInfo,9/5/20,0,0,0,0,0,0,0,0,0,1214,0,23703,0,939,0,0,0,275,0,24917,0,0,0,0,0,0,0,-16,21,0,1376
Mississippi,9/5/20,0,0,0,0,0,0,0,0,0,1405,0,9671,0,1283,0,32,0,90,0,11076,0,0,0,0,0,0,0,4,15,0,55
Monroe,9/5/20,0,0,0,0,0,0,0,0,0,100,0,1839,0,90,0,0,0,10,0,1939,0,0,0,0,0,0,0,3,0,0,27
Montgomery,9/5/20,0,0,0,0,0,0,0,0,0,118,0,1399,0,70,0,4,0,44,0,1517,0,0,0,0,0,0,0,0,2,0,4
Nevada,9/5/20,0,0,0,0,0,0,0,0,0,165,0,2239,0,147,0,12,0,6,0,2404,0,0,0,0,0,0,0,0,1,0,13
Newton,9/5/20,0,0,0,0,0,0,0,0,0,138,0,1300,0,98,0,15,0,25,0,1438,0,0,0,0,0,0,0,2,3,0,19
Ouachita,9/5/20,0,0,0,0,0,0,0,0,0,175,0,4324,0,135,0,5,0,35,0,4499,0,0,0,0,0,0,0,0,5,0,8
Perry,9/5/20,0,0,0,0,0,0,0,0,0,63,0,2158,0,59,0,0,0,4,0,2221,0,0,0,0,0,0,0,1,0,0,20
Phillips,9/5/20,0,0,0,0,0,0,0,0,0,414,0,5161,0,387,0,10,0,17,0,5575,0,0,0,0,0,0,0,0,3,0,12
Pike,9/5/20,0,0,0,0,0,0,0,0,0,183,0,1803,0,175,0,1,0,7,0,1986,0,0,0,0,0,0,0,1,1,0,13
Poinsett,9/5/20,0,0,0,0,0,0,0,0,0,511,0,5860,0,432,0,6,0,73,0,6371,0,0,0,0,0,0,0,2,8,0,52
Polk,9/5/20,0,0,0,0,0,0,0,0,0,234,0,3201,0,214,0,4,0,16,0,3435,0,0,0,0,0,0,0,2,1,0,10
Pope,9/5/20,0,0,0,0,0,0,0,0,0,1832,0,16700,0,1690,0,20,0,122,0,18532,0,0,0,0,0,0,0,13,21,1,166
Prairie,9/5/20,0,0,0,0,0,0,0,0,0,121,0,1602,0,115,0,1,0,5,0,1723,0,0,0,0,0,0,0,1,0,0,11
Pulaski,9/5/20,0,0,0,0,0,0,0,0,0,7441,0,98011,0,6606,0,113,0,722,0,105452,0,0,0,0,0,0,0,74,53,0,796
Randolph,9/5/20,0,0,0,0,0,0,0,0,0,319,0,3721,0,294,0,17,0,8,0,4040,0,0,0,0,0,0,0,2,1,4,18
Saline,9/5/20,0,0,0,0,0,0,0,0,0,1676,0,20772,0,1439,0,14,0,223,0,22448,0,0,0,0,0,0,0,10,11,0,143
Scott,9/5/20,0,0,0,0,0,0,0,0,0,89,0,1472,0,88,0,0,0,1,0,1561,0,0,0,0,0,0,0,0,0,0,2
Searcy,9/5/20,0,0,0,0,0,0,0,0,0,114,0,1552,0,81,0,0,0,33,0,1666,0,0,0,0,0,0,0,1,8,0,4
Sebastian,9/5/20,0,0,0,0,0,0,0,0,0,2983,0,32907,0,2738,0,35,0,210,0,35890,0,0,0,0,0,0,0,16,20,0,211
Sevier,9/5/20,0,0,0,0,0,0,0,0,0,1167,0,5678,0,1143,0,14,0,10,0,6845,0,0,0,0,0,0,0,3,4,0,34
Sharp,9/5/20,0,0,0,0,0,0,0,0,0,154,0,2929,0,141,0,5,0,8,0,3083,0,0,0,0,0,0,0,1,2,0,10
St.Francis,9/5/20,0,0,0,0,0,0,0,0,0,1364,0,9945,0,1283,0,4,0,77,0,11309,0,0,0,0,0,0,0,2,6,0,28
Stone,9/5/20,0,0,0,0,0,0,0,0,0,231,0,2511,0,171,0,4,0,56,0,2742,0,0,0,0,0,0,0,19,5,0,67
Union,9/5/20,0,0,0,0,0,0,0,0,0,724,0,7235,0,646,0,21,0,57,0,7959,0,0,0,0,0,0,0,3,3,0,17
VanBuren,9/5/20,0,0,0,0,0,0,0,0,0,140,0,2875,0,109,0,2,0,29,0,3015,0,0,0,0,0,0,0,2,3,0,12
Washington,9/5/20,0,0,0,0,0,0,0,0,0,7577,0,61055,0,6769,0,78,0,730,0,68632,0,0,0,0,0,0,0,148,17,0,930
White,9/5/20,0,0,0,0,0,0,0,0,0,564,0,10292,0,479,0,12,0,73,0,10856,0,0,0,0,0,0,0,0,8,0,44
Woodruff,9/5/20,0,0,0,0,0,0,0,0,0,28,0,1348,0,27,0,0,0,1,0,1376,0,0,0,0,0,0,0,0,0,0,11
Yell,9/5/20,0,0,0,0,0,0,0,0,0,1177,0,7776,0,1124,0,25,0,28,0,8953,0,0,0,0,0,0,0,4,5,0,47
Arkansas_all_counties,9/4/20,0,0,0,64678,0,0,0,0,2990671,64175,503,694320,0,57547,0,873,0,5755,0,758495,0,0,0,0,0,0,0,1174,658,12,11178
Arkansas_county,9/4/20,0,0,0,0,0,0,0,0,0,293,0,4135,0,265,0,3,0,25,0,4428,0,0,0,0,0,0,0,6,2,0,28
Ashley,9/4/20,0,0,0,0,0,0,0,0,0,389,0,4130,0,373,0,7,0,9,0,4519,0,0,0,0,0,0,0,1,5,0,25
Baxter,9/4/20,0,0,0,0,0,0,0,0,0,147,0,2791,0,121,0,1,0,25,0,2938,0,0,0,0,0,0,0,3,2,1,67
Benton,9/4/20,0,0,0,0,0,0,0,0,0,5564,0,59528,0,5185,0,58,0,321,0,65092,0,0,0,0,0,0,0,61,29,0,427
Boone,9/4/20,0,0,0,0,0,0,0,0,0,392,0,6694,0,277,0,3,0,112,0,7086,0,0,0,0,0,0,0,4,5,0,50
Bradley,9/4/20,0,0,0,0,0,0,0,0,0,300,0,3066,0,269,0,6,0,25,0,3366,0,0,0,0,0,0,0,0,3,0,18
Calhoun,9/4/20,0,0,0,0,0,0,0,0,0,23,0,1267,0,23,0,0,0,0,0,1290,0,0,0,0,0,0,0,0,0,0,8
Carroll,9/4/20,0,0,0,0,0,0,0,0,0,482,0,5759,0,437,0,8,0,37,0,6241,0,0,0,0,0,0,0,3,4,1,67
Chicot,9/4/20,0,0,0,0,0,0,0,0,0,968,0,4287,0,929,0,11,0,28,0,5255,0,0,0,0,0,0,0,4,2,0,48
Clark,9/4/20,0,0,0,0,0,0,0,0,0,253,0,4763,0,214,0,4,0,35,0,5016,0,0,0,0,0,0,0,10,3,0,34
Clay,9/4/20,0,0,0,0,0,0,0,0,0,198,0,3084,0,162,0,5,0,31,0,3282,0,0,0,0,0,0,0,8,7,0,39
Cleburne,9/4/20,0,0,0,0,0,0,0,0,0,260,0,4514,0,243,0,7,0,10,0,4774,0,0,0,0,0,0,0,1,4,0,45
Cleveland,9/4/20,0,0,0,0,0,0,0,0,0,140,0,1970,0,126,0,6,0,8,0,2110,0,0,0,0,0,0,0,1,1,1,24
Columbia,9/4/20,0,0,0,0,0,0,0,0,0,312,0,3679,0,275,0,15,0,22,0,3991,0,0,0,0,0,0,0,1,6,0,38
Conway,9/4/20,0,0,0,0,0,0,0,0,0,213,0,4807,0,194,0,3,0,16,0,5020,0,0,0,0,0,0,0,0,3,0,28
Craighead,9/4/20,0,0,0,0,0,0,0,0,0,2009,0,24618,0,1707,0,16,0,286,0,26627,0,0,0,0,0,0,0,51,40,0,381
Crawford,9/4/20,0,0,0,0,0,0,0,0,0,966,0,14138,0,853,0,9,0,104,0,15104,0,0,0,0,0,0,0,14,7,0,196
Crittenden,9/4/20,0,0,0,0,0,0,0,0,0,1693,0,11914,0,1589,0,35,0,69,0,13607,0,0,0,0,0,0,0,8,4,0,93
Cross,9/4/20,0,0,0,0,0,0,0,0,0,296,0,3371,0,244,0,5,0,47,0,3667,0,0,0,0,0,0,0,7,1,0,20
Dallas,9/4/20,0,0,0,0,0,0,0,0,0,132,0,1509,0,92,0,2,0,38,0,1641,0,0,0,0,0,0,0,0,3,0,8
Desha,9/4/20,0,0,0,0,0,0,0,0,0,252,0,3054,0,221,0,5,0,26,0,3306,0,0,0,0,0,0,0,3,5,0,37
Drew,9/4/20,0,0,0,0,0,0,0,0,0,309,0,4631,0,290,0,5,0,14,0,4940,0,0,0,0,0,0,0,0,2,0,25
Faulkner,9/4/20,0,0,0,0,0,0,0,0,0,1758,0,27774,0,1567,0,9,0,182,0,29532,0,0,0,0,0,0,0,11,20,0,289
Franklin,9/4/20,0,0,0,0,0,0,0,0,0,182,0,4177,0,154,0,2,0,26,0,4359,0,0,0,0,0,0,0,4,0,0,34
Fulton,9/4/20,0,0,0,0,0,0,0,0,0,80,0,929,0,64,0,1,0,15,0,1009,0,0,0,0,0,0,0,3,5,1,15
Garland,9/4/20,0,0,0,0,0,0,0,0,0,1499,0,21674,0,1314,0,31,0,154,0,23173,0,0,0,0,0,0,0,20,13,1,148
Grant,9/4/20,0,0,0,0,0,0,0,0,0,199,0,3645,0,173,0,1,0,25,0,3844,0,0,0,0,0,0,0,2,5,0,26
Greene,9/4/20,0,0,0,0,0,0,0,0,0,658,0,9867,0,595,0,5,0,58,0,10525,0,0,0,0,0,0,0,6,5,0,137
Hempstead,9/4/20,0,0,0,0,0,0,0,0,0,335,0,3500,0,322,0,3,0,10,0,3835,0,0,0,0,0,0,0,0,1,0,16
HotSpring,9/4/20,0,0,0,0,0,0,0,0,0,1736,0,8599,0,1670,0,21,0,45,0,10335,0,0,0,0,0,0,0,5,1,0,60
Howard,9/4/20,0,0,0,0,0,0,0,0,0,431,0,3215,0,393,0,5,0,33,0,3646,0,0,0,0,0,0,0,2,1,0,23
Independence,9/4/20,0,0,0,0,0,0,0,0,0,803,0,8114,0,707,0,8,0,88,0,8917,0,0,0,0,0,0,0,12,5,1,65
Izard,9/4/20,0,0,0,0,0,0,0,0,0,109,0,2827,0,89,0,0,0,20,0,2936,0,0,0,0,0,0,0,1,6,0,16
Jackson,9/4/20,0,0,0,0,0,0,0,0,0,194,0,5107,0,170,0,1,0,23,0,5301,0,0,0,0,0,0,0,3,9,0,17
Jefferson,9/4/20,0,0,0,0,0,0,0,0,0,2191,0,21578,0,1879,0,51,0,261,0,23769,0,0,0,0,0,0,0,25,17,0,150
Johnson,9/4/20,0,0,0,0,0,0,0,0,0,775,0,5698,0,755,0,4,0,16,0,6473,0,0,0,0,0,0,0,5,4,0,45
Lafayette,9/4/20,0,0,0,0,0,0,0,0,0,74,0,802,0,68,0,2,0,4,0,876,0,0,0,0,0,0,0,-1,2,0,2
Lawrence,9/4/20,0,0,0,0,0,0,0,0,0,262,0,2800,0,231,0,11,0,20,0,3062,0,0,0,0,0,0,0,4,0,0,31
Lee,9/4/20,0,0,0,0,0,0,0,0,0,1009,0,3314,0,981,0,11,0,17,0,4323,0,0,0,0,0,0,0,2,1,0,7
Lincoln,9/4/20,0,0,0,0,0,0,0,0,0,1737,0,5508,0,1376,0,13,0,348,0,7245,0,0,0,0,0,0,0,120,4,0,300
LittleRiver,9/4/20,0,0,0,0,0,0,0,0,0,299,0,1466,0,262,0,15,0,22,0,1765,0,0,0,0,0,0,0,3,3,0,12
Logan,9/4/20,0,0,0,0,0,0,0,0,0,367,0,5404,0,352,0,1,0,14,0,5771,0,0,0,0,0,0,0,0,3,0,60
Lonoke,9/4/20,0,0,0,0,0,0,0,0,0,762,0,13002,0,666,0,4,0,92,0,13764,0,0,0,0,0,0,0,13,19,0,110
Madison,9/4/20,0,0,0,0,0,0,0,0,0,308,0,3439,0,297,0,2,0,9,0,3747,0,0,0,0,0,0,0,6,6,0,31
Marion,9/4/20,0,0,0,0,0,0,0,0,0,51,0,1734,0,41,0,0,0,10,0,1785,0,0,0,0,0,0,0,3,1,0,25
Miller,9/4/20,0,0,0,0,0,0,0,0,0,642,0,5261,0,587,0,9,0,46,0,5903,0,0,0,0,0,0,0,4,9,0,94
MissingCountyInfo,9/4/20,0,0,0,0,0,0,0,0,0,1230,0,22311,0,918,0,0,0,312,0,23541,0,0,0,0,0,0,0,201,145,0,4025
Mississippi,9/4/20,0,0,0,0,0,0,0,0,0,1401,0,9620,0,1268,0,32,0,101,0,11021,0,0,0,0,0,0,0,13,15,1,97
Monroe,9/4/20,0,0,0,0,0,0,0,0,0,97,0,1815,0,90,0,0,0,7,0,1912,0,0,0,0,0,0,0,1,1,0,5
Montgomery,9/4/20,0,0,0,0,0,0,0,0,0,118,0,1395,0,68,0,4,0,46,0,1513,0,0,0,0,0,0,0,2,4,0,10
Nevada,9/4/20,0,0,0,0,0,0,0,0,0,165,0,2226,0,146,0,12,0,7,0,2391,0,0,0,0,0,0,0,3,4,0,18
Newton,9/4/20,0,0,0,0,0,0,0,0,0,136,0,1283,0,95,0,15,0,26,0,1419,0,0,0,0,0,0,0,2,1,0,7
Ouachita,9/4/20,0,0,0,0,0,0,0,0,0,175,0,4316,0,130,0,5,0,40,0,4491,0,0,0,0,0,0,0,2,-1,1,37
Perry,9/4/20,0,0,0,0,0,0,0,0,0,62,0,2139,0,59,0,0,0,3,0,2201,0,0,0,0,0,0,0,0,0,0,21
Phillips,9/4/20,0,0,0,0,0,0,0,0,0,414,0,5149,0,384,0,10,0,20,0,5563,0,0,0,0,0,0,0,5,1,0,20
Pike,9/4/20,0,0,0,0,0,0,0,0,0,182,0,1791,0,174,0,1,0,7,0,1973,0,0,0,0,0,0,0,3,4,0,14
Poinsett,9/4/20,0,0,0,0,0,0,0,0,0,509,0,5810,0,424,0,6,0,79,0,6319,0,0,0,0,0,0,0,6,17,0,59
Polk,9/4/20,0,0,0,0,0,0,0,0,0,232,0,3193,0,213,0,4,0,15,0,3425,0,0,0,0,0,0,0,2,2,0,25
Pope,9/4/20,0,0,0,0,0,0,0,0,0,1819,0,16547,0,1669,0,19,0,131,0,18366,0,0,0,0,0,0,0,13,24,0,165
Prairie,9/4/20,0,0,0,0,0,0,0,0,0,120,0,1592,0,115,0,1,0,4,0,1712,0,0,0,0,0,0,0,2,1,0,27
Pulaski,9/4/20,0,0,0,0,0,0,0,0,0,7367,0,97289,0,6553,0,113,0,701,0,104656,0,0,0,0,0,0,0,91,41,1,1040
Randolph,9/4/20,0,0,0,0,0,0,0,0,0,317,0,3705,0,293,0,13,0,11,0,4022,0,0,0,0,0,0,0,5,3,0,35
Saline,9/4/20,0,0,0,0,0,0,0,0,0,1666,0,20639,0,1428,0,14,0,224,0,22305,0,0,0,0,0,0,0,13,17,1,155
Scott,9/4/20,0,0,0,0,0,0,0,0,0,89,0,1470,0,88,0,0,0,1,0,1559,0,0,0,0,0,0,0,1,1,0,10
Searcy,9/4/20,0,0,0,0,0,0,0,0,0,113,0,1549,0,73,0,0,0,40,0,1662,0,0,0,0,0,0,0,2,14,0,17
Sebastian,9/4/20,0,0,0,0,0,0,0,0,0,2967,0,32712,0,2718,0,35,0,214,0,35679,0,0,0,0,0,0,0,21,26,0,492
Sevier,9/4/20,0,0,0,0,0,0,0,0,0,1164,0,5647,0,1139,0,14,0,11,0,6811,0,0,0,0,0,0,0,1,3,1,40
Sharp,9/4/20,0,0,0,0,0,0,0,0,0,153,0,2920,0,139,0,5,0,9,0,3073,0,0,0,0,0,0,0,1,4,0,17
St.Francis,9/4/20,0,0,0,0,0,0,0,0,0,1362,0,9919,0,1277,0,4,0,81,0,11281,0,0,0,0,0,0,0,5,8,0,32
Stone,9/4/20,0,0,0,0,0,0,0,0,0,212,0,2463,0,166,0,4,0,42,0,2675,0,0,0,0,0,0,0,1,3,1,23
Union,9/4/20,0,0,0,0,0,0,0,0,0,721,0,7221,0,643,0,21,0,57,0,7942,0,0,0,0,0,0,0,14,20,0,151
VanBuren,9/4/20,0,0,0,0,0,0,0,0,0,138,0,2865,0,106,0,2,0,30,0,3003,0,0,0,0,0,0,0,2,4,0,17
Washington,9/4/20,0,0,0,0,0,0,0,0,0,7429,0,60273,0,6752,0,78,0,599,0,67702,0,0,0,0,0,0,0,226,8,0,1027
White,9/4/20,0,0,0,0,0,0,0,0,0,564,0,10248,0,471,0,12,0,81,0,10812,0,0,0,0,0,0,0,13,9,0,68
Woodruff,9/4/20,0,0,0,0,0,0,0,0,0,28,0,1337,0,27,0,0,0,1,0,1365,0,0,0,0,0,0,0,0,0,0,13
Yell,9/4/20,0,0,0,0,0,0,0,0,0,1173,0,7733,0,1119,0,25,0,29,0,8906,0,0,0,0,0,0,0,4,1,0,92
Arkansas_all_counties,9/3/20,0,0,0,63504,0,0,0,0,2990671,63081,423,684236,0,56889,0,861,0,5331,0,747317,0,0,0,0,0,0,0,1014,628,20,9868
Arkansas_county,9/3/20,0,0,0,0,0,0,0,0,0,287,0,4113,0,263,0,3,0,21,0,4400,0,0,0,0,0,0,0,1,2,0,28
Ashley,9/3/20,0,0,0,0,0,0,0,0,0,388,0,4106,0,368,0,7,0,13,0,4494,0,0,0,0,0,0,0,0,2,0,38
Baxter,9/3/20,0,0,0,0,0,0,0,0,0,144,0,2727,0,119,0,0,0,25,0,2871,0,0,0,0,0,0,0,4,3,0,64
Benton,9/3/20,0,0,0,0,0,0,0,0,0,5503,0,59162,0,5156,0,58,0,289,0,64665,0,0,0,0,0,0,0,50,35,1,969
Boone,9/3/20,0,0,0,0,0,0,0,0,0,388,0,6648,0,272,0,3,0,113,0,7036,0,0,0,0,0,0,0,14,6,0,133
Bradley,9/3/20,0,0,0,0,0,0,0,0,0,300,0,3048,0,266,0,6,0,28,0,3348,0,0,0,0,0,0,0,4,10,0,47
Calhoun,9/3/20,0,0,0,0,0,0,0,0,0,23,0,1259,0,23,0,0,0,0,0,1282,0,0,0,0,0,0,0,0,0,0,11
Carroll,9/3/20,0,0,0,0,0,0,0,0,0,479,0,5695,0,433,0,7,0,39,0,6174,0,0,0,0,0,0,0,5,3,0,93
Chicot,9/3/20,0,0,0,0,0,0,0,0,0,964,0,4243,0,927,0,11,0,26,0,5207,0,0,0,0,0,0,0,1,0,0,28
Clark,9/3/20,0,0,0,0,0,0,0,0,0,243,0,4739,0,211,0,4,0,28,0,4982,0,0,0,0,0,0,0,4,4,0,36
Clay,9/3/20,0,0,0,0,0,0,0,0,0,190,0,3053,0,155,0,5,0,30,0,3243,0,0,0,0,0,0,0,5,6,0,45
Cleburne,9/3/20,0,0,0,0,0,0,0,0,0,259,0,4470,0,239,0,7,0,13,0,4729,0,0,0,0,0,0,0,2,4,0,44
Cleveland,9/3/20,0,0,0,0,0,0,0,0,0,139,0,1947,0,125,0,5,0,9,0,2086,0,0,0,0,0,0,0,1,-1,0,50
Columbia,9/3/20,0,0,0,0,0,0,0,0,0,311,0,3642,0,269,0,15,0,27,0,3953,0,0,0,0,0,0,0,8,6,0,38
Conway,9/3/20,0,0,0,0,0,0,0,0,0,213,0,4779,0,191,0,3,0,19,0,4992,0,0,0,0,0,0,0,1,4,0,48
Craighead,9/3/20,0,0,0,0,0,0,0,0,0,1958,0,24288,0,1667,0,16,0,275,0,26246,0,0,0,0,0,0,0,26,11,1,489
Crawford,9/3/20,0,0,0,0,0,0,0,0,0,952,0,13956,0,846,0,9,0,97,0,14908,0,0,0,0,0,0,0,13,20,0,179
Crittenden,9/3/20,0,0,0,0,0,0,0,0,0,1685,0,11829,0,1585,0,35,0,65,0,13514,0,0,0,0,0,0,0,26,21,0,118
Cross,9/3/20,0,0,0,0,0,0,0,0,0,289,0,3358,0,243,0,5,0,41,0,3647,0,0,0,0,0,0,0,6,3,0,79
Dallas,9/3/20,0,0,0,0,0,0,0,0,0,132,0,1501,0,89,0,2,0,41,0,1633,0,0,0,0,0,0,0,4,13,0,33
Desha,9/3/20,0,0,0,0,0,0,0,0,0,249,0,3020,0,216,0,5,0,28,0,3269,0,0,0,0,0,0,0,5,1,0,59
Drew,9/3/20,0,0,0,0,0,0,0,0,0,309,0,4606,0,288,0,5,0,16,0,4915,0,0,0,0,0,0,0,1,1,0,53
Faulkner,9/3/20,0,0,0,0,0,0,0,0,0,1747,0,27496,0,1547,0,9,0,191,0,29243,0,0,0,0,0,0,0,28,19,0,335
Franklin,9/3/20,0,0,0,0,0,0,0,0,0,178,0,4147,0,154,0,2,0,22,0,4325,0,0,0,0,0,0,0,4,2,0,43
Fulton,9/3/20,0,0,0,0,0,0,0,0,0,77,0,917,0,59,0,0,0,18,0,994,0,0,0,0,0,0,0,5,1,0,27
Garland,9/3/20,0,0,0,0,0,0,0,0,0,1479,0,21546,0,1301,0,30,0,148,0,23025,0,0,0,0,0,0,0,21,13,0,343
Grant,9/3/20,0,0,0,0,0,0,0,0,0,197,0,3621,0,168,0,1,0,28,0,3818,0,0,0,0,0,0,0,4,1,0,97
Greene,9/3/20,0,0,0,0,0,0,0,0,0,652,0,9736,0,590,0,5,0,57,0,10388,0,0,0,0,0,0,0,4,8,0,145
Hempstead,9/3/20,0,0,0,0,0,0,0,0,0,335,0,3484,0,321,0,3,0,11,0,3819,0,0,0,0,0,0,0,1,5,0,25
HotSpring,9/3/20,0,0,0,0,0,0,0,0,0,1731,0,8544,0,1669,0,21,0,41,0,10275,0,0,0,0,0,0,0,3,5,0,83
Howard,9/3/20,0,0,0,0,0,0,0,0,0,429,0,3194,0,392,0,5,0,32,0,3623,0,0,0,0,0,0,0,2,1,0,33
Independence,9/3/20,0,0,0,0,0,0,0,0,0,791,0,8061,0,702,0,7,0,82,0,8852,0,0,0,0,0,0,0,3,9,0,105
Izard,9/3/20,0,0,0,0,0,0,0,0,0,108,0,2812,0,83,0,0,0,25,0,2920,0,0,0,0,0,0,0,2,3,0,22
Jackson,9/3/20,0,0,0,0,0,0,0,0,0,191,0,5093,0,161,0,1,0,29,0,5284,0,0,0,0,0,0,0,4,3,0,135
Jefferson,9/3/20,0,0,0,0,0,0,0,0,0,2166,0,21453,0,1862,0,51,0,253,0,23619,0,0,0,0,0,0,0,37,28,0,429
Johnson,9/3/20,0,0,0,0,0,0,0,0,0,770,0,5658,0,751,0,4,0,15,0,6428,0,0,0,0,0,0,0,4,4,0,31
Lafayette,9/3/20,0,0,0,0,0,0,0,0,0,75,0,799,0,66,0,2,0,7,0,874,0,0,0,0,0,0,0,3,2,0,8
Lawrence,9/3/20,0,0,0,0,0,0,0,0,0,258,0,2773,0,231,0,11,0,16,0,3031,0,0,0,0,0,0,0,5,1,0,45
Lee,9/3/20,0,0,0,0,0,0,0,0,0,1007,0,3309,0,980,0,11,0,16,0,4316,0,0,0,0,0,0,0,1,0,0,10
Lincoln,9/3/20,0,0,0,0,0,0,0,0,0,1617,0,5328,0,1372,0,13,0,232,0,6945,0,0,0,0,0,0,0,7,3,0,55
LittleRiver,9/3/20,0,0,0,0,0,0,0,0,0,296,0,1457,0,259,0,15,0,22,0,1753,0,0,0,0,0,0,0,9,4,0,17
Logan,9/3/20,0,0,0,0,0,0,0,0,0,367,0,5344,0,349,0,1,0,17,0,5711,0,0,0,0,0,0,0,2,1,0,41
Lonoke,9/3/20,0,0,0,0,0,0,0,0,0,749,0,12905,0,647,0,4,0,98,0,13654,0,0,0,0,0,0,0,9,9,0,119
Madison,9/3/20,0,0,0,0,0,0,0,0,0,302,0,3414,0,291,0,2,0,9,0,3716,0,0,0,0,0,0,0,3,1,0,29
Marion,9/3/20,0,0,0,0,0,0,0,0,0,48,0,1712,0,40,0,0,0,8,0,1760,0,0,0,0,0,0,0,2,0,0,32
Miller,9/3/20,0,0,0,0,0,0,0,0,0,638,0,5171,0,578,0,9,0,51,0,5809,0,0,0,0,0,0,0,17,4,0,66
Mississippi,9/3/20,0,0,0,0,0,0,0,0,0,1388,0,9536,0,1253,0,31,0,104,0,10924,0,0,0,0,0,0,0,14,1,9,101
Monroe,9/3/20,0,0,0,0,0,0,0,0,0,96,0,1811,0,89,0,0,0,7,0,1907,0,0,0,0,0,0,0,0,1,0,17
Montgomery,9/3/20,0,0,0,0,0,0,0,0,0,116,0,1387,0,64,0,4,0,48,0,1503,0,0,0,0,0,0,0,12,4,1,62
Nevada,9/3/20,0,0,0,0,0,0,0,0,0,162,0,2211,0,142,0,12,0,8,0,2373,0,0,0,0,0,0,0,0,4,0,5
Newton,9/3/20,0,0,0,0,0,0,0,0,0,134,0,1278,0,94,0,15,0,25,0,1412,0,0,0,0,0,0,0,13,-1,0,58
Ouachita,9/3/20,0,0,0,0,0,0,0,0,0,173,0,4281,0,131,0,4,0,38,0,4454,0,0,0,0,0,0,0,14,6,0,86
Perry,9/3/20,0,0,0,0,0,0,0,0,0,62,0,2118,0,59,0,0,0,3,0,2180,0,0,0,0,0,0,0,-1,0,-1,17
Phillips,9/3/20,0,0,0,0,0,0,0,0,0,409,0,5134,0,383,0,10,0,16,0,5543,0,0,0,0,0,0,0,2,5,0,34
Pike,9/3/20,0,0,0,0,0,0,0,0,0,179,0,1780,0,170,0,1,0,8,0,1959,0,0,0,0,0,0,0,2,3,0,27
Poinsett,9/3/20,0,0,0,0,0,0,0,0,0,503,0,5757,0,407,0,6,0,90,0,6260,0,0,0,0,0,0,0,10,19,0,231
Polk,9/3/20,0,0,0,0,0,0,0,0,0,230,0,3170,0,211,0,4,0,15,0,3400,0,0,0,0,0,0,0,4,2,0,45
Pope,9/3/20,0,0,0,0,0,0,0,0,0,1806,0,16395,0,1645,0,19,0,142,0,18201,0,0,0,0,0,0,0,19,22,1,224
Prairie,9/3/20,0,0,0,0,0,0,0,0,0,118,0,1567,0,114,0,1,0,3,0,1685,0,0,0,0,0,0,0,3,1,1,15
Pulaski,9/3/20,0,0,0,0,0,0,0,0,0,7276,0,96340,0,6512,0,112,0,652,0,103616,0,0,0,0,0,0,0,94,68,0,1428
Randolph,9/3/20,0,0,0,0,0,0,0,0,0,312,0,3675,0,290,0,13,0,9,0,3987,0,0,0,0,0,0,0,1,0,1,37
Saline,9/3/20,0,0,0,0,0,0,0,0,0,1653,0,20497,0,1411,0,13,0,229,0,22150,0,0,0,0,0,0,0,36,18,0,329
Scott,9/3/20,0,0,0,0,0,0,0,0,0,88,0,1461,0,87,0,0,0,1,0,1549,0,0,0,0,0,0,0,1,2,0,9
Searcy,9/3/20,0,0,0,0,0,0,0,0,0,111,0,1534,0,59,0,0,0,52,0,1645,0,0,0,0,0,0,0,10,4,0,25
Sebastian,9/3/20,0,0,0,0,0,0,0,0,0,2946,0,32241,0,2692,0,35,0,219,0,35187,0,0,0,0,0,0,0,36,34,0,420
Sevier,9/3/20,0,0,0,0,0,0,0,0,0,1163,0,5608,0,1136,0,13,0,14,0,6771,0,0,0,0,0,0,0,3,11,0,41
Sharp,9/3/20,0,0,0,0,0,0,0,0,0,152,0,2904,0,135,0,5,0,12,0,3056,0,0,0,0,0,0,0,3,2,0,37
St.Francis,9/3/20,0,0,0,0,0,0,0,0,0,1357,0,9892,0,1269,0,4,0,84,0,11249,0,0,0,0,0,0,0,7,8,0,65
Stone,9/3/20,0,0,0,0,0,0,0,0,0,211,0,2441,0,163,0,3,0,45,0,2652,0,0,0,0,0,0,0,9,8,0,62
Union,9/3/20,0,0,0,0,0,0,0,0,0,707,0,7084,0,623,0,21,0,63,0,7791,0,0,0,0,0,0,0,9,13,1,112
VanBuren,9/3/20,0,0,0,0,0,0,0,0,0,136,0,2850,0,102,0,2,0,32,0,2986,0,0,0,0,0,0,0,10,11,0,44
Washington,9/3/20,0,0,0,0,0,0,0,0,0,7203,0,59472,0,6744,0,78,0,381,0,66675,0,0,0,0,0,0,0,212,73,5,1246
White,9/3/20,0,0,0,0,0,0,0,0,0,551,0,10193,0,462,0,12,0,77,0,10744,0,0,0,0,0,0,0,9,7,0,86
Woodruff,9/3/20,0,0,0,0,0,0,0,0,0,28,0,1324,0,27,0,0,0,1,0,1352,0,0,0,0,0,0,0,1,0,0,5
Yell,9/3/20,0,0,0,0,0,0,0,0,0,1169,0,7645,0,1118,0,25,0,26,0,8814,0,0,0,0,0,0,0,2,4,0,43
Arkansas_all_counties,9/2/20,0,0,0,62490,0,0,0,0,2990671,62112,378,675337,0,56261,0,841,0,5010,0,737449,0,0,0,0,0,0,0,615,614,27,6424
Arkansas_county,9/2/20,0,0,0,0,0,0,0,0,0,286,0,4086,0,261,0,3,0,22,0,4372,0,0,0,0,0,0,0,2,2,0,27
Ashley,9/2/20,0,0,0,0,0,0,0,0,0,388,0,4068,0,366,0,7,0,15,0,4456,0,0,0,0,0,0,0,0,1,0,13
Baxter,9/2/20,0,0,0,0,0,0,0,0,0,140,0,2667,0,116,0,0,0,24,0,2807,0,0,0,0,0,0,0,1,3,0,22
Benton,9/2/20,0,0,0,0,0,0,0,0,0,5453,0,58243,0,5121,0,57,0,275,0,63696,0,0,0,0,0,0,0,59,22,3,391
Boone,9/2/20,0,0,0,0,0,0,0,0,0,374,0,6529,0,266,0,3,0,105,0,6903,0,0,0,0,0,0,0,5,7,0,26
Bradley,9/2/20,0,0,0,0,0,0,0,0,0,296,0,3005,0,256,0,6,0,34,0,3301,0,0,0,0,0,0,0,1,6,0,6
Calhoun,9/2/20,0,0,0,0,0,0,0,0,0,23,0,1248,0,23,0,0,0,0,0,1271,0,0,0,0,0,0,0,-1,1,0,0
Carroll,9/2/20,0,0,0,0,0,0,0,0,0,474,0,5607,0,430,0,7,0,37,0,6081,0,0,0,0,0,0,0,4,5,0,28
Chicot,9/2/20,0,0,0,0,0,0,0,0,0,963,0,4216,0,927,0,11,0,25,0,5179,0,0,0,0,0,0,0,1,1,0,9
Clark,9/2/20,0,0,0,0,0,0,0,0,0,239,0,4707,0,207,0,4,0,28,0,4946,0,0,0,0,0,0,0,3,4,1,28
Clay,9/2/20,0,0,0,0,0,0,0,0,0,185,0,3013,0,149,0,5,0,31,0,3198,0,0,0,0,0,0,0,3,1,0,16
Cleburne,9/2/20,0,0,0,0,0,0,0,0,0,257,0,4428,0,235,0,7,0,15,0,4685,0,0,0,0,0,0,0,-2,2,0,41
Cleveland,9/2/20,0,0,0,0,0,0,0,0,0,138,0,1898,0,126,0,5,0,7,0,2036,0,0,0,0,0,0,0,1,2,1,61
Columbia,9/2/20,0,0,0,0,0,0,0,0,0,303,0,3612,0,263,0,15,0,25,0,3915,0,0,0,0,0,0,0,6,7,0,15
Conway,9/2/20,0,0,0,0,0,0,0,0,0,212,0,4732,0,187,0,3,0,22,0,4944,0,0,0,0,0,0,0,2,4,0,18
Craighead,9/2/20,0,0,0,0,0,0,0,0,0,1932,0,23825,0,1656,0,15,0,261,0,25757,0,0,0,0,0,0,0,51,35,0,269
Crawford,9/2/20,0,0,0,0,0,0,0,0,0,939,0,13790,0,826,0,9,0,104,0,14729,0,0,0,0,0,0,0,8,22,0,90
Crittenden,9/2/20,0,0,0,0,0,0,0,0,0,1659,0,11737,0,1564,0,35,0,60,0,13396,0,0,0,0,0,0,0,11,9,1,53
Cross,9/2/20,0,0,0,0,0,0,0,0,0,283,0,3285,0,240,0,5,0,38,0,3568,0,0,0,0,0,0,0,3,4,0,17
Dallas,9/2/20,0,0,0,0,0,0,0,0,0,128,0,1472,0,76,0,2,0,50,0,1600,0,0,0,0,0,0,0,1,0,0,16
Desha,9/2/20,0,0,0,0,0,0,0,0,0,244,0,2966,0,215,0,5,0,24,0,3210,0,0,0,0,0,0,0,1,2,0,13
Drew,9/2/20,0,0,0,0,0,0,0,0,0,308,0,4554,0,287,0,5,0,16,0,4862,0,0,0,0,0,0,0,3,10,0,11
Faulkner,9/2/20,0,0,0,0,0,0,0,0,0,1719,0,27189,0,1528,0,9,0,182,0,28908,0,0,0,0,0,0,0,16,17,0,175
Franklin,9/2/20,0,0,0,0,0,0,0,0,0,174,0,4108,0,152,0,2,0,20,0,4282,0,0,0,0,0,0,0,6,4,0,22
Fulton,9/2/20,0,0,0,0,0,0,0,0,0,72,0,895,0,58,0,0,0,14,0,967,0,0,0,0,0,0,0,1,2,0,7
Garland,9/2/20,0,0,0,0,0,0,0,0,0,1458,0,21224,0,1288,0,30,0,140,0,22682,0,0,0,0,0,0,0,24,16,1,92
Grant,9/2/20,0,0,0,0,0,0,0,0,0,193,0,3528,0,167,0,1,0,25,0,3721,0,0,0,0,0,0,0,2,2,0,22
Greene,9/2/20,0,0,0,0,0,0,0,0,0,648,0,9595,0,582,0,5,0,61,0,10243,0,0,0,0,0,0,0,13,8,1,97
Hempstead,9/2/20,0,0,0,0,0,0,0,0,0,334,0,3460,0,316,0,3,0,15,0,3794,0,0,0,0,0,0,0,4,9,0,10
HotSpring,9/2/20,0,0,0,0,0,0,0,0,0,1728,0,8464,0,1664,0,21,0,43,0,10192,0,0,0,0,0,0,0,9,3,0,51
Howard,9/2/20,0,0,0,0,0,0,0,0,0,427,0,3163,0,391,0,5,0,31,0,3590,0,0,0,0,0,0,0,2,3,0,8
Independence,9/2/20,0,0,0,0,0,0,0,0,0,788,0,7959,0,693,0,7,0,88,0,8747,0,0,0,0,0,0,0,18,14,1,148
Izard,9/2/20,0,0,0,0,0,0,0,0,0,106,0,2792,0,80,0,0,0,26,0,2898,0,0,0,0,0,0,0,1,0,0,20
Jackson,9/2/20,0,0,0,0,0,0,0,0,0,187,0,4962,0,158,0,1,0,28,0,5149,0,0,0,0,0,0,0,3,3,0,375
Jefferson,9/2/20,0,0,0,0,0,0,0,0,0,2129,0,21061,0,1834,0,51,0,244,0,23190,0,0,0,0,0,0,0,17,61,1,76
Johnson,9/2/20,0,0,0,0,0,0,0,0,0,766,0,5631,0,747,0,4,0,15,0,6397,0,0,0,0,0,0,0,1,2,0,19
Lafayette,9/2/20,0,0,0,0,0,0,0,0,0,72,0,794,0,64,0,2,0,6,0,866,0,0,0,0,0,0,0,2,1,0,6
Lawrence,9/2/20,0,0,0,0,0,0,0,0,0,253,0,2733,0,230,0,11,0,12,0,2986,0,0,0,0,0,0,0,3,4,1,22
Lee,9/2/20,0,0,0,0,0,0,0,0,0,1006,0,3300,0,980,0,11,0,15,0,4306,0,0,0,0,0,0,0,2,6,0,7
Lincoln,9/2/20,0,0,0,0,0,0,0,0,0,1610,0,5280,0,1369,0,13,0,228,0,6890,0,0,0,0,0,0,0,2,3,0,8
LittleRiver,9/2/20,0,0,0,0,0,0,0,0,0,287,0,1449,0,255,0,15,0,17,0,1736,0,0,0,0,0,0,0,3,2,0,4
Logan,9/2/20,0,0,0,0,0,0,0,0,0,365,0,5305,0,348,0,1,0,16,0,5670,0,0,0,0,0,0,0,0,10,0,22
Lonoke,9/2/20,0,0,0,0,0,0,0,0,0,740,0,12795,0,638,0,4,0,98,0,13535,0,0,0,0,0,0,0,12,15,0,113
Madison,9/2/20,0,0,0,0,0,0,0,0,0,299,0,3388,0,290,0,2,0,7,0,3687,0,0,0,0,0,0,0,3,2,0,11
Marion,9/2/20,0,0,0,0,0,0,0,0,0,46,0,1682,0,40,0,0,0,6,0,1728,0,0,0,0,0,0,0,0,1,0,1
Miller,9/2/20,0,0,0,0,0,0,0,0,0,621,0,5122,0,574,0,9,0,38,0,5743,0,0,0,0,0,0,0,9,8,0,15
MissingCountyInfo,9/2/20,0,0,0,0,0,0,0,0,0,956,0,18560,0,756,0,0,0,200,0,19516,0,0,0,0,0,0,0,59,34,0,1510
Mississippi,9/2/20,0,0,0,0,0,0,0,0,0,1374,0,9449,0,1252,0,22,0,100,0,10823,0,0,0,0,0,0,0,22,10,0,54
Monroe,9/2/20,0,0,0,0,0,0,0,0,0,96,0,1794,0,88,0,0,0,8,0,1890,0,0,0,0,0,0,0,1,1,0,9
Montgomery,9/2/20,0,0,0,0,0,0,0,0,0,104,0,1337,0,60,0,3,0,41,0,1441,0,0,0,0,0,0,0,0,0,0,12
Nevada,9/2/20,0,0,0,0,0,0,0,0,0,162,0,2206,0,138,0,12,0,12,0,2368,0,0,0,0,0,0,0,0,0,0,6
Newton,9/2/20,0,0,0,0,0,0,0,0,0,121,0,1233,0,95,0,15,0,11,0,1354,0,0,0,0,0,0,0,1,1,0,7
Ouachita,9/2/20,0,0,0,0,0,0,0,0,0,159,0,4209,0,125,0,4,0,30,0,4368,0,0,0,0,0,0,0,1,0,0,7
Perry,9/2/20,0,0,0,0,0,0,0,0,0,63,0,2100,0,59,0,1,0,3,0,2163,0,0,0,0,0,0,0,0,0,0,13
Phillips,9/2/20,0,0,0,0,0,0,0,0,0,407,0,5102,0,378,0,10,0,19,0,5509,0,0,0,0,0,0,0,0,7,0,11
Pike,9/2/20,0,0,0,0,0,0,0,0,0,177,0,1755,0,167,0,1,0,9,0,1932,0,0,0,0,0,0,0,0,1,0,12
Poinsett,9/2/20,0,0,0,0,0,0,0,0,0,493,0,5536,0,388,0,6,0,99,0,6029,0,0,0,0,0,0,0,4,2,0,43
Polk,9/2/20,0,0,0,0,0,0,0,0,0,226,0,3129,0,209,0,4,0,13,0,3355,0,0,0,0,0,0,0,1,2,1,17
Pope,9/2/20,0,0,0,0,0,0,0,0,0,1787,0,16190,0,1623,0,18,0,146,0,17977,0,0,0,0,0,0,0,11,12,2,111
Prairie,9/2/20,0,0,0,0,0,0,0,0,0,115,0,1555,0,113,0,0,0,2,0,1670,0,0,0,0,0,0,0,0,0,0,9
Pulaski,9/2/20,0,0,0,0,0,0,0,0,0,7182,0,95006,0,6444,0,112,0,626,0,102188,0,0,0,0,0,0,0,61,53,3,1141
Randolph,9/2/20,0,0,0,0,0,0,0,0,0,311,0,3639,0,290,0,12,0,9,0,3950,0,0,0,0,0,0,0,0,3,0,11
Saline,9/2/20,0,0,0,0,0,0,0,0,0,1617,0,20204,0,1393,0,13,0,211,0,21821,0,0,0,0,0,0,0,26,14,0,174
Scott,9/2/20,0,0,0,0,0,0,0,0,0,87,0,1453,0,85,0,0,0,2,0,1540,0,0,0,0,0,0,0,1,2,0,8
Searcy,9/2/20,0,0,0,0,0,0,0,0,0,101,0,1519,0,55,0,0,0,46,0,1620,0,0,0,0,0,0,0,0,7,0,7
Sebastian,9/2/20,0,0,0,0,0,0,0,0,0,2910,0,31857,0,2658,0,35,0,217,0,34767,0,0,0,0,0,0,0,10,46,1,123
Sevier,9/2/20,0,0,0,0,0,0,0,0,0,1160,0,5570,0,1125,0,13,0,22,0,6730,0,0,0,0,0,0,0,1,0,1,6
Sharp,9/2/20,0,0,0,0,0,0,0,0,0,149,0,2870,0,133,0,5,0,11,0,3019,0,0,0,0,0,0,0,0,5,0,57
St.Francis,9/2/20,0,0,0,0,0,0,0,0,0,1350,0,9834,0,1261,0,4,0,85,0,11184,0,0,0,0,0,0,0,2,6,0,21
Stone,9/2/20,0,0,0,0,0,0,0,0,0,202,0,2388,0,155,0,3,0,44,0,2590,0,0,0,0,0,0,0,6,5,0,27
Union,9/2/20,0,0,0,0,0,0,0,0,0,698,0,6981,0,610,0,20,0,68,0,7679,0,0,0,0,0,0,0,6,11,0,14
VanBuren,9/2/20,0,0,0,0,0,0,0,0,0,126,0,2816,0,91,0,2,0,33,0,2942,0,0,0,0,0,0,0,6,5,0,10
Washington,9/2/20,0,0,0,0,0,0,0,0,0,6991,0,58438,0,6671,0,73,0,247,0,65429,0,0,0,0,0,0,0,70,30,5,419
White,9/2/20,0,0,0,0,0,0,0,0,0,542,0,10116,0,455,0,12,0,75,0,10658,0,0,0,0,0,0,0,9,6,1,48
Woodruff,9/2/20,0,0,0,0,0,0,0,0,0,27,0,1320,0,27,0,0,0,0,0,1347,0,0,0,0,0,0,0,0,1,0,2
Yell,9/2/20,0,0,0,0,0,0,0,0,0,1167,0,7604,0,1114,0,25,0,28,0,8771,0,0,0,0,0,0,0,1,4,2,34
Arkansas_all_counties,9/1/20,0,0,0,0,0,0,0,0,2990671,61497,0,669528,0,55647,0,814,0,5036,0,731025,0,0,0,0,0,0,0,273,686,17,3990
Arkansas_county,9/1/20,0,0,0,0,0,0,0,0,0,284,0,4061,0,259,0,3,0,22,0,4345,0,0,0,0,0,0,0,1,6,0,17
Ashley,9/1/20,0,0,0,0,0,0,0,0,0,388,0,4055,0,365,0,7,0,16,0,4443,0,0,0,0,0,0,0,0,3,0,12
Baxter,9/1/20,0,0,0,0,0,0,0,0,0,139,0,2646,0,113,0,0,0,26,0,2785,0,0,0,0,0,0,0,1,4,0,43
Benton,9/1/20,0,0,0,0,0,0,0,0,0,5394,0,57911,0,5099,0,54,0,241,0,63305,0,0,0,0,0,0,0,30,37,2,275
Boone,9/1/20,0,0,0,0,0,0,0,0,0,369,0,6508,0,259,0,3,0,107,0,6877,0,0,0,0,0,0,0,4,7,0,22
Bradley,9/1/20,0,0,0,0,0,0,0,0,0,295,0,3000,0,250,0,6,0,39,0,3295,0,0,0,0,0,0,0,0,3,1,13
Calhoun,9/1/20,0,0,0,0,0,0,0,0,0,24,0,1247,0,22,0,0,0,2,0,1271,0,0,0,0,0,0,0,0,1,0,2
Carroll,9/1/20,0,0,0,0,0,0,0,0,0,470,0,5583,0,425,0,7,0,38,0,6053,0,0,0,0,0,0,0,1,5,0,16
Chicot,9/1/20,0,0,0,0,0,0,0,0,0,962,0,4208,0,926,0,11,0,25,0,5170,0,0,0,0,0,0,0,0,3,1,4
Clark,9/1/20,0,0,0,0,0,0,0,0,0,236,0,4682,0,203,0,3,0,30,0,4918,0,0,0,0,0,0,0,3,4,0,21
Clay,9/1/20,0,0,0,0,0,0,0,0,0,182,0,3000,0,148,0,5,0,29,0,3182,0,0,0,0,0,0,0,0,1,-1,14
Cleburne,9/1/20,0,0,0,0,0,0,0,0,0,259,0,4385,0,233,0,7,0,19,0,4644,0,0,0,0,0,0,0,0,2,0,21
Cleveland,9/1/20,0,0,0,0,0,0,0,0,0,137,0,1838,0,124,0,4,0,9,0,1975,0,0,0,0,0,0,0,1,4,0,6
Columbia,9/1/20,0,0,0,0,0,0,0,0,0,297,0,3603,0,256,0,15,0,26,0,3900,0,0,0,0,0,0,0,2,8,0,13
Conway,9/1/20,0,0,0,0,0,0,0,0,0,210,0,4716,0,183,0,3,0,24,0,4926,0,0,0,0,0,0,0,4,1,0,28
Craighead,9/1/20,0,0,0,0,0,0,0,0,0,1881,0,23607,0,1621,0,15,0,245,0,25488,0,0,0,0,0,0,0,12,29,0,126
Crawford,9/1/20,0,0,0,0,0,0,0,0,0,931,0,13708,0,804,0,9,0,118,0,14639,0,0,0,0,0,0,0,10,18,0,135
Crittenden,9/1/20,0,0,0,0,0,0,0,0,0,1648,0,11695,0,1555,0,34,0,59,0,13343,0,0,0,0,0,0,0,5,13,0,39
Cross,9/1/20,0,0,0,0,0,0,0,0,0,280,0,3271,0,236,0,5,0,39,0,3551,0,0,0,0,0,0,0,1,2,0,14
Dallas,9/1/20,0,0,0,0,0,0,0,0,0,127,0,1457,0,76,0,2,0,49,0,1584,0,0,0,0,0,0,0,0,3,0,6
Desha,9/1/20,0,0,0,0,0,0,0,0,0,243,0,2954,0,213,0,5,0,25,0,3197,0,0,0,0,0,0,0,0,1,0,2
Drew,9/1/20,0,0,0,0,0,0,0,0,0,305,0,4546,0,277,0,5,0,23,0,4851,0,0,0,0,0,0,0,1,1,0,16
Faulkner,9/1/20,0,0,0,0,0,0,0,0,0,1703,0,27030,0,1511,0,9,0,183,0,28733,0,0,0,0,0,0,0,10,17,0,158
Franklin,9/1/20,0,0,0,0,0,0,0,0,0,168,0,4092,0,148,0,2,0,18,0,4260,0,0,0,0,0,0,0,2,1,0,23
Fulton,9/1/20,0,0,0,0,0,0,0,0,0,71,0,889,0,56,0,0,0,15,0,960,0,0,0,0,0,0,0,1,1,0,6
Garland,9/1/20,0,0,0,0,0,0,0,0,0,1434,0,21156,0,1272,0,29,0,133,0,22590,0,0,0,0,0,0,0,6,20,0,52
Grant,9/1/20,0,0,0,0,0,0,0,0,0,191,0,3508,0,165,0,1,0,25,0,3699,0,0,0,0,0,0,0,-1,2,0,26
Greene,9/1/20,0,0,0,0,0,0,0,0,0,635,0,9511,0,574,0,4,0,57,0,10146,0,0,0,0,0,0,0,1,8,0,32
Hempstead,9/1/20,0,0,0,0,0,0,0,0,0,330,0,3454,0,307,0,3,0,20,0,3784,0,0,0,0,0,0,0,0,4,0,11
HotSpring,9/1/20,0,0,0,0,0,0,0,0,0,1719,0,8422,0,1661,0,21,0,37,0,10141,0,0,0,0,0,0,0,2,3,1,40
Howard,9/1/20,0,0,0,0,0,0,0,0,0,425,0,3157,0,388,0,5,0,32,0,3582,0,0,0,0,0,0,0,0,3,0,12
Independence,9/1/20,0,0,0,0,0,0,0,0,0,770,0,7829,0,679,0,6,0,85,0,8599,0,0,0,0,0,0,0,5,13,0,22
Izard,9/1/20,0,0,0,0,0,0,0,0,0,105,0,2773,0,80,0,0,0,25,0,2878,0,0,0,0,0,0,0,3,5,0,16
Jackson,9/1/20,0,0,0,0,0,0,0,0,0,184,0,4590,0,155,0,1,0,28,0,4774,0,0,0,0,0,0,0,1,24,0,8
Jefferson,9/1/20,0,0,0,0,0,0,0,0,0,2112,0,21002,0,1773,0,50,0,289,0,23114,0,0,0,0,0,0,0,8,35,0,63
Johnson,9/1/20,0,0,0,0,0,0,0,0,0,765,0,5613,0,745,0,4,0,16,0,6378,0,0,0,0,0,0,0,0,16,0,13
Lafayette,9/1/20,0,0,0,0,0,0,0,0,0,70,0,790,0,63,0,2,0,5,0,860,0,0,0,0,0,0,0,2,0,0,3
Lawrence,9/1/20,0,0,0,0,0,0,0,0,0,250,0,2714,0,226,0,10,0,14,0,2964,0,0,0,0,0,0,0,1,2,0,16
Lee,9/1/20,0,0,0,0,0,0,0,0,0,1004,0,3295,0,974,0,11,0,19,0,4299,0,0,0,0,0,0,0,1,2,0,6
Lincoln,9/1/20,0,0,0,0,0,0,0,0,0,1608,0,5274,0,1366,0,13,0,229,0,6882,0,0,0,0,0,0,0,4,2,0,9
LittleRiver,9/1/20,0,0,0,0,0,0,0,0,0,284,0,1448,0,253,0,15,0,16,0,1732,0,0,0,0,0,0,0,3,3,1,5
Logan,9/1/20,0,0,0,0,0,0,0,0,0,365,0,5283,0,338,0,1,0,26,0,5648,0,0,0,0,0,0,0,0,3,0,20
Lonoke,9/1/20,0,0,0,0,0,0,0,0,0,728,0,12694,0,623,0,4,0,101,0,13422,0,0,0,0,0,0,0,2,10,0,206
Madison,9/1/20,0,0,0,0,0,0,0,0,0,296,0,3380,0,288,0,2,0,6,0,3676,0,0,0,0,0,0,0,0,0,0,5
Marion,9/1/20,0,0,0,0,0,0,0,0,0,46,0,1681,0,39,0,0,0,7,0,1727,0,0,0,0,0,0,0,1,1,0,18
Miller,9/1/20,0,0,0,0,0,0,0,0,0,612,0,5116,0,566,0,9,0,37,0,5728,0,0,0,0,0,0,0,10,9,1,17
MissingCountyInfo,9/1/20,0,0,0,0,0,0,0,0,0,897,0,17109,0,722,0,0,0,175,0,18006,0,0,0,0,0,0,0,-7,3,0,416
Mississippi,9/1/20,0,0,0,0,0,0,0,0,0,1352,0,9417,0,1242,0,22,0,88,0,10769,0,0,0,0,0,0,0,3,20,1,23
Monroe,9/1/20,0,0,0,0,0,0,0,0,0,95,0,1786,0,87,0,0,0,8,0,1881,0,0,0,0,0,0,0,1,0,0,9
Montgomery,9/1/20,0,0,0,0,0,0,0,0,0,104,0,1325,0,60,0,3,0,41,0,1429,0,0,0,0,0,0,0,3,5,0,69
Nevada,9/1/20,0,0,0,0,0,0,0,0,0,162,0,2200,0,138,0,12,0,12,0,2362,0,0,0,0,0,0,0,0,1,0,9
Newton,9/1/20,0,0,0,0,0,0,0,0,0,120,0,1227,0,94,0,15,0,11,0,1347,0,0,0,0,0,0,0,0,0,0,4
Ouachita,9/1/20,0,0,0,0,0,0,0,0,0,158,0,4203,0,125,0,4,0,29,0,4361,0,0,0,0,0,0,0,0,3,0,13
Perry,9/1/20,0,0,0,0,0,0,0,0,0,63,0,2087,0,59,0,1,0,3,0,2150,0,0,0,0,0,0,0,0,1,0,0
Phillips,9/1/20,0,0,0,0,0,0,0,0,0,407,0,5091,0,371,0,10,0,26,0,5498,0,0,0,0,0,0,0,2,6,1,5
Pike,9/1/20,0,0,0,0,0,0,0,0,0,177,0,1743,0,166,0,1,0,10,0,1920,0,0,0,0,0,0,0,1,3,0,7
Poinsett,9/1/20,0,0,0,0,0,0,0,0,0,489,0,5497,0,386,0,6,0,97,0,5986,0,0,0,0,0,0,0,0,7,0,15
Polk,9/1/20,0,0,0,0,0,0,0,0,0,225,0,3113,0,207,0,3,0,15,0,3338,0,0,0,0,0,0,0,1,2,0,5
Pope,9/1/20,0,0,0,0,0,0,0,0,0,1776,0,16090,0,1611,0,16,0,149,0,17866,0,0,0,0,0,0,0,2,31,0,94
Prairie,9/1/20,0,0,0,0,0,0,0,0,0,115,0,1546,0,113,0,0,0,2,0,1661,0,0,0,0,0,0,0,0,1,0,3
Pulaski,9/1/20,0,0,0,0,0,0,0,0,0,7121,0,93926,0,6391,0,109,0,621,0,101047,0,0,0,0,0,0,0,49,89,3,815
Randolph,9/1/20,0,0,0,0,0,0,0,0,0,311,0,3628,0,287,0,12,0,12,0,3939,0,0,0,0,0,0,0,0,6,0,10
Saline,9/1/20,0,0,0,0,0,0,0,0,0,1591,0,20056,0,1379,0,13,0,199,0,21647,0,0,0,0,0,0,0,15,16,1,215
Scott,9/1/20,0,0,0,0,0,0,0,0,0,86,0,1446,0,83,0,0,0,3,0,1532,0,0,0,0,0,0,0,0,1,0,6
Searcy,9/1/20,0,0,0,0,0,0,0,0,0,101,0,1512,0,48,0,0,0,53,0,1613,0,0,0,0,0,0,0,1,1,0,11
Sebastian,9/1/20,0,0,0,0,0,0,0,0,0,2900,0,31744,0,2612,0,34,0,254,0,34644,0,0,0,0,0,0,0,23,61,1,184
Sevier,9/1/20,0,0,0,0,0,0,0,0,0,1159,0,5565,0,1125,0,12,0,22,0,6724,0,0,0,0,0,0,0,2,10,0,8
Sharp,9/1/20,0,0,0,0,0,0,0,0,0,149,0,2813,0,128,0,5,0,16,0,2962,0,0,0,0,0,0,0,0,2,0,3
St.Francis,9/1/20,0,0,0,0,0,0,0,0,0,1348,0,9815,0,1255,0,4,0,89,0,11163,0,0,0,0,0,0,0,3,5,0,14
Stone,9/1/20,0,0,0,0,0,0,0,0,0,196,0,2367,0,150,0,3,0,43,0,2563,0,0,0,0,0,0,0,3,6,1,8
Union,9/1/20,0,0,0,0,0,0,0,0,0,692,0,6973,0,599,0,20,0,73,0,7665,0,0,0,0,0,0,0,1,11,0,12
VanBuren,9/1/20,0,0,0,0,0,0,0,0,0,120,0,2812,0,86,0,2,0,32,0,2932,0,0,0,0,0,0,0,2,2,0,24
Washington,9/1/20,0,0,0,0,0,0,0,0,0,6921,0,58089,0,6641,0,68,0,212,0,65010,0,0,0,0,0,0,0,21,37,3,202
White,9/1/20,0,0,0,0,0,0,0,0,0,533,0,10077,0,449,0,11,0,73,0,10610,0,0,0,0,0,0,0,5,9,0,138
Woodruff,9/1/20,0,0,0,0,0,0,0,0,0,27,0,1318,0,26,0,0,0,1,0,1345,0,0,0,0,0,0,0,0,0,0,8
Yell,9/1/20,0,0,0,0,0,0,0,0,0,1166,0,7571,0,1110,0,23,0,33,0,8737,0,0,0,0,0,0,0,4,7,0,28
Arkansas_all_counties,8/31/20,0,0,0,0,0,0,0,0,2990671,61224,0,665811,0,54961,0,797,0,5466,0,727035,0,0,0,0,0,0,0,368,553,13,14348
Arkansas_county,8/31/20,0,0,0,0,0,0,0,0,0,283,0,4045,0,253,0,3,0,27,0,4328,0,0,0,0,0,0,0,1,2,0,32
Ashley,8/31/20,0,0,0,0,0,0,0,0,0,388,0,4043,0,362,0,7,0,19,0,4431,0,0,0,0,0,0,0,0,2,0,66
Baxter,8/31/20,0,0,0,0,0,0,0,0,0,138,0,2604,0,109,0,0,0,29,0,2742,0,0,0,0,0,0,0,1,3,0,51
Benton,8/31/20,0,0,0,0,0,0,0,0,0,5364,0,57666,0,5062,0,52,0,250,0,63030,0,0,0,0,0,0,0,30,24,1,3207
Boone,8/31/20,0,0,0,0,0,0,0,0,0,365,0,6490,0,252,0,3,0,110,0,6855,0,0,0,0,0,0,0,9,5,0,299
Bradley,8/31/20,0,0,0,0,0,0,0,0,0,295,0,2987,0,247,0,5,0,43,0,3282,0,0,0,0,0,0,0,6,3,0,61
Calhoun,8/31/20,0,0,0,0,0,0,0,0,0,24,0,1245,0,21,0,0,0,3,0,1269,0,0,0,0,0,0,0,1,0,0,20
Carroll,8/31/20,0,0,0,0,0,0,0,0,0,469,0,5568,0,420,0,7,0,42,0,6037,0,0,0,0,0,0,0,4,9,0,225
Chicot,8/31/20,0,0,0,0,0,0,0,0,0,962,0,4204,0,923,0,10,0,29,0,5166,0,0,0,0,0,0,0,0,4,0,89
Clark,8/31/20,0,0,0,0,0,0,0,0,0,233,0,4664,0,199,0,3,0,31,0,4897,0,0,0,0,0,0,0,4,1,0,40
Clay,8/31/20,0,0,0,0,0,0,0,0,0,182,0,2986,0,147,0,6,0,29,0,3168,0,0,0,0,0,0,0,2,1,0,44
Cleburne,8/31/20,0,0,0,0,0,0,0,0,0,259,0,4364,0,231,0,7,0,21,0,4623,0,0,0,0,0,0,0,1,2,0,50
Cleveland,8/31/20,0,0,0,0,0,0,0,0,0,136,0,1833,0,120,0,4,0,12,0,1969,0,0,0,0,0,0,0,0,-1,1,17
Columbia,8/31/20,0,0,0,0,0,0,0,0,0,295,0,3592,0,248,0,15,0,32,0,3887,0,0,0,0,0,0,0,2,1,0,49
Conway,8/31/20,0,0,0,0,0,0,0,0,0,206,0,4692,0,182,0,3,0,21,0,4898,0,0,0,0,0,0,0,4,3,0,76
Craighead,8/31/20,0,0,0,0,0,0,0,0,0,1869,0,23493,0,1592,0,15,0,262,0,25362,0,0,0,0,0,0,0,18,24,0,307
Crawford,8/31/20,0,0,0,0,0,0,0,0,0,921,0,13583,0,786,0,9,0,126,0,14504,0,0,0,0,0,0,0,5,12,0,266
Crittenden,8/31/20,0,0,0,0,0,0,0,0,0,1643,0,11661,0,1542,0,34,0,67,0,13304,0,0,0,0,0,0,0,2,7,0,78
Cross,8/31/20,0,0,0,0,0,0,0,0,0,279,0,3258,0,234,0,5,0,40,0,3537,0,0,0,0,0,0,0,4,1,0,138
Dallas,8/31/20,0,0,0,0,0,0,0,0,0,127,0,1451,0,73,0,2,0,52,0,1578,0,0,0,0,0,0,0,0,3,0,20
Desha,8/31/20,0,0,0,0,0,0,0,0,0,243,0,2952,0,212,0,5,0,26,0,3195,0,0,0,0,0,0,0,4,1,0,52
Drew,8/31/20,0,0,0,0,0,0,0,0,0,304,0,4531,0,276,0,5,0,23,0,4835,0,0,0,0,0,0,0,1,1,1,98
Faulkner,8/31/20,0,0,0,0,0,0,0,0,0,1693,0,26882,0,1494,0,9,0,190,0,28575,0,0,0,0,0,0,0,14,19,1,399
Franklin,8/31/20,0,0,0,0,0,0,0,0,0,166,0,4071,0,147,0,2,0,17,0,4237,0,0,0,0,0,0,0,4,2,0,85
Fulton,8/31/20,0,0,0,0,0,0,0,0,0,70,0,884,0,55,0,0,0,15,0,954,0,0,0,0,0,0,0,1,3,0,18
Garland,8/31/20,0,0,0,0,0,0,0,0,0,1428,0,21110,0,1252,0,29,0,147,0,22538,0,0,0,0,0,0,0,21,12,0,286
Grant,8/31/20,0,0,0,0,0,0,0,0,0,192,0,3481,0,163,0,1,0,28,0,3673,0,0,0,0,0,0,0,0,2,0,51
Greene,8/31/20,0,0,0,0,0,0,0,0,0,634,0,9480,0,566,0,4,0,64,0,10114,0,0,0,0,0,0,0,2,2,0,116
Hempstead,8/31/20,0,0,0,0,0,0,0,0,0,330,0,3443,0,303,0,3,0,24,0,3773,0,0,0,0,0,0,0,0,2,0,30
HotSpring,8/31/20,0,0,0,0,0,0,0,0,0,1717,0,8384,0,1658,0,20,0,39,0,10101,0,0,0,0,0,0,0,0,2,0,89
Howard,8/31/20,0,0,0,0,0,0,0,0,0,425,0,3145,0,385,0,5,0,35,0,3570,0,0,0,0,0,0,0,2,2,0,16
Independence,8/31/20,0,0,0,0,0,0,0,0,0,765,0,7812,0,666,0,6,0,93,0,8577,0,0,0,0,0,0,0,5,11,0,130
Izard,8/31/20,0,0,0,0,0,0,0,0,0,102,0,2760,0,75,0,0,0,27,0,2862,0,0,0,0,0,0,0,0,3,0,65
Jackson,8/31/20,0,0,0,0,0,0,0,0,0,183,0,4583,0,131,0,1,0,51,0,4766,0,0,0,0,0,0,0,1,5,0,18
Jefferson,8/31/20,0,0,0,0,0,0,0,0,0,2104,0,20947,0,1738,0,50,0,316,0,23051,0,0,0,0,0,0,0,13,17,0,276
Johnson,8/31/20,0,0,0,0,0,0,0,0,0,765,0,5600,0,729,0,4,0,32,0,6365,0,0,0,0,0,0,0,11,9,0,74
Lafayette,8/31/20,0,0,0,0,0,0,0,0,0,68,0,789,0,63,0,2,0,3,0,857,0,0,0,0,0,0,0,2,0,0,5
Lawrence,8/31/20,0,0,0,0,0,0,0,0,0,249,0,2699,0,224,0,10,0,15,0,2948,0,0,0,0,0,0,0,1,0,0,47
Lee,8/31/20,0,0,0,0,0,0,0,0,0,1003,0,3290,0,972,0,11,0,20,0,4293,0,0,0,0,0,0,0,1,0,0,26
Lincoln,8/31/20,0,0,0,0,0,0,0,0,0,1604,0,5269,0,1364,0,13,0,227,0,6873,0,0,0,0,0,0,0,4,8,0,161
LittleRiver,8/31/20,0,0,0,0,0,0,0,0,0,281,0,1446,0,250,0,14,0,17,0,1727,0,0,0,0,0,0,0,3,3,0,14
Logan,8/31/20,0,0,0,0,0,0,0,0,0,365,0,5263,0,335,0,1,0,29,0,5628,0,0,0,0,0,0,0,1,5,0,65
Lonoke,8/31/20,0,0,0,0,0,0,0,0,0,726,0,12490,0,613,0,4,0,109,0,13216,0,0,0,0,0,0,0,9,6,0,173
Madison,8/31/20,0,0,0,0,0,0,0,0,0,296,0,3375,0,288,0,2,0,6,0,3671,0,0,0,0,0,0,0,1,1,0,303
Marion,8/31/20,0,0,0,0,0,0,0,0,0,45,0,1664,0,38,0,0,0,7,0,1709,0,0,0,0,0,0,0,1,1,0,37
Miller,8/31/20,0,0,0,0,0,0,0,0,0,602,0,5109,0,557,0,8,0,37,0,5711,0,0,0,0,0,0,0,1,3,1,59
MissingCountyInfo,8/31/20,0,0,0,0,0,0,0,0,0,904,0,16686,0,719,0,0,0,185,0,17590,0,0,0,0,0,0,0,0,22,0,-4451
Mississippi,8/31/20,0,0,0,0,0,0,0,0,0,1349,0,9397,0,1222,0,21,0,106,0,10746,0,0,0,0,0,0,0,0,18,0,69
Monroe,8/31/20,0,0,0,0,0,0,0,0,0,94,0,1778,0,87,0,0,0,7,0,1872,0,0,0,0,0,0,0,0,3,0,15
Montgomery,8/31/20,0,0,0,0,0,0,0,0,0,101,0,1259,0,55,0,3,0,43,0,1360,0,0,0,0,0,0,0,5,2,0,24
Nevada,8/31/20,0,0,0,0,0,0,0,0,0,162,0,2191,0,137,0,12,0,13,0,2353,0,0,0,0,0,0,0,0,0,0,10
Newton,8/31/20,0,0,0,0,0,0,0,0,0,120,0,1223,0,94,0,15,0,11,0,1343,0,0,0,0,0,0,0,0,1,0,70
Ouachita,8/31/20,0,0,0,0,0,0,0,0,0,158,0,4190,0,122,0,4,0,32,0,4348,0,0,0,0,0,0,0,1,4,0,80
Perry,8/31/20,0,0,0,0,0,0,0,0,0,63,0,2087,0,58,0,1,0,4,0,2150,0,0,0,0,0,0,0,0,1,0,21
Phillips,8/31/20,0,0,0,0,0,0,0,0,0,405,0,5088,0,365,0,9,0,31,0,5493,0,0,0,0,0,0,0,1,6,0,40
Pike,8/31/20,0,0,0,0,0,0,0,0,0,176,0,1737,0,163,0,1,0,12,0,1913,0,0,0,0,0,0,0,2,4,0,18
Poinsett,8/31/20,0,0,0,0,0,0,0,0,0,489,0,5482,0,379,0,6,0,104,0,5971,0,0,0,0,0,0,0,3,10,0,65
Polk,8/31/20,0,0,0,0,0,0,0,0,0,224,0,3109,0,205,0,3,0,16,0,3333,0,0,0,0,0,0,0,0,10,0,46
Pope,8/31/20,0,0,0,0,0,0,0,0,0,1774,0,15998,0,1580,0,16,0,178,0,17772,0,0,0,0,0,0,0,42,39,2,315
Prairie,8/31/20,0,0,0,0,0,0,0,0,0,115,0,1543,0,112,0,0,0,3,0,1658,0,0,0,0,0,0,0,0,0,0,20
Pulaski,8/31/20,0,0,0,0,0,0,0,0,0,7072,0,93160,0,6302,0,106,0,664,0,100232,0,0,0,0,0,0,0,48,68,1,1182
Randolph,8/31/20,0,0,0,0,0,0,0,0,0,311,0,3618,0,281,0,12,0,18,0,3929,0,0,0,0,0,0,0,2,5,0,46
Saline,8/31/20,0,0,0,0,0,0,0,0,0,1576,0,19856,0,1363,0,12,0,201,0,21432,0,0,0,0,0,0,0,9,13,0,317
Scott,8/31/20,0,0,0,0,0,0,0,0,0,86,0,1440,0,82,0,0,0,4,0,1526,0,0,0,0,0,0,0,0,0,0,24
Searcy,8/31/20,0,0,0,0,0,0,0,0,0,100,0,1502,0,47,0,0,0,53,0,1602,0,0,0,0,0,0,0,0,8,0,45
Sebastian,8/31/20,0,0,0,0,0,0,0,0,0,2877,0,31583,0,2551,0,33,0,293,0,34460,0,0,0,0,0,0,0,15,30,0,510
Sevier,8/31/20,0,0,0,0,0,0,0,0,0,1157,0,5559,0,1115,0,12,0,30,0,6716,0,0,0,0,0,0,0,0,10,0,41
Sharp,8/31/20,0,0,0,0,0,0,0,0,0,149,0,2810,0,126,0,5,0,18,0,2959,0,0,0,0,0,0,0,2,0,0,41
St.Francis,8/31/20,0,0,0,0,0,0,0,0,0,1345,0,9804,0,1250,0,4,0,91,0,11149,0,0,0,0,0,0,0,1,4,0,705
Stone,8/31/20,0,0,0,0,0,0,0,0,0,193,0,2362,0,144,0,2,0,47,0,2555,0,0,0,0,0,0,0,-1,10,0,23
Union,8/31/20,0,0,0,0,0,0,0,0,0,691,0,6962,0,588,0,20,0,83,0,7653,0,0,0,0,0,0,0,1,4,1,50
VanBuren,8/31/20,0,0,0,0,0,0,0,0,0,118,0,2790,0,84,0,2,0,32,0,2908,0,0,0,0,0,0,0,0,4,0,18
Washington,8/31/20,0,0,0,0,0,0,0,0,0,6900,0,57908,0,6604,0,65,0,231,0,64808,0,0,0,0,0,0,0,17,20,4,6837
White,8/31/20,0,0,0,0,0,0,0,0,0,528,0,9944,0,440,0,11,0,77,0,10472,0,0,0,0,0,0,0,4,10,0,230
Woodruff,8/31/20,0,0,0,0,0,0,0,0,0,27,0,1310,0,26,0,0,0,1,0,1337,0,0,0,0,0,0,0,0,0,0,20
Yell,8/31/20,0,0,0,0,0,0,0,0,0,1162,0,7547,0,1103,0,23,0,36,0,8709,0,0,0,0,0,0,0,19,21,0,89
Arkansas_all_counties,8/30/20,0,0,0,0,0,0,0,0,2990671,60856,0,651831,0,54408,0,784,0,5664,0,712687,0,0,0,0,0,0,0,478,275,12,5717
Arkansas_county,8/30/20,0,0,0,0,0,0,0,0,0,282,0,4014,0,251,0,3,0,28,0,4296,0,0,0,0,0,0,0,5,1,0,61
Ashley,8/30/20,0,0,0,0,0,0,0,0,0,388,0,3977,0,360,0,7,0,21,0,4365,0,0,0,0,0,0,0,0,1,0,5
Baxter,8/30/20,0,0,0,0,0,0,0,0,0,137,0,2554,0,106,0,0,0,31,0,2691,0,0,0,0,0,0,0,5,5,0,32
Benton,8/30/20,0,0,0,0,0,0,0,0,0,5334,0,54489,0,5038,0,51,0,245,0,59823,0,0,0,0,0,0,0,21,13,1,246
Boone,8/30/20,0,0,0,0,0,0,0,0,0,356,0,6200,0,247,0,3,0,106,0,6556,0,0,0,0,0,0,0,40,2,0,207
Bradley,8/30/20,0,0,0,0,0,0,0,0,0,289,0,2932,0,244,0,5,0,40,0,3221,0,0,0,0,0,0,0,0,1,0,16
Calhoun,8/30/20,0,0,0,0,0,0,0,0,0,23,0,1226,0,21,0,0,0,2,0,1249,0,0,0,0,0,0,0,0,0,0,2
Carroll,8/30/20,0,0,0,0,0,0,0,0,0,465,0,5347,0,411,0,7,0,47,0,5812,0,0,0,0,0,0,0,6,6,0,42
Chicot,8/30/20,0,0,0,0,0,0,0,0,0,962,0,4115,0,919,0,10,0,33,0,5077,0,0,0,0,0,0,0,4,3,0,47
Clark,8/30/20,0,0,0,0,0,0,0,0,0,229,0,4628,0,198,0,3,0,28,0,4857,0,0,0,0,0,0,0,3,1,0,172
Clay,8/30/20,0,0,0,0,0,0,0,0,0,180,0,2944,0,146,0,6,0,28,0,3124,0,0,0,0,0,0,0,5,1,0,20
Cleburne,8/30/20,0,0,0,0,0,0,0,0,0,258,0,4315,0,229,0,7,0,22,0,4573,0,0,0,0,0,0,0,2,2,0,55
Cleveland,8/30/20,0,0,0,0,0,0,0,0,0,136,0,1816,0,121,0,3,0,12,0,1952,0,0,0,0,0,0,0,1,0,0,3
Columbia,8/30/20,0,0,0,0,0,0,0,0,0,293,0,3545,0,247,0,15,0,31,0,3838,0,0,0,0,0,0,0,2,0,1,21
Conway,8/30/20,0,0,0,0,0,0,0,0,0,202,0,4620,0,179,0,3,0,20,0,4822,0,0,0,0,0,0,0,1,0,0,29
Craighead,8/30/20,0,0,0,0,0,0,0,0,0,1851,0,23204,0,1568,0,15,0,268,0,25055,0,0,0,0,0,0,0,22,10,0,153
Crawford,8/30/20,0,0,0,0,0,0,0,0,0,916,0,13322,0,774,0,9,0,133,0,14238,0,0,0,0,0,0,0,6,6,1,97
Crittenden,8/30/20,0,0,0,0,0,0,0,0,0,1641,0,11585,0,1535,0,34,0,72,0,13226,0,0,0,0,0,0,0,6,5,1,45
Cross,8/30/20,0,0,0,0,0,0,0,0,0,275,0,3124,0,233,0,5,0,37,0,3399,0,0,0,0,0,0,0,9,3,0,94
Dallas,8/30/20,0,0,0,0,0,0,0,0,0,127,0,1431,0,70,0,2,0,55,0,1558,0,0,0,0,0,0,0,12,2,0,28
Desha,8/30/20,0,0,0,0,0,0,0,0,0,239,0,2904,0,211,0,5,0,23,0,3143,0,0,0,0,0,0,0,2,2,0,14
Drew,8/30/20,0,0,0,0,0,0,0,0,0,303,0,4434,0,275,0,4,0,24,0,4737,0,0,0,0,0,0,0,1,3,0,13
Faulkner,8/30/20,0,0,0,0,0,0,0,0,0,1679,0,26497,0,1475,0,8,0,196,0,28176,0,0,0,0,0,0,0,30,12,0,344
Franklin,8/30/20,0,0,0,0,0,0,0,0,0,162,0,3990,0,145,0,2,0,15,0,4152,0,0,0,0,0,0,0,2,2,0,13
Fulton,8/30/20,0,0,0,0,0,0,0,0,0,69,0,867,0,52,0,0,0,17,0,936,0,0,0,0,0,0,0,2,0,0,4
Garland,8/30/20,0,0,0,0,0,0,0,0,0,1407,0,20845,0,1240,0,29,0,138,0,22252,0,0,0,0,0,0,0,7,11,0,70
Grant,8/30/20,0,0,0,0,0,0,0,0,0,192,0,3430,0,161,0,1,0,30,0,3622,0,0,0,0,0,0,0,9,1,0,40
Greene,8/30/20,0,0,0,0,0,0,0,0,0,632,0,9366,0,564,0,4,0,64,0,9998,0,0,0,0,0,0,0,7,6,0,43
Hempstead,8/30/20,0,0,0,0,0,0,0,0,0,330,0,3413,0,301,0,3,0,26,0,3743,0,0,0,0,0,0,0,1,3,0,8
HotSpring,8/30/20,0,0,0,0,0,0,0,0,0,1717,0,8295,0,1656,0,20,0,41,0,10012,0,0,0,0,0,0,0,4,6,0,24
Howard,8/30/20,0,0,0,0,0,0,0,0,0,423,0,3131,0,383,0,5,0,35,0,3554,0,0,0,0,0,0,0,2,4,0,10
Independence,8/30/20,0,0,0,0,0,0,0,0,0,760,0,7687,0,655,0,6,0,99,0,8447,0,0,0,0,0,0,0,5,3,1,18
Izard,8/30/20,0,0,0,0,0,0,0,0,0,102,0,2695,0,72,0,0,0,30,0,2797,0,0,0,0,0,0,0,4,1,0,18
Jackson,8/30/20,0,0,0,0,0,0,0,0,0,182,0,4566,0,126,0,1,0,55,0,4748,0,0,0,0,0,0,0,0,1,0,6
Jefferson,8/30/20,0,0,0,0,0,0,0,0,0,2091,0,20684,0,1721,0,50,0,320,0,22775,0,0,0,0,0,0,0,9,10,0,107
Johnson,8/30/20,0,0,0,0,0,0,0,0,0,754,0,5537,0,720,0,4,0,30,0,6291,0,0,0,0,0,0,0,1,1,0,19
Lafayette,8/30/20,0,0,0,0,0,0,0,0,0,66,0,786,0,63,0,2,0,1,0,852,0,0,0,0,0,0,0,0,0,0,1
Lawrence,8/30/20,0,0,0,0,0,0,0,0,0,248,0,2653,0,224,0,10,0,14,0,2901,0,0,0,0,0,0,0,0,1,0,26
Lee,8/30/20,0,0,0,0,0,0,0,0,0,1002,0,3265,0,972,0,11,0,19,0,4267,0,0,0,0,0,0,0,1,2,0,10
Lincoln,8/30/20,0,0,0,0,0,0,0,0,0,1600,0,5112,0,1356,0,13,0,231,0,6712,0,0,0,0,0,0,0,30,4,0,35
LittleRiver,8/30/20,0,0,0,0,0,0,0,0,0,278,0,1435,0,247,0,14,0,17,0,1713,0,0,0,0,0,0,0,2,0,0,8
Logan,8/30/20,0,0,0,0,0,0,0,0,0,364,0,5199,0,330,0,1,0,33,0,5563,0,0,0,0,0,0,0,2,1,0,26
Lonoke,8/30/20,0,0,0,0,0,0,0,0,0,717,0,12326,0,607,0,4,0,106,0,13043,0,0,0,0,0,0,0,12,4,0,131
Madison,8/30/20,0,0,0,0,0,0,0,0,0,295,0,3073,0,287,0,2,0,6,0,3368,0,0,0,0,0,0,0,0,0,0,13
Marion,8/30/20,0,0,0,0,0,0,0,0,0,44,0,1628,0,37,0,0,0,7,0,1672,0,0,0,0,0,0,0,0,1,0,15
Miller,8/30/20,0,0,0,0,0,0,0,0,0,601,0,5051,0,554,0,7,0,40,0,5652,0,0,0,0,0,0,0,2,0,1,216
MissingCountyInfo,8/30/20,0,0,0,0,0,0,0,0,0,904,0,21137,0,697,0,0,0,207,0,22041,0,0,0,0,0,0,0,3,0,0,1139
Mississippi,8/30/20,0,0,0,0,0,0,0,0,0,1349,0,9328,0,1204,0,21,0,124,0,10677,0,0,0,0,0,0,0,4,8,1,60
Monroe,8/30/20,0,0,0,0,0,0,0,0,0,94,0,1763,0,84,0,0,0,10,0,1857,0,0,0,0,0,0,0,2,2,0,10
Montgomery,8/30/20,0,0,0,0,0,0,0,0,0,96,0,1240,0,53,0,3,0,40,0,1336,0,0,0,0,0,0,0,3,1,0,4
Nevada,8/30/20,0,0,0,0,0,0,0,0,0,162,0,2181,0,137,0,12,0,13,0,2343,0,0,0,0,0,0,0,0,0,0,8
Newton,8/30/20,0,0,0,0,0,0,0,0,0,120,0,1153,0,93,0,15,0,12,0,1273,0,0,0,0,0,0,0,3,0,0,6
Ouachita,8/30/20,0,0,0,0,0,0,0,0,0,157,0,4111,0,118,0,4,0,35,0,4268,0,0,0,0,0,0,0,11,1,0,88
Perry,8/30/20,0,0,0,0,0,0,0,0,0,63,0,2066,0,57,0,1,0,5,0,2129,0,0,0,0,0,0,0,1,0,0,11
Phillips,8/30/20,0,0,0,0,0,0,0,0,0,404,0,5049,0,359,0,9,0,36,0,5453,0,0,0,0,0,0,0,7,2,0,35
Pike,8/30/20,0,0,0,0,0,0,0,0,0,174,0,1721,0,159,0,1,0,14,0,1895,0,0,0,0,0,0,0,2,2,0,20
Poinsett,8/30/20,0,0,0,0,0,0,0,0,0,486,0,5420,0,369,0,6,0,111,0,5906,0,0,0,0,0,0,0,8,7,0,51
Polk,8/30/20,0,0,0,0,0,0,0,0,0,224,0,3063,0,195,0,3,0,26,0,3287,0,0,0,0,0,0,0,1,5,0,23
Pope,8/30/20,0,0,0,0,0,0,0,0,0,1732,0,15725,0,1541,0,14,0,177,0,17457,0,0,0,0,0,0,0,16,9,0,120
Prairie,8/30/20,0,0,0,0,0,0,0,0,0,115,0,1523,0,112,0,0,0,3,0,1638,0,0,0,0,0,0,0,1,0,0,5
Pulaski,8/30/20,0,0,0,0,0,0,0,0,0,7024,0,92026,0,6234,0,105,0,685,0,99050,0,0,0,0,0,0,0,33,40,2,680
Randolph,8/30/20,0,0,0,0,0,0,0,0,0,309,0,3574,0,276,0,12,0,21,0,3883,0,0,0,0,0,0,0,1,2,0,9
Saline,8/30/20,0,0,0,0,0,0,0,0,0,1567,0,19548,0,1350,0,12,0,205,0,21115,0,0,0,0,0,0,0,20,12,0,162
Scott,8/30/20,0,0,0,0,0,0,0,0,0,86,0,1416,0,82,0,0,0,4,0,1502,0,0,0,0,0,0,0,0,0,0,7
Searcy,8/30/20,0,0,0,0,0,0,0,0,0,100,0,1457,0,39,0,0,0,61,0,1557,0,0,0,0,0,0,0,5,0,0,26
Sebastian,8/30/20,0,0,0,0,0,0,0,0,0,2862,0,31088,0,2521,0,33,0,308,0,33950,0,0,0,0,0,0,0,20,12,1,183
Sevier,8/30/20,0,0,0,0,0,0,0,0,0,1157,0,5518,0,1105,0,12,0,40,0,6675,0,0,0,0,0,0,0,4,5,0,22
Sharp,8/30/20,0,0,0,0,0,0,0,0,0,147,0,2771,0,126,0,5,0,16,0,2918,0,0,0,0,0,0,0,1,1,0,18
St.Francis,8/30/20,0,0,0,0,0,0,0,0,0,1344,0,9100,0,1246,0,4,0,94,0,10444,0,0,0,0,0,0,0,1,1,0,26
Stone,8/30/20,0,0,0,0,0,0,0,0,0,194,0,2338,0,134,0,2,0,58,0,2532,0,0,0,0,0,0,0,3,4,0,14
Union,8/30/20,0,0,0,0,0,0,0,0,0,690,0,6913,0,584,0,19,0,87,0,7603,0,0,0,0,0,0,0,1,2,-1,25
VanBuren,8/30/20,0,0,0,0,0,0,0,0,0,118,0,2772,0,80,0,2,0,36,0,2890,0,0,0,0,0,0,0,2,0,0,20
Washington,8/30/20,0,0,0,0,0,0,0,0,0,6883,0,51088,0,6584,0,61,0,238,0,57971,0,0,0,0,0,0,0,33,8,3,259
White,8/30/20,0,0,0,0,0,0,0,0,0,524,0,9718,0,430,0,11,0,83,0,10242,0,0,0,0,0,0,0,4,7,0,36
Woodruff,8/30/20,0,0,0,0,0,0,0,0,0,27,0,1290,0,26,0,0,0,1,0,1317,0,0,0,0,0,0,0,0,0,0,1
Yell,8/30/20,0,0,0,0,0,0,0,0,0,1143,0,7477,0,1082,0,23,0,38,0,8620,0,0,0,0,0,0,0,3,3,0,42
Arkansas_all_counties,8/29/20,0,0,0,0,0,0,0,0,2990671,60378,0,646592,0,54133,0,772,0,5473,0,706970,0,0,0,0,0,0,0,795,468,16,8915
Arkansas_county,8/29/20,0,0,0,0,0,0,0,0,0,277,0,3958,0,250,0,3,0,24,0,4235,0,0,0,0,0,0,0,2,4,0,42
Ashley,8/29/20,0,0,0,0,0,0,0,0,0,388,0,3972,0,359,0,7,0,22,0,4360,0,0,0,0,0,0,0,1,2,0,40
Baxter,8/29/20,0,0,0,0,0,0,0,0,0,132,0,2527,0,101,0,0,0,31,0,2659,0,0,0,0,0,0,0,0,3,0,33
Benton,8/29/20,0,0,0,0,0,0,0,0,0,5313,0,54264,0,5025,0,50,0,238,0,59577,0,0,0,0,0,0,0,75,58,2,448
Boone,8/29/20,0,0,0,0,0,0,0,0,0,316,0,6033,0,245,0,3,0,68,0,6349,0,0,0,0,0,0,0,7,5,1,97
Bradley,8/29/20,0,0,0,0,0,0,0,0,0,289,0,2916,0,243,0,5,0,41,0,3205,0,0,0,0,0,0,0,5,5,0,27
Calhoun,8/29/20,0,0,0,0,0,0,0,0,0,23,0,1224,0,21,0,0,0,2,0,1247,0,0,0,0,0,0,0,0,2,0,4
Carroll,8/29/20,0,0,0,0,0,0,0,0,0,459,0,5311,0,405,0,7,0,47,0,5770,0,0,0,0,0,0,0,4,7,0,37
Chicot,8/29/20,0,0,0,0,0,0,0,0,0,958,0,4072,0,916,0,10,0,32,0,5030,0,0,0,0,0,0,0,3,2,0,75
Clark,8/29/20,0,0,0,0,0,0,0,0,0,226,0,4459,0,197,0,3,0,26,0,4685,0,0,0,0,0,0,0,2,1,0,29
Clay,8/29/20,0,0,0,0,0,0,0,0,0,175,0,2929,0,145,0,6,0,24,0,3104,0,0,0,0,0,0,0,3,1,0,29
Cleburne,8/29/20,0,0,0,0,0,0,0,0,0,256,0,4262,0,227,0,7,0,22,0,4518,0,0,0,0,0,0,0,1,2,0,55
Cleveland,8/29/20,0,0,0,0,0,0,0,0,0,135,0,1814,0,121,0,3,0,11,0,1949,0,0,0,0,0,0,0,0,2,0,22
Columbia,8/29/20,0,0,0,0,0,0,0,0,0,291,0,3526,0,247,0,14,0,30,0,3817,0,0,0,0,0,0,0,1,2,0,16
Conway,8/29/20,0,0,0,0,0,0,0,0,0,201,0,4592,0,179,0,3,0,19,0,4793,0,0,0,0,0,0,0,1,1,0,44
Craighead,8/29/20,0,0,0,0,0,0,0,0,0,1829,0,23073,0,1558,0,15,0,256,0,24902,0,0,0,0,0,0,0,57,26,0,254
Crawford,8/29/20,0,0,0,0,0,0,0,0,0,910,0,13231,0,768,0,8,0,134,0,14141,0,0,0,0,0,0,0,14,13,2,131
Crittenden,8/29/20,0,0,0,0,0,0,0,0,0,1635,0,11546,0,1530,0,33,0,72,0,13181,0,0,0,0,0,0,0,11,15,3,61
Cross,8/29/20,0,0,0,0,0,0,0,0,0,266,0,3039,0,230,0,5,0,31,0,3305,0,0,0,0,0,0,0,5,4,0,28
Dallas,8/29/20,0,0,0,0,0,0,0,0,0,115,0,1415,0,68,0,2,0,45,0,1530,0,0,0,0,0,0,0,3,0,0,17
Desha,8/29/20,0,0,0,0,0,0,0,0,0,237,0,2892,0,209,0,5,0,23,0,3129,0,0,0,0,0,0,0,3,3,0,23
Drew,8/29/20,0,0,0,0,0,0,0,0,0,302,0,4422,0,272,0,4,0,26,0,4724,0,0,0,0,0,0,0,4,1,0,33
Faulkner,8/29/20,0,0,0,0,0,0,0,0,0,1649,0,26183,0,1463,0,8,0,178,0,27832,0,0,0,0,0,0,0,9,12,0,151
Franklin,8/29/20,0,0,0,0,0,0,0,0,0,160,0,3979,0,143,0,2,0,15,0,4139,0,0,0,0,0,0,0,2,0,0,45
Fulton,8/29/20,0,0,0,0,0,0,0,0,0,67,0,865,0,52,0,0,0,15,0,932,0,0,0,0,0,0,0,1,2,0,30
Garland,8/29/20,0,0,0,0,0,0,0,0,0,1400,0,20782,0,1229,0,29,0,142,0,22182,0,0,0,0,0,0,0,9,16,1,96
Grant,8/29/20,0,0,0,0,0,0,0,0,0,183,0,3399,0,160,0,1,0,22,0,3582,0,0,0,0,0,0,0,3,3,0,23
Greene,8/29/20,0,0,0,0,0,0,0,0,0,625,0,9330,0,558,0,4,0,63,0,9955,0,0,0,0,0,0,0,10,10,0,61
Hempstead,8/29/20,0,0,0,0,0,0,0,0,0,329,0,3406,0,298,0,3,0,28,0,3735,0,0,0,0,0,0,0,1,7,0,20
HotSpring,8/29/20,0,0,0,0,0,0,0,0,0,1713,0,8275,0,1650,0,20,0,43,0,9988,0,0,0,0,0,0,0,6,7,0,107
Howard,8/29/20,0,0,0,0,0,0,0,0,0,421,0,3123,0,379,0,5,0,37,0,3544,0,0,0,0,0,0,0,1,5,0,48
Independence,8/29/20,0,0,0,0,0,0,0,0,0,755,0,7674,0,652,0,5,0,98,0,8429,0,0,0,0,0,0,0,4,8,0,290
Izard,8/29/20,0,0,0,0,0,0,0,0,0,98,0,2681,0,71,0,0,0,27,0,2779,0,0,0,0,0,0,0,5,1,0,46
Jackson,8/29/20,0,0,0,0,0,0,0,0,0,182,0,4560,0,125,0,1,0,56,0,4742,0,0,0,0,0,0,0,1,1,0,16
Jefferson,8/29/20,0,0,0,0,0,0,0,0,0,2082,0,20586,0,1711,0,50,0,321,0,22668,0,0,0,0,0,0,0,23,27,0,373
Johnson,8/29/20,0,0,0,0,0,0,0,0,0,753,0,5519,0,719,0,4,0,30,0,6272,0,0,0,0,0,0,0,0,12,0,34
Lafayette,8/29/20,0,0,0,0,0,0,0,0,0,66,0,785,0,63,0,2,0,1,0,851,0,0,0,0,0,0,0,0,1,0,1
Lawrence,8/29/20,0,0,0,0,0,0,0,0,0,248,0,2627,0,223,0,10,0,15,0,2875,0,0,0,0,0,0,0,3,1,0,116
Lee,8/29/20,0,0,0,0,0,0,0,0,0,1001,0,3256,0,970,0,11,0,20,0,4257,0,0,0,0,0,0,0,1,2,1,19
Lincoln,8/29/20,0,0,0,0,0,0,0,0,0,1570,0,5107,0,1352,0,13,0,205,0,6677,0,0,0,0,0,0,0,41,70,0,74
LittleRiver,8/29/20,0,0,0,0,0,0,0,0,0,276,0,1429,0,247,0,14,0,15,0,1705,0,0,0,0,0,0,0,0,4,0,8
Logan,8/29/20,0,0,0,0,0,0,0,0,0,362,0,5175,0,329,0,1,0,32,0,5537,0,0,0,0,0,0,0,2,0,0,39
Lonoke,8/29/20,0,0,0,0,0,0,0,0,0,705,0,12207,0,603,0,4,0,98,0,12912,0,0,0,0,0,0,0,16,10,0,198
Madison,8/29/20,0,0,0,0,0,0,0,0,0,295,0,3060,0,287,0,2,0,6,0,3355,0,0,0,0,0,0,0,5,6,0,11
Marion,8/29/20,0,0,0,0,0,0,0,0,0,44,0,1613,0,36,0,0,0,8,0,1657,0,0,0,0,0,0,0,0,1,0,6
Miller,8/29/20,0,0,0,0,0,0,0,0,0,599,0,4837,0,554,0,6,0,39,0,5436,0,0,0,0,0,0,0,2,1,0,23
MissingCountyInfo,8/29/20,0,0,0,0,0,0,0,0,0,901,0,20001,0,697,0,0,0,204,0,20902,0,0,0,0,0,0,0,86,76,0,2398
Mississippi,8/29/20,0,0,0,0,0,0,0,0,0,1345,0,9272,0,1196,0,20,0,129,0,10617,0,0,0,0,0,0,0,20,17,0,172
Monroe,8/29/20,0,0,0,0,0,0,0,0,0,92,0,1755,0,82,0,0,0,10,0,1847,0,0,0,0,0,0,0,0,1,0,8
Montgomery,8/29/20,0,0,0,0,0,0,0,0,0,93,0,1239,0,52,0,3,0,38,0,1332,0,0,0,0,0,0,0,17,3,0,92
Nevada,8/29/20,0,0,0,0,0,0,0,0,0,162,0,2173,0,137,0,12,0,13,0,2335,0,0,0,0,0,0,0,0,1,0,22
Newton,8/29/20,0,0,0,0,0,0,0,0,0,117,0,1150,0,93,0,15,0,9,0,1267,0,0,0,0,0,0,0,1,1,0,18
Ouachita,8/29/20,0,0,0,0,0,0,0,0,0,146,0,4034,0,117,0,4,0,25,0,4180,0,0,0,0,0,0,0,4,1,0,41
Perry,8/29/20,0,0,0,0,0,0,0,0,0,62,0,2056,0,57,0,1,0,4,0,2118,0,0,0,0,0,0,0,1,0,0,14
Phillips,8/29/20,0,0,0,0,0,0,0,0,0,397,0,5021,0,357,0,9,0,31,0,5418,0,0,0,0,0,0,0,1,4,0,58
Pike,8/29/20,0,0,0,0,0,0,0,0,0,172,0,1703,0,157,0,1,0,14,0,1875,0,0,0,0,0,0,0,2,4,0,17
Poinsett,8/29/20,0,0,0,0,0,0,0,0,0,478,0,5377,0,362,0,6,0,110,0,5855,0,0,0,0,0,0,0,13,8,0,61
Polk,8/29/20,0,0,0,0,0,0,0,0,0,223,0,3041,0,190,0,3,0,30,0,3264,0,0,0,0,0,0,0,3,3,-1,39
Pope,8/29/20,0,0,0,0,0,0,0,0,0,1716,0,15621,0,1532,0,14,0,170,0,17337,0,0,0,0,0,0,0,17,24,0,147
Prairie,8/29/20,0,0,0,0,0,0,0,0,0,114,0,1519,0,112,0,0,0,2,0,1633,0,0,0,0,0,0,0,0,0,0,5
Pulaski,8/29/20,0,0,0,0,0,0,0,0,0,6991,0,91379,0,6194,0,103,0,694,0,98370,0,0,0,0,0,0,0,63,74,3,941
Randolph,8/29/20,0,0,0,0,0,0,0,0,0,308,0,3566,0,274,0,12,0,22,0,3874,0,0,0,0,0,0,0,5,6,0,34
Saline,8/29/20,0,0,0,0,0,0,0,0,0,1547,0,19406,0,1338,0,12,0,197,0,20953,0,0,0,0,0,0,0,19,18,1,174
Scott,8/29/20,0,0,0,0,0,0,0,0,0,86,0,1409,0,82,0,0,0,4,0,1495,0,0,0,0,0,0,0,0,1,0,17
Searcy,8/29/20,0,0,0,0,0,0,0,0,0,95,0,1436,0,39,0,0,0,56,0,1531,0,0,0,0,0,0,0,1,0,0,4
Sebastian,8/29/20,0,0,0,0,0,0,0,0,0,2842,0,30925,0,2509,0,32,0,301,0,33767,0,0,0,0,0,0,0,25,36,0,270
Sevier,8/29/20,0,0,0,0,0,0,0,0,0,1153,0,5500,0,1100,0,12,0,41,0,6653,0,0,0,0,0,0,0,5,6,0,20
Sharp,8/29/20,0,0,0,0,0,0,0,0,0,146,0,2754,0,125,0,5,0,16,0,2900,0,0,0,0,0,0,0,-3,3,0,57
St.Francis,8/29/20,0,0,0,0,0,0,0,0,0,1343,0,9075,0,1245,0,4,0,94,0,10418,0,0,0,0,0,0,0,18,3,0,83
Stone,8/29/20,0,0,0,0,0,0,0,0,0,191,0,2327,0,130,0,2,0,59,0,2518,0,0,0,0,0,0,0,2,8,0,36
Union,8/29/20,0,0,0,0,0,0,0,0,0,689,0,6889,0,582,0,20,0,87,0,7578,0,0,0,0,0,0,0,6,4,0,163
VanBuren,8/29/20,0,0,0,0,0,0,0,0,0,116,0,2754,0,80,0,2,0,34,0,2870,0,0,0,0,0,0,0,4,6,0,28
Washington,8/29/20,0,0,0,0,0,0,0,0,0,6850,0,50862,0,6576,0,58,0,216,0,57712,0,0,0,0,0,0,0,135,121,2,451
White,8/29/20,0,0,0,0,0,0,0,0,0,520,0,9686,0,423,0,11,0,86,0,10206,0,0,0,0,0,0,0,-1,4,1,97
Woodruff,8/29/20,0,0,0,0,0,0,0,0,0,27,0,1289,0,26,0,0,0,1,0,1316,0,0,0,0,0,0,0,0,0,0,2
Yell,8/29/20,0,0,0,0,0,0,0,0,0,1140,0,7438,0,1079,0,23,0,38,0,8578,0,0,0,0,0,0,0,4,3,0,66
Arkansas_all_counties,8/28/20,0,0,0,0,0,0,0,0,2990671,59583,0,638472,0,53665,0,756,0,5162,0,698055,0,0,0,0,0,0,0,838,1000,17,8027
Arkansas_county,8/28/20,0,0,0,0,0,0,0,0,0,275,0,3918,0,246,0,3,0,26,0,4193,0,0,0,0,0,0,0,2,2,1,34
Ashley,8/28/20,0,0,0,0,0,0,0,0,0,387,0,3933,0,357,0,7,0,23,0,4320,0,0,0,0,0,0,0,1,2,0,15
Baxter,8/28/20,0,0,0,0,0,0,0,0,0,132,0,2494,0,98,0,0,0,34,0,2626,0,0,0,0,0,0,0,3,5,0,88
Benton,8/28/20,0,0,0,0,0,0,0,0,0,5238,0,53891,0,4967,0,48,0,223,0,59129,0,0,0,0,0,0,0,53,34,1,462
Boone,8/28/20,0,0,0,0,0,0,0,0,0,309,0,5943,0,240,0,2,0,67,0,6252,0,0,0,0,0,0,0,8,4,1,57
Bradley,8/28/20,0,0,0,0,0,0,0,0,0,284,0,2894,0,238,0,5,0,41,0,3178,0,0,0,0,0,0,0,9,12,0,15
Calhoun,8/28/20,0,0,0,0,0,0,0,0,0,23,0,1220,0,19,0,0,0,4,0,1243,0,0,0,0,0,0,0,0,1,0,2
Carroll,8/28/20,0,0,0,0,0,0,0,0,0,455,0,5278,0,398,0,7,0,50,0,5733,0,0,0,0,0,0,0,7,4,0,41
Chicot,8/28/20,0,0,0,0,0,0,0,0,0,955,0,4000,0,914,0,10,0,31,0,4955,0,0,0,0,0,0,0,7,30,0,15
Clark,8/28/20,0,0,0,0,0,0,0,0,0,224,0,4432,0,196,0,3,0,25,0,4656,0,0,0,0,0,0,0,2,3,0,30
Clay,8/28/20,0,0,0,0,0,0,0,0,0,172,0,2903,0,144,0,6,0,22,0,3075,0,0,0,0,0,0,0,2,0,1,28
Cleburne,8/28/20,0,0,0,0,0,0,0,0,0,255,0,4208,0,225,0,7,0,23,0,4463,0,0,0,0,0,0,0,2,0,1,43
Cleveland,8/28/20,0,0,0,0,0,0,0,0,0,135,0,1792,0,119,0,3,0,13,0,1927,0,0,0,0,0,0,0,1,3,0,7
Columbia,8/28/20,0,0,0,0,0,0,0,0,0,290,0,3511,0,245,0,14,0,31,0,3801,0,0,0,0,0,0,0,2,1,0,80
Conway,8/28/20,0,0,0,0,0,0,0,0,0,200,0,4549,0,178,0,3,0,19,0,4749,0,0,0,0,0,0,0,4,2,0,22
Craighead,8/28/20,0,0,0,0,0,0,0,0,0,1772,0,22876,0,1532,0,15,0,225,0,24648,0,0,0,0,0,0,0,26,28,1,465
Crawford,8/28/20,0,0,0,0,0,0,0,0,0,896,0,13114,0,755,0,6,0,135,0,14010,0,0,0,0,0,0,0,13,20,0,146
Crittenden,8/28/20,0,0,0,0,0,0,0,0,0,1624,0,11496,0,1515,0,30,0,79,0,13120,0,0,0,0,0,0,0,5,19,0,186
Cross,8/28/20,0,0,0,0,0,0,0,0,0,261,0,3016,0,226,0,5,0,30,0,3277,0,0,0,0,0,0,0,3,3,0,33
Dallas,8/28/20,0,0,0,0,0,0,0,0,0,112,0,1401,0,68,0,2,0,42,0,1513,0,0,0,0,0,0,0,3,1,0,8
Desha,8/28/20,0,0,0,0,0,0,0,0,0,234,0,2872,0,206,0,5,0,23,0,3106,0,0,0,0,0,0,0,2,3,0,13
Drew,8/28/20,0,0,0,0,0,0,0,0,0,298,0,4393,0,271,0,4,0,23,0,4691,0,0,0,0,0,0,0,0,2,0,33
Faulkner,8/28/20,0,0,0,0,0,0,0,0,0,1640,0,26041,0,1451,0,8,0,181,0,27681,0,0,0,0,0,0,0,30,6,0,245
Franklin,8/28/20,0,0,0,0,0,0,0,0,0,158,0,3936,0,143,0,2,0,13,0,4094,0,0,0,0,0,0,0,2,2,0,31
Fulton,8/28/20,0,0,0,0,0,0,0,0,0,66,0,836,0,50,0,0,0,16,0,902,0,0,0,0,0,0,0,1,1,0,21
Garland,8/28/20,0,0,0,0,0,0,0,0,0,1391,0,20695,0,1213,0,28,0,150,0,22086,0,0,0,0,0,0,0,23,20,0,226
Grant,8/28/20,0,0,0,0,0,0,0,0,0,180,0,3379,0,157,0,1,0,22,0,3559,0,0,0,0,0,0,0,3,5,0,22
Greene,8/28/20,0,0,0,0,0,0,0,0,0,615,0,9279,0,548,0,4,0,63,0,9894,0,0,0,0,0,0,0,12,5,0,78
Hempstead,8/28/20,0,0,0,0,0,0,0,0,0,328,0,3387,0,291,0,3,0,34,0,3715,0,0,0,0,0,0,0,5,10,0,22
HotSpring,8/28/20,0,0,0,0,0,0,0,0,0,1707,0,8174,0,1643,0,20,0,44,0,9881,0,0,0,0,0,0,0,14,19,0,53
Howard,8/28/20,0,0,0,0,0,0,0,0,0,420,0,3076,0,374,0,5,0,41,0,3496,0,0,0,0,0,0,0,13,5,0,35
Independence,8/28/20,0,0,0,0,0,0,0,0,0,751,0,7388,0,644,0,5,0,102,0,8139,0,0,0,0,0,0,0,20,11,1,59
Izard,8/28/20,0,0,0,0,0,0,0,0,0,93,0,2640,0,70,0,0,0,23,0,2733,0,0,0,0,0,0,0,5,3,0,31
Jackson,8/28/20,0,0,0,0,0,0,0,0,0,181,0,4545,0,124,0,1,0,56,0,4726,0,0,0,0,0,0,0,1,-1,0,155
Jefferson,8/28/20,0,0,0,0,0,0,0,0,0,2059,0,20236,0,1684,0,50,0,325,0,22295,0,0,0,0,0,0,0,57,14,3,240
Johnson,8/28/20,0,0,0,0,0,0,0,0,0,753,0,5485,0,707,0,4,0,42,0,6238,0,0,0,0,0,0,0,4,6,0,61
Lafayette,8/28/20,0,0,0,0,0,0,0,0,0,66,0,784,0,62,0,2,0,2,0,850,0,0,0,0,0,0,0,0,1,0,12
Lawrence,8/28/20,0,0,0,0,0,0,0,0,0,245,0,2514,0,222,0,10,0,13,0,2759,0,0,0,0,0,0,0,0,2,0,66
Lee,8/28/20,0,0,0,0,0,0,0,0,0,1000,0,3238,0,968,0,10,0,22,0,4238,0,0,0,0,0,0,0,1,1,0,13
Lincoln,8/28/20,0,0,0,0,0,0,0,0,0,1529,0,5074,0,1282,0,13,0,234,0,6603,0,0,0,0,0,0,0,123,44,0,184
LittleRiver,8/28/20,0,0,0,0,0,0,0,0,0,276,0,1421,0,243,0,14,0,19,0,1697,0,0,0,0,0,0,0,2,12,0,9
Logan,8/28/20,0,0,0,0,0,0,0,0,0,360,0,5138,0,329,0,1,0,30,0,5498,0,0,0,0,0,0,0,1,0,0,28
Lonoke,8/28/20,0,0,0,0,0,0,0,0,0,689,0,12025,0,593,0,4,0,92,0,12714,0,0,0,0,0,0,0,10,7,1,108
Madison,8/28/20,0,0,0,0,0,0,0,0,0,290,0,3054,0,281,0,2,0,7,0,3344,0,0,0,0,0,0,0,3,0,0,20
Marion,8/28/20,0,0,0,0,0,0,0,0,0,44,0,1607,0,35,0,0,0,9,0,1651,0,0,0,0,0,0,0,1,0,0,28
Miller,8/28/20,0,0,0,0,0,0,0,0,0,597,0,4816,0,553,0,6,0,38,0,5413,0,0,0,0,0,0,0,6,10,0,82
MissingCountyInfo,8/28/20,0,0,0,0,0,0,0,0,0,815,0,17689,0,621,0,0,0,194,0,18504,0,0,0,0,0,0,0,9,15,0,1431
Mississippi,8/28/20,0,0,0,0,0,0,0,0,0,1325,0,9120,0,1179,0,20,0,126,0,10445,0,0,0,0,0,0,0,21,18,0,99
Monroe,8/28/20,0,0,0,0,0,0,0,0,0,92,0,1747,0,81,0,0,0,11,0,1839,0,0,0,0,0,0,0,1,3,0,28
Montgomery,8/28/20,0,0,0,0,0,0,0,0,0,76,0,1164,0,49,0,3,0,24,0,1240,0,0,0,0,0,0,0,6,0,0,11
Nevada,8/28/20,0,0,0,0,0,0,0,0,0,162,0,2151,0,136,0,12,0,14,0,2313,0,0,0,0,0,0,0,1,-1,1,8
Newton,8/28/20,0,0,0,0,0,0,0,0,0,116,0,1133,0,92,0,15,0,9,0,1249,0,0,0,0,0,0,0,4,0,0,8
Ouachita,8/28/20,0,0,0,0,0,0,0,0,0,142,0,3997,0,116,0,4,0,22,0,4139,0,0,0,0,0,0,0,1,2,0,10
Perry,8/28/20,0,0,0,0,0,0,0,0,0,61,0,2043,0,57,0,1,0,3,0,2104,0,0,0,0,0,0,0,0,0,1,11
Phillips,8/28/20,0,0,0,0,0,0,0,0,0,396,0,4964,0,353,0,9,0,34,0,5360,0,0,0,0,0,0,0,3,9,0,35
Pike,8/28/20,0,0,0,0,0,0,0,0,0,170,0,1688,0,153,0,1,0,16,0,1858,0,0,0,0,0,0,0,3,4,0,6
Poinsett,8/28/20,0,0,0,0,0,0,0,0,0,465,0,5329,0,354,0,6,0,105,0,5794,0,0,0,0,0,0,0,12,5,1,66
Polk,8/28/20,0,0,0,0,0,0,0,0,0,220,0,3005,0,187,0,4,0,29,0,3225,0,0,0,0,0,0,0,2,5,0,17
Pope,8/28/20,0,0,0,0,0,0,0,0,0,1699,0,15491,0,1508,0,14,0,177,0,17190,0,0,0,0,0,0,0,41,25,0,156
Prairie,8/28/20,0,0,0,0,0,0,0,0,0,114,0,1514,0,112,0,0,0,2,0,1628,0,0,0,0,0,0,0,0,0,0,10
Pulaski,8/28/20,0,0,0,0,0,0,0,0,0,6928,0,90501,0,6120,0,100,0,708,0,97429,0,0,0,0,0,0,0,73,53,1,1128
Randolph,8/28/20,0,0,0,0,0,0,0,0,0,303,0,3537,0,268,0,12,0,23,0,3840,0,0,0,0,0,0,0,7,12,0,26
Saline,8/28/20,0,0,0,0,0,0,0,0,0,1528,0,19251,0,1320,0,11,0,197,0,20779,0,0,0,0,0,0,0,19,50,0,370
Scott,8/28/20,0,0,0,0,0,0,0,0,0,86,0,1392,0,81,0,0,0,5,0,1478,0,0,0,0,0,0,0,2,2,0,5
Searcy,8/28/20,0,0,0,0,0,0,0,0,0,94,0,1433,0,39,0,0,0,55,0,1527,0,0,0,0,0,0,0,7,3,0,17
Sebastian,8/28/20,0,0,0,0,0,0,0,0,0,2817,0,30680,0,2473,0,32,0,312,0,33497,0,0,0,0,0,0,0,27,34,0,286
Sevier,8/28/20,0,0,0,0,0,0,0,0,0,1148,0,5485,0,1094,0,12,0,42,0,6633,0,0,0,0,0,0,0,2,6,0,21
Sharp,8/28/20,0,0,0,0,0,0,0,0,0,149,0,2694,0,122,0,5,0,22,0,2843,0,0,0,0,0,0,0,2,0,0,13
St.Francis,8/28/20,0,0,0,0,0,0,0,0,0,1325,0,9010,0,1242,0,4,0,79,0,10335,0,0,0,0,0,0,0,26,1,1,88
Stone,8/28/20,0,0,0,0,0,0,0,0,0,189,0,2293,0,122,0,2,0,65,0,2482,0,0,0,0,0,0,0,6,8,0,83
Union,8/28/20,0,0,0,0,0,0,0,0,0,683,0,6732,0,578,0,20,0,85,0,7415,0,0,0,0,0,0,0,13,5,0,17
VanBuren,8/28/20,0,0,0,0,0,0,0,0,0,112,0,2730,0,74,0,2,0,36,0,2842,0,0,0,0,0,0,0,3,1,0,20
Washington,8/28/20,0,0,0,0,0,0,0,0,0,6715,0,50546,0,6455,0,56,0,204,0,57261,0,0,0,0,0,0,0,42,26,1,308
White,8/28/20,0,0,0,0,0,0,0,0,0,521,0,9588,0,419,0,10,0,92,0,10109,0,0,0,0,0,0,0,10,8,0,52
Woodruff,8/28/20,0,0,0,0,0,0,0,0,0,27,0,1287,0,26,0,0,0,1,0,1314,0,0,0,0,0,0,0,0,3,0,3
Yell,8/28/20,0,0,0,0,0,0,0,0,0,1136,0,7376,0,1076,0,23,0,37,0,8512,0,0,0,0,0,0,0,3,7,0,42
Arkansas_all_counties,8/27/20,0,0,0,0,0,0,0,0,2990671,58745,0,631283,0,52665,0,739,0,5341,0,690028,0,0,0,0,0,0,0,722,764,7,6755
Arkansas_county,8/27/20,0,0,0,0,0,0,0,0,0,273,0,3886,0,244,0,2,0,27,0,4159,0,0,0,0,0,0,0,3,0,0,23
Ashley,8/27/20,0,0,0,0,0,0,0,0,0,386,0,3919,0,355,0,7,0,24,0,4305,0,0,0,0,0,0,0,3,0,0,30
Baxter,8/27/20,0,0,0,0,0,0,0,0,0,129,0,2409,0,93,0,0,0,36,0,2538,0,0,0,0,0,0,0,8,6,0,63
Benton,8/27/20,0,0,0,0,0,0,0,0,0,5185,0,53482,0,4933,0,47,0,205,0,58667,0,0,0,0,0,0,0,38,31,0,483
Boone,8/27/20,0,0,0,0,0,0,0,0,0,301,0,5894,0,236,0,1,0,64,0,6195,0,0,0,0,0,0,0,9,2,0,59
Bradley,8/27/20,0,0,0,0,0,0,0,0,0,275,0,2888,0,226,0,5,0,44,0,3163,0,0,0,0,0,0,0,4,4,0,37
Calhoun,8/27/20,0,0,0,0,0,0,0,0,0,23,0,1218,0,18,0,0,0,5,0,1241,0,0,0,0,0,0,0,0,0,0,9
Carroll,8/27/20,0,0,0,0,0,0,0,0,0,448,0,5244,0,394,0,7,0,47,0,5692,0,0,0,0,0,0,0,6,3,0,28
Chicot,8/27/20,0,0,0,0,0,0,0,0,0,948,0,3992,0,884,0,10,0,54,0,4940,0,0,0,0,0,0,0,5,142,0,11
Clark,8/27/20,0,0,0,0,0,0,0,0,0,222,0,4404,0,193,0,3,0,26,0,4626,0,0,0,0,0,0,0,4,2,0,41
Clay,8/27/20,0,0,0,0,0,0,0,0,0,170,0,2877,0,144,0,5,0,21,0,3047,0,0,0,0,0,0,0,3,3,0,21
Cleburne,8/27/20,0,0,0,0,0,0,0,0,0,253,0,4167,0,225,0,6,0,22,0,4420,0,0,0,0,0,0,0,4,3,0,57
Cleveland,8/27/20,0,0,0,0,0,0,0,0,0,134,0,1786,0,116,0,3,0,15,0,1920,0,0,0,0,0,0,0,2,2,1,13
Columbia,8/27/20,0,0,0,0,0,0,0,0,0,288,0,3433,0,244,0,14,0,30,0,3721,0,0,0,0,0,0,0,2,2,0,16
Conway,8/27/20,0,0,0,0,0,0,0,0,0,196,0,4531,0,176,0,3,0,17,0,4727,0,0,0,0,0,0,0,1,1,0,42
Craighead,8/27/20,0,0,0,0,0,0,0,0,0,1746,0,22437,0,1504,0,14,0,228,0,24183,0,0,0,0,0,0,0,18,21,0,198
Crawford,8/27/20,0,0,0,0,0,0,0,0,0,883,0,12981,0,735,0,6,0,142,0,13864,0,0,0,0,0,0,0,18,14,0,93
Crittenden,8/27/20,0,0,0,0,0,0,0,0,0,1619,0,11315,0,1496,0,30,0,93,0,12934,0,0,0,0,0,0,0,17,8,1,65
Cross,8/27/20,0,0,0,0,0,0,0,0,0,258,0,2986,0,223,0,5,0,30,0,3244,0,0,0,0,0,0,0,10,5,0,38
Dallas,8/27/20,0,0,0,0,0,0,0,0,0,109,0,1396,0,67,0,2,0,40,0,1505,0,0,0,0,0,0,0,5,1,0,38
Desha,8/27/20,0,0,0,0,0,0,0,0,0,232,0,2861,0,203,0,5,0,24,0,3093,0,0,0,0,0,0,0,7,1,0,40
Drew,8/27/20,0,0,0,0,0,0,0,0,0,298,0,4360,0,269,0,4,0,25,0,4658,0,0,0,0,0,0,0,3,16,0,28
Faulkner,8/27/20,0,0,0,0,0,0,0,0,0,1610,0,25826,0,1445,0,8,0,157,0,27436,0,0,0,0,0,0,0,17,16,0,354
Franklin,8/27/20,0,0,0,0,0,0,0,0,0,156,0,3907,0,141,0,2,0,13,0,4063,0,0,0,0,0,0,0,0,2,0,19
Fulton,8/27/20,0,0,0,0,0,0,0,0,0,65,0,816,0,49,0,0,0,16,0,881,0,0,0,0,0,0,0,3,4,0,23
Garland,8/27/20,0,0,0,0,0,0,0,0,0,1368,0,20492,0,1193,0,28,0,147,0,21860,0,0,0,0,0,0,0,20,20,0,192
Grant,8/27/20,0,0,0,0,0,0,0,0,0,177,0,3360,0,152,0,1,0,24,0,3537,0,0,0,0,0,0,0,3,0,0,22
Greene,8/27/20,0,0,0,0,0,0,0,0,0,603,0,9213,0,543,0,4,0,56,0,9816,0,0,0,0,0,0,0,5,8,0,66
Hempstead,8/27/20,0,0,0,0,0,0,0,0,0,323,0,3370,0,281,0,3,0,39,0,3693,0,0,0,0,0,0,0,5,1,0,24
HotSpring,8/27/20,0,0,0,0,0,0,0,0,0,1693,0,8135,0,1624,0,20,0,49,0,9828,0,0,0,0,0,0,0,6,23,1,78
Howard,8/27/20,0,0,0,0,0,0,0,0,0,407,0,3054,0,369,0,5,0,33,0,3461,0,0,0,0,0,0,0,9,2,0,24
Independence,8/27/20,0,0,0,0,0,0,0,0,0,731,0,7349,0,633,0,4,0,94,0,8080,0,0,0,0,0,0,0,8,8,0,223
Izard,8/27/20,0,0,0,0,0,0,0,0,0,88,0,2614,0,67,0,0,0,21,0,2702,0,0,0,0,0,0,0,5,2,0,35
Jackson,8/27/20,0,0,0,0,0,0,0,0,0,180,0,4391,0,125,0,1,0,54,0,4571,0,0,0,0,0,0,0,5,0,0,17
Jefferson,8/27/20,0,0,0,0,0,0,0,0,0,2002,0,20053,0,1670,0,47,0,285,0,22055,0,0,0,0,0,0,0,32,31,0,365
Johnson,8/27/20,0,0,0,0,0,0,0,0,0,749,0,5428,0,701,0,4,0,44,0,6177,0,0,0,0,0,0,0,4,6,0,27
Lafayette,8/27/20,0,0,0,0,0,0,0,0,0,66,0,772,0,61,0,2,0,3,0,838,0,0,0,0,0,0,0,0,0,0,1
Lawrence,8/27/20,0,0,0,0,0,0,0,0,0,245,0,2448,0,220,0,10,0,15,0,2693,0,0,0,0,0,0,0,1,0,0,25
Lee,8/27/20,0,0,0,0,0,0,0,0,0,999,0,3226,0,967,0,10,0,22,0,4225,0,0,0,0,0,0,0,3,2,0,20
Lincoln,8/27/20,0,0,0,0,0,0,0,0,0,1406,0,5013,0,1238,0,13,0,155,0,6419,0,0,0,0,0,0,0,8,2,0,83
LittleRiver,8/27/20,0,0,0,0,0,0,0,0,0,274,0,1414,0,231,0,14,0,29,0,1688,0,0,0,0,0,0,0,3,9,0,8
Logan,8/27/20,0,0,0,0,0,0,0,0,0,359,0,5111,0,329,0,1,0,29,0,5470,0,0,0,0,0,0,0,4,6,0,26
Lonoke,8/27/20,0,0,0,0,0,0,0,0,0,679,0,11927,0,586,0,3,0,90,0,12606,0,0,0,0,0,0,0,5,11,0,95
Madison,8/27/20,0,0,0,0,0,0,0,0,0,287,0,3037,0,281,0,2,0,4,0,3324,0,0,0,0,0,0,0,0,0,0,9
Marion,8/27/20,0,0,0,0,0,0,0,0,0,43,0,1580,0,35,0,0,0,8,0,1623,0,0,0,0,0,0,0,0,2,0,22
Miller,8/27/20,0,0,0,0,0,0,0,0,0,591,0,4740,0,543,0,6,0,42,0,5331,0,0,0,0,0,0,0,7,6,1,27
MissingCountyInfo,8/27/20,0,0,0,0,0,0,0,0,0,806,0,16267,0,606,0,0,0,200,0,17073,0,0,0,0,0,0,0,12,-6,0,63
Mississippi,8/27/20,0,0,0,0,0,0,0,0,0,1304,0,9042,0,1161,0,20,0,123,0,10346,0,0,0,0,0,0,0,12,18,0,69
Monroe,8/27/20,0,0,0,0,0,0,0,0,0,91,0,1720,0,78,0,0,0,13,0,1811,0,0,0,0,0,0,0,0,4,0,12
Montgomery,8/27/20,0,0,0,0,0,0,0,0,0,70,0,1159,0,49,0,3,0,18,0,1229,0,0,0,0,0,0,0,5,6,0,10
Nevada,8/27/20,0,0,0,0,0,0,0,0,0,161,0,2144,0,137,0,11,0,13,0,2305,0,0,0,0,0,0,0,3,0,0,16
Newton,8/27/20,0,0,0,0,0,0,0,0,0,112,0,1129,0,92,0,15,0,5,0,1241,0,0,0,0,0,0,0,2,0,0,10
Ouachita,8/27/20,0,0,0,0,0,0,0,0,0,141,0,3988,0,114,0,4,0,23,0,4129,0,0,0,0,0,0,0,6,1,0,26
Perry,8/27/20,0,0,0,0,0,0,0,0,0,61,0,2032,0,57,0,0,0,4,0,2093,0,0,0,0,0,0,0,2,1,0,27
Phillips,8/27/20,0,0,0,0,0,0,0,0,0,393,0,4932,0,344,0,9,0,40,0,5325,0,0,0,0,0,0,0,8,6,0,32
Pike,8/27/20,0,0,0,0,0,0,0,0,0,167,0,1685,0,149,0,1,0,17,0,1852,0,0,0,0,0,0,0,4,4,0,13
Poinsett,8/27/20,0,0,0,0,0,0,0,0,0,453,0,5275,0,349,0,5,0,99,0,5728,0,0,0,0,0,0,0,1,7,1,46
Polk,8/27/20,0,0,0,0,0,0,0,0,0,218,0,2990,0,182,0,4,0,32,0,3208,0,0,0,0,0,0,0,6,4,1,28
Pope,8/27/20,0,0,0,0,0,0,0,0,0,1658,0,15376,0,1483,0,14,0,161,0,17034,0,0,0,0,0,0,0,38,31,0,145
Prairie,8/27/20,0,0,0,0,0,0,0,0,0,114,0,1504,0,112,0,0,0,2,0,1618,0,0,0,0,0,0,0,0,2,0,19
Pulaski,8/27/20,0,0,0,0,0,0,0,0,0,6855,0,89446,0,6067,0,99,0,689,0,96301,0,0,0,0,0,0,0,94,72,0,1213
Randolph,8/27/20,0,0,0,0,0,0,0,0,0,296,0,3518,0,256,0,12,0,28,0,3814,0,0,0,0,0,0,0,4,6,0,17
Saline,8/27/20,0,0,0,0,0,0,0,0,0,1509,0,18900,0,1270,0,11,0,228,0,20409,0,0,0,0,0,0,0,34,37,0,435
Scott,8/27/20,0,0,0,0,0,0,0,0,0,84,0,1389,0,79,0,0,0,5,0,1473,0,0,0,0,0,0,0,0,0,0,4
Searcy,8/27/20,0,0,0,0,0,0,0,0,0,87,0,1423,0,36,0,0,0,51,0,1510,0,0,0,0,0,0,0,14,2,0,16
Sebastian,8/27/20,0,0,0,0,0,0,0,0,0,2790,0,30421,0,2439,0,32,0,319,0,33211,0,0,0,0,0,0,0,37,43,0,317
Sevier,8/27/20,0,0,0,0,0,0,0,0,0,1146,0,5466,0,1088,0,12,0,46,0,6612,0,0,0,0,0,0,0,4,7,0,33
Sharp,8/27/20,0,0,0,0,0,0,0,0,0,147,0,2683,0,122,0,5,0,20,0,2830,0,0,0,0,0,0,0,2,3,0,25
St.Francis,8/27/20,0,0,0,0,0,0,0,0,0,1299,0,8948,0,1241,0,3,0,55,0,10247,0,0,0,0,0,0,0,17,6,0,330
Stone,8/27/20,0,0,0,0,0,0,0,0,0,183,0,2216,0,114,0,2,0,67,0,2399,0,0,0,0,0,0,0,14,11,1,49
Union,8/27/20,0,0,0,0,0,0,0,0,0,670,0,6728,0,573,0,20,0,77,0,7398,0,0,0,0,0,0,0,17,9,0,35
VanBuren,8/27/20,0,0,0,0,0,0,0,0,0,109,0,2713,0,73,0,2,0,34,0,2822,0,0,0,0,0,0,0,3,6,0,26
Washington,8/27/20,0,0,0,0,0,0,0,0,0,6673,0,50280,0,6429,0,55,0,189,0,56953,0,0,0,0,0,0,0,14,17,0,312
White,8/27/20,0,0,0,0,0,0,0,0,0,511,0,9546,0,411,0,10,0,90,0,10057,0,0,0,0,0,0,0,31,37,0,118
Woodruff,8/27/20,0,0,0,0,0,0,0,0,0,27,0,1284,0,23,0,0,0,4,0,1311,0,0,0,0,0,0,0,0,1,0,16
Yell,8/27/20,0,0,0,0,0,0,0,0,0,1133,0,7337,0,1069,0,23,0,41,0,8470,0,0,0,0,0,0,0,15,1,0,75
Arkansas_all_counties,8/26/20,0,0,0,0,0,0,0,0,2990671,58023,0,625250,0,51901,0,732,0,5390,0,683273,0,0,0,0,0,0,0,649,550,21,4716
Arkansas_county,8/26/20,0,0,0,0,0,0,0,0,0,270,0,3866,0,244,0,2,0,24,0,4136,0,0,0,0,0,0,0,4,4,0,33
Ashley,8/26/20,0,0,0,0,0,0,0,0,0,383,0,3892,0,355,0,7,0,21,0,4275,0,0,0,0,0,0,0,3,5,0,26
Baxter,8/26/20,0,0,0,0,0,0,0,0,0,121,0,2354,0,87,0,0,0,34,0,2475,0,0,0,0,0,0,0,5,3,0,16
Benton,8/26/20,0,0,0,0,0,0,0,0,0,5147,0,53037,0,4902,0,47,0,198,0,58184,0,0,0,0,0,0,0,34,21,2,340
Boone,8/26/20,0,0,0,0,0,0,0,0,0,292,0,5844,0,234,0,1,0,57,0,6136,0,0,0,0,0,0,0,18,8,0,67
Bradley,8/26/20,0,0,0,0,0,0,0,0,0,271,0,2855,0,222,0,5,0,44,0,3126,0,0,0,0,0,0,0,4,7,0,21
Calhoun,8/26/20,0,0,0,0,0,0,0,0,0,23,0,1209,0,18,0,0,0,5,0,1232,0,0,0,0,0,0,0,0,1,0,4
Carroll,8/26/20,0,0,0,0,0,0,0,0,0,442,0,5222,0,391,0,7,0,44,0,5664,0,0,0,0,0,0,0,5,7,0,23
Chicot,8/26/20,0,0,0,0,0,0,0,0,0,943,0,3986,0,742,0,10,0,191,0,4929,0,0,0,0,0,0,0,4,3,0,14
Clark,8/26/20,0,0,0,0,0,0,0,0,0,218,0,4367,0,191,0,3,0,24,0,4585,0,0,0,0,0,0,0,3,2,0,27
Clay,8/26/20,0,0,0,0,0,0,0,0,0,167,0,2859,0,141,0,5,0,21,0,3026,0,0,0,0,0,0,0,2,3,0,14
Cleburne,8/26/20,0,0,0,0,0,0,0,0,0,249,0,4114,0,222,0,6,0,21,0,4363,0,0,0,0,0,0,0,2,1,0,60
Cleveland,8/26/20,0,0,0,0,0,0,0,0,0,132,0,1775,0,114,0,2,0,16,0,1907,0,0,0,0,0,0,0,2,1,0,15
Columbia,8/26/20,0,0,0,0,0,0,0,0,0,286,0,3419,0,242,0,14,0,30,0,3705,0,0,0,0,0,0,0,2,5,1,18
Conway,8/26/20,0,0,0,0,0,0,0,0,0,195,0,4490,0,175,0,3,0,17,0,4685,0,0,0,0,0,0,0,2,2,0,7
Craighead,8/26/20,0,0,0,0,0,0,0,0,0,1728,0,22257,0,1483,0,14,0,231,0,23985,0,0,0,0,0,0,0,27,13,0,216
Crawford,8/26/20,0,0,0,0,0,0,0,0,0,865,0,12906,0,721,0,6,0,138,0,13771,0,0,0,0,0,0,0,14,9,0,106
Crittenden,8/26/20,0,0,0,0,0,0,0,0,0,1602,0,11267,0,1488,0,29,0,85,0,12869,0,0,0,0,0,0,0,7,18,1,87
Cross,8/26/20,0,0,0,0,0,0,0,0,0,248,0,2958,0,218,0,5,0,25,0,3206,0,0,0,0,0,0,0,4,1,1,17
Dallas,8/26/20,0,0,0,0,0,0,0,0,0,104,0,1363,0,66,0,2,0,36,0,1467,0,0,0,0,0,0,0,1,2,0,74
Desha,8/26/20,0,0,0,0,0,0,0,0,0,225,0,2828,0,202,0,5,0,18,0,3053,0,0,0,0,0,0,0,1,1,0,-5
Drew,8/26/20,0,0,0,0,0,0,0,0,0,295,0,4335,0,253,0,4,0,38,0,4630,0,0,0,0,0,0,0,1,3,0,32
Faulkner,8/26/20,0,0,0,0,0,0,0,0,0,1593,0,25489,0,1429,0,8,0,156,0,27082,0,0,0,0,0,0,0,14,19,1,72
Franklin,8/26/20,0,0,0,0,0,0,0,0,0,156,0,3888,0,139,0,2,0,15,0,4044,0,0,0,0,0,0,0,3,1,0,34
Fulton,8/26/20,0,0,0,0,0,0,0,0,0,62,0,796,0,45,0,0,0,17,0,858,0,0,0,0,0,0,0,1,2,0,10
Garland,8/26/20,0,0,0,0,0,0,0,0,0,1348,0,20320,0,1173,0,28,0,147,0,21668,0,0,0,0,0,0,0,28,22,1,132
Grant,8/26/20,0,0,0,0,0,0,0,0,0,174,0,3341,0,152,0,1,0,21,0,3515,0,0,0,0,0,0,0,5,0,1,33
Greene,8/26/20,0,0,0,0,0,0,0,0,0,598,0,9152,0,535,0,4,0,59,0,9750,0,0,0,0,0,0,0,11,13,0,90
Hempstead,8/26/20,0,0,0,0,0,0,0,0,0,318,0,3351,0,280,0,3,0,35,0,3669,0,0,0,0,0,0,0,6,5,0,19
HotSpring,8/26/20,0,0,0,0,0,0,0,0,0,1687,0,8063,0,1601,0,19,0,67,0,9750,0,0,0,0,0,0,0,3,2,1,36
Howard,8/26/20,0,0,0,0,0,0,0,0,0,398,0,3039,0,367,0,5,0,26,0,3437,0,0,0,0,0,0,0,0,2,0,3
Independence,8/26/20,0,0,0,0,0,0,0,0,0,723,0,7134,0,625,0,4,0,94,0,7857,0,0,0,0,0,0,0,18,11,0,58
Izard,8/26/20,0,0,0,0,0,0,0,0,0,83,0,2584,0,65,0,0,0,18,0,2667,0,0,0,0,0,0,0,3,1,0,13
Jackson,8/26/20,0,0,0,0,0,0,0,0,0,175,0,4379,0,125,0,1,0,49,0,4554,0,0,0,0,0,0,0,0,2,0,13
Jefferson,8/26/20,0,0,0,0,0,0,0,0,0,1970,0,19720,0,1639,0,47,0,284,0,21690,0,0,0,0,0,0,0,46,24,0,154
Johnson,8/26/20,0,0,0,0,0,0,0,0,0,745,0,5405,0,695,0,4,0,46,0,6150,0,0,0,0,0,0,0,3,0,1,50
Lafayette,8/26/20,0,0,0,0,0,0,0,0,0,66,0,771,0,61,0,2,0,3,0,837,0,0,0,0,0,0,0,1,2,0,2
Lawrence,8/26/20,0,0,0,0,0,0,0,0,0,244,0,2424,0,220,0,10,0,14,0,2668,0,0,0,0,0,0,0,-1,2,0,20
Lee,8/26/20,0,0,0,0,0,0,0,0,0,996,0,3209,0,965,0,10,0,21,0,4205,0,0,0,0,0,0,0,3,1,0,11
Lincoln,8/26/20,0,0,0,0,0,0,0,0,0,1398,0,4938,0,1236,0,13,0,149,0,6336,0,0,0,0,0,0,0,14,9,0,32
LittleRiver,8/26/20,0,0,0,0,0,0,0,0,0,271,0,1409,0,222,0,14,0,35,0,1680,0,0,0,0,0,0,0,6,7,1,11
Logan,8/26/20,0,0,0,0,0,0,0,0,0,355,0,5089,0,323,0,1,0,31,0,5444,0,0,0,0,0,0,0,4,27,0,36
Lonoke,8/26/20,0,0,0,0,0,0,0,0,0,674,0,11837,0,575,0,3,0,96,0,12511,0,0,0,0,0,0,0,13,16,1,95
Madison,8/26/20,0,0,0,0,0,0,0,0,0,287,0,3028,0,281,0,2,0,4,0,3315,0,0,0,0,0,0,0,0,2,0,4
Marion,8/26/20,0,0,0,0,0,0,0,0,0,43,0,1558,0,33,0,0,0,10,0,1601,0,0,0,0,0,0,0,2,0,0,5
Miller,8/26/20,0,0,0,0,0,0,0,0,0,584,0,4720,0,537,0,5,0,42,0,5304,0,0,0,0,0,0,0,6,5,0,33
MissingCountyInfo,8/26/20,0,0,0,0,0,0,0,0,0,794,0,16216,0,612,0,0,0,182,0,17010,0,0,0,0,0,0,0,-26,-10,0,166
Mississippi,8/26/20,0,0,0,0,0,0,0,0,0,1292,0,8985,0,1143,0,20,0,129,0,10277,0,0,0,0,0,0,0,15,24,2,56
Monroe,8/26/20,0,0,0,0,0,0,0,0,0,91,0,1708,0,74,0,0,0,17,0,1799,0,0,0,0,0,0,0,1,0,0,31
Montgomery,8/26/20,0,0,0,0,0,0,0,0,0,65,0,1154,0,43,0,3,0,19,0,1219,0,0,0,0,0,0,0,4,3,0,12
Nevada,8/26/20,0,0,0,0,0,0,0,0,0,158,0,2131,0,137,0,11,0,10,0,2289,0,0,0,0,0,0,0,0,1,0,6
Newton,8/26/20,0,0,0,0,0,0,0,0,0,110,0,1121,0,92,0,15,0,3,0,1231,0,0,0,0,0,0,0,1,2,0,11
Ouachita,8/26/20,0,0,0,0,0,0,0,0,0,135,0,3968,0,113,0,4,0,18,0,4103,0,0,0,0,0,0,0,2,0,0,17
Perry,8/26/20,0,0,0,0,0,0,0,0,0,59,0,2007,0,56,0,0,0,3,0,2066,0,0,0,0,0,0,0,1,0,0,-12
Phillips,8/26/20,0,0,0,0,0,0,0,0,0,385,0,4908,0,338,0,9,0,38,0,5293,0,0,0,0,0,0,0,6,3,0,49
Pike,8/26/20,0,0,0,0,0,0,0,0,0,163,0,1676,0,145,0,1,0,17,0,1839,0,0,0,0,0,0,0,2,8,0,8
Poinsett,8/26/20,0,0,0,0,0,0,0,0,0,452,0,5230,0,342,0,4,0,106,0,5682,0,0,0,0,0,0,0,20,9,0,77
Polk,8/26/20,0,0,0,0,0,0,0,0,0,212,0,2968,0,178,0,3,0,31,0,3180,0,0,0,0,0,0,0,4,4,1,18
Pope,8/26/20,0,0,0,0,0,0,0,0,0,1620,0,15269,0,1452,0,14,0,154,0,16889,0,0,0,0,0,0,0,15,35,0,94
Prairie,8/26/20,0,0,0,0,0,0,0,0,0,114,0,1485,0,110,0,0,0,4,0,1599,0,0,0,0,0,0,0,0,2,0,2
Pulaski,8/26/20,0,0,0,0,0,0,0,0,0,6761,0,88327,0,5995,0,99,0,667,0,95088,0,0,0,0,0,0,0,86,64,1,841
Randolph,8/26/20,0,0,0,0,0,0,0,0,0,292,0,3505,0,250,0,12,0,30,0,3797,0,0,0,0,0,0,0,1,7,0,21
Saline,8/26/20,0,0,0,0,0,0,0,0,0,1475,0,18499,0,1233,0,11,0,231,0,19974,0,0,0,0,0,0,0,66,19,1,202
Scott,8/26/20,0,0,0,0,0,0,0,0,0,84,0,1385,0,79,0,0,0,5,0,1469,0,0,0,0,0,0,0,0,1,0,11
Searcy,8/26/20,0,0,0,0,0,0,0,0,0,73,0,1421,0,34,0,0,0,39,0,1494,0,0,0,0,0,0,0,7,2,0,14
Sebastian,8/26/20,0,0,0,0,0,0,0,0,0,2753,0,30141,0,2396,0,32,0,325,0,32894,0,0,0,0,0,0,0,31,25,2,268
Sevier,8/26/20,0,0,0,0,0,0,0,0,0,1142,0,5437,0,1081,0,12,0,49,0,6579,0,0,0,0,0,0,0,8,9,0,29
Sharp,8/26/20,0,0,0,0,0,0,0,0,0,145,0,2660,0,119,0,5,0,21,0,2805,0,0,0,0,0,0,0,8,3,0,23
St.Francis,8/26/20,0,0,0,0,0,0,0,0,0,1282,0,8635,0,1235,0,3,0,44,0,9917,0,0,0,0,0,0,0,2,1,0,60
Stone,8/26/20,0,0,0,0,0,0,0,0,0,169,0,2181,0,103,0,1,0,65,0,2350,0,0,0,0,0,0,0,10,8,0,24
Union,8/26/20,0,0,0,0,0,0,0,0,0,653,0,6710,0,564,0,20,0,69,0,7363,0,0,0,0,0,0,0,3,5,-1,135
VanBuren,8/26/20,0,0,0,0,0,0,0,0,0,106,0,2690,0,67,0,2,0,37,0,2796,0,0,0,0,0,0,0,7,5,0,5
Washington,8/26/20,0,0,0,0,0,0,0,0,0,6659,0,49982,0,6412,0,55,0,192,0,56641,0,0,0,0,0,0,0,28,15,0,258
White,8/26/20,0,0,0,0,0,0,0,0,0,480,0,9459,0,374,0,10,0,96,0,9939,0,0,0,0,0,0,0,8,8,1,61
Woodruff,8/26/20,0,0,0,0,0,0,0,0,0,27,0,1268,0,22,0,0,0,5,0,1295,0,0,0,0,0,0,0,0,0,0,4
Yell,8/26/20,0,0,0,0,0,0,0,0,0,1118,0,7277,0,1068,0,23,0,27,0,8395,0,0,0,0,0,0,0,5,2,2,47
Arkansas_all_counties,8/25/20,0,0,0,0,0,0,0,0,2990671,57374,0,621183,0,51351,0,711,0,5312,0,678557,0,0,0,0,0,0,0,480,662,15,4853
Arkansas_county,8/25/20,0,0,0,0,0,0,0,0,0,266,0,3837,0,240,0,2,0,24,0,4103,0,0,0,0,0,0,0,1,3,0,9
Ashley,8/25/20,0,0,0,0,0,0,0,0,0,380,0,3869,0,350,0,7,0,23,0,4249,0,0,0,0,0,0,0,0,4,0,7
Baxter,8/25/20,0,0,0,0,0,0,0,0,0,116,0,2343,0,84,0,0,0,32,0,2459,0,0,0,0,0,0,0,0,3,0,162
Benton,8/25/20,0,0,0,0,0,0,0,0,0,5113,0,52731,0,4881,0,45,0,187,0,57844,0,0,0,0,0,0,0,16,24,0,443
Boone,8/25/20,0,0,0,0,0,0,0,0,0,274,0,5795,0,226,0,1,0,47,0,6069,0,0,0,0,0,0,0,4,2,0,51
Bradley,8/25/20,0,0,0,0,0,0,0,0,0,267,0,2838,0,215,0,5,0,47,0,3105,0,0,0,0,0,0,0,0,5,0,13
Calhoun,8/25/20,0,0,0,0,0,0,0,0,0,23,0,1205,0,17,0,0,0,6,0,1228,0,0,0,0,0,0,0,0,0,0,2
Carroll,8/25/20,0,0,0,0,0,0,0,0,0,437,0,5204,0,384,0,7,0,46,0,5641,0,0,0,0,0,0,0,1,5,0,36
Chicot,8/25/20,0,0,0,0,0,0,0,0,0,939,0,3976,0,739,0,10,0,190,0,4915,0,0,0,0,0,0,0,0,6,0,4
Clark,8/25/20,0,0,0,0,0,0,0,0,0,215,0,4343,0,189,0,3,0,23,0,4558,0,0,0,0,0,0,0,5,6,0,22
Clay,8/25/20,0,0,0,0,0,0,0,0,0,165,0,2847,0,138,0,5,0,22,0,3012,0,0,0,0,0,0,0,1,2,0,13
Cleburne,8/25/20,0,0,0,0,0,0,0,0,0,247,0,4056,0,221,0,6,0,20,0,4303,0,0,0,0,0,0,0,2,5,0,22
Cleveland,8/25/20,0,0,0,0,0,0,0,0,0,130,0,1762,0,113,0,2,0,15,0,1892,0,0,0,0,0,0,0,0,6,0,9
Columbia,8/25/20,0,0,0,0,0,0,0,0,0,284,0,3403,0,237,0,13,0,34,0,3687,0,0,0,0,0,0,0,3,7,1,5
Conway,8/25/20,0,0,0,0,0,0,0,0,0,193,0,4485,0,173,0,3,0,17,0,4678,0,0,0,0,0,0,0,4,6,0,20
Craighead,8/25/20,0,0,0,0,0,0,0,0,0,1701,0,22068,0,1470,0,14,0,217,0,23769,0,0,0,0,0,0,0,5,22,0,194
Crawford,8/25/20,0,0,0,0,0,0,0,0,0,851,0,12814,0,712,0,6,0,133,0,13665,0,0,0,0,0,0,0,12,24,0,127
Crittenden,8/25/20,0,0,0,0,0,0,0,0,0,1595,0,11187,0,1470,0,28,0,97,0,12782,0,0,0,0,0,0,0,13,20,0,48
Cross,8/25/20,0,0,0,0,0,0,0,0,0,244,0,2945,0,217,0,4,0,23,0,3189,0,0,0,0,0,0,0,3,5,0,14
Dallas,8/25/20,0,0,0,0,0,0,0,0,0,103,0,1290,0,64,0,2,0,37,0,1393,0,0,0,0,0,0,0,13,0,0,18
Desha,8/25/20,0,0,0,0,0,0,0,0,0,224,0,2834,0,201,0,5,0,18,0,3058,0,0,0,0,0,0,0,1,2,1,10
Drew,8/25/20,0,0,0,0,0,0,0,0,0,294,0,4304,0,250,0,4,0,40,0,4598,0,0,0,0,0,0,0,-2,12,0,10
Faulkner,8/25/20,0,0,0,0,0,0,0,0,0,1579,0,25431,0,1410,0,7,0,162,0,27010,0,0,0,0,0,0,0,44,26,0,240
Franklin,8/25/20,0,0,0,0,0,0,0,0,0,153,0,3857,0,138,0,2,0,13,0,4010,0,0,0,0,0,0,0,0,1,0,30
Fulton,8/25/20,0,0,0,0,0,0,0,0,0,61,0,787,0,43,0,0,0,18,0,848,0,0,0,0,0,0,0,1,0,0,6
Garland,8/25/20,0,0,0,0,0,0,0,0,0,1320,0,20216,0,1151,0,27,0,142,0,21536,0,0,0,0,0,0,0,12,32,2,82
Grant,8/25/20,0,0,0,0,0,0,0,0,0,169,0,3313,0,152,0,0,0,17,0,3482,0,0,0,0,0,0,0,0,2,0,16
Greene,8/25/20,0,0,0,0,0,0,0,0,0,587,0,9073,0,522,0,4,0,61,0,9660,0,0,0,0,0,0,0,3,3,1,118
Hempstead,8/25/20,0,0,0,0,0,0,0,0,0,312,0,3338,0,275,0,3,0,34,0,3650,0,0,0,0,0,0,0,5,8,0,33
HotSpring,8/25/20,0,0,0,0,0,0,0,0,0,1684,0,8030,0,1599,0,18,0,67,0,9714,0,0,0,0,0,0,0,3,6,1,28
Howard,8/25/20,0,0,0,0,0,0,0,0,0,398,0,3036,0,365,0,5,0,28,0,3434,0,0,0,0,0,0,0,5,10,0,8
Independence,8/25/20,0,0,0,0,0,0,0,0,0,705,0,7094,0,614,0,4,0,87,0,7799,0,0,0,0,0,0,0,13,22,1,75
Izard,8/25/20,0,0,0,0,0,0,0,0,0,80,0,2574,0,64,0,0,0,16,0,2654,0,0,0,0,0,0,0,-1,5,0,2
Jackson,8/25/20,0,0,0,0,0,0,0,0,0,175,0,4366,0,123,0,1,0,51,0,4541,0,0,0,0,0,0,0,-1,2,0,201
Jefferson,8/25/20,0,0,0,0,0,0,0,0,0,1924,0,19612,0,1615,0,47,0,262,0,21536,0,0,0,0,0,0,0,20,20,3,86
Johnson,8/25/20,0,0,0,0,0,0,0,0,0,742,0,5358,0,695,0,3,0,44,0,6100,0,0,0,0,0,0,0,3,3,0,23
Lafayette,8/25/20,0,0,0,0,0,0,0,0,0,65,0,770,0,59,0,2,0,4,0,835,0,0,0,0,0,0,0,0,1,0,2
Lawrence,8/25/20,0,0,0,0,0,0,0,0,0,245,0,2403,0,218,0,10,0,17,0,2648,0,0,0,0,0,0,0,0,2,0,9
Lee,8/25/20,0,0,0,0,0,0,0,0,0,993,0,3201,0,964,0,10,0,19,0,4194,0,0,0,0,0,0,0,0,3,0,10
Lincoln,8/25/20,0,0,0,0,0,0,0,0,0,1384,0,4920,0,1227,0,13,0,144,0,6304,0,0,0,0,0,0,0,9,7,0,14
LittleRiver,8/25/20,0,0,0,0,0,0,0,0,0,265,0,1404,0,215,0,13,0,37,0,1669,0,0,0,0,0,0,0,7,9,0,16
Logan,8/25/20,0,0,0,0,0,0,0,0,0,351,0,5057,0,296,0,1,0,54,0,5408,0,0,0,0,0,0,0,0,7,0,23
Lonoke,8/25/20,0,0,0,0,0,0,0,0,0,661,0,11755,0,559,0,2,0,100,0,12416,0,0,0,0,0,0,0,9,6,0,84
Madison,8/25/20,0,0,0,0,0,0,0,0,0,287,0,3024,0,279,0,2,0,6,0,3311,0,0,0,0,0,0,0,1,1,0,26
Marion,8/25/20,0,0,0,0,0,0,0,0,0,41,0,1555,0,33,0,0,0,8,0,1596,0,0,0,0,0,0,0,0,1,0,11
Miller,8/25/20,0,0,0,0,0,0,0,0,0,578,0,4693,0,532,0,5,0,41,0,5271,0,0,0,0,0,0,0,6,5,0,37
MissingCountyInfo,8/25/20,0,0,0,0,0,0,0,0,0,820,0,16024,0,622,0,0,0,198,0,16844,0,0,0,0,0,0,0,-6,-7,0,30
Mississippi,8/25/20,0,0,0,0,0,0,0,0,0,1277,0,8944,0,1119,0,18,0,140,0,10221,0,0,0,0,0,0,0,9,16,1,49
Monroe,8/25/20,0,0,0,0,0,0,0,0,0,90,0,1678,0,74,0,0,0,16,0,1768,0,0,0,0,0,0,0,1,1,0,7
Montgomery,8/25/20,0,0,0,0,0,0,0,0,0,61,0,1146,0,40,0,3,0,18,0,1207,0,0,0,0,0,0,0,1,2,1,4
Nevada,8/25/20,0,0,0,0,0,0,0,0,0,158,0,2125,0,136,0,11,0,11,0,2283,0,0,0,0,0,0,0,2,0,0,7
Newton,8/25/20,0,0,0,0,0,0,0,0,0,109,0,1111,0,90,0,15,0,4,0,1220,0,0,0,0,0,0,0,0,0,0,12
Ouachita,8/25/20,0,0,0,0,0,0,0,0,0,133,0,3953,0,113,0,4,0,16,0,4086,0,0,0,0,0,0,0,1,2,0,13
Perry,8/25/20,0,0,0,0,0,0,0,0,0,58,0,2020,0,56,0,0,0,2,0,2078,0,0,0,0,0,0,0,-1,0,0,5
Phillips,8/25/20,0,0,0,0,0,0,0,0,0,379,0,4865,0,335,0,9,0,35,0,5244,0,0,0,0,0,0,0,4,6,0,9
Pike,8/25/20,0,0,0,0,0,0,0,0,0,161,0,1670,0,137,0,1,0,23,0,1831,0,0,0,0,0,0,0,4,10,0,9
Poinsett,8/25/20,0,0,0,0,0,0,0,0,0,432,0,5173,0,333,0,4,0,95,0,5605,0,0,0,0,0,0,0,3,13,0,82
Polk,8/25/20,0,0,0,0,0,0,0,0,0,208,0,2954,0,174,0,2,0,32,0,3162,0,0,0,0,0,0,0,1,4,0,38
Pope,8/25/20,0,0,0,0,0,0,0,0,0,1605,0,15190,0,1417,0,14,0,174,0,16795,0,0,0,0,0,0,0,12,26,0,116
Prairie,8/25/20,0,0,0,0,0,0,0,0,0,114,0,1483,0,108,0,0,0,6,0,1597,0,0,0,0,0,0,0,0,2,0,6
Pulaski,8/25/20,0,0,0,0,0,0,0,0,0,6675,0,87572,0,5931,0,98,0,646,0,94247,0,0,0,0,0,0,0,85,69,0,940
Randolph,8/25/20,0,0,0,0,0,0,0,0,0,291,0,3485,0,243,0,12,0,36,0,3776,0,0,0,0,0,0,0,1,4,0,10
Saline,8/25/20,0,0,0,0,0,0,0,0,0,1409,0,18363,0,1214,0,10,0,185,0,19772,0,0,0,0,0,0,0,25,38,0,146
Scott,8/25/20,0,0,0,0,0,0,0,0,0,84,0,1374,0,78,0,0,0,6,0,1458,0,0,0,0,0,0,0,0,2,0,12
Searcy,8/25/20,0,0,0,0,0,0,0,0,0,66,0,1414,0,32,0,0,0,34,0,1480,0,0,0,0,0,0,0,4,0,0,11
Sebastian,8/25/20,0,0,0,0,0,0,0,0,0,2722,0,29904,0,2371,0,30,0,321,0,32626,0,0,0,0,0,0,0,36,43,1,384
Sevier,8/25/20,0,0,0,0,0,0,0,0,0,1134,0,5416,0,1072,0,12,0,50,0,6550,0,0,0,0,0,0,0,13,16,0,37
Sharp,8/25/20,0,0,0,0,0,0,0,0,0,137,0,2645,0,116,0,5,0,16,0,2782,0,0,0,0,0,0,0,1,0,0,18
St.Francis,8/25/20,0,0,0,0,0,0,0,0,0,1280,0,8577,0,1234,0,3,0,43,0,9857,0,0,0,0,0,0,0,0,3,0,9
Stone,8/25/20,0,0,0,0,0,0,0,0,0,159,0,2167,0,95,0,1,0,63,0,2326,0,0,0,0,0,0,0,4,10,0,38
Union,8/25/20,0,0,0,0,0,0,0,0,0,650,0,6578,0,559,0,21,0,70,0,7228,0,0,0,0,0,0,0,16,3,0,41
VanBuren,8/25/20,0,0,0,0,0,0,0,0,0,99,0,2692,0,62,0,2,0,35,0,2791,0,0,0,0,0,0,0,15,2,0,24
Washington,8/25/20,0,0,0,0,0,0,0,0,0,6631,0,49752,0,6397,0,55,0,179,0,56383,0,0,0,0,0,0,0,16,27,1,306
White,8/25/20,0,0,0,0,0,0,0,0,0,472,0,9406,0,366,0,9,0,97,0,9878,0,0,0,0,0,0,0,10,12,1,51
Woodruff,8/25/20,0,0,0,0,0,0,0,0,0,27,0,1264,0,22,0,0,0,5,0,1291,0,0,0,0,0,0,0,0,0,0,4
Yell,8/25/20,0,0,0,0,0,0,0,0,0,1113,0,7235,0,1066,0,21,0,26,0,8348,0,0,0,0,0,0,0,2,7,0,16
Arkansas_all_counties,8/24/20,0,0,0,0,0,0,0,0,2990671,56894,0,616810,0,50689,0,696,0,5509,0,673704,0,0,0,0,0,0,0,320,438,9,2878
Arkansas_county,8/24/20,0,0,0,0,0,0,0,0,0,265,0,3829,0,237,0,2,0,26,0,4094,0,0,0,0,0,0,0,0,1,0,15
Ashley,8/24/20,0,0,0,0,0,0,0,0,0,380,0,3862,0,346,0,7,0,27,0,4242,0,0,0,0,0,0,0,1,0,0,31
Baxter,8/24/20,0,0,0,0,0,0,0,0,0,116,0,2181,0,81,0,0,0,35,0,2297,0,0,0,0,0,0,0,0,1,0,11
Benton,8/24/20,0,0,0,0,0,0,0,0,0,5097,0,52304,0,4857,0,45,0,195,0,57401,0,0,0,0,0,0,0,5,16,0,496
Boone,8/24/20,0,0,0,0,0,0,0,0,0,270,0,5748,0,224,0,1,0,45,0,6018,0,0,0,0,0,0,0,4,0,0,79
Bradley,8/24/20,0,0,0,0,0,0,0,0,0,267,0,2825,0,210,0,5,0,52,0,3092,0,0,0,0,0,0,0,7,6,1,47
Calhoun,8/24/20,0,0,0,0,0,0,0,0,0,23,0,1203,0,17,0,0,0,6,0,1226,0,0,0,0,0,0,0,0,1,0,10
Carroll,8/24/20,0,0,0,0,0,0,0,0,0,436,0,5169,0,379,0,7,0,50,0,5605,0,0,0,0,0,0,0,4,15,0,50
Chicot,8/24/20,0,0,0,0,0,0,0,0,0,939,0,3972,0,733,0,10,0,196,0,4911,0,0,0,0,0,0,0,1,3,0,36
Clark,8/24/20,0,0,0,0,0,0,0,0,0,210,0,4326,0,183,0,3,0,24,0,4536,0,0,0,0,0,0,0,2,1,0,29
Clay,8/24/20,0,0,0,0,0,0,0,0,0,164,0,2835,0,136,0,5,0,23,0,2999,0,0,0,0,0,0,0,0,0,0,31
Cleburne,8/24/20,0,0,0,0,0,0,0,0,0,245,0,4036,0,216,0,6,0,23,0,4281,0,0,0,0,0,0,0,1,3,0,13
Cleveland,8/24/20,0,0,0,0,0,0,0,0,0,130,0,1753,0,107,0,2,0,21,0,1883,0,0,0,0,0,0,0,1,3,0,15
Columbia,8/24/20,0,0,0,0,0,0,0,0,0,281,0,3401,0,230,0,12,0,39,0,3682,0,0,0,0,0,0,0,7,2,0,35
Conway,8/24/20,0,0,0,0,0,0,0,0,0,189,0,4469,0,167,0,3,0,19,0,4658,0,0,0,0,0,0,0,0,3,0,38
Craighead,8/24/20,0,0,0,0,0,0,0,0,0,1696,0,21879,0,1448,0,14,0,234,0,23575,0,0,0,0,0,0,0,14,17,0,255
Crawford,8/24/20,0,0,0,0,0,0,0,0,0,839,0,12699,0,688,0,6,0,145,0,13538,0,0,0,0,0,0,0,4,12,0,178
Crittenden,8/24/20,0,0,0,0,0,0,0,0,0,1582,0,11152,0,1450,0,28,0,104,0,12734,0,0,0,0,0,0,0,9,14,0,44
Cross,8/24/20,0,0,0,0,0,0,0,0,0,241,0,2934,0,212,0,4,0,25,0,3175,0,0,0,0,0,0,0,1,2,0,65
Dallas,8/24/20,0,0,0,0,0,0,0,0,0,90,0,1285,0,64,0,2,0,24,0,1375,0,0,0,0,0,0,0,0,1,0,6
Desha,8/24/20,0,0,0,0,0,0,0,0,0,223,0,2825,0,199,0,4,0,20,0,3048,0,0,0,0,0,0,0,0,4,0,24
Drew,8/24/20,0,0,0,0,0,0,0,0,0,296,0,4292,0,238,0,4,0,54,0,4588,0,0,0,0,0,0,0,0,7,0,50
Faulkner,8/24/20,0,0,0,0,0,0,0,0,0,1535,0,25235,0,1384,0,7,0,144,0,26770,0,0,0,0,0,0,0,35,7,0,232
Franklin,8/24/20,0,0,0,0,0,0,0,0,0,153,0,3827,0,137,0,2,0,14,0,3980,0,0,0,0,0,0,0,1,1,0,49
Fulton,8/24/20,0,0,0,0,0,0,0,0,0,60,0,782,0,43,0,0,0,17,0,842,0,0,0,0,0,0,0,1,0,0,12
Garland,8/24/20,0,0,0,0,0,0,0,0,0,1308,0,20146,0,1119,0,25,0,164,0,21454,0,0,0,0,0,0,0,12,14,0,169
Grant,8/24/20,0,0,0,0,0,0,0,0,0,169,0,3297,0,150,0,0,0,19,0,3466,0,0,0,0,0,0,0,1,7,0,27
Greene,8/24/20,0,0,0,0,0,0,0,0,0,584,0,8958,0,519,0,3,0,62,0,9542,0,0,0,0,0,0,0,0,3,0,86
Hempstead,8/24/20,0,0,0,0,0,0,0,0,0,307,0,3310,0,267,0,3,0,37,0,3617,0,0,0,0,0,0,0,1,9,0,22
HotSpring,8/24/20,0,0,0,0,0,0,0,0,0,1681,0,8005,0,1593,0,17,0,71,0,9686,0,0,0,0,0,0,0,3,6,0,38
Howard,8/24/20,0,0,0,0,0,0,0,0,0,393,0,3033,0,355,0,5,0,33,0,3426,0,0,0,0,0,0,0,2,10,0,11
Independence,8/24/20,0,0,0,0,0,0,0,0,0,692,0,7032,0,592,0,3,0,97,0,7724,0,0,0,0,0,0,0,8,8,0,124
Izard,8/24/20,0,0,0,0,0,0,0,0,0,81,0,2571,0,59,0,0,0,22,0,2652,0,0,0,0,0,0,0,0,1,0,12
Jackson,8/24/20,0,0,0,0,0,0,0,0,0,176,0,4164,0,121,0,1,0,54,0,4340,0,0,0,0,0,0,0,0,0,0,8
Jefferson,8/24/20,0,0,0,0,0,0,0,0,0,1904,0,19546,0,1595,0,44,0,265,0,21450,0,0,0,0,0,0,0,5,11,1,207
Johnson,8/24/20,0,0,0,0,0,0,0,0,0,739,0,5338,0,692,0,3,0,44,0,6077,0,0,0,0,0,0,0,4,5,0,94
Lafayette,8/24/20,0,0,0,0,0,0,0,0,0,65,0,768,0,58,0,2,0,5,0,833,0,0,0,0,0,0,0,0,0,0,2
Lawrence,8/24/20,0,0,0,0,0,0,0,0,0,245,0,2394,0,216,0,10,0,19,0,2639,0,0,0,0,0,0,0,5,2,0,19
Lee,8/24/20,0,0,0,0,0,0,0,0,0,993,0,3191,0,961,0,10,0,22,0,4184,0,0,0,0,0,0,0,1,-1,2,38
Lincoln,8/24/20,0,0,0,0,0,0,0,0,0,1375,0,4915,0,1220,0,13,0,142,0,6290,0,0,0,0,0,0,0,0,0,0,25
LittleRiver,8/24/20,0,0,0,0,0,0,0,0,0,258,0,1395,0,206,0,13,0,39,0,1653,0,0,0,0,0,0,0,2,2,0,8
Logan,8/24/20,0,0,0,0,0,0,0,0,0,351,0,5034,0,289,0,1,0,61,0,5385,0,0,0,0,0,0,0,4,1,0,53
Lonoke,8/24/20,0,0,0,0,0,0,0,0,0,652,0,11680,0,553,0,2,0,97,0,12332,0,0,0,0,0,0,0,1,4,0,106
Madison,8/24/20,0,0,0,0,0,0,0,0,0,286,0,2999,0,278,0,2,0,6,0,3285,0,0,0,0,0,0,0,0,0,0,16
Marion,8/24/20,0,0,0,0,0,0,0,0,0,41,0,1544,0,32,0,0,0,9,0,1585,0,0,0,0,0,0,0,0,1,0,14
Miller,8/24/20,0,0,0,0,0,0,0,0,0,572,0,4662,0,527,0,5,0,40,0,5234,0,0,0,0,0,0,0,1,1,0,31
MissingCountyInfo,8/24/20,0,0,0,0,0,0,0,0,0,826,0,15988,0,629,0,0,0,197,0,16814,0,0,0,0,0,0,0,16,13,0,-2513
Mississippi,8/24/20,0,0,0,0,0,0,0,0,0,1268,0,8904,0,1103,0,17,0,148,0,10172,0,0,0,0,0,0,0,7,19,1,58
Monroe,8/24/20,0,0,0,0,0,0,0,0,0,89,0,1672,0,73,0,0,0,16,0,1761,0,0,0,0,0,0,0,0,5,0,19
Montgomery,8/24/20,0,0,0,0,0,0,0,0,0,60,0,1143,0,38,0,2,0,20,0,1203,0,0,0,0,0,0,0,2,1,0,22
Nevada,8/24/20,0,0,0,0,0,0,0,0,0,156,0,2120,0,136,0,11,0,9,0,2276,0,0,0,0,0,0,0,0,0,0,8
Newton,8/24/20,0,0,0,0,0,0,0,0,0,109,0,1099,0,90,0,15,0,4,0,1208,0,0,0,0,0,0,0,1,0,0,16
Ouachita,8/24/20,0,0,0,0,0,0,0,0,0,132,0,3941,0,111,0,4,0,17,0,4073,0,0,0,0,0,0,0,2,1,0,49
Perry,8/24/20,0,0,0,0,0,0,0,0,0,59,0,2014,0,56,0,0,0,3,0,2073,0,0,0,0,0,0,0,0,0,0,11
Phillips,8/24/20,0,0,0,0,0,0,0,0,0,375,0,4860,0,329,0,9,0,37,0,5235,0,0,0,0,0,0,0,0,2,0,11
Pike,8/24/20,0,0,0,0,0,0,0,0,0,157,0,1665,0,127,0,1,0,29,0,1822,0,0,0,0,0,0,0,1,5,0,8
Poinsett,8/24/20,0,0,0,0,0,0,0,0,0,429,0,5094,0,320,0,4,0,105,0,5523,0,0,0,0,0,0,0,23,10,0,60
Polk,8/24/20,0,0,0,0,0,0,0,0,0,207,0,2917,0,170,0,2,0,35,0,3124,0,0,0,0,0,0,0,3,4,0,30
Pope,8/24/20,0,0,0,0,0,0,0,0,0,1593,0,15086,0,1391,0,14,0,188,0,16679,0,0,0,0,0,0,0,2,14,0,106
Prairie,8/24/20,0,0,0,0,0,0,0,0,0,114,0,1477,0,106,0,0,0,8,0,1591,0,0,0,0,0,0,0,0,0,0,15
Pulaski,8/24/20,0,0,0,0,0,0,0,0,0,6590,0,86717,0,5862,0,98,0,630,0,93307,0,0,0,0,0,0,0,57,49,3,672
Randolph,8/24/20,0,0,0,0,0,0,0,0,0,290,0,3476,0,239,0,12,0,39,0,3766,0,0,0,0,0,0,0,0,5,1,30
Saline,8/24/20,0,0,0,0,0,0,0,0,0,1384,0,18242,0,1176,0,10,0,198,0,19626,0,0,0,0,0,0,0,9,21,0,151
Scott,8/24/20,0,0,0,0,0,0,0,0,0,84,0,1362,0,76,0,0,0,8,0,1446,0,0,0,0,0,0,0,0,1,0,11
Searcy,8/24/20,0,0,0,0,0,0,0,0,0,62,0,1407,0,32,0,0,0,30,0,1469,0,0,0,0,0,0,0,4,0,0,14
Sebastian,8/24/20,0,0,0,0,0,0,0,0,0,2686,0,29556,0,2328,0,29,0,329,0,32242,0,0,0,0,0,0,0,7,31,0,376
Sevier,8/24/20,0,0,0,0,0,0,0,0,0,1121,0,5392,0,1056,0,12,0,53,0,6513,0,0,0,0,0,0,0,1,9,0,27
Sharp,8/24/20,0,0,0,0,0,0,0,0,0,136,0,2628,0,116,0,5,0,15,0,2764,0,0,0,0,0,0,0,0,0,0,24
St.Francis,8/24/20,0,0,0,0,0,0,0,0,0,1280,0,8568,0,1231,0,3,0,46,0,9848,0,0,0,0,0,0,0,10,4,0,75
Stone,8/24/20,0,0,0,0,0,0,0,0,0,155,0,2133,0,85,0,1,0,69,0,2288,0,0,0,0,0,0,0,2,1,0,20
Union,8/24/20,0,0,0,0,0,0,0,0,0,634,0,6553,0,556,0,21,0,57,0,7187,0,0,0,0,0,0,0,7,4,0,34
VanBuren,8/24/20,0,0,0,0,0,0,0,0,0,84,0,2683,0,60,0,2,0,22,0,2767,0,0,0,0,0,0,0,4,2,0,21
Washington,8/24/20,0,0,0,0,0,0,0,0,0,6615,0,49462,0,6370,0,54,0,191,0,56077,0,0,0,0,0,0,0,5,19,0,452
White,8/24/20,0,0,0,0,0,0,0,0,0,462,0,9365,0,354,0,8,0,100,0,9827,0,0,0,0,0,0,0,7,10,0,71
Woodruff,8/24/20,0,0,0,0,0,0,0,0,0,27,0,1260,0,22,0,0,0,5,0,1287,0,0,0,0,0,0,0,0,0,0,15
Yell,8/24/20,0,0,0,0,0,0,0,0,0,1111,0,7221,0,1059,0,21,0,31,0,8332,0,0,0,0,0,0,0,2,4,0,24
Arkansas_all_counties,8/23/20,0,0,0,0,0,0,0,0,2990671,56574,0,614252,0,50251,0,687,0,5636,0,670826,0,0,0,0,0,0,0,375,487,13,5501
Arkansas_county,8/23/20,0,0,0,0,0,0,0,0,0,265,0,3814,0,236,0,2,0,27,0,4079,0,0,0,0,0,0,0,2,1,0,46
Ashley,8/23/20,0,0,0,0,0,0,0,0,0,379,0,3832,0,346,0,7,0,26,0,4211,0,0,0,0,0,0,0,3,4,0,23
Baxter,8/23/20,0,0,0,0,0,0,0,0,0,116,0,2170,0,80,0,0,0,36,0,2286,0,0,0,0,0,0,0,9,0,0,24
Benton,8/23/20,0,0,0,0,0,0,0,0,0,5092,0,51813,0,4841,0,45,0,206,0,56905,0,0,0,0,0,0,0,26,13,0,200
Boone,8/23/20,0,0,0,0,0,0,0,0,0,266,0,5673,0,224,0,1,0,41,0,5939,0,0,0,0,0,0,0,9,5,0,17
Bradley,8/23/20,0,0,0,0,0,0,0,0,0,260,0,2785,0,204,0,4,0,52,0,3045,0,0,0,0,0,0,0,9,6,0,12
Calhoun,8/23/20,0,0,0,0,0,0,0,0,0,23,0,1193,0,16,0,0,0,7,0,1216,0,0,0,0,0,0,0,0,0,0,0
Carroll,8/23/20,0,0,0,0,0,0,0,0,0,432,0,5123,0,364,0,7,0,61,0,5555,0,0,0,0,0,0,0,3,3,0,32
Chicot,8/23/20,0,0,0,0,0,0,0,0,0,938,0,3937,0,730,0,10,0,198,0,4875,0,0,0,0,0,0,0,3,2,1,19
Clark,8/23/20,0,0,0,0,0,0,0,0,0,208,0,4299,0,182,0,3,0,23,0,4507,0,0,0,0,0,0,0,2,3,0,11
Clay,8/23/20,0,0,0,0,0,0,0,0,0,164,0,2804,0,136,0,5,0,23,0,2968,0,0,0,0,0,0,0,2,2,0,16
Cleburne,8/23/20,0,0,0,0,0,0,0,0,0,244,0,4024,0,213,0,6,0,25,0,4268,0,0,0,0,0,0,0,1,4,1,25
Cleveland,8/23/20,0,0,0,0,0,0,0,0,0,129,0,1739,0,104,0,2,0,23,0,1868,0,0,0,0,0,0,0,2,2,0,12
Columbia,8/23/20,0,0,0,0,0,0,0,0,0,274,0,3373,0,228,0,12,0,34,0,3647,0,0,0,0,0,0,0,1,2,0,8
Conway,8/23/20,0,0,0,0,0,0,0,0,0,189,0,4431,0,164,0,3,0,22,0,4620,0,0,0,0,0,0,0,1,4,0,26
Craighead,8/23/20,0,0,0,0,0,0,0,0,0,1682,0,21638,0,1431,0,14,0,237,0,23320,0,0,0,0,0,0,0,7,10,0,172
Crawford,8/23/20,0,0,0,0,0,0,0,0,0,835,0,12525,0,676,0,6,0,153,0,13360,0,0,0,0,0,0,0,8,8,0,141
Crittenden,8/23/20,0,0,0,0,0,0,0,0,0,1573,0,11117,0,1436,0,28,0,109,0,12690,0,0,0,0,0,0,0,10,14,1,42
Cross,8/23/20,0,0,0,0,0,0,0,0,0,240,0,2870,0,210,0,4,0,26,0,3110,0,0,0,0,0,0,0,2,5,0,6
Dallas,8/23/20,0,0,0,0,0,0,0,0,0,90,0,1279,0,63,0,2,0,25,0,1369,0,0,0,0,0,0,0,2,2,0,5
Desha,8/23/20,0,0,0,0,0,0,0,0,0,223,0,2801,0,195,0,4,0,24,0,3024,0,0,0,0,0,0,0,3,1,0,11
Drew,8/23/20,0,0,0,0,0,0,0,0,0,296,0,4242,0,231,0,4,0,61,0,4538,0,0,0,0,0,0,0,0,3,0,12
Faulkner,8/23/20,0,0,0,0,0,0,0,0,0,1500,0,25038,0,1377,0,7,0,116,0,26538,0,0,0,0,0,0,0,15,12,0,180
Franklin,8/23/20,0,0,0,0,0,0,0,0,0,152,0,3779,0,136,0,2,0,14,0,3931,0,0,0,0,0,0,0,3,2,0,13
Fulton,8/23/20,0,0,0,0,0,0,0,0,0,59,0,771,0,43,0,0,0,16,0,830,0,0,0,0,0,0,0,4,1,0,9
Garland,8/23/20,0,0,0,0,0,0,0,0,0,1296,0,19989,0,1105,0,25,0,166,0,21285,0,0,0,0,0,0,0,8,13,2,61
Grant,8/23/20,0,0,0,0,0,0,0,0,0,168,0,3271,0,143,0,0,0,25,0,3439,0,0,0,0,0,0,0,4,0,0,21
Greene,8/23/20,0,0,0,0,0,0,0,0,0,584,0,8872,0,516,0,3,0,65,0,9456,0,0,0,0,0,0,0,10,7,0,81
Hempstead,8/23/20,0,0,0,0,0,0,0,0,0,306,0,3289,0,258,0,3,0,45,0,3595,0,0,0,0,0,0,0,3,0,0,30
HotSpring,8/23/20,0,0,0,0,0,0,0,0,0,1678,0,7970,0,1587,0,17,0,74,0,9648,0,0,0,0,0,0,0,1,16,1,18
Howard,8/23/20,0,0,0,0,0,0,0,0,0,391,0,3024,0,345,0,5,0,41,0,3415,0,0,0,0,0,0,0,2,0,1,14
Independence,8/23/20,0,0,0,0,0,0,0,0,0,684,0,6916,0,584,0,3,0,97,0,7600,0,0,0,0,0,0,0,8,13,0,81
Izard,8/23/20,0,0,0,0,0,0,0,0,0,81,0,2559,0,58,0,0,0,23,0,2640,0,0,0,0,0,0,0,3,0,0,21
Jackson,8/23/20,0,0,0,0,0,0,0,0,0,176,0,4156,0,121,0,1,0,54,0,4332,0,0,0,0,0,0,0,5,4,0,475
Jefferson,8/23/20,0,0,0,0,0,0,0,0,0,1899,0,19344,0,1584,0,43,0,272,0,21243,0,0,0,0,0,0,0,18,13,0,139
Johnson,8/23/20,0,0,0,0,0,0,0,0,0,735,0,5248,0,687,0,3,0,45,0,5983,0,0,0,0,0,0,0,1,4,0,25
Lafayette,8/23/20,0,0,0,0,0,0,0,0,0,65,0,766,0,58,0,2,0,5,0,831,0,0,0,0,0,0,0,0,1,0,6
Lawrence,8/23/20,0,0,0,0,0,0,0,0,0,240,0,2380,0,214,0,10,0,16,0,2620,0,0,0,0,0,0,0,1,1,0,16
Lee,8/23/20,0,0,0,0,0,0,0,0,0,992,0,3154,0,962,0,8,0,22,0,4146,0,0,0,0,0,0,0,1,3,0,12
Lincoln,8/23/20,0,0,0,0,0,0,0,0,0,1375,0,4890,0,1220,0,13,0,142,0,6265,0,0,0,0,0,0,0,1,2,0,20
LittleRiver,8/23/20,0,0,0,0,0,0,0,0,0,256,0,1389,0,204,0,13,0,39,0,1645,0,0,0,0,0,0,0,2,4,0,5
Logan,8/23/20,0,0,0,0,0,0,0,0,0,347,0,4985,0,288,0,1,0,58,0,5332,0,0,0,0,0,0,0,0,8,0,16
Lonoke,8/23/20,0,0,0,0,0,0,0,0,0,651,0,11575,0,549,0,2,0,100,0,12226,0,0,0,0,0,0,0,9,5,0,78
Madison,8/23/20,0,0,0,0,0,0,0,0,0,286,0,2983,0,278,0,2,0,6,0,3269,0,0,0,0,0,0,0,0,0,0,11
Marion,8/23/20,0,0,0,0,0,0,0,0,0,41,0,1530,0,31,0,0,0,10,0,1571,0,0,0,0,0,0,0,0,0,0,3
Miller,8/23/20,0,0,0,0,0,0,0,0,0,571,0,4632,0,526,0,5,0,40,0,5203,0,0,0,0,0,0,0,5,7,0,19
MissingCountyInfo,8/23/20,0,0,0,0,0,0,0,0,0,810,0,18517,0,616,0,0,0,194,0,19327,0,0,0,0,0,0,0,-3,5,0,1341
Mississippi,8/23/20,0,0,0,0,0,0,0,0,0,1261,0,8853,0,1084,0,16,0,161,0,10114,0,0,0,0,0,0,0,12,19,0,88
Monroe,8/23/20,0,0,0,0,0,0,0,0,0,89,0,1653,0,68,0,0,0,21,0,1742,0,0,0,0,0,0,0,0,3,0,25
Montgomery,8/23/20,0,0,0,0,0,0,0,0,0,58,0,1123,0,37,0,2,0,19,0,1181,0,0,0,0,0,0,0,1,1,0,11
Nevada,8/23/20,0,0,0,0,0,0,0,0,0,156,0,2112,0,136,0,11,0,9,0,2268,0,0,0,0,0,0,0,0,0,1,13
Newton,8/23/20,0,0,0,0,0,0,0,0,0,108,0,1084,0,90,0,15,0,3,0,1192,0,0,0,0,0,0,0,0,0,0,1
Ouachita,8/23/20,0,0,0,0,0,0,0,0,0,130,0,3894,0,110,0,4,0,16,0,4024,0,0,0,0,0,0,0,1,0,1,8
Perry,8/23/20,0,0,0,0,0,0,0,0,0,59,0,2003,0,56,0,0,0,3,0,2062,0,0,0,0,0,0,0,0,1,0,11
Phillips,8/23/20,0,0,0,0,0,0,0,0,0,375,0,4849,0,327,0,9,0,39,0,5224,0,0,0,0,0,0,0,1,4,0,24
Pike,8/23/20,0,0,0,0,0,0,0,0,0,156,0,1658,0,122,0,1,0,33,0,1814,0,0,0,0,0,0,0,2,4,0,8
Poinsett,8/23/20,0,0,0,0,0,0,0,0,0,406,0,5057,0,310,0,4,0,92,0,5463,0,0,0,0,0,0,0,8,6,0,162
Polk,8/23/20,0,0,0,0,0,0,0,0,0,204,0,2890,0,166,0,2,0,36,0,3094,0,0,0,0,0,0,0,4,3,0,12
Pope,8/23/20,0,0,0,0,0,0,0,0,0,1591,0,14982,0,1377,0,14,0,200,0,16573,0,0,0,0,0,0,0,11,18,0,127
Prairie,8/23/20,0,0,0,0,0,0,0,0,0,114,0,1462,0,106,0,0,0,8,0,1576,0,0,0,0,0,0,0,0,1,0,19
Pulaski,8/23/20,0,0,0,0,0,0,0,0,0,6533,0,86102,0,5813,0,95,0,625,0,92635,0,0,0,0,0,0,0,56,67,1,519
Randolph,8/23/20,0,0,0,0,0,0,0,0,0,290,0,3446,0,234,0,11,0,45,0,3736,0,0,0,0,0,0,0,2,5,0,19
Saline,8/23/20,0,0,0,0,0,0,0,0,0,1375,0,18100,0,1155,0,10,0,210,0,19475,0,0,0,0,0,0,0,8,43,0,137
Scott,8/23/20,0,0,0,0,0,0,0,0,0,84,0,1351,0,75,0,0,0,9,0,1435,0,0,0,0,0,0,0,0,2,0,3
Searcy,8/23/20,0,0,0,0,0,0,0,0,0,58,0,1397,0,32,0,0,0,26,0,1455,0,0,0,0,0,0,0,0,0,0,24
Sebastian,8/23/20,0,0,0,0,0,0,0,0,0,2679,0,29187,0,2297,0,29,0,353,0,31866,0,0,0,0,0,0,0,13,24,2,257
Sevier,8/23/20,0,0,0,0,0,0,0,0,0,1120,0,5366,0,1047,0,12,0,61,0,6486,0,0,0,0,0,0,0,6,8,0,31
Sharp,8/23/20,0,0,0,0,0,0,0,0,0,136,0,2604,0,116,0,5,0,15,0,2740,0,0,0,0,0,0,0,4,1,0,21
St.Francis,8/23/20,0,0,0,0,0,0,0,0,0,1270,0,8503,0,1227,0,3,0,40,0,9773,0,0,0,0,0,0,0,7,13,0,42
Stone,8/23/20,0,0,0,0,0,0,0,0,0,153,0,2115,0,84,0,1,0,68,0,2268,0,0,0,0,0,0,0,2,5,0,6
Union,8/23/20,0,0,0,0,0,0,0,0,0,627,0,6526,0,552,0,21,0,54,0,7153,0,0,0,0,0,0,0,3,14,0,17
VanBuren,8/23/20,0,0,0,0,0,0,0,0,0,80,0,2666,0,58,0,2,0,20,0,2746,0,0,0,0,0,0,0,5,1,0,17
Washington,8/23/20,0,0,0,0,0,0,0,0,0,6610,0,49015,0,6351,0,54,0,205,0,55625,0,0,0,0,0,0,0,13,16,1,264
White,8/23/20,0,0,0,0,0,0,0,0,0,455,0,9301,0,344,0,8,0,103,0,9756,0,0,0,0,0,0,0,7,11,0,30
Woodruff,8/23/20,0,0,0,0,0,0,0,0,0,27,0,1245,0,22,0,0,0,5,0,1272,0,0,0,0,0,0,0,1,0,0,4
Yell,8/23/20,0,0,0,0,0,0,0,0,0,1109,0,7199,0,1055,0,21,0,33,0,8308,0,0,0,0,0,0,0,2,2,0,46
Arkansas_all_counties,8/22/20,0,0,0,0,0,0,0,0,2990671,56199,0,609126,0,49764,0,674,0,5761,0,665325,0,0,0,0,0,0,0,547,629,11,6734
Arkansas_county,8/22/20,0,0,0,0,0,0,0,0,0,263,0,3770,0,235,0,2,0,26,0,4033,0,0,0,0,0,0,0,5,1,0,40
Ashley,8/22/20,0,0,0,0,0,0,0,0,0,376,0,3812,0,342,0,7,0,27,0,4188,0,0,0,0,0,0,0,4,4,0,31
Baxter,8/22/20,0,0,0,0,0,0,0,0,0,107,0,2155,0,80,0,0,0,27,0,2262,0,0,0,0,0,0,0,5,1,0,10
Benton,8/22/20,0,0,0,0,0,0,0,0,0,5066,0,51639,0,4828,0,45,0,193,0,56705,0,0,0,0,0,0,0,20,25,1,132
Boone,8/22/20,0,0,0,0,0,0,0,0,0,257,0,5665,0,219,0,1,0,37,0,5922,0,0,0,0,0,0,0,6,2,0,31
Bradley,8/22/20,0,0,0,0,0,0,0,0,0,251,0,2782,0,198,0,4,0,49,0,3033,0,0,0,0,0,0,0,8,7,0,17
Calhoun,8/22/20,0,0,0,0,0,0,0,0,0,23,0,1193,0,16,0,0,0,7,0,1216,0,0,0,0,0,0,0,1,0,0,2
Carroll,8/22/20,0,0,0,0,0,0,0,0,0,429,0,5094,0,361,0,7,0,61,0,5523,0,0,0,0,0,0,0,7,4,0,25
Chicot,8/22/20,0,0,0,0,0,0,0,0,0,935,0,3921,0,728,0,9,0,198,0,4856,0,0,0,0,0,0,0,2,6,0,25
Clark,8/22/20,0,0,0,0,0,0,0,0,0,206,0,4290,0,179,0,3,0,24,0,4496,0,0,0,0,0,0,0,5,2,0,31
Clay,8/22/20,0,0,0,0,0,0,0,0,0,162,0,2790,0,134,0,5,0,23,0,2952,0,0,0,0,0,0,0,3,5,0,19
Cleburne,8/22/20,0,0,0,0,0,0,0,0,0,243,0,4000,0,209,0,5,0,29,0,4243,0,0,0,0,0,0,0,1,2,0,22
Cleveland,8/22/20,0,0,0,0,0,0,0,0,0,127,0,1729,0,102,0,2,0,23,0,1856,0,0,0,0,0,0,0,0,5,0,7
Columbia,8/22/20,0,0,0,0,0,0,0,0,0,273,0,3366,0,226,0,12,0,35,0,3639,0,0,0,0,0,0,0,8,1,0,66
Conway,8/22/20,0,0,0,0,0,0,0,0,0,188,0,4406,0,160,0,3,0,25,0,4594,0,0,0,0,0,0,0,4,3,0,40
Craighead,8/22/20,0,0,0,0,0,0,0,0,0,1675,0,21473,0,1421,0,14,0,240,0,23148,0,0,0,0,0,0,0,54,11,1,412
Crawford,8/22/20,0,0,0,0,0,0,0,0,0,827,0,12392,0,668,0,6,0,153,0,13219,0,0,0,0,0,0,0,13,18,0,119
Crittenden,8/22/20,0,0,0,0,0,0,0,0,0,1563,0,11085,0,1422,0,27,0,114,0,12648,0,0,0,0,0,0,0,9,8,0,48
Cross,8/22/20,0,0,0,0,0,0,0,0,0,238,0,2866,0,205,0,4,0,29,0,3104,0,0,0,0,0,0,0,2,4,0,16
Dallas,8/22/20,0,0,0,0,0,0,0,0,0,88,0,1276,0,61,0,2,0,25,0,1364,0,0,0,0,0,0,0,2,1,0,7
Desha,8/22/20,0,0,0,0,0,0,0,0,0,220,0,2793,0,194,0,4,0,22,0,3013,0,0,0,0,0,0,0,2,4,0,9
Drew,8/22/20,0,0,0,0,0,0,0,0,0,296,0,4230,0,228,0,4,0,64,0,4526,0,0,0,0,0,0,0,4,4,0,40
Faulkner,8/22/20,0,0,0,0,0,0,0,0,0,1485,0,24873,0,1365,0,7,0,113,0,26358,0,0,0,0,0,0,0,17,19,0,184
Franklin,8/22/20,0,0,0,0,0,0,0,0,0,149,0,3769,0,134,0,2,0,13,0,3918,0,0,0,0,0,0,0,1,3,0,13
Fulton,8/22/20,0,0,0,0,0,0,0,0,0,55,0,766,0,42,0,0,0,13,0,821,0,0,0,0,0,0,0,0,0,0,9
Garland,8/22/20,0,0,0,0,0,0,0,0,0,1288,0,19936,0,1092,0,23,0,173,0,21224,0,0,0,0,0,0,0,12,38,0,99
Grant,8/22/20,0,0,0,0,0,0,0,0,0,164,0,3254,0,143,0,0,0,21,0,3418,0,0,0,0,0,0,0,0,2,0,14
Greene,8/22/20,0,0,0,0,0,0,0,0,0,574,0,8801,0,509,0,3,0,62,0,9375,0,0,0,0,0,0,0,4,8,0,45
Hempstead,8/22/20,0,0,0,0,0,0,0,0,0,303,0,3262,0,258,0,3,0,42,0,3565,0,0,0,0,0,0,0,9,2,0,20
HotSpring,8/22/20,0,0,0,0,0,0,0,0,0,1677,0,7953,0,1571,0,16,0,90,0,9630,0,0,0,0,0,0,0,2,10,1,44
Howard,8/22/20,0,0,0,0,0,0,0,0,0,389,0,3012,0,345,0,4,0,40,0,3401,0,0,0,0,0,0,0,3,1,0,11
Independence,8/22/20,0,0,0,0,0,0,0,0,0,676,0,6843,0,571,0,3,0,102,0,7519,0,0,0,0,0,0,0,7,12,0,23
Izard,8/22/20,0,0,0,0,0,0,0,0,0,78,0,2541,0,58,0,0,0,20,0,2619,0,0,0,0,0,0,0,6,1,0,166
Jackson,8/22/20,0,0,0,0,0,0,0,0,0,171,0,3686,0,117,0,1,0,53,0,3857,0,0,0,0,0,0,0,11,31,0,246
Jefferson,8/22/20,0,0,0,0,0,0,0,0,0,1881,0,19223,0,1571,0,43,0,267,0,21104,0,0,0,0,0,0,0,20,15,0,209
Johnson,8/22/20,0,0,0,0,0,0,0,0,0,734,0,5224,0,683,0,3,0,48,0,5958,0,0,0,0,0,0,0,8,1,0,30
Lafayette,8/22/20,0,0,0,0,0,0,0,0,0,65,0,760,0,57,0,2,0,6,0,825,0,0,0,0,0,0,0,0,0,0,4
Lawrence,8/22/20,0,0,0,0,0,0,0,0,0,239,0,2365,0,213,0,10,0,16,0,2604,0,0,0,0,0,0,0,0,0,1,27
Lee,8/22/20,0,0,0,0,0,0,0,0,0,991,0,3143,0,959,0,8,0,24,0,4134,0,0,0,0,0,0,0,3,2,0,13
Lincoln,8/22/20,0,0,0,0,0,0,0,0,0,1374,0,4871,0,1218,0,13,0,143,0,6245,0,0,0,0,0,0,0,3,8,1,9
LittleRiver,8/22/20,0,0,0,0,0,0,0,0,0,254,0,1386,0,200,0,13,0,41,0,1640,0,0,0,0,0,0,0,2,1,0,5
Logan,8/22/20,0,0,0,0,0,0,0,0,0,347,0,4969,0,280,0,1,0,66,0,5316,0,0,0,0,0,0,0,3,5,0,25
Lonoke,8/22/20,0,0,0,0,0,0,0,0,0,642,0,11506,0,544,0,2,0,96,0,12148,0,0,0,0,0,0,0,7,8,0,210
Madison,8/22/20,0,0,0,0,0,0,0,0,0,286,0,2972,0,278,0,2,0,6,0,3258,0,0,0,0,0,0,0,0,0,0,9
Marion,8/22/20,0,0,0,0,0,0,0,0,0,41,0,1527,0,31,0,0,0,10,0,1568,0,0,0,0,0,0,0,1,1,0,4
Miller,8/22/20,0,0,0,0,0,0,0,0,0,566,0,4618,0,519,0,5,0,42,0,5184,0,0,0,0,0,0,0,14,3,0,486
MissingCountyInfo,8/22/20,0,0,0,0,0,0,0,0,0,813,0,17173,0,611,0,0,0,202,0,17986,0,0,0,0,0,0,0,8,2,0,1515
Mississippi,8/22/20,0,0,0,0,0,0,0,0,0,1249,0,8777,0,1065,0,16,0,168,0,10026,0,0,0,0,0,0,0,18,36,0,74
Monroe,8/22/20,0,0,0,0,0,0,0,0,0,89,0,1628,0,65,0,0,0,24,0,1717,0,0,0,0,0,0,0,3,1,0,18
Montgomery,8/22/20,0,0,0,0,0,0,0,0,0,57,0,1113,0,36,0,2,0,19,0,1170,0,0,0,0,0,0,0,-1,4,0,16
Nevada,8/22/20,0,0,0,0,0,0,0,0,0,156,0,2099,0,136,0,10,0,10,0,2255,0,0,0,0,0,0,0,5,3,1,12
Newton,8/22/20,0,0,0,0,0,0,0,0,0,108,0,1083,0,90,0,15,0,3,0,1191,0,0,0,0,0,0,0,0,0,0,9
Ouachita,8/22/20,0,0,0,0,0,0,0,0,0,129,0,3887,0,110,0,3,0,16,0,4016,0,0,0,0,0,0,0,1,5,0,5
Perry,8/22/20,0,0,0,0,0,0,0,0,0,59,0,1992,0,55,0,0,0,4,0,2051,0,0,0,0,0,0,0,1,1,0,10
Phillips,8/22/20,0,0,0,0,0,0,0,0,0,374,0,4826,0,323,0,9,0,42,0,5200,0,0,0,0,0,0,0,4,10,0,31
Pike,8/22/20,0,0,0,0,0,0,0,0,0,154,0,1652,0,118,0,1,0,35,0,1806,0,0,0,0,0,0,0,0,3,0,3
Poinsett,8/22/20,0,0,0,0,0,0,0,0,0,398,0,4903,0,304,0,4,0,90,0,5301,0,0,0,0,0,0,0,11,3,0,77
Polk,8/22/20,0,0,0,0,0,0,0,0,0,200,0,2882,0,163,0,2,0,35,0,3082,0,0,0,0,0,0,0,1,4,0,14
Pope,8/22/20,0,0,0,0,0,0,0,0,0,1580,0,14866,0,1359,0,14,0,207,0,16446,0,0,0,0,0,0,0,25,16,0,181
Prairie,8/22/20,0,0,0,0,0,0,0,0,0,114,0,1443,0,105,0,0,0,9,0,1557,0,0,0,0,0,0,0,1,2,0,30
Pulaski,8/22/20,0,0,0,0,0,0,0,0,0,6477,0,85639,0,5746,0,94,0,637,0,92116,0,0,0,0,0,0,0,41,110,3,595
Randolph,8/22/20,0,0,0,0,0,0,0,0,0,288,0,3429,0,229,0,11,0,48,0,3717,0,0,0,0,0,0,0,1,4,0,16
Saline,8/22/20,0,0,0,0,0,0,0,0,0,1367,0,17971,0,1112,0,10,0,245,0,19338,0,0,0,0,0,0,0,15,38,0,120
Scott,8/22/20,0,0,0,0,0,0,0,0,0,84,0,1348,0,73,0,0,0,11,0,1432,0,0,0,0,0,0,0,0,0,0,4
Searcy,8/22/20,0,0,0,0,0,0,0,0,0,58,0,1373,0,32,0,0,0,26,0,1431,0,0,0,0,0,0,0,13,0,0,88
Sebastian,8/22/20,0,0,0,0,0,0,0,0,0,2666,0,28943,0,2273,0,27,0,366,0,31609,0,0,0,0,0,0,0,44,38,0,244
Sevier,8/22/20,0,0,0,0,0,0,0,0,0,1114,0,5341,0,1039,0,12,0,63,0,6455,0,0,0,0,0,0,0,5,11,0,36
Sharp,8/22/20,0,0,0,0,0,0,0,0,0,132,0,2587,0,115,0,5,0,12,0,2719,0,0,0,0,0,0,0,0,0,0,10
St.Francis,8/22/20,0,0,0,0,0,0,0,0,0,1263,0,8468,0,1214,0,3,0,46,0,9731,0,0,0,0,0,0,0,5,5,0,53
Stone,8/22/20,0,0,0,0,0,0,0,0,0,151,0,2111,0,79,0,1,0,71,0,2262,0,0,0,0,0,0,0,8,4,0,19
Union,8/22/20,0,0,0,0,0,0,0,0,0,624,0,6512,0,538,0,21,0,65,0,7136,0,0,0,0,0,0,0,12,10,0,172
VanBuren,8/22/20,0,0,0,0,0,0,0,0,0,75,0,2654,0,57,0,2,0,16,0,2729,0,0,0,0,0,0,0,1,0,0,13
Washington,8/22/20,0,0,0,0,0,0,0,0,0,6597,0,48764,0,6335,0,53,0,209,0,55361,0,0,0,0,0,0,0,15,23,0,219
White,8/22/20,0,0,0,0,0,0,0,0,0,448,0,9278,0,333,0,8,0,107,0,9726,0,0,0,0,0,0,0,9,5,1,55
Woodruff,8/22/20,0,0,0,0,0,0,0,0,0,26,0,1242,0,22,0,0,0,4,0,1268,0,0,0,0,0,0,0,0,0,0,5
Yell,8/22/20,0,0,0,0,0,0,0,0,0,1107,0,7155,0,1053,0,21,0,33,0,8262,0,0,0,0,0,0,0,3,2,1,36
Arkansas_all_counties,8/21/20,0,0,0,0,0,0,0,0,2990671,55652,0,602939,0,49135,0,663,0,5854,0,658591,0,0,0,0,0,0,0,887,677,22,10082
Arkansas_county,8/21/20,0,0,0,0,0,0,0,0,0,258,0,3735,0,234,0,2,0,22,0,3993,0,0,0,0,0,0,0,2,4,0,41
Ashley,8/21/20,0,0,0,0,0,0,0,0,0,372,0,3785,0,338,0,7,0,27,0,4157,0,0,0,0,0,0,0,3,7,0,58
Baxter,8/21/20,0,0,0,0,0,0,0,0,0,102,0,2150,0,79,0,0,0,23,0,2252,0,0,0,0,0,0,0,6,1,0,51
Benton,8/21/20,0,0,0,0,0,0,0,0,0,5046,0,51527,0,4803,0,44,0,199,0,56573,0,0,0,0,0,0,0,46,29,1,544
Boone,8/21/20,0,0,0,0,0,0,0,0,0,251,0,5640,0,217,0,1,0,33,0,5891,0,0,0,0,0,0,0,9,2,-1,82
Bradley,8/21/20,0,0,0,0,0,0,0,0,0,243,0,2773,0,191,0,4,0,48,0,3016,0,0,0,0,0,0,0,10,2,0,45
Calhoun,8/21/20,0,0,0,0,0,0,0,0,0,22,0,1192,0,16,0,0,0,6,0,1214,0,0,0,0,0,0,0,0,0,0,41
Carroll,8/21/20,0,0,0,0,0,0,0,0,0,422,0,5076,0,357,0,7,0,58,0,5498,0,0,0,0,0,0,0,13,5,0,76
Chicot,8/21/20,0,0,0,0,0,0,0,0,0,933,0,3898,0,722,0,9,0,202,0,4831,0,0,0,0,0,0,0,1,8,0,30
Clark,8/21/20,0,0,0,0,0,0,0,0,0,201,0,4264,0,177,0,3,0,21,0,4465,0,0,0,0,0,0,0,5,0,1,25
Clay,8/21/20,0,0,0,0,0,0,0,0,0,159,0,2774,0,129,0,5,0,25,0,2933,0,0,0,0,0,0,0,5,3,0,37
Cleburne,8/21/20,0,0,0,0,0,0,0,0,0,242,0,3979,0,207,0,5,0,30,0,4221,0,0,0,0,0,0,0,5,3,0,55
Cleveland,8/21/20,0,0,0,0,0,0,0,0,0,127,0,1722,0,97,0,2,0,28,0,1849,0,0,0,0,0,0,0,3,0,0,32
Columbia,8/21/20,0,0,0,0,0,0,0,0,0,265,0,3308,0,225,0,12,0,28,0,3573,0,0,0,0,0,0,0,10,3,0,30
Conway,8/21/20,0,0,0,0,0,0,0,0,0,184,0,4370,0,157,0,3,0,24,0,4554,0,0,0,0,0,0,0,6,10,0,41
Craighead,8/21/20,0,0,0,0,0,0,0,0,0,1621,0,21115,0,1410,0,13,0,198,0,22736,0,0,0,0,0,0,0,23,20,0,181
Crawford,8/21/20,0,0,0,0,0,0,0,0,0,814,0,12286,0,650,0,6,0,158,0,13100,0,0,0,0,0,0,0,24,12,0,182
Crittenden,8/21/20,0,0,0,0,0,0,0,0,0,1554,0,11046,0,1414,0,27,0,113,0,12600,0,0,0,0,0,0,0,24,31,1,89
Cross,8/21/20,0,0,0,0,0,0,0,0,0,236,0,2852,0,201,0,4,0,31,0,3088,0,0,0,0,0,0,0,0,4,0,23
Dallas,8/21/20,0,0,0,0,0,0,0,0,0,86,0,1271,0,60,0,2,0,24,0,1357,0,0,0,0,0,0,0,16,0,0,38
Desha,8/21/20,0,0,0,0,0,0,0,0,0,218,0,2786,0,190,0,4,0,24,0,3004,0,0,0,0,0,0,0,5,2,0,38
Drew,8/21/20,0,0,0,0,0,0,0,0,0,292,0,4194,0,224,0,4,0,64,0,4486,0,0,0,0,0,0,0,6,9,1,64
Faulkner,8/21/20,0,0,0,0,0,0,0,0,0,1468,0,24706,0,1346,0,7,0,115,0,26174,0,0,0,0,0,0,0,30,31,0,307
Franklin,8/21/20,0,0,0,0,0,0,0,0,0,148,0,3757,0,131,0,2,0,15,0,3905,0,0,0,0,0,0,0,1,1,0,44
Fulton,8/21/20,0,0,0,0,0,0,0,0,0,55,0,757,0,42,0,0,0,13,0,812,0,0,0,0,0,0,0,3,0,0,13
Garland,8/21/20,0,0,0,0,0,0,0,0,0,1276,0,19849,0,1054,0,23,0,199,0,21125,0,0,0,0,0,0,0,20,22,2,163
Grant,8/21/20,0,0,0,0,0,0,0,0,0,164,0,3240,0,141,0,0,0,23,0,3404,0,0,0,0,0,0,0,5,1,0,43
Greene,8/21/20,0,0,0,0,0,0,0,0,0,570,0,8760,0,501,0,3,0,66,0,9330,0,0,0,0,0,0,0,7,9,0,192
Hempstead,8/21/20,0,0,0,0,0,0,0,0,0,294,0,3251,0,256,0,3,0,35,0,3545,0,0,0,0,0,0,0,10,7,0,44
HotSpring,8/21/20,0,0,0,0,0,0,0,0,0,1675,0,7911,0,1561,0,15,0,99,0,9586,0,0,0,0,0,0,0,16,38,1,74
Howard,8/21/20,0,0,0,0,0,0,0,0,0,386,0,3004,0,344,0,4,0,38,0,3390,0,0,0,0,0,0,0,3,7,1,19
Independence,8/21/20,0,0,0,0,0,0,0,0,0,669,0,6827,0,559,0,3,0,107,0,7496,0,0,0,0,0,0,0,18,17,0,116
Izard,8/21/20,0,0,0,0,0,0,0,0,0,72,0,2381,0,57,0,0,0,15,0,2453,0,0,0,0,0,0,0,3,1,0,552
Jackson,8/21/20,0,0,0,0,0,0,0,0,0,160,0,3451,0,86,0,1,0,73,0,3611,0,0,0,0,0,0,0,5,3,0,241
Jefferson,8/21/20,0,0,0,0,0,0,0,0,0,1861,0,19034,0,1556,0,43,0,262,0,20895,0,0,0,0,0,0,0,30,23,2,1713
Johnson,8/21/20,0,0,0,0,0,0,0,0,0,726,0,5202,0,682,0,3,0,41,0,5928,0,0,0,0,0,0,0,2,1,0,65
Lafayette,8/21/20,0,0,0,0,0,0,0,0,0,65,0,756,0,57,0,2,0,6,0,821,0,0,0,0,0,0,0,1,0,0,10
Lawrence,8/21/20,0,0,0,0,0,0,0,0,0,239,0,2338,0,213,0,9,0,17,0,2577,0,0,0,0,0,0,0,1,2,0,49
Lee,8/21/20,0,0,0,0,0,0,0,0,0,988,0,3133,0,957,0,8,0,23,0,4121,0,0,0,0,0,0,0,2,0,0,37
Lincoln,8/21/20,0,0,0,0,0,0,0,0,0,1371,0,4865,0,1210,0,12,0,149,0,6236,0,0,0,0,0,0,0,11,6,0,54
LittleRiver,8/21/20,0,0,0,0,0,0,0,0,0,252,0,1383,0,199,0,13,0,40,0,1635,0,0,0,0,0,0,0,4,-2,7,18
Logan,8/21/20,0,0,0,0,0,0,0,0,0,344,0,4947,0,275,0,1,0,68,0,5291,0,0,0,0,0,0,0,1,8,0,63
Lonoke,8/21/20,0,0,0,0,0,0,0,0,0,635,0,11303,0,536,0,2,0,97,0,11938,0,0,0,0,0,0,0,24,14,0,214
Madison,8/21/20,0,0,0,0,0,0,0,0,0,286,0,2963,0,278,0,2,0,6,0,3249,0,0,0,0,0,0,0,0,0,0,21
Marion,8/21/20,0,0,0,0,0,0,0,0,0,40,0,1524,0,30,0,0,0,10,0,1564,0,0,0,0,0,0,0,2,0,0,22
Miller,8/21/20,0,0,0,0,0,0,0,0,0,552,0,4146,0,516,0,5,0,31,0,4698,0,0,0,0,0,0,0,11,9,0,36
MissingCountyInfo,8/21/20,0,0,0,0,0,0,0,0,0,805,0,15666,0,609,0,0,0,196,0,16471,0,0,0,0,0,0,0,31,33,0,102
Mississippi,8/21/20,0,0,0,0,0,0,0,0,0,1231,0,8721,0,1029,0,16,0,186,0,9952,0,0,0,0,0,0,0,15,20,0,127
Monroe,8/21/20,0,0,0,0,0,0,0,0,0,86,0,1613,0,64,0,0,0,22,0,1699,0,0,0,0,0,0,0,2,2,0,44
Montgomery,8/21/20,0,0,0,0,0,0,0,0,0,58,0,1096,0,32,0,2,0,24,0,1154,0,0,0,0,0,0,0,2,0,0,21
Nevada,8/21/20,0,0,0,0,0,0,0,0,0,151,0,2092,0,133,0,9,0,9,0,2243,0,0,0,0,0,0,0,1,0,0,16
Newton,8/21/20,0,0,0,0,0,0,0,0,0,108,0,1074,0,90,0,15,0,3,0,1182,0,0,0,0,0,0,0,1,-2,3,12
Ouachita,8/21/20,0,0,0,0,0,0,0,0,0,128,0,3883,0,105,0,3,0,20,0,4011,0,0,0,0,0,0,0,4,1,0,49
Perry,8/21/20,0,0,0,0,0,0,0,0,0,58,0,1983,0,54,0,0,0,4,0,2041,0,0,0,0,0,0,0,2,1,0,19
Phillips,8/21/20,0,0,0,0,0,0,0,0,0,370,0,4799,0,313,0,9,0,48,0,5169,0,0,0,0,0,0,0,4,0,0,42
Pike,8/21/20,0,0,0,0,0,0,0,0,0,154,0,1649,0,115,0,1,0,38,0,1803,0,0,0,0,0,0,0,3,6,0,24
Poinsett,8/21/20,0,0,0,0,0,0,0,0,0,387,0,4837,0,301,0,4,0,82,0,5224,0,0,0,0,0,0,0,20,10,0,150
Polk,8/21/20,0,0,0,0,0,0,0,0,0,199,0,2869,0,159,0,2,0,38,0,3068,0,0,0,0,0,0,0,8,5,0,48
Pope,8/21/20,0,0,0,0,0,0,0,0,0,1555,0,14710,0,1343,0,14,0,198,0,16265,0,0,0,0,0,0,0,35,25,0,253
Prairie,8/21/20,0,0,0,0,0,0,0,0,0,113,0,1414,0,103,0,0,0,10,0,1527,0,0,0,0,0,0,0,1,6,0,25
Pulaski,8/21/20,0,0,0,0,0,0,0,0,0,6436,0,85085,0,5636,0,91,0,709,0,91521,0,0,0,0,0,0,0,95,74,0,938
Randolph,8/21/20,0,0,0,0,0,0,0,0,0,287,0,3414,0,225,0,11,0,51,0,3701,0,0,0,0,0,0,0,2,3,0,40
Saline,8/21/20,0,0,0,0,0,0,0,0,0,1352,0,17866,0,1074,0,10,0,268,0,19218,0,0,0,0,0,0,0,18,21,0,228
Scott,8/21/20,0,0,0,0,0,0,0,0,0,84,0,1344,0,73,0,0,0,11,0,1428,0,0,0,0,0,0,0,0,3,0,13
Searcy,8/21/20,0,0,0,0,0,0,0,0,0,45,0,1298,0,32,0,0,0,13,0,1343,0,0,0,0,0,0,0,6,1,0,18
Sebastian,8/21/20,0,0,0,0,0,0,0,0,0,2622,0,28743,0,2235,0,27,0,360,0,31365,0,0,0,0,0,0,0,39,47,0,705
Sevier,8/21/20,0,0,0,0,0,0,0,0,0,1109,0,5310,0,1028,0,12,0,69,0,6419,0,0,0,0,0,0,0,23,13,1,40
Sharp,8/21/20,0,0,0,0,0,0,0,0,0,132,0,2577,0,115,0,5,0,12,0,2709,0,0,0,0,0,0,0,2,3,0,33
St.Francis,8/21/20,0,0,0,0,0,0,0,0,0,1258,0,8420,0,1209,0,3,0,46,0,9678,0,0,0,0,0,0,0,6,8,0,251
Stone,8/21/20,0,0,0,0,0,0,0,0,0,143,0,2100,0,75,0,1,0,67,0,2243,0,0,0,0,0,0,0,30,1,0,68
Union,8/21/20,0,0,0,0,0,0,0,0,0,612,0,6352,0,528,0,21,0,63,0,6964,0,0,0,0,0,0,0,15,10,0,45
VanBuren,8/21/20,0,0,0,0,0,0,0,0,0,74,0,2642,0,57,0,2,0,15,0,2716,0,0,0,0,0,0,0,4,2,0,26
Washington,8/21/20,0,0,0,0,0,0,0,0,0,6582,0,48560,0,6312,0,53,0,217,0,55142,0,0,0,0,0,0,0,65,29,0,687
White,8/21/20,0,0,0,0,0,0,0,0,0,439,0,9232,0,328,0,7,0,104,0,9671,0,0,0,0,0,0,0,17,0,2,76
Woodruff,8/21/20,0,0,0,0,0,0,0,0,0,26,0,1237,0,22,0,0,0,4,0,1263,0,0,0,0,0,0,0,0,0,0,17
Yell,8/21/20,0,0,0,0,0,0,0,0,0,1104,0,7122,0,1051,0,20,0,33,0,8226,0,0,0,0,0,0,0,4,2,0,52
Arkansas_all_counties,8/20/20,0,0,0,0,0,0,0,0,2990671,54765,0,593744,0,48458,0,641,0,5666,0,648509,0,0,0,0,0,0,0,549,792,10,7229
Arkansas_county,8/20/20,0,0,0,0,0,0,0,0,0,256,0,3696,0,230,0,2,0,24,0,3952,0,0,0,0,0,0,0,1,1,0,28
Ashley,8/20/20,0,0,0,0,0,0,0,0,0,369,0,3730,0,331,0,7,0,31,0,4099,0,0,0,0,0,0,0,2,9,1,30
Baxter,8/20/20,0,0,0,0,0,0,0,0,0,96,0,2105,0,78,0,0,0,18,0,2201,0,0,0,0,0,0,0,5,4,0,46
Benton,8/20/20,0,0,0,0,0,0,0,0,0,5000,0,51029,0,4774,0,43,0,183,0,56029,0,0,0,0,0,0,0,20,27,0,398
Boone,8/20/20,0,0,0,0,0,0,0,0,0,242,0,5567,0,215,0,2,0,25,0,5809,0,0,0,0,0,0,0,4,7,0,21
Bradley,8/20/20,0,0,0,0,0,0,0,0,0,233,0,2738,0,189,0,4,0,40,0,2971,0,0,0,0,0,0,0,2,3,0,30
Calhoun,8/20/20,0,0,0,0,0,0,0,0,0,22,0,1151,0,16,0,0,0,6,0,1173,0,0,0,0,0,0,0,0,1,0,4
Carroll,8/20/20,0,0,0,0,0,0,0,0,0,409,0,5013,0,352,0,7,0,50,0,5422,0,0,0,0,0,0,0,1,1,0,13
Chicot,8/20/20,0,0,0,0,0,0,0,0,0,932,0,3869,0,714,0,9,0,209,0,4801,0,0,0,0,0,0,0,1,8,0,16
Clark,8/20/20,0,0,0,0,0,0,0,0,0,196,0,4244,0,177,0,2,0,17,0,4440,0,0,0,0,0,0,0,0,0,0,14
Clay,8/20/20,0,0,0,0,0,0,0,0,0,154,0,2742,0,126,0,5,0,23,0,2896,0,0,0,0,0,0,0,4,3,0,21
Cleburne,8/20/20,0,0,0,0,0,0,0,0,0,237,0,3929,0,204,0,5,0,28,0,4166,0,0,0,0,0,0,0,4,7,0,39
Cleveland,8/20/20,0,0,0,0,0,0,0,0,0,124,0,1693,0,97,0,2,0,25,0,1817,0,0,0,0,0,0,0,0,3,0,17
Columbia,8/20/20,0,0,0,0,0,0,0,0,0,255,0,3288,0,222,0,12,0,21,0,3543,0,0,0,0,0,0,0,3,2,0,20
Conway,8/20/20,0,0,0,0,0,0,0,0,0,178,0,4335,0,147,0,3,0,28,0,4513,0,0,0,0,0,0,0,3,2,0,47
Craighead,8/20/20,0,0,0,0,0,0,0,0,0,1598,0,20957,0,1390,0,13,0,195,0,22555,0,0,0,0,0,0,0,38,24,0,273
Crawford,8/20/20,0,0,0,0,0,0,0,0,0,790,0,12128,0,638,0,6,0,146,0,12918,0,0,0,0,0,0,0,22,21,1,159
Crittenden,8/20/20,0,0,0,0,0,0,0,0,0,1530,0,10981,0,1383,0,26,0,121,0,12511,0,0,0,0,0,0,0,15,18,0,67
Cross,8/20/20,0,0,0,0,0,0,0,0,0,236,0,2829,0,197,0,4,0,35,0,3065,0,0,0,0,0,0,0,3,3,0,34
Dallas,8/20/20,0,0,0,0,0,0,0,0,0,70,0,1249,0,60,0,2,0,8,0,1319,0,0,0,0,0,0,0,0,-1,0,16
Desha,8/20/20,0,0,0,0,0,0,0,0,0,213,0,2753,0,188,0,4,0,21,0,2966,0,0,0,0,0,0,0,1,7,1,30
Drew,8/20/20,0,0,0,0,0,0,0,0,0,286,0,4136,0,215,0,3,0,68,0,4422,0,0,0,0,0,0,0,3,7,0,9
Faulkner,8/20/20,0,0,0,0,0,0,0,0,0,1438,0,24429,0,1315,0,7,0,116,0,25867,0,0,0,0,0,0,0,16,7,0,193
Franklin,8/20/20,0,0,0,0,0,0,0,0,0,147,0,3714,0,130,0,2,0,15,0,3861,0,0,0,0,0,0,0,0,2,0,35
Fulton,8/20/20,0,0,0,0,0,0,0,0,0,52,0,747,0,42,0,0,0,10,0,799,0,0,0,0,0,0,0,1,5,0,7
Garland,8/20/20,0,0,0,0,0,0,0,0,0,1256,0,19706,0,1032,0,21,0,203,0,20962,0,0,0,0,0,0,0,23,19,2,163
Grant,8/20/20,0,0,0,0,0,0,0,0,0,159,0,3202,0,140,0,0,0,19,0,3361,0,0,0,0,0,0,0,2,0,0,18
Greene,8/20/20,0,0,0,0,0,0,0,0,0,563,0,8575,0,492,0,3,0,68,0,9138,0,0,0,0,0,0,0,4,13,0,143
Hempstead,8/20/20,0,0,0,0,0,0,0,0,0,284,0,3217,0,249,0,3,0,32,0,3501,0,0,0,0,0,0,0,7,4,0,9
HotSpring,8/20/20,0,0,0,0,0,0,0,0,0,1659,0,7853,0,1523,0,14,0,122,0,9512,0,0,0,0,0,0,0,4,13,0,70
Howard,8/20/20,0,0,0,0,0,0,0,0,0,383,0,2988,0,337,0,3,0,43,0,3371,0,0,0,0,0,0,0,3,3,0,26
Independence,8/20/20,0,0,0,0,0,0,0,0,0,651,0,6729,0,542,0,3,0,106,0,7380,0,0,0,0,0,0,0,16,34,0,272
Izard,8/20/20,0,0,0,0,0,0,0,0,0,69,0,1832,0,56,0,0,0,13,0,1901,0,0,0,0,0,0,0,0,2,0,291
Jackson,8/20/20,0,0,0,0,0,0,0,0,0,155,0,3215,0,83,0,1,0,71,0,3370,0,0,0,0,0,0,0,2,13,0,376
Jefferson,8/20/20,0,0,0,0,0,0,0,0,0,1831,0,17351,0,1533,0,41,0,257,0,19182,0,0,0,0,0,0,0,55,60,0,514
Johnson,8/20/20,0,0,0,0,0,0,0,0,0,724,0,5139,0,681,0,3,0,40,0,5863,0,0,0,0,0,0,0,7,5,1,33
Lafayette,8/20/20,0,0,0,0,0,0,0,0,0,64,0,747,0,57,0,2,0,5,0,811,0,0,0,0,0,0,0,1,1,0,6
Lawrence,8/20/20,0,0,0,0,0,0,0,0,0,238,0,2290,0,211,0,9,0,18,0,2528,0,0,0,0,0,0,0,4,1,0,25
Lee,8/20/20,0,0,0,0,0,0,0,0,0,986,0,3098,0,957,0,8,0,21,0,4084,0,0,0,0,0,0,0,3,1,0,13
Lincoln,8/20/20,0,0,0,0,0,0,0,0,0,1360,0,4822,0,1204,0,12,0,144,0,6182,0,0,0,0,0,0,0,4,4,0,156
LittleRiver,8/20/20,0,0,0,0,0,0,0,0,0,248,0,1369,0,201,0,6,0,41,0,1617,0,0,0,0,0,0,0,11,8,1,17
Logan,8/20/20,0,0,0,0,0,0,0,0,0,343,0,4885,0,267,0,1,0,75,0,5228,0,0,0,0,0,0,0,4,6,0,36
Lonoke,8/20/20,0,0,0,0,0,0,0,0,0,611,0,11113,0,522,0,2,0,87,0,11724,0,0,0,0,0,0,0,7,11,0,119
Madison,8/20/20,0,0,0,0,0,0,0,0,0,286,0,2942,0,278,0,2,0,6,0,3228,0,0,0,0,0,0,0,2,1,0,17
Marion,8/20/20,0,0,0,0,0,0,0,0,0,38,0,1504,0,30,0,0,0,8,0,1542,0,0,0,0,0,0,0,1,0,0,22
Miller,8/20/20,0,0,0,0,0,0,0,0,0,541,0,4121,0,507,0,5,0,29,0,4662,0,0,0,0,0,0,0,-5,0,0,20
MissingCountyInfo,8/20/20,0,0,0,0,0,0,0,0,0,774,0,15595,0,576,0,0,0,198,0,16369,0,0,0,0,0,0,0,-12,-2,0,-54
Mississippi,8/20/20,0,0,0,0,0,0,0,0,0,1216,0,8609,0,1009,0,16,0,191,0,9825,0,0,0,0,0,0,0,20,28,0,105
Monroe,8/20/20,0,0,0,0,0,0,0,0,0,84,0,1571,0,62,0,0,0,22,0,1655,0,0,0,0,0,0,0,3,2,0,25
Montgomery,8/20/20,0,0,0,0,0,0,0,0,0,56,0,1077,0,32,0,2,0,22,0,1133,0,0,0,0,0,0,0,3,0,1,15
Nevada,8/20/20,0,0,0,0,0,0,0,0,0,150,0,2077,0,133,0,9,0,8,0,2227,0,0,0,0,0,0,0,3,3,0,14
Newton,8/20/20,0,0,0,0,0,0,0,0,0,107,0,1063,0,92,0,12,0,3,0,1170,0,0,0,0,0,0,0,0,0,1,4
Ouachita,8/20/20,0,0,0,0,0,0,0,0,0,124,0,3838,0,104,0,3,0,17,0,3962,0,0,0,0,0,0,0,4,6,0,39
Perry,8/20/20,0,0,0,0,0,0,0,0,0,56,0,1966,0,53,0,0,0,3,0,2022,0,0,0,0,0,0,0,1,3,0,14
Phillips,8/20/20,0,0,0,0,0,0,0,0,0,366,0,4761,0,313,0,9,0,44,0,5127,0,0,0,0,0,0,0,6,2,0,31
Pike,8/20/20,0,0,0,0,0,0,0,0,0,151,0,1628,0,109,0,1,0,41,0,1779,0,0,0,0,0,0,0,0,5,0,12
Poinsett,8/20/20,0,0,0,0,0,0,0,0,0,367,0,4707,0,291,0,4,0,72,0,5074,0,0,0,0,0,0,0,9,14,0,54
Polk,8/20/20,0,0,0,0,0,0,0,0,0,191,0,2829,0,154,0,2,0,35,0,3020,0,0,0,0,0,0,0,5,9,0,21
Pope,8/20/20,0,0,0,0,0,0,0,0,0,1520,0,14492,0,1318,0,14,0,188,0,16012,0,0,0,0,0,0,0,21,7,0,177
Prairie,8/20/20,0,0,0,0,0,0,0,0,0,112,0,1390,0,97,0,0,0,15,0,1502,0,0,0,0,0,0,0,0,4,0,15
Pulaski,8/20/20,0,0,0,0,0,0,0,0,0,6341,0,84242,0,5562,0,91,0,688,0,90583,0,0,0,0,0,0,0,57,177,0,1100
Randolph,8/20/20,0,0,0,0,0,0,0,0,0,285,0,3376,0,222,0,11,0,52,0,3661,0,0,0,0,0,0,0,5,5,0,36
Saline,8/20/20,0,0,0,0,0,0,0,0,0,1334,0,17656,0,1053,0,10,0,271,0,18990,0,0,0,0,0,0,0,15,19,0,187
Scott,8/20/20,0,0,0,0,0,0,0,0,0,84,0,1331,0,70,0,0,0,14,0,1415,0,0,0,0,0,0,0,4,7,0,27
Searcy,8/20/20,0,0,0,0,0,0,0,0,0,39,0,1286,0,31,0,0,0,8,0,1325,0,0,0,0,0,0,0,2,0,0,1
Sebastian,8/20/20,0,0,0,0,0,0,0,0,0,2583,0,28077,0,2188,0,27,0,368,0,30660,0,0,0,0,0,0,0,31,42,0,530
Sevier,8/20/20,0,0,0,0,0,0,0,0,0,1086,0,5293,0,1015,0,11,0,60,0,6379,0,0,0,0,0,0,0,7,6,0,28
Sharp,8/20/20,0,0,0,0,0,0,0,0,0,130,0,2546,0,112,0,5,0,13,0,2676,0,0,0,0,0,0,0,2,1,0,20
St.Francis,8/20/20,0,0,0,0,0,0,0,0,0,1252,0,8175,0,1201,0,3,0,48,0,9427,0,0,0,0,0,0,0,7,28,0,35
Stone,8/20/20,0,0,0,0,0,0,0,0,0,113,0,2062,0,74,0,1,0,38,0,2175,0,0,0,0,0,0,0,15,3,0,30
Union,8/20/20,0,0,0,0,0,0,0,0,0,597,0,6322,0,518,0,21,0,58,0,6919,0,0,0,0,0,0,0,8,12,0,83
VanBuren,8/20/20,0,0,0,0,0,0,0,0,0,70,0,2620,0,55,0,2,0,13,0,2690,0,0,0,0,0,0,0,6,2,0,20
Washington,8/20/20,0,0,0,0,0,0,0,0,0,6517,0,47938,0,6283,0,53,0,181,0,54455,0,0,0,0,0,0,0,10,27,0,656
White,8/20/20,0,0,0,0,0,0,0,0,0,422,0,9173,0,328,0,5,0,89,0,9595,0,0,0,0,0,0,0,10,9,0,41
Woodruff,8/20/20,0,0,0,0,0,0,0,0,0,26,0,1220,0,22,0,0,0,4,0,1246,0,0,0,0,0,0,0,0,0,0,9
Yell,8/20/20,0,0,0,0,0,0,0,0,0,1100,0,7074,0,1049,0,20,0,31,0,8174,0,0,0,0,0,0,0,3,3,1,41
Arkansas_all_counties,8/19/20,0,0,0,0,0,0,0,0,2990671,54216,0,587064,0,47666,0,631,0,5919,0,641280,0,0,0,0,0,0,0,729,696,12,4550
Arkansas_county,8/19/20,0,0,0,0,0,0,0,0,0,255,0,3669,0,229,0,2,0,24,0,3924,0,0,0,0,0,0,0,4,7,0,44
Ashley,8/19/20,0,0,0,0,0,0,0,0,0,367,0,3702,0,322,0,6,0,39,0,4069,0,0,0,0,0,0,0,5,12,0,50
Baxter,8/19/20,0,0,0,0,0,0,0,0,0,91,0,2064,0,74,0,0,0,17,0,2155,0,0,0,0,0,0,0,2,1,0,27
Benton,8/19/20,0,0,0,0,0,0,0,0,0,4980,0,50651,0,4747,0,43,0,190,0,55631,0,0,0,0,0,0,0,30,27,0,338
Boone,8/19/20,0,0,0,0,0,0,0,0,0,238,0,5550,0,208,0,2,0,28,0,5788,0,0,0,0,0,0,0,6,7,0,44
Bradley,8/19/20,0,0,0,0,0,0,0,0,0,231,0,2710,0,186,0,4,0,41,0,2941,0,0,0,0,0,0,0,1,6,0,18
Calhoun,8/19/20,0,0,0,0,0,0,0,0,0,22,0,1147,0,15,0,0,0,7,0,1169,0,0,0,0,0,0,0,0,0,0,6
Carroll,8/19/20,0,0,0,0,0,0,0,0,0,408,0,5001,0,351,0,7,0,50,0,5409,0,0,0,0,0,0,0,7,3,0,30
Chicot,8/19/20,0,0,0,0,0,0,0,0,0,931,0,3854,0,706,0,9,0,216,0,4785,0,0,0,0,0,0,0,5,41,0,13
Clark,8/19/20,0,0,0,0,0,0,0,0,0,196,0,4230,0,177,0,2,0,17,0,4426,0,0,0,0,0,0,0,1,2,0,18
Clay,8/19/20,0,0,0,0,0,0,0,0,0,150,0,2725,0,123,0,5,0,22,0,2875,0,0,0,0,0,0,0,3,2,0,11
Cleburne,8/19/20,0,0,0,0,0,0,0,0,0,233,0,3894,0,197,0,5,0,31,0,4127,0,0,0,0,0,0,0,4,6,0,21
Cleveland,8/19/20,0,0,0,0,0,0,0,0,0,124,0,1676,0,94,0,2,0,28,0,1800,0,0,0,0,0,0,0,3,1,0,10
Columbia,8/19/20,0,0,0,0,0,0,0,0,0,252,0,3271,0,220,0,12,0,20,0,3523,0,0,0,0,0,0,0,2,6,0,12
Conway,8/19/20,0,0,0,0,0,0,0,0,0,175,0,4291,0,145,0,3,0,27,0,4466,0,0,0,0,0,0,0,6,1,0,33
Craighead,8/19/20,0,0,0,0,0,0,0,0,0,1560,0,20722,0,1366,0,13,0,181,0,22282,0,0,0,0,0,0,0,48,21,-1,239
Crawford,8/19/20,0,0,0,0,0,0,0,0,0,768,0,11991,0,617,0,5,0,146,0,12759,0,0,0,0,0,0,0,11,19,0,125
Crittenden,8/19/20,0,0,0,0,0,0,0,0,0,1515,0,10929,0,1365,0,26,0,124,0,12444,0,0,0,0,0,0,0,12,23,0,59
Cross,8/19/20,0,0,0,0,0,0,0,0,0,233,0,2798,0,194,0,4,0,35,0,3031,0,0,0,0,0,0,0,4,3,0,22
Dallas,8/19/20,0,0,0,0,0,0,0,0,0,70,0,1233,0,61,0,2,0,7,0,1303,0,0,0,0,0,0,0,-1,0,0,3
Desha,8/19/20,0,0,0,0,0,0,0,0,0,212,0,2724,0,181,0,3,0,28,0,2936,0,0,0,0,0,0,0,0,6,0,10
Drew,8/19/20,0,0,0,0,0,0,0,0,0,283,0,4130,0,208,0,3,0,72,0,4413,0,0,0,0,0,0,0,6,12,0,29
Faulkner,8/19/20,0,0,0,0,0,0,0,0,0,1422,0,24252,0,1308,0,7,0,107,0,25674,0,0,0,0,0,0,0,10,12,0,176
Franklin,8/19/20,0,0,0,0,0,0,0,0,0,147,0,3679,0,128,0,2,0,17,0,3826,0,0,0,0,0,0,0,1,0,0,25
Fulton,8/19/20,0,0,0,0,0,0,0,0,0,51,0,741,0,37,0,0,0,14,0,792,0,0,0,0,0,0,0,0,2,0,6
Garland,8/19/20,0,0,0,0,0,0,0,0,0,1233,0,19566,0,1013,0,19,0,201,0,20799,0,0,0,0,0,0,0,26,32,1,217
Grant,8/19/20,0,0,0,0,0,0,0,0,0,157,0,3186,0,140,0,0,0,17,0,3343,0,0,0,0,0,0,0,0,1,0,17
Greene,8/19/20,0,0,0,0,0,0,0,0,0,559,0,8436,0,479,0,3,0,77,0,8995,0,0,0,0,0,0,0,11,9,0,64
Hempstead,8/19/20,0,0,0,0,0,0,0,0,0,277,0,3215,0,245,0,3,0,29,0,3492,0,0,0,0,0,0,0,5,7,1,7
HotSpring,8/19/20,0,0,0,0,0,0,0,0,0,1655,0,7787,0,1510,0,14,0,131,0,9442,0,0,0,0,0,0,0,8,13,0,56
Howard,8/19/20,0,0,0,0,0,0,0,0,0,380,0,2965,0,334,0,3,0,43,0,3345,0,0,0,0,0,0,0,4,15,-1,19
Independence,8/19/20,0,0,0,0,0,0,0,0,0,635,0,6473,0,508,0,3,0,124,0,7108,0,0,0,0,0,0,0,9,13,1,45
Izard,8/19/20,0,0,0,0,0,0,0,0,0,69,0,1541,0,54,0,0,0,15,0,1610,0,0,0,0,0,0,0,4,1,0,16
Jackson,8/19/20,0,0,0,0,0,0,0,0,0,153,0,2841,0,70,0,1,0,82,0,2994,0,0,0,0,0,0,0,22,3,0,28
Jefferson,8/19/20,0,0,0,0,0,0,0,0,0,1776,0,16892,0,1473,0,41,0,262,0,18668,0,0,0,0,0,0,0,58,34,0,107
Johnson,8/19/20,0,0,0,0,0,0,0,0,0,717,0,5113,0,676,0,2,0,39,0,5830,0,0,0,0,0,0,0,22,7,0,61
Lafayette,8/19/20,0,0,0,0,0,0,0,0,0,63,0,742,0,56,0,2,0,5,0,805,0,0,0,0,0,0,0,1,2,0,3
Lawrence,8/19/20,0,0,0,0,0,0,0,0,0,234,0,2269,0,210,0,9,0,15,0,2503,0,0,0,0,0,0,0,2,2,0,23
Lee,8/19/20,0,0,0,0,0,0,0,0,0,983,0,3088,0,956,0,8,0,19,0,4071,0,0,0,0,0,0,0,0,-1,0,8
Lincoln,8/19/20,0,0,0,0,0,0,0,0,0,1356,0,4670,0,1200,0,12,0,144,0,6026,0,0,0,0,0,0,0,1,0,0,6
LittleRiver,8/19/20,0,0,0,0,0,0,0,0,0,237,0,1363,0,193,0,5,0,39,0,1600,0,0,0,0,0,0,0,10,6,1,18
Logan,8/19/20,0,0,0,0,0,0,0,0,0,339,0,4853,0,261,0,1,0,77,0,5192,0,0,0,0,0,0,0,2,17,0,28
Lonoke,8/19/20,0,0,0,0,0,0,0,0,0,604,0,11001,0,511,0,2,0,91,0,11605,0,0,0,0,0,0,0,15,12,0,85
Madison,8/19/20,0,0,0,0,0,0,0,0,0,284,0,2927,0,277,0,2,0,5,0,3211,0,0,0,0,0,0,0,4,5,0,27
Marion,8/19/20,0,0,0,0,0,0,0,0,0,37,0,1483,0,30,0,0,0,7,0,1520,0,0,0,0,0,0,0,3,0,0,18
Miller,8/19/20,0,0,0,0,0,0,0,0,0,546,0,4096,0,507,0,5,0,34,0,4642,0,0,0,0,0,0,0,5,4,0,18
MissingCountyInfo,8/19/20,0,0,0,0,0,0,0,0,0,786,0,15637,0,578,0,0,0,208,0,16423,0,0,0,0,0,0,0,1,19,0,111
Mississippi,8/19/20,0,0,0,0,0,0,0,0,0,1196,0,8524,0,981,0,16,0,199,0,9720,0,0,0,0,0,0,0,32,18,1,87
Monroe,8/19/20,0,0,0,0,0,0,0,0,0,81,0,1549,0,60,0,0,0,21,0,1630,0,0,0,0,0,0,0,2,2,0,18
Montgomery,8/19/20,0,0,0,0,0,0,0,0,0,53,0,1065,0,32,0,1,0,20,0,1118,0,0,0,0,0,0,0,8,4,0,12
Nevada,8/19/20,0,0,0,0,0,0,0,0,0,147,0,2066,0,130,0,9,0,8,0,2213,0,0,0,0,0,0,0,0,1,0,7
Newton,8/19/20,0,0,0,0,0,0,0,0,0,107,0,1059,0,92,0,11,0,4,0,1166,0,0,0,0,0,0,0,0,1,0,7
Ouachita,8/19/20,0,0,0,0,0,0,0,0,0,120,0,3803,0,98,0,3,0,19,0,3923,0,0,0,0,0,0,0,2,2,0,15
Perry,8/19/20,0,0,0,0,0,0,0,0,0,55,0,1953,0,50,0,0,0,5,0,2008,0,0,0,0,0,0,0,0,0,0,5
Phillips,8/19/20,0,0,0,0,0,0,0,0,0,360,0,4736,0,311,0,9,0,40,0,5096,0,0,0,0,0,0,0,3,1,0,21
Pike,8/19/20,0,0,0,0,0,0,0,0,0,151,0,1616,0,104,0,1,0,46,0,1767,0,0,0,0,0,0,0,5,3,0,17
Poinsett,8/19/20,0,0,0,0,0,0,0,0,0,358,0,4662,0,277,0,4,0,77,0,5020,0,0,0,0,0,0,0,8,13,0,42
Polk,8/19/20,0,0,0,0,0,0,0,0,0,186,0,2813,0,145,0,2,0,39,0,2999,0,0,0,0,0,0,0,9,6,1,26
Pope,8/19/20,0,0,0,0,0,0,0,0,0,1499,0,14336,0,1311,0,14,0,174,0,15835,0,0,0,0,0,0,0,31,13,2,132
Prairie,8/19/20,0,0,0,0,0,0,0,0,0,112,0,1375,0,93,0,0,0,19,0,1487,0,0,0,0,0,0,0,0,1,0,7
Pulaski,8/19/20,0,0,0,0,0,0,0,0,0,6284,0,83199,0,5385,0,91,0,808,0,89483,0,0,0,0,0,0,0,83,68,0,735
Randolph,8/19/20,0,0,0,0,0,0,0,0,0,280,0,3345,0,217,0,11,0,52,0,3625,0,0,0,0,0,0,0,9,3,0,16
Saline,8/19/20,0,0,0,0,0,0,0,0,0,1319,0,17484,0,1034,0,10,0,275,0,18803,0,0,0,0,0,0,0,26,16,1,173
Scott,8/19/20,0,0,0,0,0,0,0,0,0,80,0,1308,0,63,0,0,0,17,0,1388,0,0,0,0,0,0,0,1,2,0,4
Searcy,8/19/20,0,0,0,0,0,0,0,0,0,37,0,1287,0,31,0,0,0,6,0,1324,0,0,0,0,0,0,0,2,0,0,10
Sebastian,8/19/20,0,0,0,0,0,0,0,0,0,2552,0,27578,0,2146,0,27,0,379,0,30130,0,0,0,0,0,0,0,53,40,4,329
Sevier,8/19/20,0,0,0,0,0,0,0,0,0,1079,0,5272,0,1009,0,11,0,59,0,6351,0,0,0,0,0,0,0,5,13,0,46
Sharp,8/19/20,0,0,0,0,0,0,0,0,0,128,0,2528,0,111,0,5,0,12,0,2656,0,0,0,0,0,0,0,2,3,0,10
St.Francis,8/19/20,0,0,0,0,0,0,0,0,0,1245,0,8147,0,1173,0,3,0,69,0,9392,0,0,0,0,0,0,0,2,7,0,25
Stone,8/19/20,0,0,0,0,0,0,0,0,0,98,0,2047,0,71,0,1,0,26,0,2145,0,0,0,0,0,0,0,7,5,0,23
Union,8/19/20,0,0,0,0,0,0,0,0,0,589,0,6247,0,506,0,21,0,62,0,6836,0,0,0,0,0,0,0,11,8,0,17
VanBuren,8/19/20,0,0,0,0,0,0,0,0,0,64,0,2606,0,53,0,2,0,9,0,2670,0,0,0,0,0,0,0,2,1,0,17
Washington,8/19/20,0,0,0,0,0,0,0,0,0,6507,0,47292,0,6256,0,53,0,198,0,53799,0,0,0,0,0,0,0,35,34,0,316
White,8/19/20,0,0,0,0,0,0,0,0,0,412,0,9142,0,319,0,5,0,88,0,9554,0,0,0,0,0,0,0,3,7,1,41
Woodruff,8/19/20,0,0,0,0,0,0,0,0,0,26,0,1211,0,22,0,0,0,4,0,1237,0,0,0,0,0,0,0,1,0,0,8
Yell,8/19/20,0,0,0,0,0,0,0,0,0,1097,0,7036,0,1046,0,19,0,32,0,8133,0,0,0,0,0,0,0,4,3,0,33
Arkansas_all_counties,8/18/20,0,0,0,0,0,0,0,0,2990671,53487,0,583243,0,46970,0,619,0,5898,0,636730,0,0,0,0,0,0,0,410,837,16,4078
Arkansas_county,8/18/20,0,0,0,0,0,0,0,0,0,251,0,3629,0,222,0,2,0,27,0,3880,0,0,0,0,0,0,0,2,3,0,16
Ashley,8/18/20,0,0,0,0,0,0,0,0,0,362,0,3657,0,310,0,6,0,46,0,4019,0,0,0,0,0,0,0,-1,11,0,3
Baxter,8/18/20,0,0,0,0,0,0,0,0,0,89,0,2039,0,73,0,0,0,16,0,2128,0,0,0,0,0,0,0,0,3,0,32
Benton,8/18/20,0,0,0,0,0,0,0,0,0,4950,0,50343,0,4720,0,43,0,187,0,55293,0,0,0,0,0,0,0,17,29,0,248
Boone,8/18/20,0,0,0,0,0,0,0,0,0,232,0,5512,0,201,0,2,0,29,0,5744,0,0,0,0,0,0,0,2,3,0,40
Bradley,8/18/20,0,0,0,0,0,0,0,0,0,230,0,2693,0,180,0,4,0,46,0,2923,0,0,0,0,0,0,0,3,14,0,18
Calhoun,8/18/20,0,0,0,0,0,0,0,0,0,22,0,1141,0,15,0,0,0,7,0,1163,0,0,0,0,0,0,0,6,1,0,37
Carroll,8/18/20,0,0,0,0,0,0,0,0,0,401,0,4978,0,348,0,7,0,46,0,5379,0,0,0,0,0,0,0,6,2,0,52
Chicot,8/18/20,0,0,0,0,0,0,0,0,0,926,0,3846,0,665,0,9,0,252,0,4772,0,0,0,0,0,0,0,1,110,0,11
Clark,8/18/20,0,0,0,0,0,0,0,0,0,195,0,4213,0,175,0,2,0,18,0,4408,0,0,0,0,0,0,0,3,4,0,34
Clay,8/18/20,0,0,0,0,0,0,0,0,0,147,0,2717,0,121,0,5,0,21,0,2864,0,0,0,0,0,0,0,0,5,0,21
Cleburne,8/18/20,0,0,0,0,0,0,0,0,0,229,0,3877,0,191,0,5,0,33,0,4106,0,0,0,0,0,0,0,1,3,0,21
Cleveland,8/18/20,0,0,0,0,0,0,0,0,0,121,0,1669,0,93,0,2,0,26,0,1790,0,0,0,0,0,0,0,0,7,0,9
Columbia,8/18/20,0,0,0,0,0,0,0,0,0,250,0,3261,0,214,0,12,0,24,0,3511,0,0,0,0,0,0,0,6,4,0,14
Conway,8/18/20,0,0,0,0,0,0,0,0,0,169,0,4264,0,144,0,3,0,22,0,4433,0,0,0,0,0,0,0,1,2,0,18
Craighead,8/18/20,0,0,0,0,0,0,0,0,0,1512,0,20531,0,1345,0,14,0,153,0,22043,0,0,0,0,0,0,0,14,36,0,202
Crawford,8/18/20,0,0,0,0,0,0,0,0,0,757,0,11877,0,598,0,5,0,154,0,12634,0,0,0,0,0,0,0,11,13,0,108
Crittenden,8/18/20,0,0,0,0,0,0,0,0,0,1503,0,10882,0,1342,0,26,0,135,0,12385,0,0,0,0,0,0,0,10,19,2,48
Cross,8/18/20,0,0,0,0,0,0,0,0,0,229,0,2780,0,191,0,4,0,34,0,3009,0,0,0,0,0,0,0,1,2,0,12
Dallas,8/18/20,0,0,0,0,0,0,0,0,0,71,0,1229,0,61,0,2,0,8,0,1300,0,0,0,0,0,0,0,3,0,0,18
Desha,8/18/20,0,0,0,0,0,0,0,0,0,212,0,2714,0,175,0,3,0,34,0,2926,0,0,0,0,0,0,0,1,3,1,19
Drew,8/18/20,0,0,0,0,0,0,0,0,0,277,0,4107,0,196,0,3,0,78,0,4384,0,0,0,0,0,0,0,7,10,0,32
Faulkner,8/18/20,0,0,0,0,0,0,0,0,0,1412,0,24086,0,1296,0,7,0,109,0,25498,0,0,0,0,0,0,0,10,27,1,152
Franklin,8/18/20,0,0,0,0,0,0,0,0,0,146,0,3655,0,128,0,2,0,16,0,3801,0,0,0,0,0,0,0,5,4,0,27
Fulton,8/18/20,0,0,0,0,0,0,0,0,0,51,0,735,0,35,0,0,0,16,0,786,0,0,0,0,0,0,0,2,5,0,7
Garland,8/18/20,0,0,0,0,0,0,0,0,0,1207,0,19375,0,981,0,18,0,208,0,20582,0,0,0,0,0,0,0,6,36,1,94
Grant,8/18/20,0,0,0,0,0,0,0,0,0,157,0,3169,0,139,0,0,0,18,0,3326,0,0,0,0,0,0,0,3,7,0,22
Greene,8/18/20,0,0,0,0,0,0,0,0,0,548,0,8383,0,470,0,3,0,75,0,8931,0,0,0,0,0,0,0,4,12,0,66
Hempstead,8/18/20,0,0,0,0,0,0,0,0,0,272,0,3213,0,238,0,2,0,32,0,3485,0,0,0,0,0,0,0,1,4,0,20
HotSpring,8/18/20,0,0,0,0,0,0,0,0,0,1647,0,7739,0,1497,0,14,0,136,0,9386,0,0,0,0,0,0,0,3,8,1,16
Howard,8/18/20,0,0,0,0,0,0,0,0,0,376,0,2950,0,319,0,4,0,53,0,3326,0,0,0,0,0,0,0,0,2,0,12
Independence,8/18/20,0,0,0,0,0,0,0,0,0,626,0,6437,0,495,0,2,0,129,0,7063,0,0,0,0,0,0,0,5,23,0,58
Izard,8/18/20,0,0,0,0,0,0,0,0,0,65,0,1529,0,53,0,0,0,12,0,1594,0,0,0,0,0,0,0,4,1,0,66
Jackson,8/18/20,0,0,0,0,0,0,0,0,0,131,0,2835,0,67,0,1,0,63,0,2966,0,0,0,0,0,0,0,7,3,0,79
Jefferson,8/18/20,0,0,0,0,0,0,0,0,0,1718,0,16843,0,1439,0,41,0,238,0,18561,0,0,0,0,0,0,0,8,24,0,97
Johnson,8/18/20,0,0,0,0,0,0,0,0,0,695,0,5074,0,669,0,2,0,24,0,5769,0,0,0,0,0,0,0,0,8,0,19
Lafayette,8/18/20,0,0,0,0,0,0,0,0,0,62,0,740,0,54,0,2,0,6,0,802,0,0,0,0,0,0,0,1,1,0,9
Lawrence,8/18/20,0,0,0,0,0,0,0,0,0,232,0,2248,0,208,0,9,0,15,0,2480,0,0,0,0,0,0,0,1,4,0,15
Lee,8/18/20,0,0,0,0,0,0,0,0,0,983,0,3080,0,957,0,8,0,18,0,4063,0,0,0,0,0,0,0,4,2,0,14
Lincoln,8/18/20,0,0,0,0,0,0,0,0,0,1355,0,4665,0,1200,0,12,0,143,0,6020,0,0,0,0,0,0,0,7,3,0,107
LittleRiver,8/18/20,0,0,0,0,0,0,0,0,0,227,0,1355,0,187,0,4,0,36,0,1582,0,0,0,0,0,0,0,8,6,1,9
Logan,8/18/20,0,0,0,0,0,0,0,0,0,337,0,4827,0,244,0,1,0,92,0,5164,0,0,0,0,0,0,0,-1,11,0,45
Lonoke,8/18/20,0,0,0,0,0,0,0,0,0,589,0,10931,0,499,0,2,0,88,0,11520,0,0,0,0,0,0,0,9,15,0,104
Madison,8/18/20,0,0,0,0,0,0,0,0,0,280,0,2904,0,272,0,2,0,6,0,3184,0,0,0,0,0,0,0,1,0,0,15
Marion,8/18/20,0,0,0,0,0,0,0,0,0,34,0,1468,0,30,0,0,0,4,0,1502,0,0,0,0,0,0,0,0,1,0,24
Miller,8/18/20,0,0,0,0,0,0,0,0,0,541,0,4083,0,503,0,5,0,33,0,4624,0,0,0,0,0,0,0,3,2,0,12
MissingCountyInfo,8/18/20,0,0,0,0,0,0,0,0,0,785,0,15527,0,559,0,0,0,226,0,16312,0,0,0,0,0,0,0,11,0,0,70
Mississippi,8/18/20,0,0,0,0,0,0,0,0,0,1164,0,8469,0,963,0,15,0,186,0,9633,0,0,0,0,0,0,0,5,35,1,61
Monroe,8/18/20,0,0,0,0,0,0,0,0,0,79,0,1533,0,58,0,0,0,21,0,1612,0,0,0,0,0,0,0,3,2,0,27
Montgomery,8/18/20,0,0,0,0,0,0,0,0,0,45,0,1061,0,28,0,1,0,16,0,1106,0,0,0,0,0,0,0,1,0,0,4
Nevada,8/18/20,0,0,0,0,0,0,0,0,0,147,0,2059,0,129,0,9,0,9,0,2206,0,0,0,0,0,0,0,0,2,0,10
Newton,8/18/20,0,0,0,0,0,0,0,0,0,107,0,1052,0,91,0,11,0,5,0,1159,0,0,0,0,0,0,0,0,1,0,4
Ouachita,8/18/20,0,0,0,0,0,0,0,0,0,118,0,3790,0,96,0,3,0,19,0,3908,0,0,0,0,0,0,0,0,5,0,11
Perry,8/18/20,0,0,0,0,0,0,0,0,0,55,0,1948,0,50,0,0,0,5,0,2003,0,0,0,0,0,0,0,0,0,0,6
Phillips,8/18/20,0,0,0,0,0,0,0,0,0,357,0,4718,0,310,0,9,0,38,0,5075,0,0,0,0,0,0,0,2,4,0,21
Pike,8/18/20,0,0,0,0,0,0,0,0,0,146,0,1604,0,101,0,1,0,44,0,1750,0,0,0,0,0,0,0,2,3,0,11
Poinsett,8/18/20,0,0,0,0,0,0,0,0,0,350,0,4628,0,264,0,4,0,82,0,4978,0,0,0,0,0,0,0,3,14,0,41
Polk,8/18/20,0,0,0,0,0,0,0,0,0,177,0,2796,0,139,0,1,0,37,0,2973,0,0,0,0,0,0,0,6,4,0,35
Pope,8/18/20,0,0,0,0,0,0,0,0,0,1468,0,14235,0,1298,0,12,0,158,0,15703,0,0,0,0,0,0,0,3,15,0,103
Prairie,8/18/20,0,0,0,0,0,0,0,0,0,112,0,1368,0,92,0,0,0,20,0,1480,0,0,0,0,0,0,0,1,3,0,10
Pulaski,8/18/20,0,0,0,0,0,0,0,0,0,6201,0,82547,0,5317,0,91,0,793,0,88748,0,0,0,0,0,0,0,55,89,3,616
Randolph,8/18/20,0,0,0,0,0,0,0,0,0,271,0,3338,0,214,0,11,0,46,0,3609,0,0,0,0,0,0,0,6,4,0,36
Saline,8/18/20,0,0,0,0,0,0,0,0,0,1293,0,17337,0,1018,0,9,0,266,0,18630,0,0,0,0,0,0,0,16,26,1,153
Scott,8/18/20,0,0,0,0,0,0,0,0,0,79,0,1305,0,61,0,0,0,18,0,1384,0,0,0,0,0,0,0,1,5,0,4
Searcy,8/18/20,0,0,0,0,0,0,0,0,0,35,0,1279,0,31,0,0,0,4,0,1314,0,0,0,0,0,0,0,1,0,0,2
Sebastian,8/18/20,0,0,0,0,0,0,0,0,0,2499,0,27302,0,2106,0,23,0,370,0,29801,0,0,0,0,0,0,0,43,51,1,259
Sevier,8/18/20,0,0,0,0,0,0,0,0,0,1074,0,5231,0,996,0,11,0,67,0,6305,0,0,0,0,0,0,0,7,10,0,32
Sharp,8/18/20,0,0,0,0,0,0,0,0,0,126,0,2520,0,108,0,5,0,13,0,2646,0,0,0,0,0,0,0,-2,4,0,16
St.Francis,8/18/20,0,0,0,0,0,0,0,0,0,1243,0,8124,0,1166,0,3,0,74,0,9367,0,0,0,0,0,0,0,0,3,0,45
Stone,8/18/20,0,0,0,0,0,0,0,0,0,91,0,2031,0,66,0,1,0,24,0,2122,0,0,0,0,0,0,0,4,1,0,19
Union,8/18/20,0,0,0,0,0,0,0,0,0,578,0,6241,0,498,0,21,0,59,0,6819,0,0,0,0,0,0,0,17,13,1,92
VanBuren,8/18/20,0,0,0,0,0,0,0,0,0,62,0,2591,0,52,0,2,0,8,0,2653,0,0,0,0,0,0,0,4,2,0,13
Washington,8/18/20,0,0,0,0,0,0,0,0,0,6472,0,47011,0,6222,0,53,0,197,0,53483,0,0,0,0,0,0,0,30,36,0,203
White,8/18/20,0,0,0,0,0,0,0,0,0,409,0,9104,0,312,0,4,0,93,0,9513,0,0,0,0,0,0,0,1,4,1,39
Woodruff,8/18/20,0,0,0,0,0,0,0,0,0,25,0,1204,0,22,0,0,0,3,0,1229,0,0,0,0,0,0,0,0,1,0,1
Yell,8/18/20,0,0,0,0,0,0,0,0,0,1093,0,7007,0,1043,0,19,0,31,0,8100,0,0,0,0,0,0,0,5,7,1,32
Arkansas_all_counties,8/17/20,0,0,0,0,0,0,0,0,2990671,53077,0,579575,0,46133,0,603,0,6341,0,632652,0,0,0,0,0,0,0,412,561,4,10602
Arkansas_county,8/17/20,0,0,0,0,0,0,0,0,0,249,0,3615,0,219,0,2,0,28,0,3864,0,0,0,0,0,0,0,2,4,0,28
Ashley,8/17/20,0,0,0,0,0,0,0,0,0,363,0,3653,0,299,0,6,0,58,0,4016,0,0,0,0,0,0,0,1,4,1,78
Baxter,8/17/20,0,0,0,0,0,0,0,0,0,89,0,2007,0,70,0,0,0,19,0,2096,0,0,0,0,0,0,0,3,2,0,47
Benton,8/17/20,0,0,0,0,0,0,0,0,0,4933,0,50112,0,4691,0,43,0,199,0,55045,0,0,0,0,0,0,0,16,21,0,1041
Boone,8/17/20,0,0,0,0,0,0,0,0,0,230,0,5474,0,198,0,2,0,30,0,5704,0,0,0,0,0,0,0,0,4,0,131
Bradley,8/17/20,0,0,0,0,0,0,0,0,0,227,0,2678,0,166,0,4,0,57,0,2905,0,0,0,0,0,0,0,6,9,0,70
Calhoun,8/17/20,0,0,0,0,0,0,0,0,0,16,0,1110,0,14,0,0,0,2,0,1126,0,0,0,0,0,0,0,0,0,0,16
Carroll,8/17/20,0,0,0,0,0,0,0,0,0,395,0,4932,0,346,0,7,0,42,0,5327,0,0,0,0,0,0,0,3,1,0,110
Chicot,8/17/20,0,0,0,0,0,0,0,0,0,925,0,3836,0,555,0,9,0,361,0,4761,0,0,0,0,0,0,0,4,14,0,85
Clark,8/17/20,0,0,0,0,0,0,0,0,0,192,0,4182,0,171,0,2,0,19,0,4374,0,0,0,0,0,0,0,3,1,0,52
Clay,8/17/20,0,0,0,0,0,0,0,0,0,147,0,2696,0,116,0,5,0,26,0,2843,0,0,0,0,0,0,0,1,2,1,59
Cleburne,8/17/20,0,0,0,0,0,0,0,0,0,228,0,3857,0,188,0,5,0,35,0,4085,0,0,0,0,0,0,0,3,5,0,40
Cleveland,8/17/20,0,0,0,0,0,0,0,0,0,121,0,1660,0,86,0,2,0,33,0,1781,0,0,0,0,0,0,0,1,2,0,39
Columbia,8/17/20,0,0,0,0,0,0,0,0,0,244,0,3253,0,210,0,12,0,22,0,3497,0,0,0,0,0,0,0,2,6,0,38
Conway,8/17/20,0,0,0,0,0,0,0,0,0,168,0,4247,0,142,0,3,0,23,0,4415,0,0,0,0,0,0,0,6,2,0,154
Craighead,8/17/20,0,0,0,0,0,0,0,0,0,1498,0,20343,0,1309,0,14,0,175,0,21841,0,0,0,0,0,0,0,16,23,1,1286
Crawford,8/17/20,0,0,0,0,0,0,0,0,0,746,0,11780,0,585,0,5,0,156,0,12526,0,0,0,0,0,0,0,10,6,0,258
Crittenden,8/17/20,0,0,0,0,0,0,0,0,0,1493,0,10844,0,1323,0,24,0,146,0,12337,0,0,0,0,0,0,0,11,23,0,125
Cross,8/17/20,0,0,0,0,0,0,0,0,0,228,0,2769,0,189,0,4,0,35,0,2997,0,0,0,0,0,0,0,3,3,0,72
Dallas,8/17/20,0,0,0,0,0,0,0,0,0,68,0,1214,0,61,0,2,0,5,0,1282,0,0,0,0,0,0,0,0,1,0,19
Desha,8/17/20,0,0,0,0,0,0,0,0,0,211,0,2696,0,172,0,2,0,37,0,2907,0,0,0,0,0,0,0,1,2,0,47
Drew,8/17/20,0,0,0,0,0,0,0,0,0,270,0,4082,0,186,0,3,0,81,0,4352,0,0,0,0,0,0,0,10,4,0,102
Faulkner,8/17/20,0,0,0,0,0,0,0,0,0,1402,0,23944,0,1269,0,6,0,127,0,25346,0,0,0,0,0,0,0,5,16,0,222
Franklin,8/17/20,0,0,0,0,0,0,0,0,0,141,0,3633,0,124,0,2,0,15,0,3774,0,0,0,0,0,0,0,1,4,0,75
Fulton,8/17/20,0,0,0,0,0,0,0,0,0,49,0,730,0,30,0,0,0,19,0,779,0,0,0,0,0,0,0,1,0,0,17
Garland,8/17/20,0,0,0,0,0,0,0,0,0,1201,0,19287,0,945,0,17,0,239,0,20488,0,0,0,0,0,0,0,19,20,0,397
Grant,8/17/20,0,0,0,0,0,0,0,0,0,154,0,3150,0,132,0,0,0,22,0,3304,0,0,0,0,0,0,0,4,2,0,68
Greene,8/17/20,0,0,0,0,0,0,0,0,0,544,0,8321,0,458,0,3,0,83,0,8865,0,0,0,0,0,0,0,10,4,0,249
Hempstead,8/17/20,0,0,0,0,0,0,0,0,0,271,0,3194,0,234,0,2,0,35,0,3465,0,0,0,0,0,0,0,4,2,0,90
HotSpring,8/17/20,0,0,0,0,0,0,0,0,0,1644,0,7726,0,1489,0,13,0,142,0,9370,0,0,0,0,0,0,0,1,3,0,121
Howard,8/17/20,0,0,0,0,0,0,0,0,0,376,0,2938,0,317,0,4,0,55,0,3314,0,0,0,0,0,0,0,2,2,0,239
Independence,8/17/20,0,0,0,0,0,0,0,0,0,621,0,6384,0,472,0,2,0,147,0,7005,0,0,0,0,0,0,0,7,16,0,161
Izard,8/17/20,0,0,0,0,0,0,0,0,0,61,0,1467,0,52,0,0,0,9,0,1528,0,0,0,0,0,0,0,0,3,0,36
Jackson,8/17/20,0,0,0,0,0,0,0,0,0,124,0,2763,0,64,0,1,0,59,0,2887,0,0,0,0,0,0,0,0,1,0,23
Jefferson,8/17/20,0,0,0,0,0,0,0,0,0,1710,0,16754,0,1415,0,41,0,254,0,18464,0,0,0,0,0,0,0,14,11,0,375
Johnson,8/17/20,0,0,0,0,0,0,0,0,0,695,0,5055,0,661,0,2,0,32,0,5750,0,0,0,0,0,0,0,4,4,0,75
Lafayette,8/17/20,0,0,0,0,0,0,0,0,0,61,0,732,0,53,0,2,0,6,0,793,0,0,0,0,0,0,0,2,1,0,16
Lawrence,8/17/20,0,0,0,0,0,0,0,0,0,231,0,2234,0,204,0,9,0,18,0,2465,0,0,0,0,0,0,0,1,4,0,39
Lee,8/17/20,0,0,0,0,0,0,0,0,0,979,0,3070,0,955,0,8,0,16,0,4049,0,0,0,0,0,0,0,2,0,0,35
Lincoln,8/17/20,0,0,0,0,0,0,0,0,0,1348,0,4565,0,1197,0,12,0,139,0,5913,0,0,0,0,0,0,0,2,3,0,175
LittleRiver,8/17/20,0,0,0,0,0,0,0,0,0,219,0,1354,0,181,0,3,0,35,0,1573,0,0,0,0,0,0,0,1,3,0,25
Logan,8/17/20,0,0,0,0,0,0,0,0,0,338,0,4781,0,233,0,1,0,104,0,5119,0,0,0,0,0,0,0,1,11,0,83
Lonoke,8/17/20,0,0,0,0,0,0,0,0,0,580,0,10836,0,484,0,2,0,94,0,11416,0,0,0,0,0,0,0,7,5,0,230
Madison,8/17/20,0,0,0,0,0,0,0,0,0,279,0,2890,0,272,0,2,0,5,0,3169,0,0,0,0,0,0,0,1,4,0,55
Marion,8/17/20,0,0,0,0,0,0,0,0,0,34,0,1444,0,29,0,0,0,5,0,1478,0,0,0,0,0,0,0,1,2,0,16
Miller,8/17/20,0,0,0,0,0,0,0,0,0,538,0,4074,0,501,0,5,0,32,0,4612,0,0,0,0,0,0,0,3,3,0,77
MissingCountyInfo,8/17/20,0,0,0,0,0,0,0,0,0,774,0,15468,0,559,0,0,0,215,0,16242,0,0,0,0,0,0,0,19,4,0,-1660
Mississippi,8/17/20,0,0,0,0,0,0,0,0,0,1159,0,8413,0,928,0,14,0,217,0,9572,0,0,0,0,0,0,0,5,37,0,217
Monroe,8/17/20,0,0,0,0,0,0,0,0,0,76,0,1509,0,56,0,0,0,20,0,1585,0,0,0,0,0,0,0,0,1,0,34
Montgomery,8/17/20,0,0,0,0,0,0,0,0,0,44,0,1058,0,28,0,1,0,15,0,1102,0,0,0,0,0,0,0,1,0,0,17
Nevada,8/17/20,0,0,0,0,0,0,0,0,0,147,0,2049,0,127,0,9,0,11,0,2196,0,0,0,0,0,0,0,0,0,0,24
Newton,8/17/20,0,0,0,0,0,0,0,0,0,107,0,1048,0,90,0,11,0,6,0,1155,0,0,0,0,0,0,0,0,1,0,27
Ouachita,8/17/20,0,0,0,0,0,0,0,0,0,118,0,3779,0,91,0,3,0,24,0,3897,0,0,0,0,0,0,0,0,4,0,105
Perry,8/17/20,0,0,0,0,0,0,0,0,0,55,0,1942,0,50,0,0,0,5,0,1997,0,0,0,0,0,0,0,0,0,0,50
Phillips,8/17/20,0,0,0,0,0,0,0,0,0,355,0,4699,0,306,0,9,0,40,0,5054,0,0,0,0,0,0,0,6,7,0,140
Pike,8/17/20,0,0,0,0,0,0,0,0,0,144,0,1595,0,98,0,1,0,45,0,1739,0,0,0,0,0,0,0,4,7,0,82
Poinsett,8/17/20,0,0,0,0,0,0,0,0,0,347,0,4590,0,250,0,4,0,93,0,4937,0,0,0,0,0,0,0,7,14,0,75
Polk,8/17/20,0,0,0,0,0,0,0,0,0,171,0,2767,0,135,0,1,0,35,0,2938,0,0,0,0,0,0,0,10,1,0,62
Pope,8/17/20,0,0,0,0,0,0,0,0,0,1465,0,14135,0,1283,0,12,0,170,0,15600,0,0,0,0,0,0,0,16,20,0,235
Prairie,8/17/20,0,0,0,0,0,0,0,0,0,111,0,1359,0,89,0,0,0,22,0,1470,0,0,0,0,0,0,0,2,1,0,45
Pulaski,8/17/20,0,0,0,0,0,0,0,0,0,6146,0,81986,0,5228,0,88,0,830,0,88132,0,0,0,0,0,0,0,61,62,0,1498
Randolph,8/17/20,0,0,0,0,0,0,0,0,0,265,0,3308,0,210,0,11,0,44,0,3573,0,0,0,0,0,0,0,5,4,0,51
Saline,8/17/20,0,0,0,0,0,0,0,0,0,1277,0,17200,0,992,0,8,0,277,0,18477,0,0,0,0,0,0,0,10,16,0,272
Scott,8/17/20,0,0,0,0,0,0,0,0,0,78,0,1302,0,56,0,0,0,22,0,1380,0,0,0,0,0,0,0,0,2,0,31
Searcy,8/17/20,0,0,0,0,0,0,0,0,0,34,0,1278,0,31,0,0,0,3,0,1312,0,0,0,0,0,0,0,0,1,0,13
Sebastian,8/17/20,0,0,0,0,0,0,0,0,0,2456,0,27086,0,2055,0,22,0,379,0,29542,0,0,0,0,0,0,0,21,38,0,606
Sevier,8/17/20,0,0,0,0,0,0,0,0,0,1067,0,5206,0,986,0,11,0,70,0,6273,0,0,0,0,0,0,0,9,8,0,105
Sharp,8/17/20,0,0,0,0,0,0,0,0,0,128,0,2502,0,104,0,5,0,19,0,2630,0,0,0,0,0,0,0,0,1,0,43
St.Francis,8/17/20,0,0,0,0,0,0,0,0,0,1243,0,8079,0,1163,0,3,0,77,0,9322,0,0,0,0,0,0,0,5,8,0,238
Stone,8/17/20,0,0,0,0,0,0,0,0,0,87,0,2016,0,65,0,1,0,21,0,2103,0,0,0,0,0,0,0,1,5,0,35
Union,8/17/20,0,0,0,0,0,0,0,0,0,561,0,6166,0,485,0,20,0,56,0,6727,0,0,0,0,0,0,0,5,5,0,107
VanBuren,8/17/20,0,0,0,0,0,0,0,0,0,58,0,2582,0,50,0,2,0,6,0,2640,0,0,0,0,0,0,0,3,1,0,32
Washington,8/17/20,0,0,0,0,0,0,0,0,0,6442,0,46838,0,6186,0,53,0,203,0,53280,0,0,0,0,0,0,0,12,41,0,1087
White,8/17/20,0,0,0,0,0,0,0,0,0,408,0,9066,0,308,0,3,0,97,0,9474,0,0,0,0,0,0,0,14,6,0,108
Woodruff,8/17/20,0,0,0,0,0,0,0,0,0,25,0,1203,0,21,0,0,0,4,0,1228,0,0,0,0,0,0,0,1,0,0,46
Yell,8/17/20,0,0,0,0,0,0,0,0,0,1088,0,6980,0,1036,0,18,0,34,0,8068,0,0,0,0,0,0,0,0,3,1,81
Arkansas_all_counties,8/16/20,0,0,0,0,0,0,0,0,2990671,52665,0,569385,0,45572,0,599,0,6494,0,622050,0,0,0,0,0,0,0,673,667,-1,5949
Arkansas_county,8/16/20,0,0,0,0,0,0,0,0,0,247,0,3589,0,215,0,2,0,30,0,3836,0,0,0,0,0,0,0,1,3,0,25
Ashley,8/16/20,0,0,0,0,0,0,0,0,0,362,0,3576,0,295,0,5,0,62,0,3938,0,0,0,0,0,0,0,10,3,0,16
Baxter,8/16/20,0,0,0,0,0,0,0,0,0,86,0,1963,0,68,0,0,0,18,0,2049,0,0,0,0,0,0,0,5,1,0,29
Benton,8/16/20,0,0,0,0,0,0,0,0,0,4917,0,49087,0,4670,0,43,0,204,0,54004,0,0,0,0,0,0,0,17,15,0,154
Boone,8/16/20,0,0,0,0,0,0,0,0,0,230,0,5343,0,194,0,2,0,34,0,5573,0,0,0,0,0,0,0,5,4,0,48
Bradley,8/16/20,0,0,0,0,0,0,0,0,0,221,0,2614,0,157,0,4,0,60,0,2835,0,0,0,0,0,0,0,3,5,0,22
Calhoun,8/16/20,0,0,0,0,0,0,0,0,0,16,0,1094,0,14,0,0,0,2,0,1110,0,0,0,0,0,0,0,0,0,0,4
Carroll,8/16/20,0,0,0,0,0,0,0,0,0,392,0,4825,0,345,0,7,0,40,0,5217,0,0,0,0,0,0,0,9,2,0,32
Chicot,8/16/20,0,0,0,0,0,0,0,0,0,921,0,3755,0,541,0,9,0,371,0,4676,0,0,0,0,0,0,0,2,6,0,10
Clark,8/16/20,0,0,0,0,0,0,0,0,0,189,0,4133,0,170,0,2,0,17,0,4322,0,0,0,0,0,0,0,3,3,0,33
Clay,8/16/20,0,0,0,0,0,0,0,0,0,146,0,2638,0,114,0,4,0,28,0,2784,0,0,0,0,0,0,0,1,2,0,20
Cleburne,8/16/20,0,0,0,0,0,0,0,0,0,225,0,3820,0,183,0,5,0,37,0,4045,0,0,0,0,0,0,0,5,1,0,25
Cleveland,8/16/20,0,0,0,0,0,0,0,0,0,120,0,1622,0,84,0,2,0,34,0,1742,0,0,0,0,0,0,0,3,1,0,21
Columbia,8/16/20,0,0,0,0,0,0,0,0,0,242,0,3217,0,204,0,12,0,26,0,3459,0,0,0,0,0,0,0,1,8,0,16
Conway,8/16/20,0,0,0,0,0,0,0,0,0,162,0,4099,0,140,0,3,0,19,0,4261,0,0,0,0,0,0,0,0,2,0,30
Craighead,8/16/20,0,0,0,0,0,0,0,0,0,1482,0,19073,0,1286,0,13,0,183,0,20555,0,0,0,0,0,0,0,9,12,0,108
Crawford,8/16/20,0,0,0,0,0,0,0,0,0,736,0,11532,0,579,0,5,0,152,0,12268,0,0,0,0,0,0,0,25,8,0,105
Crittenden,8/16/20,0,0,0,0,0,0,0,0,0,1482,0,10730,0,1300,0,24,0,158,0,12212,0,0,0,0,0,0,0,22,15,0,69
Cross,8/16/20,0,0,0,0,0,0,0,0,0,225,0,2700,0,186,0,4,0,35,0,2925,0,0,0,0,0,0,0,3,2,0,36
Dallas,8/16/20,0,0,0,0,0,0,0,0,0,68,0,1195,0,60,0,2,0,6,0,1263,0,0,0,0,0,0,0,0,2,0,7
Desha,8/16/20,0,0,0,0,0,0,0,0,0,210,0,2650,0,170,0,2,0,38,0,2860,0,0,0,0,0,0,0,0,7,0,10
Drew,8/16/20,0,0,0,0,0,0,0,0,0,260,0,3990,0,182,0,3,0,75,0,4250,0,0,0,0,0,0,0,6,2,0,18
Faulkner,8/16/20,0,0,0,0,0,0,0,0,0,1397,0,23727,0,1253,0,6,0,138,0,25124,0,0,0,0,0,0,0,22,15,0,201
Franklin,8/16/20,0,0,0,0,0,0,0,0,0,140,0,3559,0,120,0,2,0,18,0,3699,0,0,0,0,0,0,0,1,3,0,7
Fulton,8/16/20,0,0,0,0,0,0,0,0,0,48,0,714,0,30,0,0,0,18,0,762,0,0,0,0,0,0,0,1,0,0,4
Garland,8/16/20,0,0,0,0,0,0,0,0,0,1182,0,18909,0,925,0,17,0,240,0,20091,0,0,0,0,0,0,0,13,13,0,131
Grant,8/16/20,0,0,0,0,0,0,0,0,0,150,0,3086,0,130,0,0,0,20,0,3236,0,0,0,0,0,0,0,2,1,0,13
Greene,8/16/20,0,0,0,0,0,0,0,0,0,534,0,8082,0,454,0,3,0,77,0,8616,0,0,0,0,0,0,0,3,16,0,42
Hempstead,8/16/20,0,0,0,0,0,0,0,0,0,267,0,3108,0,232,0,2,0,33,0,3375,0,0,0,0,0,0,0,2,5,0,25
HotSpring,8/16/20,0,0,0,0,0,0,0,0,0,1643,0,7606,0,1486,0,13,0,144,0,9249,0,0,0,0,0,0,0,22,21,0,53
Howard,8/16/20,0,0,0,0,0,0,0,0,0,374,0,2701,0,315,0,4,0,55,0,3075,0,0,0,0,0,0,0,7,6,0,17
Independence,8/16/20,0,0,0,0,0,0,0,0,0,614,0,6230,0,456,0,2,0,156,0,6844,0,0,0,0,0,0,0,10,17,0,41
Izard,8/16/20,0,0,0,0,0,0,0,0,0,61,0,1431,0,49,0,0,0,12,0,1492,0,0,0,0,0,0,0,-1,0,-1,5
Jackson,8/16/20,0,0,0,0,0,0,0,0,0,124,0,2740,0,63,0,1,0,60,0,2864,0,0,0,0,0,0,0,0,1,0,15
Jefferson,8/16/20,0,0,0,0,0,0,0,0,0,1696,0,16393,0,1404,0,41,0,251,0,18089,0,0,0,0,0,0,0,26,32,0,115
Johnson,8/16/20,0,0,0,0,0,0,0,0,0,691,0,4984,0,657,0,2,0,32,0,5675,0,0,0,0,0,0,0,4,9,0,21
Lafayette,8/16/20,0,0,0,0,0,0,0,0,0,59,0,718,0,52,0,2,0,5,0,777,0,0,0,0,0,0,0,0,0,0,4
Lawrence,8/16/20,0,0,0,0,0,0,0,0,0,230,0,2196,0,200,0,9,0,21,0,2426,0,0,0,0,0,0,0,1,1,0,12
Lee,8/16/20,0,0,0,0,0,0,0,0,0,977,0,3037,0,955,0,8,0,14,0,4014,0,0,0,0,0,0,0,76,77,0,82
Lincoln,8/16/20,0,0,0,0,0,0,0,0,0,1346,0,4392,0,1194,0,12,0,140,0,5738,0,0,0,0,0,0,0,56,5,0,483
LittleRiver,8/16/20,0,0,0,0,0,0,0,0,0,218,0,1330,0,178,0,3,0,37,0,1548,0,0,0,0,0,0,0,3,6,0,10
Logan,8/16/20,0,0,0,0,0,0,0,0,0,337,0,4699,0,222,0,1,0,114,0,5036,0,0,0,0,0,0,0,3,32,0,33
Lonoke,8/16/20,0,0,0,0,0,0,0,0,0,573,0,10613,0,479,0,2,0,92,0,11186,0,0,0,0,0,0,0,9,18,0,98
Madison,8/16/20,0,0,0,0,0,0,0,0,0,278,0,2836,0,268,0,2,0,8,0,3114,0,0,0,0,0,0,0,1,1,0,6
Marion,8/16/20,0,0,0,0,0,0,0,0,0,33,0,1429,0,27,0,0,0,6,0,1462,0,0,0,0,0,0,0,0,0,0,5
Miller,8/16/20,0,0,0,0,0,0,0,0,0,535,0,4000,0,498,0,5,0,32,0,4535,0,0,0,0,0,0,0,0,6,0,9
MissingCountyInfo,8/16/20,0,0,0,0,0,0,0,0,0,755,0,17147,0,555,0,0,0,200,0,17902,0,0,0,0,0,0,0,13,10,0,1723
Mississippi,8/16/20,0,0,0,0,0,0,0,0,0,1154,0,8201,0,891,0,14,0,249,0,9355,0,0,0,0,0,0,0,21,17,0,79
Monroe,8/16/20,0,0,0,0,0,0,0,0,0,76,0,1475,0,55,0,0,0,21,0,1551,0,0,0,0,0,0,0,3,0,0,17
Montgomery,8/16/20,0,0,0,0,0,0,0,0,0,43,0,1042,0,28,0,1,0,14,0,1085,0,0,0,0,0,0,0,1,0,0,4
Nevada,8/16/20,0,0,0,0,0,0,0,0,0,147,0,2025,0,127,0,9,0,11,0,2172,0,0,0,0,0,0,0,0,1,0,3
Newton,8/16/20,0,0,0,0,0,0,0,0,0,107,0,1021,0,89,0,11,0,7,0,1128,0,0,0,0,0,0,0,0,1,0,4
Ouachita,8/16/20,0,0,0,0,0,0,0,0,0,118,0,3674,0,87,0,3,0,28,0,3792,0,0,0,0,0,0,0,5,2,0,27
Perry,8/16/20,0,0,0,0,0,0,0,0,0,55,0,1892,0,50,0,0,0,5,0,1947,0,0,0,0,0,0,0,0,0,0,15
Phillips,8/16/20,0,0,0,0,0,0,0,0,0,349,0,4565,0,299,0,9,0,41,0,4914,0,0,0,0,0,0,0,3,6,0,44
Pike,8/16/20,0,0,0,0,0,0,0,0,0,140,0,1517,0,91,0,1,0,48,0,1657,0,0,0,0,0,0,0,2,2,0,11
Poinsett,8/16/20,0,0,0,0,0,0,0,0,0,340,0,4522,0,236,0,4,0,100,0,4862,0,0,0,0,0,0,0,4,9,0,36
Polk,8/16/20,0,0,0,0,0,0,0,0,0,161,0,2715,0,134,0,1,0,26,0,2876,0,0,0,0,0,0,0,2,1,0,36
Pope,8/16/20,0,0,0,0,0,0,0,0,0,1449,0,13916,0,1263,0,12,0,174,0,15365,0,0,0,0,0,0,0,23,8,0,149
Prairie,8/16/20,0,0,0,0,0,0,0,0,0,109,0,1316,0,88,0,0,0,21,0,1425,0,0,0,0,0,0,0,1,5,0,10
Pulaski,8/16/20,0,0,0,0,0,0,0,0,0,6085,0,80549,0,5166,0,88,0,831,0,86634,0,0,0,0,0,0,0,85,72,0,709
Randolph,8/16/20,0,0,0,0,0,0,0,0,0,260,0,3262,0,206,0,11,0,43,0,3522,0,0,0,0,0,0,0,5,3,0,13
Saline,8/16/20,0,0,0,0,0,0,0,0,0,1267,0,16938,0,976,0,8,0,283,0,18205,0,0,0,0,0,0,0,28,10,0,192
Scott,8/16/20,0,0,0,0,0,0,0,0,0,78,0,1271,0,54,0,0,0,24,0,1349,0,0,0,0,0,0,0,1,2,0,5
Searcy,8/16/20,0,0,0,0,0,0,0,0,0,34,0,1265,0,30,0,0,0,4,0,1299,0,0,0,0,0,0,0,0,1,0,5
Sebastian,8/16/20,0,0,0,0,0,0,0,0,0,2435,0,26501,0,2017,0,22,0,396,0,28936,0,0,0,0,0,0,0,34,62,0,222
Sevier,8/16/20,0,0,0,0,0,0,0,0,0,1058,0,5110,0,978,0,11,0,69,0,6168,0,0,0,0,0,0,0,5,4,0,19
Sharp,8/16/20,0,0,0,0,0,0,0,0,0,128,0,2459,0,103,0,5,0,20,0,2587,0,0,0,0,0,0,0,1,0,0,28
St.Francis,8/16/20,0,0,0,0,0,0,0,0,0,1238,0,7846,0,1155,0,3,0,80,0,9084,0,0,0,0,0,0,0,2,0,0,62
Stone,8/16/20,0,0,0,0,0,0,0,0,0,86,0,1982,0,60,0,1,0,25,0,2068,0,0,0,0,0,0,0,2,1,0,15
Union,8/16/20,0,0,0,0,0,0,0,0,0,556,0,6064,0,480,0,20,0,56,0,6620,0,0,0,0,0,0,0,3,4,0,22
VanBuren,8/16/20,0,0,0,0,0,0,0,0,0,55,0,2553,0,49,0,2,0,4,0,2608,0,0,0,0,0,0,0,1,1,0,11
Washington,8/16/20,0,0,0,0,0,0,0,0,0,6430,0,45763,0,6145,0,53,0,232,0,52193,0,0,0,0,0,0,0,30,47,0,154
White,8/16/20,0,0,0,0,0,0,0,0,0,394,0,8972,0,302,0,3,0,89,0,9366,0,0,0,0,0,0,0,5,6,0,39
Woodruff,8/16/20,0,0,0,0,0,0,0,0,0,24,0,1158,0,21,0,0,0,3,0,1182,0,0,0,0,0,0,0,0,1,0,1
Yell,8/16/20,0,0,0,0,0,0,0,0,0,1088,0,6899,0,1033,0,17,0,38,0,7987,0,0,0,0,0,0,0,3,2,0,24
Arkansas_all_counties,8/15/20,0,0,0,0,0,0,0,0,2990671,51992,0,564109,0,44905,0,600,0,6487,0,616101,0,0,0,0,0,0,0,851,-541,13,27441
Arkansas_county,8/15/20,0,0,0,0,0,0,0,0,0,246,0,3565,0,212,0,2,0,32,0,3811,0,0,0,0,0,0,0,3,1,1,621
Ashley,8/15/20,0,0,0,0,0,0,0,0,0,352,0,3570,0,292,0,5,0,55,0,3922,0,0,0,0,0,0,0,10,5,0,564
Baxter,8/15/20,0,0,0,0,0,0,0,0,0,81,0,1939,0,67,0,0,0,14,0,2020,0,0,0,0,0,0,0,0,-2,0,-1533
Benton,8/15/20,0,0,0,0,0,0,0,0,0,4900,0,48950,0,4655,0,43,0,202,0,53850,0,0,0,0,0,0,0,21,19,0,-8209
Boone,8/15/20,0,0,0,0,0,0,0,0,0,225,0,5300,0,190,0,2,0,33,0,5525,0,0,0,0,0,0,0,2,6,0,939
Bradley,8/15/20,0,0,0,0,0,0,0,0,0,218,0,2595,0,152,0,4,0,62,0,2813,0,0,0,0,0,0,0,5,2,0,233
Calhoun,8/15/20,0,0,0,0,0,0,0,0,0,16,0,1090,0,14,0,0,0,2,0,1106,0,0,0,0,0,0,0,-1,-1,0,521
Carroll,8/15/20,0,0,0,0,0,0,0,0,0,383,0,4802,0,343,0,7,0,33,0,5185,0,0,0,0,0,0,0,3,3,0,377
Chicot,8/15/20,0,0,0,0,0,0,0,0,0,919,0,3747,0,535,0,9,0,375,0,4666,0,0,0,0,0,0,0,32,1,0,672
Clark,8/15/20,0,0,0,0,0,0,0,0,0,186,0,4103,0,167,0,2,0,17,0,4289,0,0,0,0,0,0,0,1,1,0,1124
Clay,8/15/20,0,0,0,0,0,0,0,0,0,145,0,2619,0,112,0,4,0,29,0,2764,0,0,0,0,0,0,0,2,1,0,153
Cleburne,8/15/20,0,0,0,0,0,0,0,0,0,220,0,3800,0,182,0,5,0,33,0,4020,0,0,0,0,0,0,0,10,0,0,369
Cleveland,8/15/20,0,0,0,0,0,0,0,0,0,117,0,1604,0,83,0,2,0,32,0,1721,0,0,0,0,0,0,0,2,0,0,209
Columbia,8/15/20,0,0,0,0,0,0,0,0,0,241,0,3202,0,196,0,12,0,33,0,3443,0,0,0,0,0,0,0,14,9,0,514
Conway,8/15/20,0,0,0,0,0,0,0,0,0,162,0,4069,0,138,0,3,0,21,0,4231,0,0,0,0,0,0,0,1,0,0,814
Craighead,8/15/20,0,0,0,0,0,0,0,0,0,1473,0,18974,0,1274,0,13,0,186,0,20447,0,0,0,0,0,0,0,22,15,1,1362
Crawford,8/15/20,0,0,0,0,0,0,0,0,0,711,0,11452,0,571,0,5,0,135,0,12163,0,0,0,0,0,0,0,16,13,0,2178
Crittenden,8/15/20,0,0,0,0,0,0,0,0,0,1460,0,10683,0,1285,0,24,0,151,0,12143,0,0,0,0,0,0,0,5,7,0,1628
Cross,8/15/20,0,0,0,0,0,0,0,0,0,222,0,2667,0,184,0,4,0,34,0,2889,0,0,0,0,0,0,0,2,4,0,401
Dallas,8/15/20,0,0,0,0,0,0,0,0,0,68,0,1188,0,58,0,2,0,8,0,1256,0,0,0,0,0,0,0,1,1,1,248
Desha,8/15/20,0,0,0,0,0,0,0,0,0,210,0,2640,0,163,0,2,0,45,0,2850,0,0,0,0,0,0,0,3,1,0,738
Drew,8/15/20,0,0,0,0,0,0,0,0,0,254,0,3978,0,180,0,3,0,71,0,4232,0,0,0,0,0,0,0,14,0,0,756
Faulkner,8/15/20,0,0,0,0,0,0,0,0,0,1375,0,23548,0,1238,0,6,0,131,0,24923,0,0,0,0,0,0,0,5,6,0,5413
Franklin,8/15/20,0,0,0,0,0,0,0,0,0,139,0,3553,0,117,0,2,0,20,0,3692,0,0,0,0,0,0,0,1,3,0,427
Fulton,8/15/20,0,0,0,0,0,0,0,0,0,47,0,711,0,30,0,0,0,17,0,758,0,0,0,0,0,0,0,0,1,0,-692
Garland,8/15/20,0,0,0,0,0,0,0,0,0,1169,0,18791,0,912,0,17,0,240,0,19960,0,0,0,0,0,0,0,14,12,0,4154
Grant,8/15/20,0,0,0,0,0,0,0,0,0,148,0,3075,0,129,0,0,0,19,0,3223,0,0,0,0,0,0,0,4,0,0,757
Greene,8/15/20,0,0,0,0,0,0,0,0,0,531,0,8043,0,438,0,3,0,90,0,8574,0,0,0,0,0,0,0,5,14,0,742
Hempstead,8/15/20,0,0,0,0,0,0,0,0,0,265,0,3085,0,227,0,2,0,36,0,3350,0,0,0,0,0,0,0,5,1,0,68
HotSpring,8/15/20,0,0,0,0,0,0,0,0,0,1621,0,7575,0,1465,0,13,0,143,0,9196,0,0,0,0,0,0,0,22,4,0,1833
Howard,8/15/20,0,0,0,0,0,0,0,0,0,367,0,2691,0,309,0,4,0,54,0,3058,0,0,0,0,0,0,0,3,1,0,88
Independence,8/15/20,0,0,0,0,0,0,0,0,0,604,0,6199,0,439,0,2,0,163,0,6803,0,0,0,0,0,0,0,15,23,0,1213
Izard,8/15/20,0,0,0,0,0,0,0,0,0,62,0,1425,0,49,0,1,0,12,0,1487,0,0,0,0,0,0,0,-2,0,0,-51
Jackson,8/15/20,0,0,0,0,0,0,0,0,0,124,0,2725,0,62,0,1,0,61,0,2849,0,0,0,0,0,0,0,4,0,0,-397
Jefferson,8/15/20,0,0,0,0,0,0,0,0,0,1670,0,16304,0,1372,0,41,0,257,0,17974,0,0,0,0,0,0,0,13,17,0,1302
Johnson,8/15/20,0,0,0,0,0,0,0,0,0,687,0,4967,0,648,0,2,0,37,0,5654,0,0,0,0,0,0,0,0,3,0,1982
Lafayette,8/15/20,0,0,0,0,0,0,0,0,0,59,0,714,0,52,0,2,0,5,0,773,0,0,0,0,0,0,0,0,0,0,137
Lawrence,8/15/20,0,0,0,0,0,0,0,0,0,229,0,2185,0,199,0,9,0,21,0,2414,0,0,0,0,0,0,0,3,5,0,-197
Lee,8/15/20,0,0,0,0,0,0,0,0,0,901,0,3031,0,878,0,8,0,15,0,3932,0,0,0,0,0,0,0,0,0,0,88
Lincoln,8/15/20,0,0,0,0,0,0,0,0,0,1290,0,3965,0,1189,0,12,0,89,0,5255,0,0,0,0,0,0,0,62,7,0,832
LittleRiver,8/15/20,0,0,0,0,0,0,0,0,0,215,0,1323,0,172,0,3,0,40,0,1538,0,0,0,0,0,0,0,19,5,0,77
Logan,8/15/20,0,0,0,0,0,0,0,0,0,334,0,4669,0,190,0,1,0,143,0,5003,0,0,0,0,0,0,0,3,11,0,567
Lonoke,8/15/20,0,0,0,0,0,0,0,0,0,564,0,10524,0,461,0,2,0,101,0,11088,0,0,0,0,0,0,0,8,7,0,2125
Madison,8/15/20,0,0,0,0,0,0,0,0,0,277,0,2831,0,267,0,2,0,8,0,3108,0,0,0,0,0,0,0,0,2,0,204
Marion,8/15/20,0,0,0,0,0,0,0,0,0,33,0,1424,0,27,0,0,0,6,0,1457,0,0,0,0,0,0,0,0,0,0,84
Miller,8/15/20,0,0,0,0,0,0,0,0,0,536,0,3990,0,492,0,5,0,39,0,4526,0,0,0,0,0,0,0,3,6,0,-203
MissingCountyInfo,8/15/20,0,0,0,0,0,0,0,0,0,742,0,15437,0,545,0,0,0,197,0,16179,0,0,0,0,0,0,0,-1093,-949,0,-51127
Mississippi,8/15/20,0,0,0,0,0,0,0,0,0,1133,0,8143,0,874,0,14,0,245,0,9276,0,0,0,0,0,0,0,36,16,0,856
Monroe,8/15/20,0,0,0,0,0,0,0,0,0,73,0,1461,0,55,0,0,0,18,0,1534,0,0,0,0,0,0,0,2,1,0,75
Montgomery,8/15/20,0,0,0,0,0,0,0,0,0,42,0,1039,0,28,0,1,0,13,0,1081,0,0,0,0,0,0,0,2,-1,0,106
Nevada,8/15/20,0,0,0,0,0,0,0,0,0,147,0,2022,0,126,0,9,0,12,0,2169,0,0,0,0,0,0,0,1,1,0,382
Newton,8/15/20,0,0,0,0,0,0,0,0,0,107,0,1017,0,88,0,11,0,8,0,1124,0,0,0,0,0,0,0,0,-1,1,144
Ouachita,8/15/20,0,0,0,0,0,0,0,0,0,113,0,3652,0,85,0,3,0,25,0,3765,0,0,0,0,0,0,0,2,-1,0,383
Perry,8/15/20,0,0,0,0,0,0,0,0,0,55,0,1877,0,50,0,0,0,5,0,1932,0,0,0,0,0,0,0,0,0,0,369
Phillips,8/15/20,0,0,0,0,0,0,0,0,0,346,0,4524,0,293,0,9,0,44,0,4870,0,0,0,0,0,0,0,10,5,0,606
Pike,8/15/20,0,0,0,0,0,0,0,0,0,138,0,1508,0,89,0,1,0,48,0,1646,0,0,0,0,0,0,0,8,2,0,-1461
Poinsett,8/15/20,0,0,0,0,0,0,0,0,0,336,0,4490,0,227,0,4,0,105,0,4826,0,0,0,0,0,0,0,12,8,0,1709
Polk,8/15/20,0,0,0,0,0,0,0,0,0,159,0,2681,0,133,0,1,0,25,0,2840,0,0,0,0,0,0,0,2,-1,0,295
Pope,8/15/20,0,0,0,0,0,0,0,0,0,1426,0,13790,0,1255,0,12,0,159,0,15216,0,0,0,0,0,0,0,25,14,1,3433
Prairie,8/15/20,0,0,0,0,0,0,0,0,0,108,0,1307,0,83,0,0,0,25,0,1415,0,0,0,0,0,0,0,1,5,0,160
Pulaski,8/15/20,0,0,0,0,0,0,0,0,0,6000,0,79925,0,5094,0,88,0,818,0,85925,0,0,0,0,0,0,0,63,45,0,13197
Randolph,8/15/20,0,0,0,0,0,0,0,0,0,255,0,3254,0,203,0,11,0,41,0,3509,0,0,0,0,0,0,0,3,-6,7,340
Saline,8/15/20,0,0,0,0,0,0,0,0,0,1239,0,16774,0,966,0,8,0,265,0,18013,0,0,0,0,0,0,0,55,16,0,-479
Scott,8/15/20,0,0,0,0,0,0,0,0,0,77,0,1267,0,52,0,0,0,25,0,1344,0,0,0,0,0,0,0,5,5,0,145
Searcy,8/15/20,0,0,0,0,0,0,0,0,0,34,0,1260,0,29,0,0,0,5,0,1294,0,0,0,0,0,0,0,2,0,0,115
Sebastian,8/15/20,0,0,0,0,0,0,0,0,0,2401,0,26313,0,1955,0,22,0,424,0,28714,0,0,0,0,0,0,0,43,37,1,3128
Sevier,8/15/20,0,0,0,0,0,0,0,0,0,1053,0,5096,0,974,0,11,0,68,0,6149,0,0,0,0,0,0,0,19,5,0,510
Sharp,8/15/20,0,0,0,0,0,0,0,0,0,127,0,2432,0,103,0,5,0,19,0,2559,0,0,0,0,0,0,0,2,0,0,554
St.Francis,8/15/20,0,0,0,0,0,0,0,0,0,1236,0,7786,0,1155,0,3,0,78,0,9022,0,0,0,0,0,0,0,0,16,0,482
Stone,8/15/20,0,0,0,0,0,0,0,0,0,84,0,1969,0,59,0,1,0,24,0,2053,0,0,0,0,0,0,0,5,1,0,180
Union,8/15/20,0,0,0,0,0,0,0,0,0,553,0,6045,0,476,0,20,0,57,0,6598,0,0,0,0,0,0,0,14,11,0,1478
VanBuren,8/15/20,0,0,0,0,0,0,0,0,0,54,0,2543,0,48,0,2,0,4,0,2597,0,0,0,0,0,0,0,1,0,0,959
Washington,8/15/20,0,0,0,0,0,0,0,0,0,6400,0,45639,0,6098,0,53,0,249,0,52039,0,0,0,0,0,0,0,6,13,0,20231
White,8/15/20,0,0,0,0,0,0,0,0,0,389,0,8938,0,296,0,3,0,90,0,9327,0,0,0,0,0,0,0,19,3,0,2341
Woodruff,8/15/20,0,0,0,0,0,0,0,0,0,24,0,1157,0,20,0,0,0,4,0,1181,0,0,0,0,0,0,0,1,0,0,59
Yell,8/15/20,0,0,0,0,0,0,0,0,0,1085,0,6878,0,1031,0,17,0,37,0,7963,0,0,0,0,0,0,0,-1,0,0,3039
Arkansas_all_counties,8/14/20,0,0,0,0,0,0,0,0,2990671,52392,0,536268,0,45446,0,587,0,6359,0,588660,0,0,0,0,0,0,0,626,844,5,5180
Arkansas_county,8/14/20,0,0,0,0,0,0,0,0,0,243,0,2947,0,211,0,1,0,31,0,3190,0,0,0,0,0,0,0,2,6,0,12
Ashley,8/14/20,0,0,0,0,0,0,0,0,0,342,0,3016,0,287,0,5,0,50,0,3358,0,0,0,0,0,0,0,5,16,0,21
Baxter,8/14/20,0,0,0,0,0,0,0,0,0,81,0,3472,0,69,0,0,0,12,0,3553,0,0,0,0,0,0,0,3,5,0,7
Benton,8/14/20,0,0,0,0,0,0,0,0,0,4879,0,57180,0,4636,0,43,0,200,0,62059,0,0,0,0,0,0,0,15,40,0,325
Boone,8/14/20,0,0,0,0,0,0,0,0,0,223,0,4363,0,184,0,2,0,37,0,4586,0,0,0,0,0,0,0,1,9,0,25
Bradley,8/14/20,0,0,0,0,0,0,0,0,0,213,0,2367,0,150,0,4,0,59,0,2580,0,0,0,0,0,0,0,1,3,0,20
Calhoun,8/14/20,0,0,0,0,0,0,0,0,0,17,0,568,0,15,0,0,0,2,0,585,0,0,0,0,0,0,0,0,2,0,7
Carroll,8/14/20,0,0,0,0,0,0,0,0,0,380,0,4428,0,340,0,7,0,33,0,4808,0,0,0,0,0,0,0,0,5,0,15
Chicot,8/14/20,0,0,0,0,0,0,0,0,0,887,0,3107,0,534,0,9,0,344,0,3994,0,0,0,0,0,0,0,141,18,0,195
Clark,8/14/20,0,0,0,0,0,0,0,0,0,185,0,2980,0,166,0,2,0,17,0,3165,0,0,0,0,0,0,0,2,5,1,22
Clay,8/14/20,0,0,0,0,0,0,0,0,0,143,0,2468,0,111,0,4,0,28,0,2611,0,0,0,0,0,0,0,3,2,0,6
Cleburne,8/14/20,0,0,0,0,0,0,0,0,0,210,0,3441,0,182,0,5,0,23,0,3651,0,0,0,0,0,0,0,0,1,0,8
Cleveland,8/14/20,0,0,0,0,0,0,0,0,0,115,0,1397,0,83,0,2,0,30,0,1512,0,0,0,0,0,0,0,0,4,0,9
Columbia,8/14/20,0,0,0,0,0,0,0,0,0,227,0,2702,0,187,0,12,0,28,0,2929,0,0,0,0,0,0,0,1,4,0,15
Conway,8/14/20,0,0,0,0,0,0,0,0,0,161,0,3256,0,138,0,3,0,20,0,3417,0,0,0,0,0,0,0,0,2,0,40
Craighead,8/14/20,0,0,0,0,0,0,0,0,0,1451,0,17634,0,1259,0,12,0,180,0,19085,0,0,0,0,0,0,0,6,30,0,83
Crawford,8/14/20,0,0,0,0,0,0,0,0,0,695,0,9290,0,558,0,5,0,132,0,9985,0,0,0,0,0,0,0,13,11,0,84
Crittenden,8/14/20,0,0,0,0,0,0,0,0,0,1455,0,9060,0,1278,0,24,0,153,0,10515,0,0,0,0,0,0,0,13,20,0,43
Cross,8/14/20,0,0,0,0,0,0,0,0,0,220,0,2268,0,180,0,4,0,36,0,2488,0,0,0,0,0,0,0,3,8,0,28
Dallas,8/14/20,0,0,0,0,0,0,0,0,0,67,0,941,0,57,0,1,0,9,0,1008,0,0,0,0,0,0,0,0,0,0,45
Desha,8/14/20,0,0,0,0,0,0,0,0,0,207,0,1905,0,162,0,2,0,43,0,2112,0,0,0,0,0,0,0,1,8,0,14
Drew,8/14/20,0,0,0,0,0,0,0,0,0,240,0,3236,0,180,0,3,0,57,0,3476,0,0,0,0,0,0,0,6,8,0,17
Faulkner,8/14/20,0,0,0,0,0,0,0,0,0,1370,0,18140,0,1232,0,6,0,132,0,19510,0,0,0,0,0,0,0,9,19,0,148
Franklin,8/14/20,0,0,0,0,0,0,0,0,0,138,0,3127,0,114,0,2,0,22,0,3265,0,0,0,0,0,0,0,2,6,0,24
Fulton,8/14/20,0,0,0,0,0,0,0,0,0,47,0,1403,0,29,0,0,0,18,0,1450,0,0,0,0,0,0,0,3,0,0,14
Garland,8/14/20,0,0,0,0,0,0,0,0,0,1155,0,14651,0,900,0,17,0,238,0,15806,0,0,0,0,0,0,0,21,27,0,99
Grant,8/14/20,0,0,0,0,0,0,0,0,0,144,0,2322,0,129,0,0,0,15,0,2466,0,0,0,0,0,0,0,0,0,0,22
Greene,8/14/20,0,0,0,0,0,0,0,0,0,526,0,7306,0,424,0,3,0,99,0,7832,0,0,0,0,0,0,0,3,71,0,19
Hempstead,8/14/20,0,0,0,0,0,0,0,0,0,260,0,3022,0,226,0,2,0,32,0,3282,0,0,0,0,0,0,0,5,5,0,22
HotSpring,8/14/20,0,0,0,0,0,0,0,0,0,1599,0,5764,0,1461,0,13,0,125,0,7363,0,0,0,0,0,0,0,30,6,1,109
Howard,8/14/20,0,0,0,0,0,0,0,0,0,364,0,2606,0,308,0,4,0,52,0,2970,0,0,0,0,0,0,0,2,5,0,15
Independence,8/14/20,0,0,0,0,0,0,0,0,0,589,0,5001,0,416,0,2,0,171,0,5590,0,0,0,0,0,0,0,5,28,0,53
Izard,8/14/20,0,0,0,0,0,0,0,0,0,64,0,1474,0,49,0,1,0,14,0,1538,0,0,0,0,0,0,0,2,4,0,18
Jackson,8/14/20,0,0,0,0,0,0,0,0,0,120,0,3126,0,62,0,1,0,57,0,3246,0,0,0,0,0,0,0,1,3,0,8
Jefferson,8/14/20,0,0,0,0,0,0,0,0,0,1657,0,15015,0,1355,0,41,0,261,0,16672,0,0,0,0,0,0,0,13,17,0,518
Johnson,8/14/20,0,0,0,0,0,0,0,0,0,687,0,2985,0,645,0,2,0,40,0,3672,0,0,0,0,0,0,0,8,8,0,47
Lafayette,8/14/20,0,0,0,0,0,0,0,0,0,59,0,577,0,52,0,2,0,5,0,636,0,0,0,0,0,0,0,1,1,0,1
Lawrence,8/14/20,0,0,0,0,0,0,0,0,0,226,0,2385,0,194,0,9,0,23,0,2611,0,0,0,0,0,0,0,3,1,0,29
Lee,8/14/20,0,0,0,0,0,0,0,0,0,901,0,2943,0,878,0,8,0,15,0,3844,0,0,0,0,0,0,0,0,1,0,7
Lincoln,8/14/20,0,0,0,0,0,0,0,0,0,1228,0,3195,0,1182,0,12,0,34,0,4423,0,0,0,0,0,0,0,4,10,0,367
LittleRiver,8/14/20,0,0,0,0,0,0,0,0,0,196,0,1265,0,167,0,3,0,26,0,1461,0,0,0,0,0,0,0,3,3,1,24
Logan,8/14/20,0,0,0,0,0,0,0,0,0,331,0,4105,0,179,0,1,0,151,0,4436,0,0,0,0,0,0,0,10,11,0,168
Lonoke,8/14/20,0,0,0,0,0,0,0,0,0,556,0,8407,0,454,0,2,0,100,0,8963,0,0,0,0,0,0,0,10,6,0,62
Madison,8/14/20,0,0,0,0,0,0,0,0,0,277,0,2627,0,265,0,2,0,10,0,2904,0,0,0,0,0,0,0,2,7,0,19
Marion,8/14/20,0,0,0,0,0,0,0,0,0,33,0,1340,0,27,0,0,0,6,0,1373,0,0,0,0,0,0,0,2,1,0,10
Miller,8/14/20,0,0,0,0,0,0,0,0,0,533,0,4196,0,486,0,5,0,42,0,4729,0,0,0,0,0,0,0,6,6,0,28
MissingCountyInfo,8/14/20,0,0,0,0,0,0,0,0,0,1835,0,65471,0,1494,0,0,0,341,0,67306,0,0,0,0,0,0,0,19,28,0,296
Mississippi,8/14/20,0,0,0,0,0,0,0,0,0,1097,0,7323,0,858,0,14,0,225,0,8420,0,0,0,0,0,0,0,8,74,0,48
Monroe,8/14/20,0,0,0,0,0,0,0,0,0,71,0,1388,0,54,0,0,0,17,0,1459,0,0,0,0,0,0,0,6,0,0,22
Montgomery,8/14/20,0,0,0,0,0,0,0,0,0,40,0,935,0,29,0,1,0,10,0,975,0,0,0,0,0,0,0,2,0,0,5
Nevada,8/14/20,0,0,0,0,0,0,0,0,0,146,0,1641,0,125,0,9,0,12,0,1787,0,0,0,0,0,0,0,-1,1,0,5
Newton,8/14/20,0,0,0,0,0,0,0,0,0,107,0,873,0,89,0,10,0,8,0,980,0,0,0,0,0,0,0,0,1,0,3
Ouachita,8/14/20,0,0,0,0,0,0,0,0,0,111,0,3271,0,86,0,3,0,22,0,3382,0,0,0,0,0,0,0,1,3,1,44
Perry,8/14/20,0,0,0,0,0,0,0,0,0,55,0,1508,0,50,0,0,0,5,0,1563,0,0,0,0,0,0,0,0,0,0,16
Phillips,8/14/20,0,0,0,0,0,0,0,0,0,336,0,3928,0,288,0,9,0,39,0,4264,0,0,0,0,0,0,0,2,3,0,19
Pike,8/14/20,0,0,0,0,0,0,0,0,0,130,0,2977,0,87,0,1,0,42,0,3107,0,0,0,0,0,0,0,4,3,0,28
Poinsett,8/14/20,0,0,0,0,0,0,0,0,0,324,0,2793,0,219,0,4,0,101,0,3117,0,0,0,0,0,0,0,5,10,0,22
Polk,8/14/20,0,0,0,0,0,0,0,0,0,157,0,2388,0,134,0,1,0,22,0,2545,0,0,0,0,0,0,0,0,0,0,22
Pope,8/14/20,0,0,0,0,0,0,0,0,0,1401,0,10382,0,1241,0,11,0,149,0,11783,0,0,0,0,0,0,0,21,15,0,96
Prairie,8/14/20,0,0,0,0,0,0,0,0,0,107,0,1148,0,78,0,0,0,29,0,1255,0,0,0,0,0,0,0,3,4,0,12
Pulaski,8/14/20,0,0,0,0,0,0,0,0,0,5937,0,66791,0,5049,0,88,0,800,0,72728,0,0,0,0,0,0,0,57,62,0,491
Randolph,8/14/20,0,0,0,0,0,0,0,0,0,252,0,2917,0,209,0,4,0,39,0,3169,0,0,0,0,0,0,0,7,11,0,19
Saline,8/14/20,0,0,0,0,0,0,0,0,0,1184,0,17308,0,950,0,8,0,226,0,18492,0,0,0,0,0,0,0,26,26,0,239
Scott,8/14/20,0,0,0,0,0,0,0,0,0,72,0,1127,0,47,0,0,0,25,0,1199,0,0,0,0,0,0,0,2,2,0,15
Searcy,8/14/20,0,0,0,0,0,0,0,0,0,32,0,1147,0,29,0,0,0,3,0,1179,0,0,0,0,0,0,0,0,1,0,5
Sebastian,8/14/20,0,0,0,0,0,0,0,0,0,2358,0,23228,0,1918,0,21,0,419,0,25586,0,0,0,0,0,0,0,14,56,0,179
Sevier,8/14/20,0,0,0,0,0,0,0,0,0,1034,0,4605,0,969,0,11,0,54,0,5639,0,0,0,0,0,0,0,17,11,0,34
Sharp,8/14/20,0,0,0,0,0,0,0,0,0,125,0,1880,0,103,0,5,0,17,0,2005,0,0,0,0,0,0,0,5,0,0,133
St.Francis,8/14/20,0,0,0,0,0,0,0,0,0,1236,0,7304,0,1139,0,3,0,94,0,8540,0,0,0,0,0,0,0,5,6,0,31
Stone,8/14/20,0,0,0,0,0,0,0,0,0,79,0,1794,0,58,0,1,0,20,0,1873,0,0,0,0,0,0,0,3,1,0,20
Union,8/14/20,0,0,0,0,0,0,0,0,0,539,0,4581,0,465,0,20,0,54,0,5120,0,0,0,0,0,0,0,7,9,1,32
VanBuren,8/14/20,0,0,0,0,0,0,0,0,0,53,0,1585,0,48,0,2,0,3,0,1638,0,0,0,0,0,0,0,0,0,0,6
Washington,8/14/20,0,0,0,0,0,0,0,0,0,6394,0,25414,0,6085,0,53,0,256,0,31808,0,0,0,0,0,0,0,21,46,0,301
White,8/14/20,0,0,0,0,0,0,0,0,0,370,0,6616,0,293,0,3,0,74,0,6986,0,0,0,0,0,0,0,28,6,0,118
Woodruff,8/14/20,0,0,0,0,0,0,0,0,0,23,0,1099,0,20,0,0,0,3,0,1122,0,0,0,0,0,0,0,1,2,0,26
Yell,8/14/20,0,0,0,0,0,0,0,0,0,1086,0,3838,0,1031,0,17,0,38,0,4924,0,0,0,0,0,0,0,2,10,0,21
Arkansas_all_counties,8/13/20,0,0,0,0,0,0,0,0,2990671,51766,0,531714,0,44602,0,582,0,6582,0,583480,0,0,0,0,0,0,0,652,786,9,4692
Arkansas_county,8/13/20,0,0,0,0,0,0,0,0,0,241,0,2937,0,205,0,1,0,35,0,3178,0,0,0,0,0,0,0,8,10,0,19
Ashley,8/13/20,0,0,0,0,0,0,0,0,0,337,0,3000,0,271,0,5,0,61,0,3337,0,0,0,0,0,0,0,2,7,0,40
Baxter,8/13/20,0,0,0,0,0,0,0,0,0,78,0,3468,0,64,0,0,0,14,0,3546,0,0,0,0,0,0,0,2,2,0,38
Benton,8/13/20,0,0,0,0,0,0,0,0,0,4864,0,56870,0,4596,0,43,0,225,0,61734,0,0,0,0,0,0,0,39,49,0,359
Boone,8/13/20,0,0,0,0,0,0,0,0,0,222,0,4339,0,175,0,2,0,45,0,4561,0,0,0,0,0,0,0,5,10,0,59
Bradley,8/13/20,0,0,0,0,0,0,0,0,0,212,0,2348,0,147,0,4,0,61,0,2560,0,0,0,0,0,0,0,5,4,0,50
Calhoun,8/13/20,0,0,0,0,0,0,0,0,0,17,0,561,0,13,0,0,0,4,0,578,0,0,0,0,0,0,0,0,0,0,3
Carroll,8/13/20,0,0,0,0,0,0,0,0,0,380,0,4413,0,335,0,7,0,38,0,4793,0,0,0,0,0,0,0,1,3,0,47
Chicot,8/13/20,0,0,0,0,0,0,0,0,0,746,0,3053,0,516,0,9,0,221,0,3799,0,0,0,0,0,0,0,8,7,0,28
Clark,8/13/20,0,0,0,0,0,0,0,0,0,183,0,2960,0,161,0,1,0,21,0,3143,0,0,0,0,0,0,0,1,3,0,18
Clay,8/13/20,0,0,0,0,0,0,0,0,0,140,0,2465,0,109,0,4,0,27,0,2605,0,0,0,0,0,0,0,0,0,0,16
Cleburne,8/13/20,0,0,0,0,0,0,0,0,0,210,0,3433,0,181,0,5,0,24,0,3643,0,0,0,0,0,0,0,4,3,0,22
Cleveland,8/13/20,0,0,0,0,0,0,0,0,0,115,0,1388,0,79,0,2,0,34,0,1503,0,0,0,0,0,0,0,3,3,0,24
Columbia,8/13/20,0,0,0,0,0,0,0,0,0,226,0,2688,0,183,0,12,0,31,0,2914,0,0,0,0,0,0,0,3,4,0,11
Conway,8/13/20,0,0,0,0,0,0,0,0,0,161,0,3216,0,136,0,3,0,22,0,3377,0,0,0,0,0,0,0,5,1,0,36
Craighead,8/13/20,0,0,0,0,0,0,0,0,0,1445,0,17557,0,1229,0,12,0,204,0,19002,0,0,0,0,0,0,0,26,25,0,120
Crawford,8/13/20,0,0,0,0,0,0,0,0,0,682,0,9219,0,547,0,5,0,130,0,9901,0,0,0,0,0,0,0,14,12,0,123
Crittenden,8/13/20,0,0,0,0,0,0,0,0,0,1442,0,9030,0,1258,0,24,0,160,0,10472,0,0,0,0,0,0,0,40,27,0,107
Cross,8/13/20,0,0,0,0,0,0,0,0,0,217,0,2243,0,172,0,4,0,41,0,2460,0,0,0,0,0,0,0,5,6,0,12
Dallas,8/13/20,0,0,0,0,0,0,0,0,0,67,0,896,0,57,0,1,0,9,0,963,0,0,0,0,0,0,0,2,2,0,11
Desha,8/13/20,0,0,0,0,0,0,0,0,0,206,0,1892,0,154,0,2,0,50,0,2098,0,0,0,0,0,0,0,3,7,0,20
Drew,8/13/20,0,0,0,0,0,0,0,0,0,234,0,3225,0,172,0,3,0,59,0,3459,0,0,0,0,0,0,0,13,7,0,58
Faulkner,8/13/20,0,0,0,0,0,0,0,0,0,1361,0,18001,0,1213,0,6,0,142,0,19362,0,0,0,0,0,0,0,21,12,0,172
Franklin,8/13/20,0,0,0,0,0,0,0,0,0,136,0,3105,0,108,0,2,0,26,0,3241,0,0,0,0,0,0,0,3,6,0,15
Fulton,8/13/20,0,0,0,0,0,0,0,0,0,44,0,1392,0,29,0,0,0,15,0,1436,0,0,0,0,0,0,0,0,0,0,21
Garland,8/13/20,0,0,0,0,0,0,0,0,0,1134,0,14573,0,873,0,17,0,244,0,15707,0,0,0,0,0,0,0,19,19,0,186
Grant,8/13/20,0,0,0,0,0,0,0,0,0,144,0,2300,0,129,0,0,0,15,0,2444,0,0,0,0,0,0,0,2,1,0,24
Greene,8/13/20,0,0,0,0,0,0,0,0,0,523,0,7290,0,353,0,3,0,167,0,7813,0,0,0,0,0,0,0,18,16,1,91
Hempstead,8/13/20,0,0,0,0,0,0,0,0,0,255,0,3005,0,221,0,2,0,32,0,3260,0,0,0,0,0,0,0,2,2,0,23
HotSpring,8/13/20,0,0,0,0,0,0,0,0,0,1569,0,5685,0,1455,0,12,0,102,0,7254,0,0,0,0,0,0,0,5,7,0,27
Howard,8/13/20,0,0,0,0,0,0,0,0,0,362,0,2593,0,303,0,4,0,55,0,2955,0,0,0,0,0,0,0,2,4,0,9
Independence,8/13/20,0,0,0,0,0,0,0,0,0,584,0,4953,0,388,0,2,0,194,0,5537,0,0,0,0,0,0,0,16,26,0,81
Izard,8/13/20,0,0,0,0,0,0,0,0,0,62,0,1458,0,45,0,1,0,16,0,1520,0,0,0,0,0,0,0,4,1,0,15
Jackson,8/13/20,0,0,0,0,0,0,0,0,0,119,0,3119,0,59,0,1,0,59,0,3238,0,0,0,0,0,0,0,2,3,0,18
Jefferson,8/13/20,0,0,0,0,0,0,0,0,0,1644,0,14510,0,1338,0,41,0,265,0,16154,0,0,0,0,0,0,0,27,30,1,449
Johnson,8/13/20,0,0,0,0,0,0,0,0,0,679,0,2946,0,637,0,2,0,40,0,3625,0,0,0,0,0,0,0,3,7,0,14
Lafayette,8/13/20,0,0,0,0,0,0,0,0,0,58,0,577,0,51,0,2,0,5,0,635,0,0,0,0,0,0,0,0,0,0,1
Lawrence,8/13/20,0,0,0,0,0,0,0,0,0,223,0,2359,0,193,0,9,0,21,0,2582,0,0,0,0,0,0,0,2,5,0,16
Lee,8/13/20,0,0,0,0,0,0,0,0,0,901,0,2936,0,877,0,8,0,16,0,3837,0,0,0,0,0,0,0,3,2,0,22
Lincoln,8/13/20,0,0,0,0,0,0,0,0,0,1224,0,2832,0,1172,0,12,0,40,0,4056,0,0,0,0,0,0,0,0,8,0,10
LittleRiver,8/13/20,0,0,0,0,0,0,0,0,0,193,0,1244,0,164,0,2,0,27,0,1437,0,0,0,0,0,0,0,4,3,1,9
Logan,8/13/20,0,0,0,0,0,0,0,0,0,321,0,3947,0,168,0,1,0,152,0,4268,0,0,0,0,0,0,0,-2,13,0,24
Lonoke,8/13/20,0,0,0,0,0,0,0,0,0,546,0,8355,0,448,0,2,0,96,0,8901,0,0,0,0,0,0,0,7,9,0,116
Madison,8/13/20,0,0,0,0,0,0,0,0,0,275,0,2610,0,258,0,2,0,15,0,2885,0,0,0,0,0,0,0,4,0,0,18
Marion,8/13/20,0,0,0,0,0,0,0,0,0,31,0,1332,0,26,0,0,0,5,0,1363,0,0,0,0,0,0,0,1,4,0,14
Miller,8/13/20,0,0,0,0,0,0,0,0,0,527,0,4174,0,480,0,5,0,42,0,4701,0,0,0,0,0,0,0,8,11,0,32
MissingCountyInfo,8/13/20,0,0,0,0,0,0,0,0,0,1816,0,65194,0,1466,0,0,0,350,0,67010,0,0,0,0,0,0,0,15,37,0,240
Mississippi,8/13/20,0,0,0,0,0,0,0,0,0,1089,0,7283,0,784,0,14,0,291,0,8372,0,0,0,0,0,0,0,21,18,0,62
Monroe,8/13/20,0,0,0,0,0,0,0,0,0,65,0,1372,0,54,0,0,0,11,0,1437,0,0,0,0,0,0,0,1,0,0,16
Montgomery,8/13/20,0,0,0,0,0,0,0,0,0,38,0,932,0,29,0,1,0,8,0,970,0,0,0,0,0,0,0,0,0,0,11
Nevada,8/13/20,0,0,0,0,0,0,0,0,0,147,0,1635,0,124,0,9,0,14,0,1782,0,0,0,0,0,0,0,1,1,0,6
Newton,8/13/20,0,0,0,0,0,0,0,0,0,107,0,870,0,88,0,10,0,9,0,977,0,0,0,0,0,0,0,1,0,0,9
Ouachita,8/13/20,0,0,0,0,0,0,0,0,0,110,0,3228,0,83,0,2,0,25,0,3338,0,0,0,0,0,0,0,3,1,0,17
Perry,8/13/20,0,0,0,0,0,0,0,0,0,55,0,1492,0,50,0,0,0,5,0,1547,0,0,0,0,0,0,0,0,0,0,14
Phillips,8/13/20,0,0,0,0,0,0,0,0,0,334,0,3911,0,285,0,9,0,40,0,4245,0,0,0,0,0,0,0,2,10,0,25
Pike,8/13/20,0,0,0,0,0,0,0,0,0,126,0,2953,0,84,0,1,0,41,0,3079,0,0,0,0,0,0,0,8,3,0,28
Poinsett,8/13/20,0,0,0,0,0,0,0,0,0,319,0,2776,0,209,0,4,0,106,0,3095,0,0,0,0,0,0,0,11,10,1,41
Polk,8/13/20,0,0,0,0,0,0,0,0,0,157,0,2366,0,134,0,1,0,22,0,2523,0,0,0,0,0,0,0,3,2,0,31
Pope,8/13/20,0,0,0,0,0,0,0,0,0,1380,0,10307,0,1226,0,11,0,143,0,11687,0,0,0,0,0,0,0,17,19,1,56
Prairie,8/13/20,0,0,0,0,0,0,0,0,0,104,0,1139,0,74,0,0,0,30,0,1243,0,0,0,0,0,0,0,2,2,0,13
Pulaski,8/13/20,0,0,0,0,0,0,0,0,0,5880,0,66357,0,4987,0,88,0,805,0,72237,0,0,0,0,0,0,0,93,86,1,599
Randolph,8/13/20,0,0,0,0,0,0,0,0,0,245,0,2905,0,198,0,4,0,43,0,3150,0,0,0,0,0,0,0,6,5,0,41
Saline,8/13/20,0,0,0,0,0,0,0,0,0,1158,0,17095,0,924,0,8,0,226,0,18253,0,0,0,0,0,0,0,25,22,1,193
Scott,8/13/20,0,0,0,0,0,0,0,0,0,70,0,1114,0,45,0,0,0,25,0,1184,0,0,0,0,0,0,0,2,7,0,20
Searcy,8/13/20,0,0,0,0,0,0,0,0,0,32,0,1142,0,28,0,0,0,4,0,1174,0,0,0,0,0,0,0,0,0,0,12
Sebastian,8/13/20,0,0,0,0,0,0,0,0,0,2344,0,23063,0,1862,0,21,0,461,0,25407,0,0,0,0,0,0,0,47,61,0,295
Sevier,8/13/20,0,0,0,0,0,0,0,0,0,1017,0,4588,0,958,0,11,0,48,0,5605,0,0,0,0,0,0,0,8,9,1,17
Sharp,8/13/20,0,0,0,0,0,0,0,0,0,120,0,1752,0,103,0,5,0,12,0,1872,0,0,0,0,0,0,0,3,3,0,20
St.Francis,8/13/20,0,0,0,0,0,0,0,0,0,1231,0,7278,0,1133,0,3,0,95,0,8509,0,0,0,0,0,0,0,3,15,0,42
Stone,8/13/20,0,0,0,0,0,0,0,0,0,76,0,1777,0,57,0,1,0,18,0,1853,0,0,0,0,0,0,0,2,3,0,14
Union,8/13/20,0,0,0,0,0,0,0,0,0,532,0,4556,0,456,0,19,0,57,0,5088,0,0,0,0,0,0,0,9,31,0,39
VanBuren,8/13/20,0,0,0,0,0,0,0,0,0,53,0,1579,0,48,0,2,0,3,0,1632,0,0,0,0,0,0,0,0,0,0,7
Washington,8/13/20,0,0,0,0,0,0,0,0,0,6373,0,25134,0,6039,0,53,0,281,0,31507,0,0,0,0,0,0,0,21,44,0,125
White,8/13/20,0,0,0,0,0,0,0,0,0,342,0,6526,0,287,0,3,0,52,0,6868,0,0,0,0,0,0,0,1,8,1,36
Woodruff,8/13/20,0,0,0,0,0,0,0,0,0,22,0,1074,0,18,0,0,0,4,0,1096,0,0,0,0,0,0,0,0,0,0,6
Yell,8/13/20,0,0,0,0,0,0,0,0,0,1084,0,3819,0,1021,0,17,0,46,0,4903,0,0,0,0,0,0,0,7,8,0,29
Arkansas_all_counties,8/12/20,0,0,0,0,0,0,0,0,2990671,51114,0,527674,0,43816,0,573,0,6725,0,578788,0,0,0,0,0,0,0,703,828,7,5920
Arkansas_county,8/12/20,0,0,0,0,0,0,0,0,0,233,0,2926,0,195,0,1,0,37,0,3159,0,0,0,0,0,0,0,6,4,0,21
Ashley,8/12/20,0,0,0,0,0,0,0,0,0,335,0,2962,0,264,0,5,0,66,0,3297,0,0,0,0,0,0,0,5,15,0,36
Baxter,8/12/20,0,0,0,0,0,0,0,0,0,76,0,3432,0,62,0,0,0,14,0,3508,0,0,0,0,0,0,0,3,2,0,20
Benton,8/12/20,0,0,0,0,0,0,0,0,0,4825,0,56550,0,4547,0,43,0,235,0,61375,0,0,0,0,0,0,0,20,42,0,476
Boone,8/12/20,0,0,0,0,0,0,0,0,0,217,0,4285,0,165,0,2,0,50,0,4502,0,0,0,0,0,0,0,3,7,0,27
Bradley,8/12/20,0,0,0,0,0,0,0,0,0,207,0,2303,0,143,0,4,0,60,0,2510,0,0,0,0,0,0,0,0,15,0,9
Calhoun,8/12/20,0,0,0,0,0,0,0,0,0,17,0,558,0,13,0,0,0,4,0,575,0,0,0,0,0,0,0,0,0,0,1
Carroll,8/12/20,0,0,0,0,0,0,0,0,0,379,0,4367,0,332,0,7,0,40,0,4746,0,0,0,0,0,0,0,0,1,0,34
Chicot,8/12/20,0,0,0,0,0,0,0,0,0,738,0,3033,0,509,0,9,0,220,0,3771,0,0,0,0,0,0,0,2,85,0,12
Clark,8/12/20,0,0,0,0,0,0,0,0,0,182,0,2943,0,158,0,1,0,23,0,3125,0,0,0,0,0,0,0,5,1,0,23
Clay,8/12/20,0,0,0,0,0,0,0,0,0,140,0,2449,0,109,0,4,0,27,0,2589,0,0,0,0,0,0,0,2,2,0,32
Cleburne,8/12/20,0,0,0,0,0,0,0,0,0,206,0,3415,0,178,0,5,0,23,0,3621,0,0,0,0,0,0,0,4,1,0,27
Cleveland,8/12/20,0,0,0,0,0,0,0,0,0,112,0,1367,0,76,0,2,0,34,0,1479,0,0,0,0,0,0,0,9,5,0,28
Columbia,8/12/20,0,0,0,0,0,0,0,0,0,223,0,2680,0,179,0,12,0,32,0,2903,0,0,0,0,0,0,0,3,3,0,14
Conway,8/12/20,0,0,0,0,0,0,0,0,0,156,0,3185,0,135,0,3,0,18,0,3341,0,0,0,0,0,0,0,3,4,0,94
Craighead,8/12/20,0,0,0,0,0,0,0,0,0,1419,0,17463,0,1204,0,12,0,203,0,18882,0,0,0,0,0,0,0,30,36,0,138
Crawford,8/12/20,0,0,0,0,0,0,0,0,0,668,0,9110,0,535,0,5,0,128,0,9778,0,0,0,0,0,0,0,20,7,1,137
Crittenden,8/12/20,0,0,0,0,0,0,0,0,0,1402,0,8963,0,1231,0,24,0,147,0,10365,0,0,0,0,0,0,0,21,15,1,435
Cross,8/12/20,0,0,0,0,0,0,0,0,0,212,0,2236,0,166,0,4,0,42,0,2448,0,0,0,0,0,0,0,4,5,0,18
Dallas,8/12/20,0,0,0,0,0,0,0,0,0,65,0,887,0,55,0,1,0,9,0,952,0,0,0,0,0,0,0,1,1,0,13
Desha,8/12/20,0,0,0,0,0,0,0,0,0,203,0,1875,0,147,0,2,0,54,0,2078,0,0,0,0,0,0,0,2,6,0,31
Drew,8/12/20,0,0,0,0,0,0,0,0,0,221,0,3180,0,165,0,3,0,53,0,3401,0,0,0,0,0,0,0,4,8,0,34
Faulkner,8/12/20,0,0,0,0,0,0,0,0,0,1340,0,17850,0,1201,0,6,0,133,0,19190,0,0,0,0,0,0,0,10,17,0,143
Franklin,8/12/20,0,0,0,0,0,0,0,0,0,133,0,3093,0,102,0,2,0,29,0,3226,0,0,0,0,0,0,0,5,2,0,28
Fulton,8/12/20,0,0,0,0,0,0,0,0,0,44,0,1371,0,29,0,0,0,15,0,1415,0,0,0,0,0,0,0,0,0,0,25
Garland,8/12/20,0,0,0,0,0,0,0,0,0,1115,0,14406,0,854,0,17,0,244,0,15521,0,0,0,0,0,0,0,44,24,0,310
Grant,8/12/20,0,0,0,0,0,0,0,0,0,142,0,2278,0,128,0,0,0,14,0,2420,0,0,0,0,0,0,0,2,1,0,20
Greene,8/12/20,0,0,0,0,0,0,0,0,0,505,0,7217,0,337,0,2,0,166,0,7722,0,0,0,0,0,0,0,13,17,0,87
Hempstead,8/12/20,0,0,0,0,0,0,0,0,0,253,0,2984,0,219,0,2,0,32,0,3237,0,0,0,0,0,0,0,4,3,0,28
HotSpring,8/12/20,0,0,0,0,0,0,0,0,0,1564,0,5663,0,1448,0,12,0,104,0,7227,0,0,0,0,0,0,0,7,16,0,38
Howard,8/12/20,0,0,0,0,0,0,0,0,0,360,0,2586,0,299,0,4,0,57,0,2946,0,0,0,0,0,0,0,5,7,0,16
Independence,8/12/20,0,0,0,0,0,0,0,0,0,568,0,4888,0,362,0,2,0,204,0,5456,0,0,0,0,0,0,0,18,22,1,71
Izard,8/12/20,0,0,0,0,0,0,0,0,0,58,0,1447,0,44,0,1,0,13,0,1505,0,0,0,0,0,0,0,5,0,0,23
Jackson,8/12/20,0,0,0,0,0,0,0,0,0,117,0,3103,0,56,0,1,0,60,0,3220,0,0,0,0,0,0,0,0,0,0,7
Jefferson,8/12/20,0,0,0,0,0,0,0,0,0,1617,0,14088,0,1308,0,40,0,269,0,15705,0,0,0,0,0,0,0,33,28,0,504
Johnson,8/12/20,0,0,0,0,0,0,0,0,0,676,0,2935,0,630,0,2,0,44,0,3611,0,0,0,0,0,0,0,4,7,0,15
Lafayette,8/12/20,0,0,0,0,0,0,0,0,0,58,0,576,0,51,0,2,0,5,0,634,0,0,0,0,0,0,0,2,0,0,9
Lawrence,8/12/20,0,0,0,0,0,0,0,0,0,221,0,2345,0,188,0,9,0,24,0,2566,0,0,0,0,0,0,0,4,5,0,13
Lee,8/12/20,0,0,0,0,0,0,0,0,0,898,0,2917,0,875,0,8,0,15,0,3815,0,0,0,0,0,0,0,2,0,0,11
Lincoln,8/12/20,0,0,0,0,0,0,0,0,0,1224,0,2822,0,1164,0,12,0,48,0,4046,0,0,0,0,0,0,0,0,5,0,9
LittleRiver,8/12/20,0,0,0,0,0,0,0,0,0,189,0,1239,0,161,0,1,0,27,0,1428,0,0,0,0,0,0,0,4,4,0,9
Logan,8/12/20,0,0,0,0,0,0,0,0,0,323,0,3921,0,155,0,1,0,167,0,4244,0,0,0,0,0,0,0,46,12,0,160
Lonoke,8/12/20,0,0,0,0,0,0,0,0,0,539,0,8246,0,439,0,2,0,98,0,8785,0,0,0,0,0,0,0,8,13,0,60
Madison,8/12/20,0,0,0,0,0,0,0,0,0,271,0,2596,0,258,0,2,0,11,0,2867,0,0,0,0,0,0,0,1,1,0,20
Marion,8/12/20,0,0,0,0,0,0,0,0,0,30,0,1319,0,22,0,0,0,8,0,1349,0,0,0,0,0,0,0,1,0,0,8
Miller,8/12/20,0,0,0,0,0,0,0,0,0,519,0,4150,0,469,0,5,0,45,0,4669,0,0,0,0,0,0,0,1,11,0,28
MissingCountyInfo,8/12/20,0,0,0,0,0,0,0,0,0,1801,0,64969,0,1429,0,0,0,372,0,66770,0,0,0,0,0,0,0,-10,25,0,168
Mississippi,8/12/20,0,0,0,0,0,0,0,0,0,1068,0,7242,0,766,0,14,0,288,0,8310,0,0,0,0,0,0,0,24,30,0,290
Monroe,8/12/20,0,0,0,0,0,0,0,0,0,64,0,1357,0,54,0,0,0,10,0,1421,0,0,0,0,0,0,0,0,1,0,17
Montgomery,8/12/20,0,0,0,0,0,0,0,0,0,38,0,921,0,29,0,1,0,8,0,959,0,0,0,0,0,0,0,0,0,0,6
Nevada,8/12/20,0,0,0,0,0,0,0,0,0,146,0,1630,0,123,0,9,0,14,0,1776,0,0,0,0,0,0,0,3,1,0,16
Newton,8/12/20,0,0,0,0,0,0,0,0,0,106,0,862,0,88,0,10,0,8,0,968,0,0,0,0,0,0,0,0,2,0,6
Ouachita,8/12/20,0,0,0,0,0,0,0,0,0,107,0,3214,0,82,0,2,0,23,0,3321,0,0,0,0,0,0,0,2,1,0,28
Perry,8/12/20,0,0,0,0,0,0,0,0,0,55,0,1478,0,50,0,0,0,5,0,1533,0,0,0,0,0,0,0,0,1,0,20
Phillips,8/12/20,0,0,0,0,0,0,0,0,0,332,0,3888,0,275,0,9,0,48,0,4220,0,0,0,0,0,0,0,3,4,0,19
Pike,8/12/20,0,0,0,0,0,0,0,0,0,118,0,2933,0,81,0,1,0,36,0,3051,0,0,0,0,0,0,0,7,3,0,22
Poinsett,8/12/20,0,0,0,0,0,0,0,0,0,308,0,2746,0,199,0,3,0,106,0,3054,0,0,0,0,0,0,0,16,10,0,39
Polk,8/12/20,0,0,0,0,0,0,0,0,0,154,0,2338,0,132,0,1,0,21,0,2492,0,0,0,0,0,0,0,4,0,0,20
Pope,8/12/20,0,0,0,0,0,0,0,0,0,1363,0,10268,0,1207,0,10,0,146,0,11631,0,0,0,0,0,0,0,30,17,0,110
Prairie,8/12/20,0,0,0,0,0,0,0,0,0,102,0,1128,0,72,0,0,0,30,0,1230,0,0,0,0,0,0,0,2,8,0,14
Pulaski,8/12/20,0,0,0,0,0,0,0,0,0,5787,0,65851,0,4901,0,87,0,799,0,71638,0,0,0,0,0,0,0,81,74,1,718
Randolph,8/12/20,0,0,0,0,0,0,0,0,0,239,0,2870,0,193,0,4,0,42,0,3109,0,0,0,0,0,0,0,17,7,0,24
Saline,8/12/20,0,0,0,0,0,0,0,0,0,1133,0,16927,0,902,0,7,0,224,0,18060,0,0,0,0,0,0,0,20,14,0,157
Scott,8/12/20,0,0,0,0,0,0,0,0,0,68,0,1096,0,38,0,0,0,30,0,1164,0,0,0,0,0,0,0,2,2,0,22
Searcy,8/12/20,0,0,0,0,0,0,0,0,0,32,0,1130,0,28,0,0,0,4,0,1162,0,0,0,0,0,0,0,-1,0,0,1
Sebastian,8/12/20,0,0,0,0,0,0,0,0,0,2297,0,22815,0,1801,0,21,0,475,0,25112,0,0,0,0,0,0,0,47,61,1,427
Sevier,8/12/20,0,0,0,0,0,0,0,0,0,1009,0,4579,0,949,0,10,0,50,0,5588,0,0,0,0,0,0,0,13,10,0,21
Sharp,8/12/20,0,0,0,0,0,0,0,0,0,117,0,1735,0,100,0,5,0,12,0,1852,0,0,0,0,0,0,0,3,2,0,20
St.Francis,8/12/20,0,0,0,0,0,0,0,0,0,1228,0,7239,0,1118,0,3,0,107,0,8467,0,0,0,0,0,0,0,2,6,0,23
Stone,8/12/20,0,0,0,0,0,0,0,0,0,74,0,1765,0,54,0,1,0,19,0,1839,0,0,0,0,0,0,0,5,2,0,17
Union,8/12/20,0,0,0,0,0,0,0,0,0,523,0,4526,0,425,0,19,0,79,0,5049,0,0,0,0,0,0,0,15,15,1,44
VanBuren,8/12/20,0,0,0,0,0,0,0,0,0,53,0,1572,0,48,0,2,0,3,0,1625,0,0,0,0,0,0,0,0,1,0,7
Washington,8/12/20,0,0,0,0,0,0,0,0,0,6352,0,25030,0,5995,0,53,0,304,0,31382,0,0,0,0,0,0,0,31,38,1,196
White,8/12/20,0,0,0,0,0,0,0,0,0,341,0,6491,0,279,0,2,0,60,0,6832,0,0,0,0,0,0,0,13,10,0,141
Woodruff,8/12/20,0,0,0,0,0,0,0,0,0,22,0,1068,0,18,0,0,0,4,0,1090,0,0,0,0,0,0,0,0,1,0,0
Yell,8/12/20,0,0,0,0,0,0,0,0,0,1077,0,3797,0,1013,0,17,0,47,0,4874,0,0,0,0,0,0,0,8,12,0,25
Arkansas_all_counties,8/11/20,0,0,0,0,0,0,0,0,2990671,50411,0,522457,0,42988,0,566,0,6857,0,572868,0,0,0,0,0,0,0,383,858,11,3548
Arkansas_county,8/11/20,0,0,0,0,0,0,0,0,0,227,0,2911,0,191,0,1,0,35,0,3138,0,0,0,0,0,0,0,6,7,0,15
Ashley,8/11/20,0,0,0,0,0,0,0,0,0,330,0,2931,0,249,0,5,0,76,0,3261,0,0,0,0,0,0,0,0,15,0,9
Baxter,8/11/20,0,0,0,0,0,0,0,0,0,73,0,3415,0,60,0,0,0,13,0,3488,0,0,0,0,0,0,0,2,2,0,16
Benton,8/11/20,0,0,0,0,0,0,0,0,0,4805,0,56094,0,4505,0,43,0,257,0,60899,0,0,0,0,0,0,0,11,44,0,472
Boone,8/11/20,0,0,0,0,0,0,0,0,0,214,0,4261,0,158,0,2,0,54,0,4475,0,0,0,0,0,0,0,2,9,0,49
Bradley,8/11/20,0,0,0,0,0,0,0,0,0,207,0,2294,0,128,0,4,0,75,0,2501,0,0,0,0,0,0,0,3,6,0,30
Calhoun,8/11/20,0,0,0,0,0,0,0,0,0,17,0,557,0,13,0,0,0,4,0,574,0,0,0,0,0,0,0,0,0,0,6
Carroll,8/11/20,0,0,0,0,0,0,0,0,0,379,0,4333,0,331,0,7,0,41,0,4712,0,0,0,0,0,0,0,20,0,0,137
Chicot,8/11/20,0,0,0,0,0,0,0,0,0,736,0,3023,0,424,0,9,0,303,0,3759,0,0,0,0,0,0,0,-3,79,1,6
Clark,8/11/20,0,0,0,0,0,0,0,0,0,177,0,2925,0,157,0,1,0,19,0,3102,0,0,0,0,0,0,0,0,6,0,6
Clay,8/11/20,0,0,0,0,0,0,0,0,0,138,0,2419,0,107,0,4,0,27,0,2557,0,0,0,0,0,0,0,2,1,0,7
Cleburne,8/11/20,0,0,0,0,0,0,0,0,0,202,0,3392,0,177,0,5,0,20,0,3594,0,0,0,0,0,0,0,0,1,0,8
Cleveland,8/11/20,0,0,0,0,0,0,0,0,0,103,0,1348,0,71,0,2,0,30,0,1451,0,0,0,0,0,0,0,1,7,0,4
Columbia,8/11/20,0,0,0,0,0,0,0,0,0,220,0,2669,0,176,0,12,0,32,0,2889,0,0,0,0,0,0,0,3,6,0,9
Conway,8/11/20,0,0,0,0,0,0,0,0,0,153,0,3094,0,131,0,3,0,19,0,3247,0,0,0,0,0,0,0,0,2,0,5
Craighead,8/11/20,0,0,0,0,0,0,0,0,0,1389,0,17355,0,1168,0,12,0,209,0,18744,0,0,0,0,0,0,0,15,37,0,76
Crawford,8/11/20,0,0,0,0,0,0,0,0,0,648,0,8993,0,528,0,4,0,116,0,9641,0,0,0,0,0,0,0,13,12,0,79
Crittenden,8/11/20,0,0,0,0,0,0,0,0,0,1381,0,8549,0,1216,0,23,0,142,0,9930,0,0,0,0,0,0,0,12,24,0,166
Cross,8/11/20,0,0,0,0,0,0,0,0,0,208,0,2222,0,161,0,4,0,43,0,2430,0,0,0,0,0,0,0,4,3,0,10
Dallas,8/11/20,0,0,0,0,0,0,0,0,0,64,0,875,0,54,0,1,0,9,0,939,0,0,0,0,0,0,0,0,0,1,2
Desha,8/11/20,0,0,0,0,0,0,0,0,0,201,0,1846,0,141,0,2,0,58,0,2047,0,0,0,0,0,0,0,4,4,0,13
Drew,8/11/20,0,0,0,0,0,0,0,0,0,217,0,3150,0,157,0,3,0,57,0,3367,0,0,0,0,0,0,0,8,4,0,23
Faulkner,8/11/20,0,0,0,0,0,0,0,0,0,1330,0,17717,0,1184,0,6,0,140,0,19047,0,0,0,0,0,0,0,11,16,0,92
Franklin,8/11/20,0,0,0,0,0,0,0,0,0,128,0,3070,0,100,0,2,0,26,0,3198,0,0,0,0,0,0,0,1,7,0,20
Fulton,8/11/20,0,0,0,0,0,0,0,0,0,44,0,1346,0,29,0,0,0,15,0,1390,0,0,0,0,0,0,0,0,1,0,4
Garland,8/11/20,0,0,0,0,0,0,0,0,0,1071,0,14140,0,830,0,17,0,224,0,15211,0,0,0,0,0,0,0,13,28,1,38
Grant,8/11/20,0,0,0,0,0,0,0,0,0,140,0,2260,0,127,0,0,0,13,0,2400,0,0,0,0,0,0,0,3,3,0,14
Greene,8/11/20,0,0,0,0,0,0,0,0,0,492,0,7143,0,320,0,2,0,170,0,7635,0,0,0,0,0,0,0,7,21,0,21
Hempstead,8/11/20,0,0,0,0,0,0,0,0,0,249,0,2960,0,216,0,2,0,31,0,3209,0,0,0,0,0,0,0,2,8,0,17
HotSpring,8/11/20,0,0,0,0,0,0,0,0,0,1557,0,5632,0,1432,0,12,0,113,0,7189,0,0,0,0,0,0,0,3,9,1,13
Howard,8/11/20,0,0,0,0,0,0,0,0,0,355,0,2575,0,292,0,4,0,59,0,2930,0,0,0,0,0,0,0,13,7,0,77
Independence,8/11/20,0,0,0,0,0,0,0,0,0,550,0,4835,0,340,0,1,0,209,0,5385,0,0,0,0,0,0,0,13,18,0,40
Izard,8/11/20,0,0,0,0,0,0,0,0,0,53,0,1429,0,44,0,1,0,8,0,1482,0,0,0,0,0,0,0,0,2,0,4
Jackson,8/11/20,0,0,0,0,0,0,0,0,0,117,0,3096,0,56,0,1,0,60,0,3213,0,0,0,0,0,0,0,0,1,0,12
Jefferson,8/11/20,0,0,0,0,0,0,0,0,0,1584,0,13617,0,1280,0,40,0,264,0,15201,0,0,0,0,0,0,0,10,19,0,70
Johnson,8/11/20,0,0,0,0,0,0,0,0,0,672,0,2924,0,623,0,2,0,47,0,3596,0,0,0,0,0,0,0,2,5,0,5
Lafayette,8/11/20,0,0,0,0,0,0,0,0,0,56,0,569,0,51,0,2,0,3,0,625,0,0,0,0,0,0,0,2,1,0,5
Lawrence,8/11/20,0,0,0,0,0,0,0,0,0,217,0,2336,0,183,0,9,0,25,0,2553,0,0,0,0,0,0,0,3,8,0,18
Lee,8/11/20,0,0,0,0,0,0,0,0,0,896,0,2908,0,875,0,8,0,13,0,3804,0,0,0,0,0,0,0,0,2,0,10
Lincoln,8/11/20,0,0,0,0,0,0,0,0,0,1224,0,2813,0,1159,0,12,0,53,0,4037,0,0,0,0,0,0,0,1,5,0,5
LittleRiver,8/11/20,0,0,0,0,0,0,0,0,0,185,0,1234,0,157,0,1,0,27,0,1419,0,0,0,0,0,0,0,4,43,0,4
Logan,8/11/20,0,0,0,0,0,0,0,0,0,277,0,3807,0,143,0,1,0,133,0,4084,0,0,0,0,0,0,0,4,4,0,24
Lonoke,8/11/20,0,0,0,0,0,0,0,0,0,531,0,8194,0,426,0,2,0,103,0,8725,0,0,0,0,0,0,0,7,16,0,73
Madison,8/11/20,0,0,0,0,0,0,0,0,0,270,0,2577,0,257,0,2,0,11,0,2847,0,0,0,0,0,0,0,0,3,0,11
Marion,8/11/20,0,0,0,0,0,0,0,0,0,29,0,1312,0,22,0,0,0,7,0,1341,0,0,0,0,0,0,0,0,1,0,3
Miller,8/11/20,0,0,0,0,0,0,0,0,0,518,0,4123,0,458,0,5,0,55,0,4641,0,0,0,0,0,0,0,0,9,0,7
MissingCountyInfo,8/11/20,0,0,0,0,0,0,0,0,0,1811,0,64791,0,1404,0,0,0,407,0,66602,0,0,0,0,0,0,0,-12,12,0,232
Mississippi,8/11/20,0,0,0,0,0,0,0,0,0,1044,0,6976,0,736,0,14,0,294,0,8020,0,0,0,0,0,0,0,11,24,0,85
Monroe,8/11/20,0,0,0,0,0,0,0,0,0,64,0,1340,0,53,0,0,0,11,0,1404,0,0,0,0,0,0,0,2,3,0,13
Montgomery,8/11/20,0,0,0,0,0,0,0,0,0,38,0,915,0,29,0,1,0,8,0,953,0,0,0,0,0,0,0,0,2,0,3
Nevada,8/11/20,0,0,0,0,0,0,0,0,0,143,0,1617,0,122,0,9,0,12,0,1760,0,0,0,0,0,0,0,0,2,0,2
Newton,8/11/20,0,0,0,0,0,0,0,0,0,106,0,856,0,86,0,10,0,10,0,962,0,0,0,0,0,0,0,0,-1,4,7
Ouachita,8/11/20,0,0,0,0,0,0,0,0,0,105,0,3188,0,81,0,2,0,22,0,3293,0,0,0,0,0,0,0,3,1,0,26
Perry,8/11/20,0,0,0,0,0,0,0,0,0,55,0,1458,0,49,0,0,0,6,0,1513,0,0,0,0,0,0,0,1,2,0,5
Phillips,8/11/20,0,0,0,0,0,0,0,0,0,329,0,3872,0,271,0,9,0,49,0,4201,0,0,0,0,0,0,0,4,8,0,27
Pike,8/11/20,0,0,0,0,0,0,0,0,0,111,0,2918,0,78,0,1,0,32,0,3029,0,0,0,0,0,0,0,3,2,0,18
Poinsett,8/11/20,0,0,0,0,0,0,0,0,0,292,0,2723,0,189,0,3,0,100,0,3015,0,0,0,0,0,0,0,6,13,0,12
Polk,8/11/20,0,0,0,0,0,0,0,0,0,150,0,2322,0,132,0,1,0,17,0,2472,0,0,0,0,0,0,0,2,1,0,11
Pope,8/11/20,0,0,0,0,0,0,0,0,0,1333,0,10188,0,1190,0,10,0,133,0,11521,0,0,0,0,0,0,0,14,25,0,47
Prairie,8/11/20,0,0,0,0,0,0,0,0,0,100,0,1116,0,64,0,0,0,36,0,1216,0,0,0,0,0,0,0,4,4,0,8
Pulaski,8/11/20,0,0,0,0,0,0,0,0,0,5706,0,65214,0,4827,0,86,0,793,0,70920,0,0,0,0,0,0,0,67,78,1,620
Randolph,8/11/20,0,0,0,0,0,0,0,0,0,222,0,2863,0,186,0,4,0,32,0,3085,0,0,0,0,0,0,0,3,17,0,19
Saline,8/11/20,0,0,0,0,0,0,0,0,0,1113,0,16790,0,888,0,7,0,218,0,17903,0,0,0,0,0,0,0,18,18,1,147
Scott,8/11/20,0,0,0,0,0,0,0,0,0,66,0,1076,0,36,0,0,0,30,0,1142,0,0,0,0,0,0,0,5,0,0,9
Searcy,8/11/20,0,0,0,0,0,0,0,0,0,33,0,1128,0,28,0,0,0,5,0,1161,0,0,0,0,0,0,0,1,1,0,6
Sebastian,8/11/20,0,0,0,0,0,0,0,0,0,2250,0,22435,0,1740,0,20,0,490,0,24685,0,0,0,0,0,0,0,21,55,0,212
Sevier,8/11/20,0,0,0,0,0,0,0,0,0,996,0,4571,0,939,0,10,0,47,0,5567,0,0,0,0,0,0,0,4,8,0,6
Sharp,8/11/20,0,0,0,0,0,0,0,0,0,114,0,1718,0,98,0,5,0,11,0,1832,0,0,0,0,0,0,0,2,6,0,7
St.Francis,8/11/20,0,0,0,0,0,0,0,0,0,1226,0,7218,0,1112,0,3,0,111,0,8444,0,0,0,0,0,0,0,3,8,0,16
Stone,8/11/20,0,0,0,0,0,0,0,0,0,69,0,1753,0,52,0,1,0,16,0,1822,0,0,0,0,0,0,0,0,1,0,3
Union,8/11/20,0,0,0,0,0,0,0,0,0,508,0,4497,0,410,0,18,0,80,0,5005,0,0,0,0,0,0,0,4,14,0,21
VanBuren,8/11/20,0,0,0,0,0,0,0,0,0,53,0,1565,0,47,0,2,0,4,0,1618,0,0,0,0,0,0,0,0,1,0,8
Washington,8/11/20,0,0,0,0,0,0,0,0,0,6321,0,24865,0,5957,0,52,0,312,0,31186,0,0,0,0,0,0,0,11,40,1,206
White,8/11/20,0,0,0,0,0,0,0,0,0,328,0,6363,0,269,0,2,0,57,0,6691,0,0,0,0,0,0,0,2,9,0,28
Woodruff,8/11/20,0,0,0,0,0,0,0,0,0,22,0,1068,0,17,0,0,0,5,0,1090,0,0,0,0,0,0,0,0,0,0,2
Yell,8/11/20,0,0,0,0,0,0,0,0,0,1069,0,3780,0,1001,0,17,0,51,0,4849,0,0,0,0,0,0,0,2,8,0,7
Arkansas_all_counties,8/10/20,0,0,0,0,0,0,0,0,2990671,50028,0,519292,0,42130,0,555,0,7343,0,569320,0,0,0,0,0,0,0,645,678,11,5489
Arkansas_county,8/10/20,0,0,0,0,0,0,0,0,0,221,0,2902,0,184,0,1,0,36,0,3123,0,0,0,0,0,0,0,4,2,0,22
Ashley,8/10/20,0,0,0,0,0,0,0,0,0,330,0,2922,0,234,0,5,0,91,0,3252,0,0,0,0,0,0,0,4,4,0,92
Baxter,8/10/20,0,0,0,0,0,0,0,0,0,71,0,3401,0,58,0,0,0,13,0,3472,0,0,0,0,0,0,0,0,1,0,38
Benton,8/10/20,0,0,0,0,0,0,0,0,0,4794,0,55633,0,4461,0,43,0,290,0,60427,0,0,0,0,0,0,0,20,39,0,355
Boone,8/10/20,0,0,0,0,0,0,0,0,0,212,0,4214,0,149,0,2,0,61,0,4426,0,0,0,0,0,0,0,1,6,1,18
Bradley,8/10/20,0,0,0,0,0,0,0,0,0,204,0,2267,0,122,0,4,0,78,0,2471,0,0,0,0,0,0,0,14,3,1,72
Calhoun,8/10/20,0,0,0,0,0,0,0,0,0,17,0,551,0,13,0,0,0,4,0,568,0,0,0,0,0,0,0,1,0,0,6
Carroll,8/10/20,0,0,0,0,0,0,0,0,0,359,0,4216,0,331,0,7,0,21,0,4575,0,0,0,0,0,0,0,5,5,0,26
Chicot,8/10/20,0,0,0,0,0,0,0,0,0,739,0,3014,0,345,0,8,0,386,0,3753,0,0,0,0,0,0,0,6,7,0,24
Clark,8/10/20,0,0,0,0,0,0,0,0,0,177,0,2919,0,151,0,1,0,25,0,3096,0,0,0,0,0,0,0,0,1,0,19
Clay,8/10/20,0,0,0,0,0,0,0,0,0,136,0,2414,0,106,0,4,0,26,0,2550,0,0,0,0,0,0,0,0,2,0,8
Cleburne,8/10/20,0,0,0,0,0,0,0,0,0,202,0,3384,0,176,0,5,0,21,0,3586,0,0,0,0,0,0,0,2,2,0,36
Cleveland,8/10/20,0,0,0,0,0,0,0,0,0,102,0,1345,0,64,0,2,0,36,0,1447,0,0,0,0,0,0,0,5,4,0,34
Columbia,8/10/20,0,0,0,0,0,0,0,0,0,217,0,2663,0,170,0,12,0,35,0,2880,0,0,0,0,0,0,0,2,1,1,17
Conway,8/10/20,0,0,0,0,0,0,0,0,0,153,0,3089,0,129,0,3,0,21,0,3242,0,0,0,0,0,0,0,1,0,0,23
Craighead,8/10/20,0,0,0,0,0,0,0,0,0,1374,0,17294,0,1131,0,12,0,231,0,18668,0,0,0,0,0,0,0,30,47,0,182
Crawford,8/10/20,0,0,0,0,0,0,0,0,0,635,0,8927,0,516,0,4,0,115,0,9562,0,0,0,0,0,0,0,8,12,0,125
Crittenden,8/10/20,0,0,0,0,0,0,0,0,0,1369,0,8395,0,1192,0,23,0,154,0,9764,0,0,0,0,0,0,0,13,15,0,68
Cross,8/10/20,0,0,0,0,0,0,0,0,0,204,0,2216,0,158,0,4,0,42,0,2420,0,0,0,0,0,0,0,9,0,0,51
Dallas,8/10/20,0,0,0,0,0,0,0,0,0,64,0,873,0,54,0,0,0,10,0,937,0,0,0,0,0,0,0,1,3,0,22
Desha,8/10/20,0,0,0,0,0,0,0,0,0,197,0,1837,0,137,0,2,0,58,0,2034,0,0,0,0,0,0,0,3,1,0,26
Drew,8/10/20,0,0,0,0,0,0,0,0,0,209,0,3135,0,153,0,3,0,53,0,3344,0,0,0,0,0,0,0,6,4,0,37
Faulkner,8/10/20,0,0,0,0,0,0,0,0,0,1319,0,17636,0,1168,0,6,0,145,0,18955,0,0,0,0,0,0,0,15,23,0,121
Franklin,8/10/20,0,0,0,0,0,0,0,0,0,127,0,3051,0,93,0,2,0,32,0,3178,0,0,0,0,0,0,0,1,1,0,35
Fulton,8/10/20,0,0,0,0,0,0,0,0,0,44,0,1342,0,28,0,0,0,16,0,1386,0,0,0,0,0,0,0,2,1,0,13
Garland,8/10/20,0,0,0,0,0,0,0,0,0,1058,0,14115,0,802,0,16,0,240,0,15173,0,0,0,0,0,0,0,50,17,2,243
Grant,8/10/20,0,0,0,0,0,0,0,0,0,137,0,2249,0,124,0,0,0,13,0,2386,0,0,0,0,0,0,0,1,0,0,22
Greene,8/10/20,0,0,0,0,0,0,0,0,0,485,0,7129,0,299,0,2,0,184,0,7614,0,0,0,0,0,0,0,9,15,1,54
Hempstead,8/10/20,0,0,0,0,0,0,0,0,0,247,0,2945,0,208,0,2,0,37,0,3192,0,0,0,0,0,0,0,8,8,0,47
HotSpring,8/10/20,0,0,0,0,0,0,0,0,0,1554,0,5622,0,1423,0,11,0,120,0,7176,0,0,0,0,0,0,0,8,7,0,93
Howard,8/10/20,0,0,0,0,0,0,0,0,0,342,0,2511,0,285,0,4,0,53,0,2853,0,0,0,0,0,0,0,2,13,0,14
Independence,8/10/20,0,0,0,0,0,0,0,0,0,537,0,4808,0,322,0,1,0,214,0,5345,0,0,0,0,0,0,0,20,24,0,63
Izard,8/10/20,0,0,0,0,0,0,0,0,0,53,0,1425,0,42,0,1,0,10,0,1478,0,0,0,0,0,0,0,0,2,0,7
Jackson,8/10/20,0,0,0,0,0,0,0,0,0,117,0,3084,0,55,0,1,0,61,0,3201,0,0,0,0,0,0,0,5,0,0,26
Jefferson,8/10/20,0,0,0,0,0,0,0,0,0,1574,0,13557,0,1261,0,40,0,273,0,15131,0,0,0,0,0,0,0,40,26,0,265
Johnson,8/10/20,0,0,0,0,0,0,0,0,0,670,0,2921,0,618,0,2,0,50,0,3591,0,0,0,0,0,0,0,2,6,0,24
Lafayette,8/10/20,0,0,0,0,0,0,0,0,0,54,0,566,0,50,0,2,0,2,0,620,0,0,0,0,0,0,0,0,1,0,4
Lawrence,8/10/20,0,0,0,0,0,0,0,0,0,214,0,2321,0,175,0,9,0,30,0,2535,0,0,0,0,0,0,0,2,4,0,6
Lee,8/10/20,0,0,0,0,0,0,0,0,0,896,0,2898,0,873,0,8,0,15,0,3794,0,0,0,0,0,0,0,2,3,0,14
Lincoln,8/10/20,0,0,0,0,0,0,0,0,0,1223,0,2809,0,1154,0,12,0,57,0,4032,0,0,0,0,0,0,0,4,7,0,35
LittleRiver,8/10/20,0,0,0,0,0,0,0,0,0,181,0,1234,0,114,0,1,0,66,0,1415,0,0,0,0,0,0,0,0,4,0,8
Logan,8/10/20,0,0,0,0,0,0,0,0,0,273,0,3787,0,139,0,1,0,133,0,4060,0,0,0,0,0,0,0,12,7,0,62
Lonoke,8/10/20,0,0,0,0,0,0,0,0,0,524,0,8128,0,410,0,2,0,112,0,8652,0,0,0,0,0,0,0,12,9,0,115
Madison,8/10/20,0,0,0,0,0,0,0,0,0,270,0,2566,0,254,0,2,0,14,0,2836,0,0,0,0,0,0,0,0,3,0,8
Marion,8/10/20,0,0,0,0,0,0,0,0,0,29,0,1309,0,21,0,0,0,8,0,1338,0,0,0,0,0,0,0,1,0,0,27
Miller,8/10/20,0,0,0,0,0,0,0,0,0,518,0,4116,0,449,0,5,0,64,0,4634,0,0,0,0,0,0,0,6,6,0,35
MissingCountyInfo,8/10/20,0,0,0,0,0,0,0,0,0,1823,0,64547,0,1392,0,0,0,431,0,66370,0,0,0,0,0,0,0,27,34,0,259
Mississippi,8/10/20,0,0,0,0,0,0,0,0,0,1033,0,6902,0,712,0,14,0,307,0,7935,0,0,0,0,0,0,0,19,32,0,62
Monroe,8/10/20,0,0,0,0,0,0,0,0,0,62,0,1329,0,50,0,0,0,12,0,1391,0,0,0,0,0,0,0,2,1,0,14
Montgomery,8/10/20,0,0,0,0,0,0,0,0,0,38,0,912,0,27,0,1,0,10,0,950,0,0,0,0,0,0,0,3,2,0,12
Nevada,8/10/20,0,0,0,0,0,0,0,0,0,143,0,1615,0,120,0,9,0,14,0,1758,0,0,0,0,0,0,0,1,0,0,20
Newton,8/10/20,0,0,0,0,0,0,0,0,0,106,0,849,0,87,0,6,0,13,0,955,0,0,0,0,0,0,0,3,2,0,9
Ouachita,8/10/20,0,0,0,0,0,0,0,0,0,102,0,3165,0,80,0,2,0,20,0,3267,0,0,0,0,0,0,0,2,6,0,44
Perry,8/10/20,0,0,0,0,0,0,0,0,0,54,0,1454,0,47,0,0,0,7,0,1508,0,0,0,0,0,0,0,0,0,0,10
Phillips,8/10/20,0,0,0,0,0,0,0,0,0,325,0,3849,0,263,0,9,0,53,0,4174,0,0,0,0,0,0,0,7,4,1,53
Pike,8/10/20,0,0,0,0,0,0,0,0,0,108,0,2903,0,76,0,1,0,31,0,3011,0,0,0,0,0,0,0,7,2,0,32
Poinsett,8/10/20,0,0,0,0,0,0,0,0,0,286,0,2717,0,176,0,3,0,107,0,3003,0,0,0,0,0,0,0,14,14,0,41
Polk,8/10/20,0,0,0,0,0,0,0,0,0,148,0,2313,0,131,0,1,0,16,0,2461,0,0,0,0,0,0,0,6,3,0,36
Pope,8/10/20,0,0,0,0,0,0,0,0,0,1319,0,10155,0,1165,0,10,0,144,0,11474,0,0,0,0,0,0,0,6,20,0,94
Prairie,8/10/20,0,0,0,0,0,0,0,0,0,96,0,1112,0,60,0,0,0,36,0,1208,0,0,0,0,0,0,0,5,2,0,29
Pulaski,8/10/20,0,0,0,0,0,0,0,0,0,5639,0,64661,0,4749,0,85,0,805,0,70300,0,0,0,0,0,0,0,57,67,0,752
Randolph,8/10/20,0,0,0,0,0,0,0,0,0,219,0,2847,0,169,0,4,0,46,0,3066,0,0,0,0,0,0,0,6,0,1,24
Saline,8/10/20,0,0,0,0,0,0,0,0,0,1095,0,16661,0,870,0,6,0,219,0,17756,0,0,0,0,0,0,0,49,20,0,395
Scott,8/10/20,0,0,0,0,0,0,0,0,0,61,0,1072,0,36,0,0,0,25,0,1133,0,0,0,0,0,0,0,0,0,0,4
Searcy,8/10/20,0,0,0,0,0,0,0,0,0,32,0,1123,0,27,0,0,0,5,0,1155,0,0,0,0,0,0,0,2,0,0,10
Sebastian,8/10/20,0,0,0,0,0,0,0,0,0,2229,0,22244,0,1685,0,20,0,524,0,24473,0,0,0,0,0,0,0,53,45,0,377
Sevier,8/10/20,0,0,0,0,0,0,0,0,0,992,0,4569,0,931,0,10,0,51,0,5561,0,0,0,0,0,0,0,3,5,0,19
Sharp,8/10/20,0,0,0,0,0,0,0,0,0,112,0,1713,0,92,0,5,0,15,0,1825,0,0,0,0,0,0,0,-1,1,0,15
St.Francis,8/10/20,0,0,0,0,0,0,0,0,0,1223,0,7205,0,1104,0,3,0,116,0,8428,0,0,0,0,0,0,0,14,4,0,65
Stone,8/10/20,0,0,0,0,0,0,0,0,0,69,0,1750,0,51,0,1,0,17,0,1819,0,0,0,0,0,0,0,0,0,0,7
Union,8/10/20,0,0,0,0,0,0,0,0,0,504,0,4480,0,396,0,18,0,90,0,4984,0,0,0,0,0,0,0,5,7,1,46
VanBuren,8/10/20,0,0,0,0,0,0,0,0,0,53,0,1557,0,46,0,2,0,5,0,1610,0,0,0,0,0,0,0,0,0,0,6
Washington,8/10/20,0,0,0,0,0,0,0,0,0,6310,0,24670,0,5917,0,51,0,342,0,30980,0,0,0,0,0,0,0,12,50,-1,226
White,8/10/20,0,0,0,0,0,0,0,0,0,326,0,6337,0,260,0,2,0,64,0,6663,0,0,0,0,0,0,0,4,4,0,156
Woodruff,8/10/20,0,0,0,0,0,0,0,0,0,22,0,1066,0,17,0,0,0,5,0,1088,0,0,0,0,0,0,0,1,0,0,13
Yell,8/10/20,0,0,0,0,0,0,0,0,0,1067,0,3775,0,993,0,17,0,57,0,4842,0,0,0,0,0,0,0,1,7,3,17
Arkansas_all_counties,8/9/20,0,0,0,0,0,0,0,0,2990671,49383,0,514448,0,41452,0,544,0,7387,0,563831,0,0,0,0,0,0,0,572,475,9,5757
Arkansas_county,8/9/20,0,0,0,0,0,0,0,0,0,217,0,2884,0,182,0,1,0,34,0,3101,0,0,0,0,0,0,0,5,1,0,32
Ashley,8/9/20,0,0,0,0,0,0,0,0,0,326,0,2834,0,230,0,5,0,91,0,3160,0,0,0,0,0,0,0,4,5,0,25
Baxter,8/9/20,0,0,0,0,0,0,0,0,0,71,0,3363,0,57,0,0,0,14,0,3434,0,0,0,0,0,0,0,0,1,0,40
Benton,8/9/20,0,0,0,0,0,0,0,0,0,4774,0,55298,0,4422,0,43,0,309,0,60072,0,0,0,0,0,0,0,19,27,0,444
Boone,8/9/20,0,0,0,0,0,0,0,0,0,211,0,4197,0,143,0,1,0,67,0,4408,0,0,0,0,0,0,0,3,7,0,40
Bradley,8/9/20,0,0,0,0,0,0,0,0,0,190,0,2209,0,119,0,3,0,68,0,2399,0,0,0,0,0,0,0,4,3,0,20
Calhoun,8/9/20,0,0,0,0,0,0,0,0,0,16,0,546,0,13,0,0,0,3,0,562,0,0,0,0,0,0,0,0,1,0,5
Carroll,8/9/20,0,0,0,0,0,0,0,0,0,354,0,4195,0,326,0,7,0,21,0,4549,0,0,0,0,0,0,0,1,3,0,25
Chicot,8/9/20,0,0,0,0,0,0,0,0,0,733,0,2996,0,338,0,8,0,387,0,3729,0,0,0,0,0,0,0,4,11,0,21
Clark,8/9/20,0,0,0,0,0,0,0,0,0,177,0,2900,0,150,0,1,0,26,0,3077,0,0,0,0,0,0,0,0,3,0,26
Clay,8/9/20,0,0,0,0,0,0,0,0,0,136,0,2406,0,104,0,4,0,28,0,2542,0,0,0,0,0,0,0,6,1,0,59
Cleburne,8/9/20,0,0,0,0,0,0,0,0,0,200,0,3350,0,174,0,5,0,21,0,3550,0,0,0,0,0,0,0,6,2,0,33
Cleveland,8/9/20,0,0,0,0,0,0,0,0,0,97,0,1316,0,60,0,2,0,35,0,1413,0,0,0,0,0,0,0,0,1,0,8
Columbia,8/9/20,0,0,0,0,0,0,0,0,0,215,0,2648,0,169,0,11,0,35,0,2863,0,0,0,0,0,0,0,1,0,2,28
Conway,8/9/20,0,0,0,0,0,0,0,0,0,152,0,3067,0,129,0,3,0,20,0,3219,0,0,0,0,0,0,0,2,1,0,22
Craighead,8/9/20,0,0,0,0,0,0,0,0,0,1344,0,17142,0,1084,0,12,0,248,0,18486,0,0,0,0,0,0,0,8,13,0,163
Crawford,8/9/20,0,0,0,0,0,0,0,0,0,627,0,8810,0,504,0,4,0,119,0,9437,0,0,0,0,0,0,0,7,7,0,175
Crittenden,8/9/20,0,0,0,0,0,0,0,0,0,1356,0,8340,0,1177,0,23,0,156,0,9696,0,0,0,0,0,0,0,5,3,2,43
Cross,8/9/20,0,0,0,0,0,0,0,0,0,195,0,2174,0,158,0,4,0,33,0,2369,0,0,0,0,0,0,0,0,1,0,20
Dallas,8/9/20,0,0,0,0,0,0,0,0,0,63,0,852,0,51,0,0,0,12,0,915,0,0,0,0,0,0,0,2,1,0,10
Desha,8/9/20,0,0,0,0,0,0,0,0,0,194,0,1814,0,136,0,2,0,56,0,2008,0,0,0,0,0,0,0,2,1,0,33
Drew,8/9/20,0,0,0,0,0,0,0,0,0,203,0,3104,0,149,0,3,0,51,0,3307,0,0,0,0,0,0,0,5,3,0,36
Faulkner,8/9/20,0,0,0,0,0,0,0,0,0,1304,0,17530,0,1145,0,6,0,153,0,18834,0,0,0,0,0,0,0,14,9,0,177
Franklin,8/9/20,0,0,0,0,0,0,0,0,0,126,0,3017,0,92,0,2,0,32,0,3143,0,0,0,0,0,0,0,0,1,0,23
Fulton,8/9/20,0,0,0,0,0,0,0,0,0,42,0,1331,0,27,0,0,0,15,0,1373,0,0,0,0,0,0,0,2,0,0,29
Garland,8/9/20,0,0,0,0,0,0,0,0,0,1008,0,13922,0,785,0,14,0,209,0,14930,0,0,0,0,0,0,0,16,17,2,135
Grant,8/9/20,0,0,0,0,0,0,0,0,0,136,0,2228,0,124,0,0,0,12,0,2364,0,0,0,0,0,0,0,1,2,0,16
Greene,8/9/20,0,0,0,0,0,0,0,0,0,476,0,7084,0,284,0,1,0,191,0,7560,0,0,0,0,0,0,0,3,7,0,114
Hempstead,8/9/20,0,0,0,0,0,0,0,0,0,239,0,2906,0,200,0,2,0,37,0,3145,0,0,0,0,0,0,0,0,6,0,38
HotSpring,8/9/20,0,0,0,0,0,0,0,0,0,1546,0,5537,0,1416,0,11,0,119,0,7083,0,0,0,0,0,0,0,16,2,0,58
Howard,8/9/20,0,0,0,0,0,0,0,0,0,340,0,2499,0,272,0,4,0,64,0,2839,0,0,0,0,0,0,0,4,13,1,25
Independence,8/9/20,0,0,0,0,0,0,0,0,0,517,0,4765,0,298,0,1,0,218,0,5282,0,0,0,0,0,0,0,25,18,0,142
Izard,8/9/20,0,0,0,0,0,0,0,0,0,53,0,1418,0,40,0,1,0,12,0,1471,0,0,0,0,0,0,0,1,1,0,15
Jackson,8/9/20,0,0,0,0,0,0,0,0,0,112,0,3063,0,55,0,1,0,56,0,3175,0,0,0,0,0,0,0,3,1,0,109
Jefferson,8/9/20,0,0,0,0,0,0,0,0,0,1534,0,13332,0,1235,0,40,0,259,0,14866,0,0,0,0,0,0,0,15,18,0,215
Johnson,8/9/20,0,0,0,0,0,0,0,0,0,668,0,2899,0,612,0,2,0,54,0,3567,0,0,0,0,0,0,0,5,5,0,22
Lafayette,8/9/20,0,0,0,0,0,0,0,0,0,54,0,562,0,49,0,2,0,3,0,616,0,0,0,0,0,0,0,1,1,0,6
Lawrence,8/9/20,0,0,0,0,0,0,0,0,0,212,0,2317,0,171,0,9,0,32,0,2529,0,0,0,0,0,0,0,3,1,0,47
Lee,8/9/20,0,0,0,0,0,0,0,0,0,894,0,2886,0,870,0,8,0,16,0,3780,0,0,0,0,0,0,0,1,0,0,13
Lincoln,8/9/20,0,0,0,0,0,0,0,0,0,1219,0,2778,0,1147,0,12,0,60,0,3997,0,0,0,0,0,0,0,7,0,0,128
LittleRiver,8/9/20,0,0,0,0,0,0,0,0,0,181,0,1226,0,110,0,1,0,70,0,1407,0,0,0,0,0,0,0,1,3,0,6
Logan,8/9/20,0,0,0,0,0,0,0,0,0,261,0,3737,0,132,0,1,0,128,0,3998,0,0,0,0,0,0,0,9,6,0,60
Lonoke,8/9/20,0,0,0,0,0,0,0,0,0,512,0,8025,0,401,0,2,0,109,0,8537,0,0,0,0,0,0,0,4,15,0,74
Madison,8/9/20,0,0,0,0,0,0,0,0,0,270,0,2558,0,251,0,2,0,17,0,2828,0,0,0,0,0,0,0,0,1,0,15
Marion,8/9/20,0,0,0,0,0,0,0,0,0,28,0,1283,0,21,0,0,0,7,0,1311,0,0,0,0,0,0,0,3,2,0,11
Miller,8/9/20,0,0,0,0,0,0,0,0,0,512,0,4087,0,443,0,5,0,64,0,4599,0,0,0,0,0,0,0,4,4,0,19
MissingCountyInfo,8/9/20,0,0,0,0,0,0,0,0,0,1796,0,64315,0,1358,0,0,0,438,0,66111,0,0,0,0,0,0,0,24,28,0,156
Mississippi,8/9/20,0,0,0,0,0,0,0,0,0,1014,0,6859,0,680,0,14,0,320,0,7873,0,0,0,0,0,0,0,32,12,0,150
Monroe,8/9/20,0,0,0,0,0,0,0,0,0,60,0,1317,0,49,0,0,0,11,0,1377,0,0,0,0,0,0,0,2,2,0,28
Montgomery,8/9/20,0,0,0,0,0,0,0,0,0,35,0,903,0,25,0,1,0,9,0,938,0,0,0,0,0,0,0,1,2,0,8
Nevada,8/9/20,0,0,0,0,0,0,0,0,0,142,0,1596,0,120,0,9,0,13,0,1738,0,0,0,0,0,0,0,5,1,0,15
Newton,8/9/20,0,0,0,0,0,0,0,0,0,103,0,843,0,85,0,6,0,12,0,946,0,0,0,0,0,0,0,1,0,0,11
Ouachita,8/9/20,0,0,0,0,0,0,0,0,0,100,0,3123,0,74,0,2,0,24,0,3223,0,0,0,0,0,0,0,2,4,0,45
Perry,8/9/20,0,0,0,0,0,0,0,0,0,54,0,1444,0,47,0,0,0,7,0,1498,0,0,0,0,0,0,0,4,0,0,16
Phillips,8/9/20,0,0,0,0,0,0,0,0,0,318,0,3803,0,259,0,8,0,51,0,4121,0,0,0,0,0,0,0,7,2,1,39
Pike,8/9/20,0,0,0,0,0,0,0,0,0,101,0,2878,0,74,0,1,0,26,0,2979,0,0,0,0,0,0,0,0,0,0,14
Poinsett,8/9/20,0,0,0,0,0,0,0,0,0,272,0,2690,0,162,0,3,0,107,0,2962,0,0,0,0,0,0,0,3,6,0,95
Polk,8/9/20,0,0,0,0,0,0,0,0,0,142,0,2283,0,128,0,1,0,13,0,2425,0,0,0,0,0,0,0,2,1,0,27
Pope,8/9/20,0,0,0,0,0,0,0,0,0,1313,0,10067,0,1145,0,10,0,158,0,11380,0,0,0,0,0,0,0,7,18,0,47
Prairie,8/9/20,0,0,0,0,0,0,0,0,0,91,0,1088,0,58,0,0,0,33,0,1179,0,0,0,0,0,0,0,1,0,0,13
Pulaski,8/9/20,0,0,0,0,0,0,0,0,0,5582,0,63966,0,4682,0,85,0,815,0,69548,0,0,0,0,0,0,0,102,51,0,521
Randolph,8/9/20,0,0,0,0,0,0,0,0,0,213,0,2829,0,169,0,3,0,41,0,3042,0,0,0,0,0,0,0,4,1,0,49
Saline,8/9/20,0,0,0,0,0,0,0,0,0,1046,0,16315,0,850,0,6,0,190,0,17361,0,0,0,0,0,0,0,29,12,0,532
Scott,8/9/20,0,0,0,0,0,0,0,0,0,61,0,1068,0,36,0,0,0,25,0,1129,0,0,0,0,0,0,0,3,1,0,39
Searcy,8/9/20,0,0,0,0,0,0,0,0,0,30,0,1115,0,27,0,0,0,3,0,1145,0,0,0,0,0,0,0,1,1,0,11
Sebastian,8/9/20,0,0,0,0,0,0,0,0,0,2176,0,21920,0,1640,0,20,0,516,0,24096,0,0,0,0,0,0,0,43,48,0,333
Sevier,8/9/20,0,0,0,0,0,0,0,0,0,989,0,4553,0,926,0,10,0,53,0,5542,0,0,0,0,0,0,0,1,3,0,9
Sharp,8/9/20,0,0,0,0,0,0,0,0,0,113,0,1697,0,91,0,5,0,17,0,1810,0,0,0,0,0,0,0,2,0,0,41
St.Francis,8/9/20,0,0,0,0,0,0,0,0,0,1209,0,7154,0,1100,0,3,0,106,0,8363,0,0,0,0,0,0,0,16,9,0,232
Stone,8/9/20,0,0,0,0,0,0,0,0,0,69,0,1743,0,51,0,1,0,17,0,1812,0,0,0,0,0,0,0,2,2,0,19
Union,8/9/20,0,0,0,0,0,0,0,0,0,499,0,4439,0,389,0,17,0,93,0,4938,0,0,0,0,0,0,0,21,8,0,127
VanBuren,8/9/20,0,0,0,0,0,0,0,0,0,53,0,1551,0,46,0,2,0,5,0,1604,0,0,0,0,0,0,0,0,0,0,10
Washington,8/9/20,0,0,0,0,0,0,0,0,0,6298,0,24456,0,5867,0,52,0,379,0,30754,0,0,0,0,0,0,0,30,29,1,284
White,8/9/20,0,0,0,0,0,0,0,0,0,322,0,6185,0,256,0,2,0,64,0,6507,0,0,0,0,0,0,0,4,0,0,53
Woodruff,8/9/20,0,0,0,0,0,0,0,0,0,21,0,1054,0,17,0,0,0,4,0,1075,0,0,0,0,0,0,0,0,0,0,6
Yell,8/9/20,0,0,0,0,0,0,0,0,0,1066,0,3759,0,986,0,14,0,66,0,4825,0,0,0,0,0,0,0,1,5,0,22
Arkansas_all_counties,8/8/20,0,0,0,0,0,0,0,0,2990671,48811,0,509263,0,40977,0,535,0,7299,0,558074,0,0,0,0,0,0,0,772,617,14,6551
Arkansas_county,8/8/20,0,0,0,0,0,0,0,0,0,212,0,2857,0,181,0,1,0,30,0,3069,0,0,0,0,0,0,0,2,3,0,29
Ashley,8/8/20,0,0,0,0,0,0,0,0,0,322,0,2813,0,225,0,5,0,92,0,3135,0,0,0,0,0,0,0,18,19,0,76
Baxter,8/8/20,0,0,0,0,0,0,0,0,0,71,0,3323,0,56,0,0,0,15,0,3394,0,0,0,0,0,0,0,2,2,0,24
Benton,8/8/20,0,0,0,0,0,0,0,0,0,4755,0,54873,0,4395,0,43,0,317,0,59628,0,0,0,0,0,0,0,57,46,2,546
Boone,8/8/20,0,0,0,0,0,0,0,0,0,208,0,4160,0,136,0,1,0,71,0,4368,0,0,0,0,0,0,0,7,8,0,45
Bradley,8/8/20,0,0,0,0,0,0,0,0,0,186,0,2193,0,116,0,3,0,67,0,2379,0,0,0,0,0,0,0,7,0,0,33
Calhoun,8/8/20,0,0,0,0,0,0,0,0,0,16,0,541,0,12,0,0,0,4,0,557,0,0,0,0,0,0,0,1,0,0,16
Carroll,8/8/20,0,0,0,0,0,0,0,0,0,353,0,4171,0,323,0,7,0,23,0,4524,0,0,0,0,0,0,0,3,1,0,42
Chicot,8/8/20,0,0,0,0,0,0,0,0,0,729,0,2979,0,327,0,8,0,394,0,3708,0,0,0,0,0,0,0,11,10,0,26
Clark,8/8/20,0,0,0,0,0,0,0,0,0,177,0,2874,0,147,0,1,0,29,0,3051,0,0,0,0,0,0,0,0,1,0,28
Clay,8/8/20,0,0,0,0,0,0,0,0,0,130,0,2353,0,103,0,4,0,23,0,2483,0,0,0,0,0,0,0,3,2,0,21
Cleburne,8/8/20,0,0,0,0,0,0,0,0,0,194,0,3323,0,172,0,5,0,17,0,3517,0,0,0,0,0,0,0,0,3,0,37
Cleveland,8/8/20,0,0,0,0,0,0,0,0,0,97,0,1308,0,59,0,2,0,36,0,1405,0,0,0,0,0,0,0,4,1,0,12
Columbia,8/8/20,0,0,0,0,0,0,0,0,0,214,0,2621,0,169,0,9,0,36,0,2835,0,0,0,0,0,0,0,2,1,1,25
Conway,8/8/20,0,0,0,0,0,0,0,0,0,150,0,3047,0,128,0,3,0,19,0,3197,0,0,0,0,0,0,0,3,5,0,29
Craighead,8/8/20,0,0,0,0,0,0,0,0,0,1336,0,16987,0,1071,0,12,0,253,0,18323,0,0,0,0,0,0,0,18,31,0,183
Crawford,8/8/20,0,0,0,0,0,0,0,0,0,620,0,8642,0,497,0,4,0,119,0,9262,0,0,0,0,0,0,0,23,10,1,249
Crittenden,8/8/20,0,0,0,0,0,0,0,0,0,1351,0,8302,0,1174,0,21,0,156,0,9653,0,0,0,0,0,0,0,24,12,1,93
Cross,8/8/20,0,0,0,0,0,0,0,0,0,195,0,2154,0,157,0,4,0,34,0,2349,0,0,0,0,0,0,0,5,0,1,33
Dallas,8/8/20,0,0,0,0,0,0,0,0,0,61,0,844,0,50,0,0,0,11,0,905,0,0,0,0,0,0,0,0,1,0,14
Desha,8/8/20,0,0,0,0,0,0,0,0,0,192,0,1783,0,135,0,2,0,55,0,1975,0,0,0,0,0,0,0,5,0,0,41
Drew,8/8/20,0,0,0,0,0,0,0,0,0,198,0,3073,0,146,0,3,0,49,0,3271,0,0,0,0,0,0,0,12,1,0,45
Faulkner,8/8/20,0,0,0,0,0,0,0,0,0,1290,0,17367,0,1136,0,6,0,148,0,18657,0,0,0,0,0,0,0,12,11,0,157
Franklin,8/8/20,0,0,0,0,0,0,0,0,0,126,0,2994,0,91,0,2,0,33,0,3120,0,0,0,0,0,0,0,3,5,0,52
Fulton,8/8/20,0,0,0,0,0,0,0,0,0,40,0,1304,0,27,0,0,0,13,0,1344,0,0,0,0,0,0,0,5,0,0,23
Garland,8/8/20,0,0,0,0,0,0,0,0,0,992,0,13803,0,768,0,12,0,212,0,14795,0,0,0,0,0,0,0,28,25,3,212
Grant,8/8/20,0,0,0,0,0,0,0,0,0,135,0,2213,0,122,0,0,0,13,0,2348,0,0,0,0,0,0,0,2,9,0,19
Greene,8/8/20,0,0,0,0,0,0,0,0,0,473,0,6973,0,277,0,1,0,195,0,7446,0,0,0,0,0,0,0,14,9,0,88
Hempstead,8/8/20,0,0,0,0,0,0,0,0,0,239,0,2868,0,194,0,2,0,43,0,3107,0,0,0,0,0,0,0,6,4,0,24
HotSpring,8/8/20,0,0,0,0,0,0,0,0,0,1530,0,5495,0,1414,0,11,0,105,0,7025,0,0,0,0,0,0,0,34,6,0,76
Howard,8/8/20,0,0,0,0,0,0,0,0,0,336,0,2478,0,259,0,3,0,74,0,2814,0,0,0,0,0,0,0,9,6,0,22
Independence,8/8/20,0,0,0,0,0,0,0,0,0,492,0,4648,0,280,0,1,0,211,0,5140,0,0,0,0,0,0,0,9,21,0,37
Izard,8/8/20,0,0,0,0,0,0,0,0,0,52,0,1404,0,39,0,1,0,12,0,1456,0,0,0,0,0,0,0,2,2,0,13
Jackson,8/8/20,0,0,0,0,0,0,0,0,0,109,0,2957,0,54,0,1,0,54,0,3066,0,0,0,0,0,0,0,32,0,0,604
Jefferson,8/8/20,0,0,0,0,0,0,0,0,0,1519,0,13132,0,1217,0,40,0,262,0,14651,0,0,0,0,0,0,0,35,25,0,152
Johnson,8/8/20,0,0,0,0,0,0,0,0,0,663,0,2882,0,607,0,2,0,54,0,3545,0,0,0,0,0,0,0,1,6,0,10
Lafayette,8/8/20,0,0,0,0,0,0,0,0,0,53,0,557,0,48,0,2,0,3,0,610,0,0,0,0,0,0,0,1,1,0,2
Lawrence,8/8/20,0,0,0,0,0,0,0,0,0,209,0,2273,0,170,0,9,0,30,0,2482,0,0,0,0,0,0,0,3,6,0,14
Lee,8/8/20,0,0,0,0,0,0,0,0,0,893,0,2874,0,870,0,8,0,15,0,3767,0,0,0,0,0,0,0,0,0,0,42
Lincoln,8/8/20,0,0,0,0,0,0,0,0,0,1212,0,2657,0,1147,0,12,0,53,0,3869,0,0,0,0,0,0,0,3,3,1,16
LittleRiver,8/8/20,0,0,0,0,0,0,0,0,0,180,0,1221,0,107,0,1,0,72,0,1401,0,0,0,0,0,0,0,12,7,0,19
Logan,8/8/20,0,0,0,0,0,0,0,0,0,252,0,3686,0,126,0,1,0,125,0,3938,0,0,0,0,0,0,0,19,1,0,63
Lonoke,8/8/20,0,0,0,0,0,0,0,0,0,508,0,7955,0,386,0,2,0,120,0,8463,0,0,0,0,0,0,0,13,8,0,136
Madison,8/8/20,0,0,0,0,0,0,0,0,0,270,0,2543,0,250,0,2,0,18,0,2813,0,0,0,0,0,0,0,1,0,0,19
Marion,8/8/20,0,0,0,0,0,0,0,0,0,25,0,1275,0,19,0,0,0,6,0,1300,0,0,0,0,0,0,0,0,0,0,10
Miller,8/8/20,0,0,0,0,0,0,0,0,0,508,0,4072,0,439,0,5,0,64,0,4580,0,0,0,0,0,0,0,9,5,0,40
MissingCountyInfo,8/8/20,0,0,0,0,0,0,0,0,0,1772,0,64183,0,1330,0,0,0,442,0,65955,0,0,0,0,0,0,0,-13,0,0,221
Mississippi,8/8/20,0,0,0,0,0,0,0,0,0,982,0,6741,0,668,0,14,0,300,0,7723,0,0,0,0,0,0,0,24,11,1,111
Monroe,8/8/20,0,0,0,0,0,0,0,0,0,58,0,1291,0,47,0,0,0,11,0,1349,0,0,0,0,0,0,0,0,1,0,13
Montgomery,8/8/20,0,0,0,0,0,0,0,0,0,34,0,896,0,23,0,1,0,10,0,930,0,0,0,0,0,0,0,0,0,0,4
Nevada,8/8/20,0,0,0,0,0,0,0,0,0,137,0,1586,0,119,0,9,0,9,0,1723,0,0,0,0,0,0,0,0,2,0,12
Newton,8/8/20,0,0,0,0,0,0,0,0,0,102,0,833,0,85,0,6,0,11,0,935,0,0,0,0,0,0,0,-2,6,0,-1
Ouachita,8/8/20,0,0,0,0,0,0,0,0,0,98,0,3080,0,70,0,2,0,26,0,3178,0,0,0,0,0,0,0,6,3,0,149
Perry,8/8/20,0,0,0,0,0,0,0,0,0,50,0,1432,0,47,0,0,0,3,0,1482,0,0,0,0,0,0,0,0,0,0,11
Phillips,8/8/20,0,0,0,0,0,0,0,0,0,311,0,3771,0,257,0,7,0,47,0,4082,0,0,0,0,0,0,0,8,2,0,40
Pike,8/8/20,0,0,0,0,0,0,0,0,0,101,0,2864,0,74,0,1,0,26,0,2965,0,0,0,0,0,0,0,4,2,0,28
Poinsett,8/8/20,0,0,0,0,0,0,0,0,0,269,0,2598,0,156,0,3,0,110,0,2867,0,0,0,0,0,0,0,29,8,0,53
Polk,8/8/20,0,0,0,0,0,0,0,0,0,140,0,2258,0,127,0,1,0,12,0,2398,0,0,0,0,0,0,0,0,0,0,22
Pope,8/8/20,0,0,0,0,0,0,0,0,0,1306,0,10027,0,1127,0,10,0,169,0,11333,0,0,0,0,0,0,0,24,28,0,108
Prairie,8/8/20,0,0,0,0,0,0,0,0,0,90,0,1076,0,58,0,0,0,32,0,1166,0,0,0,0,0,0,0,3,0,0,28
Pulaski,8/8/20,0,0,0,0,0,0,0,0,0,5480,0,63547,0,4631,0,85,0,764,0,69027,0,0,0,0,0,0,0,73,77,2,728
Randolph,8/8/20,0,0,0,0,0,0,0,0,0,209,0,2784,0,168,0,3,0,38,0,2993,0,0,0,0,0,0,0,3,5,0,15
Saline,8/8/20,0,0,0,0,0,0,0,0,0,1017,0,15812,0,838,0,6,0,173,0,16829,0,0,0,0,0,0,0,18,18,0,267
Scott,8/8/20,0,0,0,0,0,0,0,0,0,58,0,1032,0,35,0,0,0,23,0,1090,0,0,0,0,0,0,0,3,0,0,31
Searcy,8/8/20,0,0,0,0,0,0,0,0,0,29,0,1105,0,26,0,0,0,3,0,1134,0,0,0,0,0,0,0,1,1,0,4
Sebastian,8/8/20,0,0,0,0,0,0,0,0,0,2133,0,21630,0,1592,0,20,0,521,0,23763,0,0,0,0,0,0,0,54,44,1,433
Sevier,8/8/20,0,0,0,0,0,0,0,0,0,988,0,4545,0,923,0,10,0,55,0,5533,0,0,0,0,0,0,0,12,7,0,47
Sharp,8/8/20,0,0,0,0,0,0,0,0,0,111,0,1658,0,91,0,5,0,15,0,1769,0,0,0,0,0,0,0,2,1,0,19
St.Francis,8/8/20,0,0,0,0,0,0,0,0,0,1193,0,6938,0,1091,0,3,0,99,0,8131,0,0,0,0,0,0,0,7,26,0,288
Stone,8/8/20,0,0,0,0,0,0,0,0,0,67,0,1726,0,49,0,1,0,17,0,1793,0,0,0,0,0,0,0,3,3,0,16
Union,8/8/20,0,0,0,0,0,0,0,0,0,478,0,4333,0,381,0,17,0,80,0,4811,0,0,0,0,0,0,0,6,6,0,53
VanBuren,8/8/20,0,0,0,0,0,0,0,0,0,53,0,1541,0,46,0,2,0,5,0,1594,0,0,0,0,0,0,0,1,1,0,8
Washington,8/8/20,0,0,0,0,0,0,0,0,0,6268,0,24202,0,5838,0,51,0,379,0,30470,0,0,0,0,0,0,0,37,32,0,273
White,8/8/20,0,0,0,0,0,0,0,0,0,318,0,6136,0,256,0,2,0,60,0,6454,0,0,0,0,0,0,0,6,11,0,35
Woodruff,8/8/20,0,0,0,0,0,0,0,0,0,21,0,1048,0,17,0,0,0,4,0,1069,0,0,0,0,0,0,0,0,0,0,8
Yell,8/8/20,0,0,0,0,0,0,0,0,0,1065,0,3738,0,981,0,14,0,70,0,4803,0,0,0,0,0,0,0,3,5,0,30
Arkansas_all_counties,8/7/20,0,0,0,0,0,0,0,0,2990671,48039,0,503484,0,40360,0,521,0,7158,0,551523,0,0,0,0,0,0,0,1011,805,6,7160
Arkansas_county,8/7/20,0,0,0,0,0,0,0,0,0,210,0,2830,0,178,0,1,0,31,0,3040,0,0,0,0,0,0,0,2,2,0,52
Ashley,8/7/20,0,0,0,0,0,0,0,0,0,304,0,2755,0,206,0,5,0,93,0,3059,0,0,0,0,0,0,0,6,15,0,35
Baxter,8/7/20,0,0,0,0,0,0,0,0,0,69,0,3301,0,54,0,0,0,15,0,3370,0,0,0,0,0,0,0,1,0,0,26
Benton,8/7/20,0,0,0,0,0,0,0,0,0,4698,0,54384,0,4349,0,41,0,308,0,59082,0,0,0,0,0,0,0,35,31,1,465
Boone,8/7/20,0,0,0,0,0,0,0,0,0,201,0,4122,0,128,0,1,0,72,0,4323,0,0,0,0,0,0,0,8,7,0,42
Bradley,8/7/20,0,0,0,0,0,0,0,0,0,179,0,2167,0,116,0,3,0,60,0,2346,0,0,0,0,0,0,0,6,1,0,26
Calhoun,8/7/20,0,0,0,0,0,0,0,0,0,15,0,526,0,12,0,0,0,3,0,541,0,0,0,0,0,0,0,2,0,0,10
Carroll,8/7/20,0,0,0,0,0,0,0,0,0,350,0,4132,0,322,0,7,0,21,0,4482,0,0,0,0,0,0,0,0,6,0,43
Chicot,8/7/20,0,0,0,0,0,0,0,0,0,718,0,2964,0,317,0,8,0,393,0,3682,0,0,0,0,0,0,0,11,12,0,31
Clark,8/7/20,0,0,0,0,0,0,0,0,0,177,0,2846,0,146,0,1,0,30,0,3023,0,0,0,0,0,0,0,2,6,0,18
Clay,8/7/20,0,0,0,0,0,0,0,0,0,127,0,2335,0,101,0,4,0,22,0,2462,0,0,0,0,0,0,0,9,3,0,41
Cleburne,8/7/20,0,0,0,0,0,0,0,0,0,194,0,3286,0,169,0,5,0,20,0,3480,0,0,0,0,0,0,0,6,1,0,48
Cleveland,8/7/20,0,0,0,0,0,0,0,0,0,93,0,1300,0,58,0,2,0,33,0,1393,0,0,0,0,0,0,0,6,0,0,18
Columbia,8/7/20,0,0,0,0,0,0,0,0,0,212,0,2598,0,168,0,8,0,36,0,2810,0,0,0,0,0,0,0,3,2,0,74
Conway,8/7/20,0,0,0,0,0,0,0,0,0,147,0,3021,0,123,0,3,0,21,0,3168,0,0,0,0,0,0,0,4,4,0,61
Craighead,8/7/20,0,0,0,0,0,0,0,0,0,1318,0,16822,0,1040,0,12,0,266,0,18140,0,0,0,0,0,0,0,54,18,0,212
Crawford,8/7/20,0,0,0,0,0,0,0,0,0,597,0,8416,0,487,0,3,0,107,0,9013,0,0,0,0,0,0,0,15,29,0,178
Crittenden,8/7/20,0,0,0,0,0,0,0,0,0,1327,0,8233,0,1162,0,20,0,145,0,9560,0,0,0,0,0,0,0,12,22,0,106
Cross,8/7/20,0,0,0,0,0,0,0,0,0,190,0,2126,0,157,0,3,0,30,0,2316,0,0,0,0,0,0,0,7,4,0,39
Dallas,8/7/20,0,0,0,0,0,0,0,0,0,61,0,830,0,49,0,0,0,12,0,891,0,0,0,0,0,0,0,2,3,0,13
Desha,8/7/20,0,0,0,0,0,0,0,0,0,187,0,1747,0,135,0,2,0,50,0,1934,0,0,0,0,0,0,0,8,2,0,38
Drew,8/7/20,0,0,0,0,0,0,0,0,0,186,0,3040,0,145,0,3,0,38,0,3226,0,0,0,0,0,0,0,4,4,0,41
Faulkner,8/7/20,0,0,0,0,0,0,0,0,0,1278,0,17222,0,1125,0,6,0,147,0,18500,0,0,0,0,0,0,0,26,31,1,224
Franklin,8/7/20,0,0,0,0,0,0,0,0,0,123,0,2945,0,86,0,2,0,35,0,3068,0,0,0,0,0,0,0,4,4,0,51
Fulton,8/7/20,0,0,0,0,0,0,0,0,0,35,0,1286,0,27,0,0,0,8,0,1321,0,0,0,0,0,0,0,5,2,0,22
Garland,8/7/20,0,0,0,0,0,0,0,0,0,964,0,13619,0,743,0,9,0,212,0,14583,0,0,0,0,0,0,0,25,22,1,215
Grant,8/7/20,0,0,0,0,0,0,0,0,0,133,0,2196,0,113,0,0,0,20,0,2329,0,0,0,0,0,0,0,2,1,0,27
Greene,8/7/20,0,0,0,0,0,0,0,0,0,459,0,6899,0,268,0,1,0,190,0,7358,0,0,0,0,0,0,0,14,9,0,180
Hempstead,8/7/20,0,0,0,0,0,0,0,0,0,233,0,2850,0,190,0,2,0,41,0,3083,0,0,0,0,0,0,0,6,6,0,59
HotSpring,8/7/20,0,0,0,0,0,0,0,0,0,1496,0,5453,0,1408,0,11,0,77,0,6949,0,0,0,0,0,0,0,12,7,-1,82
Howard,8/7/20,0,0,0,0,0,0,0,0,0,327,0,2465,0,253,0,3,0,71,0,2792,0,0,0,0,0,0,0,5,2,0,24
Independence,8/7/20,0,0,0,0,0,0,0,0,0,483,0,4620,0,259,0,1,0,223,0,5103,0,0,0,0,0,0,0,40,16,0,141
Izard,8/7/20,0,0,0,0,0,0,0,0,0,50,0,1393,0,37,0,1,0,12,0,1443,0,0,0,0,0,0,0,3,2,0,35
Jackson,8/7/20,0,0,0,0,0,0,0,0,0,77,0,2385,0,54,0,1,0,22,0,2462,0,0,0,0,0,0,0,14,4,0,587
Jefferson,8/7/20,0,0,0,0,0,0,0,0,0,1484,0,13015,0,1192,0,40,0,252,0,14499,0,0,0,0,0,0,0,61,16,0,213
Johnson,8/7/20,0,0,0,0,0,0,0,0,0,662,0,2873,0,601,0,2,0,59,0,3535,0,0,0,0,0,0,0,10,6,0,29
Lafayette,8/7/20,0,0,0,0,0,0,0,0,0,52,0,556,0,47,0,2,0,3,0,608,0,0,0,0,0,0,0,0,2,0,6
Lawrence,8/7/20,0,0,0,0,0,0,0,0,0,206,0,2262,0,164,0,9,0,33,0,2468,0,0,0,0,0,0,0,1,0,0,33
Lee,8/7/20,0,0,0,0,0,0,0,0,0,893,0,2832,0,870,0,8,0,15,0,3725,0,0,0,0,0,0,0,3,3,0,21
Lincoln,8/7/20,0,0,0,0,0,0,0,0,0,1209,0,2644,0,1144,0,11,0,54,0,3853,0,0,0,0,0,0,0,12,6,0,55
LittleRiver,8/7/20,0,0,0,0,0,0,0,0,0,168,0,1214,0,100,0,1,0,67,0,1382,0,0,0,0,0,0,0,4,6,0,9
Logan,8/7/20,0,0,0,0,0,0,0,0,0,233,0,3642,0,125,0,1,0,107,0,3875,0,0,0,0,0,0,0,8,0,0,74
Lonoke,8/7/20,0,0,0,0,0,0,0,0,0,495,0,7832,0,378,0,2,0,115,0,8327,0,0,0,0,0,0,0,13,13,0,129
Madison,8/7/20,0,0,0,0,0,0,0,0,0,269,0,2525,0,250,0,2,0,17,0,2794,0,0,0,0,0,0,0,0,2,0,16
Marion,8/7/20,0,0,0,0,0,0,0,0,0,25,0,1265,0,19,0,0,0,6,0,1290,0,0,0,0,0,0,0,0,0,0,8
Miller,8/7/20,0,0,0,0,0,0,0,0,0,499,0,4041,0,434,0,5,0,60,0,4540,0,0,0,0,0,0,0,4,4,0,39
MissingCountyInfo,8/7/20,0,0,0,0,0,0,0,0,0,1785,0,63949,0,1330,0,0,0,455,0,65734,0,0,0,0,0,0,0,52,53,0,265
Mississippi,8/7/20,0,0,0,0,0,0,0,0,0,958,0,6654,0,657,0,13,0,288,0,7612,0,0,0,0,0,0,0,44,23,0,107
Monroe,8/7/20,0,0,0,0,0,0,0,0,0,58,0,1278,0,46,0,0,0,12,0,1336,0,0,0,0,0,0,0,3,3,0,14
Montgomery,8/7/20,0,0,0,0,0,0,0,0,0,34,0,892,0,23,0,1,0,10,0,926,0,0,0,0,0,0,0,0,0,0,5
Nevada,8/7/20,0,0,0,0,0,0,0,0,0,137,0,1574,0,117,0,9,0,11,0,1711,0,0,0,0,0,0,0,1,2,0,19
Newton,8/7/20,0,0,0,0,0,0,0,0,0,104,0,832,0,79,0,6,0,19,0,936,0,0,0,0,0,0,0,2,22,0,7
Ouachita,8/7/20,0,0,0,0,0,0,0,0,0,92,0,2937,0,67,0,2,0,23,0,3029,0,0,0,0,0,0,0,8,1,0,85
Perry,8/7/20,0,0,0,0,0,0,0,0,0,50,0,1421,0,47,0,0,0,3,0,1471,0,0,0,0,0,0,0,0,0,0,10
Phillips,8/7/20,0,0,0,0,0,0,0,0,0,303,0,3739,0,255,0,7,0,41,0,4042,0,0,0,0,0,0,0,5,8,0,61
Pike,8/7/20,0,0,0,0,0,0,0,0,0,97,0,2840,0,72,0,1,0,24,0,2937,0,0,0,0,0,0,0,6,3,0,62
Poinsett,8/7/20,0,0,0,0,0,0,0,0,0,240,0,2574,0,148,0,3,0,89,0,2814,0,0,0,0,0,0,0,23,11,0,44
Polk,8/7/20,0,0,0,0,0,0,0,0,0,140,0,2236,0,127,0,1,0,12,0,2376,0,0,0,0,0,0,0,3,4,0,37
Pope,8/7/20,0,0,0,0,0,0,0,0,0,1282,0,9943,0,1099,0,10,0,173,0,11225,0,0,0,0,0,0,0,6,25,0,164
Prairie,8/7/20,0,0,0,0,0,0,0,0,0,87,0,1051,0,58,0,0,0,29,0,1138,0,0,0,0,0,0,0,7,3,0,33
Pulaski,8/7/20,0,0,0,0,0,0,0,0,0,5407,0,62892,0,4554,0,83,0,770,0,68299,0,0,0,0,0,0,0,185,83,2,924
Randolph,8/7/20,0,0,0,0,0,0,0,0,0,206,0,2772,0,163,0,3,0,40,0,2978,0,0,0,0,0,0,0,7,9,0,33
Saline,8/7/20,0,0,0,0,0,0,0,0,0,999,0,15563,0,820,0,6,0,173,0,16562,0,0,0,0,0,0,0,24,21,0,242
Scott,8/7/20,0,0,0,0,0,0,0,0,0,55,0,1004,0,35,0,0,0,20,0,1059,0,0,0,0,0,0,0,4,2,0,23
Searcy,8/7/20,0,0,0,0,0,0,0,0,0,28,0,1102,0,25,0,0,0,3,0,1130,0,0,0,0,0,0,0,0,0,0,5
Sebastian,8/7/20,0,0,0,0,0,0,0,0,0,2079,0,21251,0,1548,0,19,0,512,0,23330,0,0,0,0,0,0,0,41,48,2,397
Sevier,8/7/20,0,0,0,0,0,0,0,0,0,976,0,4510,0,916,0,10,0,50,0,5486,0,0,0,0,0,0,0,7,6,0,39
Sharp,8/7/20,0,0,0,0,0,0,0,0,0,109,0,1641,0,90,0,5,0,14,0,1750,0,0,0,0,0,0,0,2,1,0,47
St.Francis,8/7/20,0,0,0,0,0,0,0,0,0,1186,0,6657,0,1065,0,3,0,118,0,7843,0,0,0,0,0,0,0,21,36,0,114
Stone,8/7/20,0,0,0,0,0,0,0,0,0,64,0,1713,0,46,0,1,0,17,0,1777,0,0,0,0,0,0,0,3,0,0,34
Union,8/7/20,0,0,0,0,0,0,0,0,0,472,0,4286,0,375,0,17,0,80,0,4758,0,0,0,0,0,0,0,8,10,0,59
VanBuren,8/7/20,0,0,0,0,0,0,0,0,0,52,0,1534,0,45,0,2,0,5,0,1586,0,0,0,0,0,0,0,0,0,0,11
Washington,8/7/20,0,0,0,0,0,0,0,0,0,6231,0,23966,0,5806,0,51,0,374,0,30197,0,0,0,0,0,0,0,43,70,0,263
White,8/7/20,0,0,0,0,0,0,0,0,0,312,0,6107,0,245,0,2,0,65,0,6419,0,0,0,0,0,0,0,23,16,0,93
Woodruff,8/7/20,0,0,0,0,0,0,0,0,0,21,0,1040,0,17,0,0,0,4,0,1061,0,0,0,0,0,0,0,1,0,0,29
Yell,8/7/20,0,0,0,0,0,0,0,0,0,1062,0,3711,0,976,0,14,0,72,0,4773,0,0,0,0,0,0,0,7,9,0,38
Arkansas_all_counties,8/6/20,0,0,0,0,0,0,0,0,2990671,47028,0,497335,0,39555,0,515,0,6958,0,544363,0,0,0,0,0,0,0,735,707,7,5262
Arkansas_county,8/6/20,0,0,0,0,0,0,0,0,0,208,0,2780,0,176,0,1,0,31,0,2988,0,0,0,0,0,0,0,-1,5,0,17
Ashley,8/6/20,0,0,0,0,0,0,0,0,0,298,0,2726,0,191,0,5,0,102,0,3024,0,0,0,0,0,0,0,14,13,0,83
Baxter,8/6/20,0,0,0,0,0,0,0,0,0,68,0,3276,0,54,0,0,0,14,0,3344,0,0,0,0,0,0,0,0,2,0,25
Benton,8/6/20,0,0,0,0,0,0,0,0,0,4663,0,53954,0,4318,0,40,0,305,0,58617,0,0,0,0,0,0,0,29,53,0,527
Boone,8/6/20,0,0,0,0,0,0,0,0,0,193,0,4088,0,121,0,1,0,71,0,4281,0,0,0,0,0,0,0,9,6,0,48
Bradley,8/6/20,0,0,0,0,0,0,0,0,0,173,0,2147,0,115,0,3,0,55,0,2320,0,0,0,0,0,0,0,6,3,0,34
Calhoun,8/6/20,0,0,0,0,0,0,0,0,0,13,0,518,0,12,0,0,0,1,0,531,0,0,0,0,0,0,0,0,1,0,5
Carroll,8/6/20,0,0,0,0,0,0,0,0,0,350,0,4089,0,316,0,7,0,27,0,4439,0,0,0,0,0,0,0,4,2,0,30
Chicot,8/6/20,0,0,0,0,0,0,0,0,0,707,0,2944,0,305,0,8,0,394,0,3651,0,0,0,0,0,0,0,7,6,0,65
Clark,8/6/20,0,0,0,0,0,0,0,0,0,175,0,2830,0,140,0,1,0,34,0,3005,0,0,0,0,0,0,0,5,4,0,150
Clay,8/6/20,0,0,0,0,0,0,0,0,0,118,0,2303,0,98,0,4,0,16,0,2421,0,0,0,0,0,0,0,4,0,0,29
Cleburne,8/6/20,0,0,0,0,0,0,0,0,0,188,0,3244,0,168,0,5,0,15,0,3432,0,0,0,0,0,0,0,1,1,0,15
Cleveland,8/6/20,0,0,0,0,0,0,0,0,0,87,0,1288,0,58,0,2,0,27,0,1375,0,0,0,0,0,0,0,4,3,0,15
Columbia,8/6/20,0,0,0,0,0,0,0,0,0,209,0,2527,0,166,0,8,0,35,0,2736,0,0,0,0,0,0,0,0,1,1,14
Conway,8/6/20,0,0,0,0,0,0,0,0,0,143,0,2964,0,119,0,3,0,21,0,3107,0,0,0,0,0,0,0,0,0,0,48
Craighead,8/6/20,0,0,0,0,0,0,0,0,0,1264,0,16664,0,1022,0,12,0,230,0,17928,0,0,0,0,0,0,0,68,15,0,172
Crawford,8/6/20,0,0,0,0,0,0,0,0,0,582,0,8253,0,458,0,3,0,121,0,8835,0,0,0,0,0,0,0,13,10,0,116
Crittenden,8/6/20,0,0,0,0,0,0,0,0,0,1315,0,8139,0,1140,0,20,0,155,0,9454,0,0,0,0,0,0,0,24,14,0,87
Cross,8/6/20,0,0,0,0,0,0,0,0,0,183,0,2094,0,153,0,3,0,27,0,2277,0,0,0,0,0,0,0,10,3,0,16
Dallas,8/6/20,0,0,0,0,0,0,0,0,0,59,0,819,0,46,0,0,0,13,0,878,0,0,0,0,0,0,0,0,2,0,7
Desha,8/6/20,0,0,0,0,0,0,0,0,0,179,0,1717,0,133,0,2,0,44,0,1896,0,0,0,0,0,0,0,5,1,0,18
Drew,8/6/20,0,0,0,0,0,0,0,0,0,182,0,3003,0,141,0,3,0,38,0,3185,0,0,0,0,0,0,0,7,3,0,68
Faulkner,8/6/20,0,0,0,0,0,0,0,0,0,1252,0,17024,0,1094,0,5,0,153,0,18276,0,0,0,0,0,0,0,13,17,0,140
Franklin,8/6/20,0,0,0,0,0,0,0,0,0,119,0,2898,0,82,0,2,0,35,0,3017,0,0,0,0,0,0,0,6,2,0,37
Fulton,8/6/20,0,0,0,0,0,0,0,0,0,30,0,1269,0,25,0,0,0,5,0,1299,0,0,0,0,0,0,0,0,0,0,10
Garland,8/6/20,0,0,0,0,0,0,0,0,0,939,0,13429,0,721,0,8,0,210,0,14368,0,0,0,0,0,0,0,29,28,0,189
Grant,8/6/20,0,0,0,0,0,0,0,0,0,131,0,2171,0,112,0,0,0,19,0,2302,0,0,0,0,0,0,0,1,2,0,20
Greene,8/6/20,0,0,0,0,0,0,0,0,0,445,0,6733,0,259,0,1,0,185,0,7178,0,0,0,0,0,0,0,23,1,0,156
Hempstead,8/6/20,0,0,0,0,0,0,0,0,0,227,0,2797,0,184,0,2,0,41,0,3024,0,0,0,0,0,0,0,0,5,0,13
HotSpring,8/6/20,0,0,0,0,0,0,0,0,0,1484,0,5383,0,1401,0,12,0,71,0,6867,0,0,0,0,0,0,0,5,5,0,96
Howard,8/6/20,0,0,0,0,0,0,0,0,0,322,0,2446,0,251,0,3,0,68,0,2768,0,0,0,0,0,0,0,14,6,1,45
Independence,8/6/20,0,0,0,0,0,0,0,0,0,443,0,4519,0,243,0,1,0,199,0,4962,0,0,0,0,0,0,0,10,21,0,78
Izard,8/6/20,0,0,0,0,0,0,0,0,0,47,0,1361,0,35,0,1,0,11,0,1408,0,0,0,0,0,0,0,2,1,0,10
Jackson,8/6/20,0,0,0,0,0,0,0,0,0,63,0,1812,0,50,0,1,0,12,0,1875,0,0,0,0,0,0,0,1,2,0,8
Jefferson,8/6/20,0,0,0,0,0,0,0,0,0,1423,0,12863,0,1176,0,40,0,207,0,14286,0,0,0,0,0,0,0,11,28,0,115
Johnson,8/6/20,0,0,0,0,0,0,0,0,0,652,0,2854,0,595,0,2,0,55,0,3506,0,0,0,0,0,0,0,6,5,0,25
Lafayette,8/6/20,0,0,0,0,0,0,0,0,0,52,0,550,0,45,0,2,0,5,0,602,0,0,0,0,0,0,0,0,2,0,9
Lawrence,8/6/20,0,0,0,0,0,0,0,0,0,205,0,2230,0,164,0,9,0,32,0,2435,0,0,0,0,0,0,0,14,2,0,17
Lee,8/6/20,0,0,0,0,0,0,0,0,0,890,0,2814,0,867,0,8,0,15,0,3704,0,0,0,0,0,0,0,0,0,0,9
Lincoln,8/6/20,0,0,0,0,0,0,0,0,0,1197,0,2601,0,1138,0,11,0,48,0,3798,0,0,0,0,0,0,0,1,0,0,11
LittleRiver,8/6/20,0,0,0,0,0,0,0,0,0,164,0,1209,0,94,0,1,0,69,0,1373,0,0,0,0,0,0,0,4,5,0,8
Logan,8/6/20,0,0,0,0,0,0,0,0,0,225,0,3576,0,125,0,1,0,99,0,3801,0,0,0,0,0,0,0,17,0,0,115
Lonoke,8/6/20,0,0,0,0,0,0,0,0,0,482,0,7716,0,365,0,2,0,115,0,8198,0,0,0,0,0,0,0,8,15,0,49
Madison,8/6/20,0,0,0,0,0,0,0,0,0,269,0,2509,0,248,0,2,0,19,0,2778,0,0,0,0,0,0,0,2,0,1,26
Marion,8/6/20,0,0,0,0,0,0,0,0,0,25,0,1257,0,19,0,0,0,6,0,1282,0,0,0,0,0,0,0,-1,0,0,3
Miller,8/6/20,0,0,0,0,0,0,0,0,0,495,0,4006,0,430,0,5,0,60,0,4501,0,0,0,0,0,0,0,6,4,0,32
MissingCountyInfo,8/6/20,0,0,0,0,0,0,0,0,0,1733,0,63736,0,1277,0,0,0,456,0,65469,0,0,0,0,0,0,0,47,47,0,279
Mississippi,8/6/20,0,0,0,0,0,0,0,0,0,914,0,6591,0,634,0,13,0,267,0,7505,0,0,0,0,0,0,0,23,22,1,63
Monroe,8/6/20,0,0,0,0,0,0,0,0,0,55,0,1267,0,43,0,0,0,12,0,1322,0,0,0,0,0,0,0,3,3,0,14
Montgomery,8/6/20,0,0,0,0,0,0,0,0,0,34,0,887,0,23,0,1,0,10,0,921,0,0,0,0,0,0,0,3,0,1,21
Nevada,8/6/20,0,0,0,0,0,0,0,0,0,136,0,1556,0,115,0,9,0,12,0,1692,0,0,0,0,0,0,0,2,0,0,4
Newton,8/6/20,0,0,0,0,0,0,0,0,0,102,0,827,0,57,0,6,0,39,0,929,0,0,0,0,0,0,0,2,29,1,6
Ouachita,8/6/20,0,0,0,0,0,0,0,0,0,84,0,2860,0,66,0,2,0,16,0,2944,0,0,0,0,0,0,0,0,2,0,23
Perry,8/6/20,0,0,0,0,0,0,0,0,0,50,0,1411,0,47,0,0,0,3,0,1461,0,0,0,0,0,0,0,0,0,0,7
Phillips,8/6/20,0,0,0,0,0,0,0,0,0,298,0,3683,0,247,0,7,0,44,0,3981,0,0,0,0,0,0,0,0,5,0,17
Pike,8/6/20,0,0,0,0,0,0,0,0,0,91,0,2784,0,69,0,1,0,21,0,2875,0,0,0,0,0,0,0,3,2,0,68
Poinsett,8/6/20,0,0,0,0,0,0,0,0,0,217,0,2553,0,137,0,3,0,77,0,2770,0,0,0,0,0,0,0,27,8,0,37
Polk,8/6/20,0,0,0,0,0,0,0,0,0,137,0,2202,0,123,0,1,0,13,0,2339,0,0,0,0,0,0,0,3,3,0,16
Pope,8/6/20,0,0,0,0,0,0,0,0,0,1276,0,9785,0,1074,0,10,0,192,0,11061,0,0,0,0,0,0,0,10,26,0,67
Prairie,8/6/20,0,0,0,0,0,0,0,0,0,80,0,1025,0,55,0,0,0,25,0,1105,0,0,0,0,0,0,0,2,2,0,9
Pulaski,8/6/20,0,0,0,0,0,0,0,0,0,5222,0,62153,0,4471,0,81,0,670,0,67375,0,0,0,0,0,0,0,71,100,0,734
Randolph,8/6/20,0,0,0,0,0,0,0,0,0,199,0,2746,0,154,0,3,0,42,0,2945,0,0,0,0,0,0,0,1,3,0,16
Saline,8/6/20,0,0,0,0,0,0,0,0,0,975,0,15345,0,799,0,6,0,170,0,16320,0,0,0,0,0,0,0,26,24,0,195
Scott,8/6/20,0,0,0,0,0,0,0,0,0,51,0,985,0,33,0,0,0,18,0,1036,0,0,0,0,0,0,0,5,0,0,23
Searcy,8/6/20,0,0,0,0,0,0,0,0,0,28,0,1097,0,25,0,0,0,3,0,1125,0,0,0,0,0,0,0,0,2,0,6
Sebastian,8/6/20,0,0,0,0,0,0,0,0,0,2038,0,20895,0,1500,0,17,0,521,0,22933,0,0,0,0,0,0,0,61,36,0,395
Sevier,8/6/20,0,0,0,0,0,0,0,0,0,969,0,4478,0,910,0,10,0,49,0,5447,0,0,0,0,0,0,0,11,6,0,34
Sharp,8/6/20,0,0,0,0,0,0,0,0,0,107,0,1596,0,89,0,5,0,13,0,1703,0,0,0,0,0,0,0,1,4,0,16
St.Francis,8/6/20,0,0,0,0,0,0,0,0,0,1165,0,6564,0,1029,0,3,0,133,0,7729,0,0,0,0,0,0,0,17,10,0,118
Stone,8/6/20,0,0,0,0,0,0,0,0,0,61,0,1682,0,46,0,1,0,14,0,1743,0,0,0,0,0,0,0,2,1,0,19
Union,8/6/20,0,0,0,0,0,0,0,0,0,464,0,4235,0,365,0,17,0,82,0,4699,0,0,0,0,0,0,0,6,6,0,43
VanBuren,8/6/20,0,0,0,0,0,0,0,0,0,52,0,1523,0,45,0,2,0,5,0,1575,0,0,0,0,0,0,0,0,0,0,1
Washington,8/6/20,0,0,0,0,0,0,0,0,0,6188,0,23746,0,5736,0,51,0,401,0,29934,0,0,0,0,0,0,0,20,55,1,169
White,8/6/20,0,0,0,0,0,0,0,0,0,289,0,6037,0,229,0,2,0,58,0,6326,0,0,0,0,0,0,0,5,1,0,20
Woodruff,8/6/20,0,0,0,0,0,0,0,0,0,20,0,1012,0,17,0,0,0,3,0,1032,0,0,0,0,0,0,0,0,0,0,0
Yell,8/6/20,0,0,0,0,0,0,0,0,0,1055,0,3680,0,967,0,14,0,74,0,4735,0,0,0,0,0,0,0,3,11,0,32
Arkansas_all_counties,8/5/20,0,0,0,0,0,0,0,0,2990671,46293,0,492808,0,38848,0,508,0,6937,0,539101,0,0,0,0,0,0,0,912,848,18,5202
Arkansas_county,8/5/20,0,0,0,0,0,0,0,0,0,209,0,2762,0,171,0,1,0,37,0,2971,0,0,0,0,0,0,0,3,6,0,49
Ashley,8/5/20,0,0,0,0,0,0,0,0,0,284,0,2657,0,178,0,5,0,101,0,2941,0,0,0,0,0,0,0,22,15,1,57
Baxter,8/5/20,0,0,0,0,0,0,0,0,0,68,0,3251,0,52,0,0,0,16,0,3319,0,0,0,0,0,0,0,4,2,0,16
Benton,8/5/20,0,0,0,0,0,0,0,0,0,4634,0,53456,0,4265,0,40,0,329,0,58090,0,0,0,0,0,0,0,23,63,0,438
Boone,8/5/20,0,0,0,0,0,0,0,0,0,184,0,4049,0,115,0,1,0,68,0,4233,0,0,0,0,0,0,0,0,9,0,18
Bradley,8/5/20,0,0,0,0,0,0,0,0,0,167,0,2119,0,112,0,3,0,52,0,2286,0,0,0,0,0,0,0,12,0,0,67
Calhoun,8/5/20,0,0,0,0,0,0,0,0,0,13,0,513,0,11,0,0,0,2,0,526,0,0,0,0,0,0,0,0,1,0,5
Carroll,8/5/20,0,0,0,0,0,0,0,0,0,346,0,4063,0,314,0,7,0,25,0,4409,0,0,0,0,0,0,0,5,5,0,37
Chicot,8/5/20,0,0,0,0,0,0,0,0,0,700,0,2886,0,299,0,8,0,393,0,3586,0,0,0,0,0,0,0,148,14,1,336
Clark,8/5/20,0,0,0,0,0,0,0,0,0,170,0,2685,0,136,0,1,0,33,0,2855,0,0,0,0,0,0,0,6,2,0,37
Clay,8/5/20,0,0,0,0,0,0,0,0,0,114,0,2278,0,98,0,4,0,12,0,2392,0,0,0,0,0,0,0,2,5,0,22
Cleburne,8/5/20,0,0,0,0,0,0,0,0,0,187,0,3230,0,167,0,5,0,15,0,3417,0,0,0,0,0,0,0,4,6,0,26
Cleveland,8/5/20,0,0,0,0,0,0,0,0,0,83,0,1277,0,55,0,2,0,26,0,1360,0,0,0,0,0,0,0,7,2,0,27
Columbia,8/5/20,0,0,0,0,0,0,0,0,0,209,0,2513,0,165,0,7,0,37,0,2722,0,0,0,0,0,0,0,2,3,0,24
Conway,8/5/20,0,0,0,0,0,0,0,0,0,143,0,2916,0,119,0,3,0,21,0,3059,0,0,0,0,0,0,0,5,0,0,45
Craighead,8/5/20,0,0,0,0,0,0,0,0,0,1196,0,16560,0,1007,0,12,0,177,0,17756,0,0,0,0,0,0,0,40,26,0,165
Crawford,8/5/20,0,0,0,0,0,0,0,0,0,569,0,8150,0,448,0,3,0,118,0,8719,0,0,0,0,0,0,0,3,11,0,75
Crittenden,8/5/20,0,0,0,0,0,0,0,0,0,1291,0,8076,0,1126,0,20,0,145,0,9367,0,0,0,0,0,0,0,22,32,0,72
Cross,8/5/20,0,0,0,0,0,0,0,0,0,173,0,2088,0,150,0,3,0,20,0,2261,0,0,0,0,0,0,0,1,1,1,7
Dallas,8/5/20,0,0,0,0,0,0,0,0,0,59,0,812,0,44,0,0,0,15,0,871,0,0,0,0,0,0,0,0,5,0,9
Desha,8/5/20,0,0,0,0,0,0,0,0,0,174,0,1704,0,132,0,2,0,40,0,1878,0,0,0,0,0,0,0,9,6,0,23
Drew,8/5/20,0,0,0,0,0,0,0,0,0,175,0,2942,0,138,0,3,0,34,0,3117,0,0,0,0,0,0,0,4,6,0,27
Faulkner,8/5/20,0,0,0,0,0,0,0,0,0,1239,0,16897,0,1077,0,5,0,157,0,18136,0,0,0,0,0,0,0,10,14,0,205
Franklin,8/5/20,0,0,0,0,0,0,0,0,0,113,0,2867,0,80,0,2,0,31,0,2980,0,0,0,0,0,0,0,2,4,0,28
Fulton,8/5/20,0,0,0,0,0,0,0,0,0,30,0,1259,0,25,0,0,0,5,0,1289,0,0,0,0,0,0,0,1,0,0,13
Garland,8/5/20,0,0,0,0,0,0,0,0,0,910,0,13269,0,693,0,8,0,209,0,14179,0,0,0,0,0,0,0,31,19,0,227
Grant,8/5/20,0,0,0,0,0,0,0,0,0,130,0,2152,0,110,0,0,0,20,0,2282,0,0,0,0,0,0,0,0,4,0,19
Greene,8/5/20,0,0,0,0,0,0,0,0,0,422,0,6600,0,258,0,1,0,163,0,7022,0,0,0,0,0,0,0,19,19,0,62
Hempstead,8/5/20,0,0,0,0,0,0,0,0,0,227,0,2784,0,179,0,2,0,46,0,3011,0,0,0,0,0,0,0,3,2,0,25
HotSpring,8/5/20,0,0,0,0,0,0,0,0,0,1479,0,5292,0,1396,0,12,0,71,0,6771,0,0,0,0,0,0,0,4,3,2,47
Howard,8/5/20,0,0,0,0,0,0,0,0,0,308,0,2415,0,245,0,2,0,61,0,2723,0,0,0,0,0,0,0,5,4,0,12
Independence,8/5/20,0,0,0,0,0,0,0,0,0,433,0,4451,0,222,0,1,0,210,0,4884,0,0,0,0,0,0,0,20,33,0,38
Izard,8/5/20,0,0,0,0,0,0,0,0,0,45,0,1353,0,34,0,1,0,10,0,1398,0,0,0,0,0,0,0,0,2,0,9
Jackson,8/5/20,0,0,0,0,0,0,0,0,0,62,0,1805,0,48,0,1,0,13,0,1867,0,0,0,0,0,0,0,1,0,0,10
Jefferson,8/5/20,0,0,0,0,0,0,0,0,0,1412,0,12759,0,1148,0,40,0,224,0,14171,0,0,0,0,0,0,0,8,27,1,80
Johnson,8/5/20,0,0,0,0,0,0,0,0,0,646,0,2835,0,590,0,2,0,54,0,3481,0,0,0,0,0,0,0,7,17,2,19
Lafayette,8/5/20,0,0,0,0,0,0,0,0,0,52,0,541,0,43,0,2,0,7,0,593,0,0,0,0,0,0,0,2,1,0,5
Lawrence,8/5/20,0,0,0,0,0,0,0,0,0,191,0,2227,0,162,0,9,0,20,0,2418,0,0,0,0,0,0,0,5,7,-1,30
Lee,8/5/20,0,0,0,0,0,0,0,0,0,890,0,2805,0,867,0,8,0,15,0,3695,0,0,0,0,0,0,0,0,0,1,10
Lincoln,8/5/20,0,0,0,0,0,0,0,0,0,1196,0,2591,0,1138,0,11,0,47,0,3787,0,0,0,0,0,0,0,1,8,0,14
LittleRiver,8/5/20,0,0,0,0,0,0,0,0,0,160,0,1205,0,89,0,1,0,70,0,1365,0,0,0,0,0,0,0,2,2,0,8
Logan,8/5/20,0,0,0,0,0,0,0,0,0,208,0,3478,0,125,0,1,0,82,0,3686,0,0,0,0,0,0,0,12,5,0,107
Lonoke,8/5/20,0,0,0,0,0,0,0,0,0,474,0,7675,0,350,0,2,0,122,0,8149,0,0,0,0,0,0,0,5,9,0,102
Madison,8/5/20,0,0,0,0,0,0,0,0,0,267,0,2485,0,248,0,1,0,18,0,2752,0,0,0,0,0,0,0,2,3,0,17
Marion,8/5/20,0,0,0,0,0,0,0,0,0,26,0,1253,0,19,0,0,0,7,0,1279,0,0,0,0,0,0,0,2,1,0,8
Miller,8/5/20,0,0,0,0,0,0,0,0,0,489,0,3980,0,426,0,5,0,58,0,4469,0,0,0,0,0,0,0,14,11,1,23
MissingCountyInfo,8/5/20,0,0,0,0,0,0,0,0,0,1686,0,63504,0,1230,0,0,0,456,0,65190,0,0,0,0,0,0,0,34,45,0,321
Mississippi,8/5/20,0,0,0,0,0,0,0,0,0,891,0,6551,0,612,0,12,0,267,0,7442,0,0,0,0,0,0,0,38,28,1,129
Monroe,8/5/20,0,0,0,0,0,0,0,0,0,52,0,1256,0,40,0,0,0,12,0,1308,0,0,0,0,0,0,0,-1,2,0,6
Montgomery,8/5/20,0,0,0,0,0,0,0,0,0,31,0,869,0,23,0,0,0,8,0,900,0,0,0,0,0,0,0,2,0,0,14
Nevada,8/5/20,0,0,0,0,0,0,0,0,0,134,0,1554,0,115,0,9,0,10,0,1688,0,0,0,0,0,0,0,0,0,0,9
Newton,8/5/20,0,0,0,0,0,0,0,0,0,100,0,823,0,28,0,5,0,67,0,923,0,0,0,0,0,0,0,0,3,2,7
Ouachita,8/5/20,0,0,0,0,0,0,0,0,0,84,0,2837,0,64,0,2,0,18,0,2921,0,0,0,0,0,0,0,3,1,0,22
Perry,8/5/20,0,0,0,0,0,0,0,0,0,50,0,1404,0,47,0,0,0,3,0,1454,0,0,0,0,0,0,0,1,0,0,18
Phillips,8/5/20,0,0,0,0,0,0,0,0,0,298,0,3666,0,242,0,7,0,49,0,3964,0,0,0,0,0,0,0,9,2,0,40
Pike,8/5/20,0,0,0,0,0,0,0,0,0,88,0,2719,0,67,0,1,0,20,0,2807,0,0,0,0,0,0,0,4,2,0,34
Poinsett,8/5/20,0,0,0,0,0,0,0,0,0,190,0,2543,0,129,0,3,0,58,0,2733,0,0,0,0,0,0,0,17,5,0,38
Polk,8/5/20,0,0,0,0,0,0,0,0,0,134,0,2189,0,120,0,1,0,13,0,2323,0,0,0,0,0,0,0,2,4,0,9
Pope,8/5/20,0,0,0,0,0,0,0,0,0,1266,0,9728,0,1048,0,10,0,208,0,10994,0,0,0,0,0,0,0,25,27,0,100
Prairie,8/5/20,0,0,0,0,0,0,0,0,0,78,0,1018,0,53,0,0,0,25,0,1096,0,0,0,0,0,0,0,2,1,0,11
Pulaski,8/5/20,0,0,0,0,0,0,0,0,0,5151,0,61490,0,4371,0,81,0,699,0,66641,0,0,0,0,0,0,0,97,107,2,600
Randolph,8/5/20,0,0,0,0,0,0,0,0,0,198,0,2731,0,151,0,3,0,44,0,2929,0,0,0,0,0,0,0,20,3,0,56
Saline,8/5/20,0,0,0,0,0,0,0,0,0,949,0,15176,0,775,0,6,0,168,0,16125,0,0,0,0,0,0,0,27,24,0,171
Scott,8/5/20,0,0,0,0,0,0,0,0,0,46,0,967,0,33,0,0,0,13,0,1013,0,0,0,0,0,0,0,1,1,0,11
Searcy,8/5/20,0,0,0,0,0,0,0,0,0,28,0,1091,0,23,0,0,0,5,0,1119,0,0,0,0,0,0,0,1,1,0,11
Sebastian,8/5/20,0,0,0,0,0,0,0,0,0,1977,0,20561,0,1464,0,17,0,496,0,22538,0,0,0,0,0,0,0,58,49,2,270
Sevier,8/5/20,0,0,0,0,0,0,0,0,0,958,0,4455,0,904,0,10,0,44,0,5413,0,0,0,0,0,0,0,14,5,0,17
Sharp,8/5/20,0,0,0,0,0,0,0,0,0,106,0,1581,0,85,0,5,0,16,0,1687,0,0,0,0,0,0,0,0,2,0,10
St.Francis,8/5/20,0,0,0,0,0,0,0,0,0,1148,0,6463,0,1019,0,3,0,126,0,7611,0,0,0,0,0,0,0,4,20,0,26
Stone,8/5/20,0,0,0,0,0,0,0,0,0,59,0,1665,0,45,0,1,0,13,0,1724,0,0,0,0,0,0,0,0,5,0,8
Union,8/5/20,0,0,0,0,0,0,0,0,0,458,0,4198,0,359,0,17,0,82,0,4656,0,0,0,0,0,0,0,6,6,0,33
VanBuren,8/5/20,0,0,0,0,0,0,0,0,0,52,0,1522,0,45,0,2,0,5,0,1574,0,0,0,0,0,0,0,0,3,0,9
Washington,8/5/20,0,0,0,0,0,0,0,0,0,6168,0,23597,0,5681,0,50,0,437,0,29765,0,0,0,0,0,0,0,48,70,2,429
White,8/5/20,0,0,0,0,0,0,0,0,0,284,0,6022,0,228,0,2,0,54,0,6306,0,0,0,0,0,0,0,13,8,0,43
Woodruff,8/5/20,0,0,0,0,0,0,0,0,0,20,0,1012,0,17,0,0,0,3,0,1032,0,0,0,0,0,0,0,0,0,0,0
Yell,8/5/20,0,0,0,0,0,0,0,0,0,1052,0,3651,0,956,0,14,0,82,0,4703,0,0,0,0,0,0,0,9,9,0,50
Arkansas_all_counties,8/4/20,0,0,0,0,0,0,0,0,2990671,45381,0,488518,0,38000,0,490,0,6891,0,533899,0,0,0,0,0,0,0,784,760,15,6499
Arkansas_county,8/4/20,0,0,0,0,0,0,0,0,0,206,0,2716,0,165,0,1,0,40,0,2922,0,0,0,0,0,0,0,5,3,1,100
Ashley,8/4/20,0,0,0,0,0,0,0,0,0,262,0,2622,0,163,0,4,0,95,0,2884,0,0,0,0,0,0,0,8,3,0,63
Baxter,8/4/20,0,0,0,0,0,0,0,0,0,64,0,3239,0,50,0,0,0,14,0,3303,0,0,0,0,0,0,0,2,2,0,19
Benton,8/4/20,0,0,0,0,0,0,0,0,0,4611,0,53041,0,4202,0,40,0,369,0,57652,0,0,0,0,0,0,0,39,51,1,906
Boone,8/4/20,0,0,0,0,0,0,0,0,0,184,0,4031,0,106,0,1,0,77,0,4215,0,0,0,0,0,0,0,8,6,0,136
Bradley,8/4/20,0,0,0,0,0,0,0,0,0,155,0,2064,0,112,0,3,0,40,0,2219,0,0,0,0,0,0,0,8,0,0,255
Calhoun,8/4/20,0,0,0,0,0,0,0,0,0,13,0,508,0,10,0,0,0,3,0,521,0,0,0,0,0,0,0,0,0,0,4
Carroll,8/4/20,0,0,0,0,0,0,0,0,0,341,0,4031,0,309,0,7,0,25,0,4372,0,0,0,0,0,0,0,1,8,1,57
Chicot,8/4/20,0,0,0,0,0,0,0,0,0,552,0,2698,0,285,0,7,0,260,0,3250,0,0,0,0,0,0,0,16,7,1,119
Clark,8/4/20,0,0,0,0,0,0,0,0,0,164,0,2654,0,134,0,1,0,29,0,2818,0,0,0,0,0,0,0,5,3,1,55
Clay,8/4/20,0,0,0,0,0,0,0,0,0,112,0,2258,0,93,0,4,0,15,0,2370,0,0,0,0,0,0,0,3,1,0,25
Cleburne,8/4/20,0,0,0,0,0,0,0,0,0,183,0,3208,0,161,0,5,0,17,0,3391,0,0,0,0,0,0,0,1,0,0,19
Cleveland,8/4/20,0,0,0,0,0,0,0,0,0,76,0,1257,0,53,0,2,0,21,0,1333,0,0,0,0,0,0,0,5,1,0,31
Columbia,8/4/20,0,0,0,0,0,0,0,0,0,207,0,2491,0,162,0,7,0,38,0,2698,0,0,0,0,0,0,0,5,7,1,39
Conway,8/4/20,0,0,0,0,0,0,0,0,0,138,0,2876,0,119,0,3,0,16,0,3014,0,0,0,0,0,0,0,1,0,0,28
Craighead,8/4/20,0,0,0,0,0,0,0,0,0,1156,0,16435,0,981,0,12,0,163,0,17591,0,0,0,0,0,0,0,22,30,0,317
Crawford,8/4/20,0,0,0,0,0,0,0,0,0,566,0,8078,0,437,0,3,0,126,0,8644,0,0,0,0,0,0,0,12,19,0,197
Crittenden,8/4/20,0,0,0,0,0,0,0,0,0,1269,0,8026,0,1094,0,20,0,155,0,9295,0,0,0,0,0,0,0,27,20,0,99
Cross,8/4/20,0,0,0,0,0,0,0,0,0,172,0,2082,0,149,0,2,0,21,0,2254,0,0,0,0,0,0,0,0,3,0,7
Dallas,8/4/20,0,0,0,0,0,0,0,0,0,59,0,803,0,39,0,0,0,20,0,862,0,0,0,0,0,0,0,1,1,0,10
Desha,8/4/20,0,0,0,0,0,0,0,0,0,165,0,1690,0,126,0,2,0,37,0,1855,0,0,0,0,0,0,0,5,2,0,33
Drew,8/4/20,0,0,0,0,0,0,0,0,0,171,0,2919,0,132,0,3,0,36,0,3090,0,0,0,0,0,0,0,5,9,1,129
Faulkner,8/4/20,0,0,0,0,0,0,0,0,0,1229,0,16702,0,1063,0,5,0,161,0,17931,0,0,0,0,0,0,0,17,23,0,150
Franklin,8/4/20,0,0,0,0,0,0,0,0,0,111,0,2841,0,76,0,2,0,33,0,2952,0,0,0,0,0,0,0,3,0,0,39
Fulton,8/4/20,0,0,0,0,0,0,0,0,0,29,0,1247,0,25,0,0,0,4,0,1276,0,0,0,0,0,0,0,0,0,0,12
Garland,8/4/20,0,0,0,0,0,0,0,0,0,879,0,13073,0,674,0,8,0,197,0,13952,0,0,0,0,0,0,0,4,34,0,49
Grant,8/4/20,0,0,0,0,0,0,0,0,0,130,0,2133,0,106,0,0,0,24,0,2263,0,0,0,0,0,0,0,3,7,0,19
Greene,8/4/20,0,0,0,0,0,0,0,0,0,403,0,6557,0,239,0,1,0,163,0,6960,0,0,0,0,0,0,0,10,14,0,129
Hempstead,8/4/20,0,0,0,0,0,0,0,0,0,224,0,2762,0,177,0,2,0,45,0,2986,0,0,0,0,0,0,0,4,5,0,23
HotSpring,8/4/20,0,0,0,0,0,0,0,0,0,1475,0,5249,0,1393,0,10,0,72,0,6724,0,0,0,0,0,0,0,10,14,1,40
Howard,8/4/20,0,0,0,0,0,0,0,0,0,303,0,2408,0,241,0,2,0,60,0,2711,0,0,0,0,0,0,0,3,10,0,6
Independence,8/4/20,0,0,0,0,0,0,0,0,0,413,0,4433,0,189,0,1,0,223,0,4846,0,0,0,0,0,0,0,15,12,1,41
Izard,8/4/20,0,0,0,0,0,0,0,0,0,45,0,1344,0,32,0,1,0,12,0,1389,0,0,0,0,0,0,0,0,1,0,3
Jackson,8/4/20,0,0,0,0,0,0,0,0,0,61,0,1796,0,48,0,1,0,12,0,1857,0,0,0,0,0,0,0,2,1,0,25
Jefferson,8/4/20,0,0,0,0,0,0,0,0,0,1404,0,12687,0,1121,0,39,0,244,0,14091,0,0,0,0,0,0,0,22,21,0,110
Johnson,8/4/20,0,0,0,0,0,0,0,0,0,639,0,2823,0,573,0,0,0,66,0,3462,0,0,0,0,0,0,0,3,6,0,11
Lafayette,8/4/20,0,0,0,0,0,0,0,0,0,50,0,538,0,42,0,2,0,6,0,588,0,0,0,0,0,0,0,1,1,0,3
Lawrence,8/4/20,0,0,0,0,0,0,0,0,0,186,0,2202,0,155,0,10,0,21,0,2388,0,0,0,0,0,0,0,1,1,0,16
Lee,8/4/20,0,0,0,0,0,0,0,0,0,890,0,2795,0,867,0,7,0,16,0,3685,0,0,0,0,0,0,0,0,2,0,12
Lincoln,8/4/20,0,0,0,0,0,0,0,0,0,1195,0,2578,0,1130,0,11,0,54,0,3773,0,0,0,0,0,0,0,9,3,0,25
LittleRiver,8/4/20,0,0,0,0,0,0,0,0,0,158,0,1199,0,87,0,1,0,70,0,1357,0,0,0,0,0,0,0,2,2,0,8
Logan,8/4/20,0,0,0,0,0,0,0,0,0,196,0,3383,0,120,0,1,0,75,0,3579,0,0,0,0,0,0,0,1,1,0,56
Lonoke,8/4/20,0,0,0,0,0,0,0,0,0,469,0,7578,0,341,0,2,0,126,0,8047,0,0,0,0,0,0,0,17,10,0,142
Madison,8/4/20,0,0,0,0,0,0,0,0,0,265,0,2470,0,245,0,1,0,19,0,2735,0,0,0,0,0,0,0,3,2,0,26
Marion,8/4/20,0,0,0,0,0,0,0,0,0,24,0,1247,0,18,0,0,0,6,0,1271,0,0,0,0,0,0,0,1,0,0,13
Miller,8/4/20,0,0,0,0,0,0,0,0,0,475,0,3971,0,415,0,4,0,56,0,4446,0,0,0,0,0,0,0,5,17,0,20
MissingCountyInfo,8/4/20,0,0,0,0,0,0,0,0,0,1652,0,63217,0,1185,0,0,0,467,0,64869,0,0,0,0,0,0,0,11,27,0,526
Mississippi,8/4/20,0,0,0,0,0,0,0,0,0,853,0,6460,0,584,0,11,0,258,0,7313,0,0,0,0,0,0,0,56,27,0,180
Monroe,8/4/20,0,0,0,0,0,0,0,0,0,53,0,1249,0,38,0,0,0,15,0,1302,0,0,0,0,0,0,0,0,0,0,19
Montgomery,8/4/20,0,0,0,0,0,0,0,0,0,29,0,857,0,23,0,0,0,6,0,886,0,0,0,0,0,0,0,3,1,0,12
Nevada,8/4/20,0,0,0,0,0,0,0,0,0,134,0,1545,0,115,0,9,0,10,0,1679,0,0,0,0,0,0,0,1,0,0,11
Newton,8/4/20,0,0,0,0,0,0,0,0,0,100,0,816,0,25,0,3,0,72,0,916,0,0,0,0,0,0,0,2,3,0,8
Ouachita,8/4/20,0,0,0,0,0,0,0,0,0,81,0,2818,0,63,0,2,0,16,0,2899,0,0,0,0,0,0,0,0,2,1,19
Perry,8/4/20,0,0,0,0,0,0,0,0,0,49,0,1387,0,47,0,0,0,2,0,1436,0,0,0,0,0,0,0,0,0,0,12
Phillips,8/4/20,0,0,0,0,0,0,0,0,0,289,0,3635,0,240,0,7,0,42,0,3924,0,0,0,0,0,0,0,5,6,1,64
Pike,8/4/20,0,0,0,0,0,0,0,0,0,84,0,2689,0,65,0,1,0,18,0,2773,0,0,0,0,0,0,0,3,5,0,39
Poinsett,8/4/20,0,0,0,0,0,0,0,0,0,173,0,2522,0,124,0,3,0,46,0,2695,0,0,0,0,0,0,0,6,4,0,24
Polk,8/4/20,0,0,0,0,0,0,0,0,0,132,0,2182,0,116,0,1,0,15,0,2314,0,0,0,0,0,0,0,1,3,0,19
Pope,8/4/20,0,0,0,0,0,0,0,0,0,1241,0,9653,0,1021,0,10,0,210,0,10894,0,0,0,0,0,0,0,25,35,1,120
Prairie,8/4/20,0,0,0,0,0,0,0,0,0,76,0,1009,0,52,0,0,0,24,0,1085,0,0,0,0,0,0,0,2,-1,0,29
Pulaski,8/4/20,0,0,0,0,0,0,0,0,0,5054,0,60987,0,4264,0,79,0,711,0,66041,0,0,0,0,0,0,0,161,92,0,665
Randolph,8/4/20,0,0,0,0,0,0,0,0,0,178,0,2695,0,148,0,3,0,27,0,2873,0,0,0,0,0,0,0,3,12,0,18
Saline,8/4/20,0,0,0,0,0,0,0,0,0,922,0,15032,0,751,0,6,0,165,0,15954,0,0,0,0,0,0,0,30,22,1,209
Scott,8/4/20,0,0,0,0,0,0,0,0,0,45,0,957,0,32,0,0,0,13,0,1002,0,0,0,0,0,0,0,1,1,0,13
Searcy,8/4/20,0,0,0,0,0,0,0,0,0,27,0,1081,0,22,0,0,0,5,0,1108,0,0,0,0,0,0,0,0,0,0,8
Sebastian,8/4/20,0,0,0,0,0,0,0,0,0,1919,0,20349,0,1415,0,15,0,489,0,22268,0,0,0,0,0,0,0,63,58,0,338
Sevier,8/4/20,0,0,0,0,0,0,0,0,0,944,0,4452,0,899,0,10,0,35,0,5396,0,0,0,0,0,0,0,5,5,0,8
Sharp,8/4/20,0,0,0,0,0,0,0,0,0,106,0,1571,0,83,0,5,0,18,0,1677,0,0,0,0,0,0,0,0,0,0,13
St.Francis,8/4/20,0,0,0,0,0,0,0,0,0,1144,0,6441,0,999,0,3,0,142,0,7585,0,0,0,0,0,0,0,4,5,0,32
Stone,8/4/20,0,0,0,0,0,0,0,0,0,59,0,1657,0,40,0,1,0,18,0,1716,0,0,0,0,0,0,0,4,2,0,13
Union,8/4/20,0,0,0,0,0,0,0,0,0,452,0,4171,0,353,0,17,0,82,0,4623,0,0,0,0,0,0,0,17,7,1,45
VanBuren,8/4/20,0,0,0,0,0,0,0,0,0,52,0,1513,0,42,0,2,0,8,0,1565,0,0,0,0,0,0,0,0,0,0,14
Washington,8/4/20,0,0,0,0,0,0,0,0,0,6120,0,23216,0,5611,0,48,0,461,0,29336,0,0,0,0,0,0,0,48,63,1,341
White,8/4/20,0,0,0,0,0,0,0,0,0,271,0,5992,0,220,0,2,0,49,0,6263,0,0,0,0,0,0,0,5,12,0,41
Woodruff,8/4/20,0,0,0,0,0,0,0,0,0,20,0,1012,0,17,0,0,0,3,0,1032,0,0,0,0,0,0,0,0,0,0,2
Yell,8/4/20,0,0,0,0,0,0,0,0,0,1043,0,3610,0,947,0,14,0,82,0,4653,0,0,0,0,0,0,0,13,6,0,31
Arkansas_all_counties,8/3/20,0,0,0,0,0,0,0,0,2990671,44597,0,482803,0,37240,0,475,0,6882,0,527400,0,0,0,0,0,0,0,787,664,11,6357
Arkansas_county,8/3/20,0,0,0,0,0,0,0,0,0,201,0,2621,0,162,0,0,0,39,0,2822,0,0,0,0,0,0,0,2,6,0,23
Ashley,8/3/20,0,0,0,0,0,0,0,0,0,254,0,2567,0,160,0,4,0,90,0,2821,0,0,0,0,0,0,0,5,6,0,55
Baxter,8/3/20,0,0,0,0,0,0,0,0,0,62,0,3222,0,48,0,0,0,14,0,3284,0,0,0,0,0,0,0,1,0,0,31
Benton,8/3/20,0,0,0,0,0,0,0,0,0,4572,0,52174,0,4151,0,39,0,382,0,56746,0,0,0,0,0,0,0,44,52,0,971
Boone,8/3/20,0,0,0,0,0,0,0,0,0,176,0,3903,0,100,0,1,0,75,0,4079,0,0,0,0,0,0,0,6,5,0,79
Bradley,8/3/20,0,0,0,0,0,0,0,0,0,147,0,1817,0,112,0,3,0,32,0,1964,0,0,0,0,0,0,0,5,5,0,31
Calhoun,8/3/20,0,0,0,0,0,0,0,0,0,13,0,504,0,10,0,0,0,3,0,517,0,0,0,0,0,0,0,0,0,0,4
Carroll,8/3/20,0,0,0,0,0,0,0,0,0,340,0,3975,0,301,0,6,0,33,0,4315,0,0,0,0,0,0,0,0,5,0,58
Chicot,8/3/20,0,0,0,0,0,0,0,0,0,536,0,2595,0,278,0,6,0,252,0,3131,0,0,0,0,0,0,0,7,3,0,29
Clark,8/3/20,0,0,0,0,0,0,0,0,0,159,0,2604,0,131,0,0,0,28,0,2763,0,0,0,0,0,0,0,5,4,0,38
Clay,8/3/20,0,0,0,0,0,0,0,0,0,109,0,2236,0,92,0,4,0,13,0,2345,0,0,0,0,0,0,0,2,0,0,29
Cleburne,8/3/20,0,0,0,0,0,0,0,0,0,182,0,3190,0,161,0,5,0,16,0,3372,0,0,0,0,0,0,0,1,5,0,39
Cleveland,8/3/20,0,0,0,0,0,0,0,0,0,71,0,1231,0,52,0,2,0,17,0,1302,0,0,0,0,0,0,0,3,1,0,16
Columbia,8/3/20,0,0,0,0,0,0,0,0,0,202,0,2457,0,155,0,6,0,41,0,2659,0,0,0,0,0,0,0,9,2,0,127
Conway,8/3/20,0,0,0,0,0,0,0,0,0,137,0,2849,0,119,0,3,0,15,0,2986,0,0,0,0,0,0,0,1,0,0,55
Craighead,8/3/20,0,0,0,0,0,0,0,0,0,1134,0,16140,0,951,0,12,0,171,0,17274,0,0,0,0,0,0,0,14,19,1,195
Crawford,8/3/20,0,0,0,0,0,0,0,0,0,554,0,7893,0,418,0,3,0,133,0,8447,0,0,0,0,0,0,0,18,7,0,202
Crittenden,8/3/20,0,0,0,0,0,0,0,0,0,1242,0,7954,0,1074,0,20,0,148,0,9196,0,0,0,0,0,0,0,29,18,0,147
Cross,8/3/20,0,0,0,0,0,0,0,0,0,172,0,2075,0,146,0,2,0,24,0,2247,0,0,0,0,0,0,0,6,4,1,43
Dallas,8/3/20,0,0,0,0,0,0,0,0,0,58,0,794,0,38,0,0,0,20,0,852,0,0,0,0,0,0,0,0,-1,0,6
Desha,8/3/20,0,0,0,0,0,0,0,0,0,160,0,1662,0,124,0,2,0,34,0,1822,0,0,0,0,0,0,0,9,0,0,28
Drew,8/3/20,0,0,0,0,0,0,0,0,0,166,0,2795,0,123,0,2,0,41,0,2961,0,0,0,0,0,0,0,4,1,0,72
Faulkner,8/3/20,0,0,0,0,0,0,0,0,0,1212,0,16569,0,1040,0,5,0,167,0,17781,0,0,0,0,0,0,0,9,16,0,158
Franklin,8/3/20,0,0,0,0,0,0,0,0,0,108,0,2805,0,76,0,2,0,30,0,2913,0,0,0,0,0,0,0,0,8,0,59
Fulton,8/3/20,0,0,0,0,0,0,0,0,0,29,0,1235,0,25,0,0,0,4,0,1264,0,0,0,0,0,0,0,0,1,0,12
Garland,8/3/20,0,0,0,0,0,0,0,0,0,875,0,13028,0,640,0,8,0,227,0,13903,0,0,0,0,0,0,0,32,26,1,275
Grant,8/3/20,0,0,0,0,0,0,0,0,0,127,0,2117,0,99,0,0,0,28,0,2244,0,0,0,0,0,0,0,2,4,0,43
Greene,8/3/20,0,0,0,0,0,0,0,0,0,393,0,6438,0,225,0,1,0,167,0,6831,0,0,0,0,0,0,0,10,8,0,172
Hempstead,8/3/20,0,0,0,0,0,0,0,0,0,220,0,2743,0,172,0,2,0,46,0,2963,0,0,0,0,0,0,0,10,7,0,77
HotSpring,8/3/20,0,0,0,0,0,0,0,0,0,1465,0,5219,0,1379,0,9,0,77,0,6684,0,0,0,0,0,0,0,8,1,1,76
Howard,8/3/20,0,0,0,0,0,0,0,0,0,300,0,2405,0,231,0,2,0,67,0,2705,0,0,0,0,0,0,0,4,8,0,35
Independence,8/3/20,0,0,0,0,0,0,0,0,0,398,0,4407,0,177,0,0,0,221,0,4805,0,0,0,0,0,0,0,31,15,0,118
Izard,8/3/20,0,0,0,0,0,0,0,0,0,45,0,1341,0,31,0,1,0,13,0,1386,0,0,0,0,0,0,0,1,1,0,22
Jackson,8/3/20,0,0,0,0,0,0,0,0,0,59,0,1773,0,47,0,1,0,11,0,1832,0,0,0,0,0,0,0,1,1,0,26
Jefferson,8/3/20,0,0,0,0,0,0,0,0,0,1382,0,12599,0,1100,0,39,0,243,0,13981,0,0,0,0,0,0,0,25,14,1,230
Johnson,8/3/20,0,0,0,0,0,0,0,0,0,636,0,2815,0,567,0,0,0,69,0,3451,0,0,0,0,0,0,0,5,19,0,19
Lafayette,8/3/20,0,0,0,0,0,0,0,0,0,49,0,536,0,41,0,2,0,6,0,585,0,0,0,0,0,0,0,0,1,0,5
Lawrence,8/3/20,0,0,0,0,0,0,0,0,0,185,0,2187,0,154,0,10,0,21,0,2372,0,0,0,0,0,0,0,0,2,0,25
Lee,8/3/20,0,0,0,0,0,0,0,0,0,890,0,2783,0,865,0,7,0,18,0,3673,0,0,0,0,0,0,0,5,1,1,42
Lincoln,8/3/20,0,0,0,0,0,0,0,0,0,1186,0,2562,0,1127,0,11,0,48,0,3748,0,0,0,0,0,0,0,4,7,0,31
LittleRiver,8/3/20,0,0,0,0,0,0,0,0,0,156,0,1193,0,85,0,1,0,70,0,1349,0,0,0,0,0,0,0,3,4,0,10
Logan,8/3/20,0,0,0,0,0,0,0,0,0,195,0,3328,0,119,0,1,0,75,0,3523,0,0,0,0,0,0,0,37,2,0,174
Lonoke,8/3/20,0,0,0,0,0,0,0,0,0,452,0,7453,0,331,0,2,0,119,0,7905,0,0,0,0,0,0,0,19,6,0,149
Madison,8/3/20,0,0,0,0,0,0,0,0,0,262,0,2447,0,243,0,1,0,18,0,2709,0,0,0,0,0,0,0,3,0,0,32
Marion,8/3/20,0,0,0,0,0,0,0,0,0,23,0,1235,0,18,0,0,0,5,0,1258,0,0,0,0,0,0,0,0,1,0,6
Miller,8/3/20,0,0,0,0,0,0,0,0,0,470,0,3956,0,398,0,4,0,68,0,4426,0,0,0,0,0,0,0,8,10,0,55
MissingCountyInfo,8/3/20,0,0,0,0,0,0,0,0,0,1641,0,62702,0,1158,0,0,0,483,0,64343,0,0,0,0,0,0,0,63,52,0,357
Mississippi,8/3/20,0,0,0,0,0,0,0,0,0,797,0,6336,0,557,0,11,0,229,0,7133,0,0,0,0,0,0,0,22,23,1,133
Monroe,8/3/20,0,0,0,0,0,0,0,0,0,53,0,1230,0,38,0,0,0,15,0,1283,0,0,0,0,0,0,0,1,1,0,16
Montgomery,8/3/20,0,0,0,0,0,0,0,0,0,26,0,848,0,22,0,0,0,4,0,874,0,0,0,0,0,0,0,1,3,0,15
Nevada,8/3/20,0,0,0,0,0,0,0,0,0,133,0,1535,0,115,0,9,0,9,0,1668,0,0,0,0,0,0,0,3,2,0,21
Newton,8/3/20,0,0,0,0,0,0,0,0,0,98,0,810,0,22,0,3,0,73,0,908,0,0,0,0,0,0,0,4,1,0,23
Ouachita,8/3/20,0,0,0,0,0,0,0,0,0,81,0,2799,0,61,0,1,0,19,0,2880,0,0,0,0,0,0,0,4,1,0,41
Perry,8/3/20,0,0,0,0,0,0,0,0,0,49,0,1375,0,47,0,0,0,2,0,1424,0,0,0,0,0,0,0,0,0,0,13
Phillips,8/3/20,0,0,0,0,0,0,0,0,0,284,0,3576,0,234,0,6,0,44,0,3860,0,0,0,0,0,0,0,2,2,0,23
Pike,8/3/20,0,0,0,0,0,0,0,0,0,81,0,2653,0,60,0,1,0,20,0,2734,0,0,0,0,0,0,0,3,1,0,27
Poinsett,8/3/20,0,0,0,0,0,0,0,0,0,167,0,2504,0,120,0,3,0,44,0,2671,0,0,0,0,0,0,0,8,5,0,33
Polk,8/3/20,0,0,0,0,0,0,0,0,0,131,0,2164,0,113,0,1,0,17,0,2295,0,0,0,0,0,0,0,3,2,0,30
Pope,8/3/20,0,0,0,0,0,0,0,0,0,1216,0,9558,0,986,0,9,0,221,0,10774,0,0,0,0,0,0,0,14,24,0,122
Prairie,8/3/20,0,0,0,0,0,0,0,0,0,74,0,982,0,53,0,0,0,21,0,1056,0,0,0,0,0,0,0,8,0,0,47
Pulaski,8/3/20,0,0,0,0,0,0,0,0,0,4893,0,60483,0,4172,0,79,0,642,0,65376,0,0,0,0,0,0,0,55,83,1,673
Randolph,8/3/20,0,0,0,0,0,0,0,0,0,175,0,2680,0,136,0,3,0,36,0,2855,0,0,0,0,0,0,0,2,2,1,56
Saline,8/3/20,0,0,0,0,0,0,0,0,0,892,0,14853,0,729,0,5,0,158,0,15745,0,0,0,0,0,0,0,13,21,1,187
Scott,8/3/20,0,0,0,0,0,0,0,0,0,44,0,945,0,31,0,0,0,13,0,989,0,0,0,0,0,0,0,2,3,0,24
Searcy,8/3/20,0,0,0,0,0,0,0,0,0,27,0,1073,0,22,0,0,0,5,0,1100,0,0,0,0,0,0,0,2,0,0,13
Sebastian,8/3/20,0,0,0,0,0,0,0,0,0,1856,0,20074,0,1357,0,15,0,484,0,21930,0,0,0,0,0,0,0,88,39,0,724
Sevier,8/3/20,0,0,0,0,0,0,0,0,0,939,0,4449,0,894,0,10,0,35,0,5388,0,0,0,0,0,0,0,4,3,0,44
Sharp,8/3/20,0,0,0,0,0,0,0,0,0,106,0,1558,0,83,0,5,0,18,0,1664,0,0,0,0,0,0,0,2,5,0,27
St.Francis,8/3/20,0,0,0,0,0,0,0,0,0,1140,0,6413,0,994,0,3,0,143,0,7553,0,0,0,0,0,0,0,9,7,0,183
Stone,8/3/20,0,0,0,0,0,0,0,0,0,55,0,1648,0,38,0,1,0,16,0,1703,0,0,0,0,0,0,0,2,1,0,18
Union,8/3/20,0,0,0,0,0,0,0,0,0,435,0,4143,0,346,0,16,0,73,0,4578,0,0,0,0,0,0,0,2,3,0,39
VanBuren,8/3/20,0,0,0,0,0,0,0,0,0,52,0,1499,0,42,0,2,0,8,0,1551,0,0,0,0,0,0,0,2,1,0,10
Washington,8/3/20,0,0,0,0,0,0,0,0,0,6072,0,22923,0,5548,0,47,0,477,0,28995,0,0,0,0,0,0,0,67,59,1,533
White,8/3/20,0,0,0,0,0,0,0,0,0,266,0,5956,0,208,0,2,0,56,0,6222,0,0,0,0,0,0,0,4,9,0,57
Woodruff,8/3/20,0,0,0,0,0,0,0,0,0,20,0,1010,0,17,0,0,0,3,0,1030,0,0,0,0,0,0,0,1,0,0,21
Yell,8/3/20,0,0,0,0,0,0,0,0,0,1030,0,3592,0,941,0,14,0,75,0,4622,0,0,0,0,0,0,0,8,6,0,20
Arkansas_all_counties,8/2/20,0,0,0,0,0,0,0,0,2990671,43810,0,475931,0,36576,0,464,0,6770,0,519741,0,0,0,0,0,0,0,637,542,6,5160
Arkansas_county,8/2/20,0,0,0,0,0,0,0,0,0,199,0,2600,0,156,0,0,0,43,0,2799,0,0,0,0,0,0,0,5,2,0,122
Ashley,8/2/20,0,0,0,0,0,0,0,0,0,249,0,2517,0,154,0,4,0,91,0,2766,0,0,0,0,0,0,0,11,0,0,38
Baxter,8/2/20,0,0,0,0,0,0,0,0,0,61,0,3192,0,48,0,0,0,13,0,3253,0,0,0,0,0,0,0,1,1,0,33
Benton,8/2/20,0,0,0,0,0,0,0,0,0,4528,0,51247,0,4099,0,39,0,390,0,55775,0,0,0,0,0,0,0,33,38,0,465
Boone,8/2/20,0,0,0,0,0,0,0,0,0,170,0,3830,0,95,0,1,0,74,0,4000,0,0,0,0,0,0,0,8,6,0,74
Bradley,8/2/20,0,0,0,0,0,0,0,0,0,142,0,1791,0,107,0,3,0,32,0,1933,0,0,0,0,0,0,0,0,1,0,25
Calhoun,8/2/20,0,0,0,0,0,0,0,0,0,13,0,500,0,10,0,0,0,3,0,513,0,0,0,0,0,0,0,0,1,0,6
Carroll,8/2/20,0,0,0,0,0,0,0,0,0,340,0,3917,0,296,0,6,0,38,0,4257,0,0,0,0,0,0,0,3,11,0,49
Chicot,8/2/20,0,0,0,0,0,0,0,0,0,529,0,2573,0,275,0,6,0,248,0,3102,0,0,0,0,0,0,0,7,9,0,28
Clark,8/2/20,0,0,0,0,0,0,0,0,0,154,0,2571,0,127,0,0,0,27,0,2725,0,0,0,0,0,0,0,2,4,0,29
Clay,8/2/20,0,0,0,0,0,0,0,0,0,107,0,2209,0,92,0,4,0,11,0,2316,0,0,0,0,0,0,0,2,1,0,28
Cleburne,8/2/20,0,0,0,0,0,0,0,0,0,181,0,3152,0,156,0,5,0,20,0,3333,0,0,0,0,0,0,0,2,1,0,37
Cleveland,8/2/20,0,0,0,0,0,0,0,0,0,68,0,1218,0,51,0,2,0,15,0,1286,0,0,0,0,0,0,0,1,2,0,42
Columbia,8/2/20,0,0,0,0,0,0,0,0,0,193,0,2339,0,153,0,6,0,34,0,2532,0,0,0,0,0,0,0,7,1,0,51
Conway,8/2/20,0,0,0,0,0,0,0,0,0,136,0,2795,0,119,0,3,0,14,0,2931,0,0,0,0,0,0,0,2,1,0,51
Craighead,8/2/20,0,0,0,0,0,0,0,0,0,1120,0,15959,0,932,0,11,0,177,0,17079,0,0,0,0,0,0,0,16,22,0,136
Crawford,8/2/20,0,0,0,0,0,0,0,0,0,536,0,7709,0,411,0,3,0,122,0,8245,0,0,0,0,0,0,0,14,10,0,106
Crittenden,8/2/20,0,0,0,0,0,0,0,0,0,1213,0,7836,0,1056,0,20,0,137,0,9049,0,0,0,0,0,0,0,22,8,2,124
Cross,8/2/20,0,0,0,0,0,0,0,0,0,166,0,2038,0,142,0,1,0,23,0,2204,0,0,0,0,0,0,0,4,4,0,23
Dallas,8/2/20,0,0,0,0,0,0,0,0,0,58,0,788,0,39,0,0,0,19,0,846,0,0,0,0,0,0,0,2,1,0,17
Desha,8/2/20,0,0,0,0,0,0,0,0,0,151,0,1643,0,124,0,2,0,25,0,1794,0,0,0,0,0,0,0,7,7,0,54
Drew,8/2/20,0,0,0,0,0,0,0,0,0,162,0,2727,0,122,0,2,0,38,0,2889,0,0,0,0,0,0,0,7,3,0,56
Faulkner,8/2/20,0,0,0,0,0,0,0,0,0,1203,0,16420,0,1024,0,5,0,174,0,17623,0,0,0,0,0,0,0,13,8,0,150
Franklin,8/2/20,0,0,0,0,0,0,0,0,0,108,0,2746,0,68,0,2,0,38,0,2854,0,0,0,0,0,0,0,3,5,0,54
Fulton,8/2/20,0,0,0,0,0,0,0,0,0,29,0,1223,0,24,0,0,0,5,0,1252,0,0,0,0,0,0,0,2,0,0,12
Garland,8/2/20,0,0,0,0,0,0,0,0,0,843,0,12785,0,614,0,7,0,222,0,13628,0,0,0,0,0,0,0,6,24,0,142
Grant,8/2/20,0,0,0,0,0,0,0,0,0,125,0,2076,0,95,0,0,0,30,0,2201,0,0,0,0,0,0,0,1,4,0,21
Greene,8/2/20,0,0,0,0,0,0,0,0,0,383,0,6276,0,217,0,1,0,165,0,6659,0,0,0,0,0,0,0,24,4,0,157
Hempstead,8/2/20,0,0,0,0,0,0,0,0,0,210,0,2676,0,165,0,2,0,43,0,2886,0,0,0,0,0,0,0,3,6,0,27
HotSpring,8/2/20,0,0,0,0,0,0,0,0,0,1457,0,5151,0,1378,0,8,0,71,0,6608,0,0,0,0,0,0,0,6,8,0,77
Howard,8/2/20,0,0,0,0,0,0,0,0,0,296,0,2374,0,223,0,2,0,71,0,2670,0,0,0,0,0,0,0,2,4,0,13
Independence,8/2/20,0,0,0,0,0,0,0,0,0,367,0,4320,0,162,0,0,0,205,0,4687,0,0,0,0,0,0,0,22,8,0,83
Izard,8/2/20,0,0,0,0,0,0,0,0,0,44,0,1320,0,30,0,1,0,13,0,1364,0,0,0,0,0,0,0,0,0,0,7
Jackson,8/2/20,0,0,0,0,0,0,0,0,0,58,0,1748,0,46,0,1,0,11,0,1806,0,0,0,0,0,0,0,0,3,0,17
Jefferson,8/2/20,0,0,0,0,0,0,0,0,0,1357,0,12394,0,1086,0,38,0,233,0,13751,0,0,0,0,0,0,0,42,30,0,187
Johnson,8/2/20,0,0,0,0,0,0,0,0,0,631,0,2801,0,548,0,0,0,83,0,3432,0,0,0,0,0,0,0,14,4,0,52
Lafayette,8/2/20,0,0,0,0,0,0,0,0,0,49,0,531,0,40,0,2,0,7,0,580,0,0,0,0,0,0,0,0,0,0,6
Lawrence,8/2/20,0,0,0,0,0,0,0,0,0,185,0,2162,0,152,0,10,0,23,0,2347,0,0,0,0,0,0,0,3,3,1,31
Lee,8/2/20,0,0,0,0,0,0,0,0,0,885,0,2746,0,864,0,6,0,15,0,3631,0,0,0,0,0,0,0,0,3,0,17
Lincoln,8/2/20,0,0,0,0,0,0,0,0,0,1182,0,2535,0,1120,0,11,0,51,0,3717,0,0,0,0,0,0,0,14,5,0,42
LittleRiver,8/2/20,0,0,0,0,0,0,0,0,0,153,0,1186,0,81,0,1,0,71,0,1339,0,0,0,0,0,0,0,1,6,0,5
Logan,8/2/20,0,0,0,0,0,0,0,0,0,158,0,3191,0,117,0,1,0,40,0,3349,0,0,0,0,0,0,0,17,0,1,43
Lonoke,8/2/20,0,0,0,0,0,0,0,0,0,433,0,7323,0,325,0,2,0,106,0,7756,0,0,0,0,0,0,0,17,4,0,82
Madison,8/2/20,0,0,0,0,0,0,0,0,0,259,0,2418,0,243,0,1,0,15,0,2677,0,0,0,0,0,0,0,5,1,0,15
Marion,8/2/20,0,0,0,0,0,0,0,0,0,23,0,1229,0,17,0,0,0,6,0,1252,0,0,0,0,0,0,0,0,0,0,11
Miller,8/2/20,0,0,0,0,0,0,0,0,0,462,0,3909,0,388,0,4,0,70,0,4371,0,0,0,0,0,0,0,5,4,0,42
MissingCountyInfo,8/2/20,0,0,0,0,0,0,0,0,0,1578,0,62408,0,1106,0,0,0,472,0,63986,0,0,0,0,0,0,0,23,15,0,187
Mississippi,8/2/20,0,0,0,0,0,0,0,0,0,775,0,6225,0,534,0,10,0,231,0,7000,0,0,0,0,0,0,0,23,24,0,110
Monroe,8/2/20,0,0,0,0,0,0,0,0,0,52,0,1215,0,37,0,0,0,15,0,1267,0,0,0,0,0,0,0,1,1,0,14
Montgomery,8/2/20,0,0,0,0,0,0,0,0,0,25,0,834,0,19,0,0,0,6,0,859,0,0,0,0,0,0,0,0,0,0,5
Nevada,8/2/20,0,0,0,0,0,0,0,0,0,130,0,1517,0,113,0,9,0,8,0,1647,0,0,0,0,0,0,0,1,0,0,8
Newton,8/2/20,0,0,0,0,0,0,0,0,0,94,0,791,0,21,0,3,0,70,0,885,0,0,0,0,0,0,0,1,2,0,13
Ouachita,8/2/20,0,0,0,0,0,0,0,0,0,77,0,2762,0,60,0,1,0,16,0,2839,0,0,0,0,0,0,0,1,2,0,15
Perry,8/2/20,0,0,0,0,0,0,0,0,0,49,0,1362,0,47,0,0,0,2,0,1411,0,0,0,0,0,0,0,0,0,0,10
Phillips,8/2/20,0,0,0,0,0,0,0,0,0,282,0,3555,0,232,0,6,0,44,0,3837,0,0,0,0,0,0,0,9,6,0,57
Pike,8/2/20,0,0,0,0,0,0,0,0,0,78,0,2629,0,59,0,1,0,18,0,2707,0,0,0,0,0,0,0,1,1,0,18
Poinsett,8/2/20,0,0,0,0,0,0,0,0,0,159,0,2479,0,115,0,3,0,41,0,2638,0,0,0,0,0,0,0,3,5,0,37
Polk,8/2/20,0,0,0,0,0,0,0,0,0,128,0,2137,0,111,0,1,0,16,0,2265,0,0,0,0,0,0,0,0,2,0,36
Pope,8/2/20,0,0,0,0,0,0,0,0,0,1202,0,9450,0,962,0,9,0,231,0,10652,0,0,0,0,0,0,0,28,27,0,171
Prairie,8/2/20,0,0,0,0,0,0,0,0,0,66,0,943,0,53,0,0,0,13,0,1009,0,0,0,0,0,0,0,3,1,0,15
Pulaski,8/2/20,0,0,0,0,0,0,0,0,0,4838,0,59865,0,4089,0,78,0,671,0,64703,0,0,0,0,0,0,0,35,41,1,468
Randolph,8/2/20,0,0,0,0,0,0,0,0,0,173,0,2626,0,134,0,2,0,37,0,2799,0,0,0,0,0,0,0,3,4,0,32
Saline,8/2/20,0,0,0,0,0,0,0,0,0,879,0,14679,0,708,0,4,0,167,0,15558,0,0,0,0,0,0,0,11,17,0,131
Scott,8/2/20,0,0,0,0,0,0,0,0,0,42,0,923,0,28,0,0,0,14,0,965,0,0,0,0,0,0,0,1,0,0,17
Searcy,8/2/20,0,0,0,0,0,0,0,0,0,25,0,1062,0,22,0,0,0,3,0,1087,0,0,0,0,0,0,0,0,0,0,14
Sebastian,8/2/20,0,0,0,0,0,0,0,0,0,1768,0,19438,0,1318,0,15,0,435,0,21206,0,0,0,0,0,0,0,44,41,1,306
Sevier,8/2/20,0,0,0,0,0,0,0,0,0,935,0,4409,0,891,0,10,0,34,0,5344,0,0,0,0,0,0,0,2,5,0,10
Sharp,8/2/20,0,0,0,0,0,0,0,0,0,104,0,1533,0,78,0,5,0,21,0,1637,0,0,0,0,0,0,0,2,2,0,17
St.Francis,8/2/20,0,0,0,0,0,0,0,0,0,1131,0,6239,0,987,0,3,0,141,0,7370,0,0,0,0,0,0,0,14,10,0,104
Stone,8/2/20,0,0,0,0,0,0,0,0,0,53,0,1632,0,37,0,1,0,15,0,1685,0,0,0,0,0,0,0,1,0,0,15
Union,8/2/20,0,0,0,0,0,0,0,0,0,433,0,4106,0,343,0,16,0,74,0,4539,0,0,0,0,0,0,0,3,5,0,52
VanBuren,8/2/20,0,0,0,0,0,0,0,0,0,50,0,1491,0,41,0,2,0,7,0,1541,0,0,0,0,0,0,0,0,2,0,5
Washington,8/2/20,0,0,0,0,0,0,0,0,0,6005,0,22457,0,5489,0,46,0,470,0,28462,0,0,0,0,0,0,0,53,46,0,305
White,8/2/20,0,0,0,0,0,0,0,0,0,262,0,5903,0,199,0,2,0,61,0,6165,0,0,0,0,0,0,0,8,7,0,58
Woodruff,8/2/20,0,0,0,0,0,0,0,0,0,19,0,990,0,17,0,0,0,2,0,1009,0,0,0,0,0,0,0,0,0,0,7
Yell,8/2/20,0,0,0,0,0,0,0,0,0,1022,0,3580,0,935,0,14,0,73,0,4602,0,0,0,0,0,0,0,10,8,0,36
Arkansas_all_counties,8/1/20,0,0,0,0,0,0,0,0,2990671,43173,0,471408,0,36034,0,458,0,6681,0,514581,0,0,0,0,0,0,0,662,621,5,5731
Arkansas_county,8/1/20,0,0,0,0,0,0,0,0,0,194,0,2483,0,154,0,0,0,40,0,2677,0,0,0,0,0,0,0,5,9,-1,67
Ashley,8/1/20,0,0,0,0,0,0,0,0,0,238,0,2490,0,154,0,4,0,80,0,2728,0,0,0,0,0,0,0,8,8,0,42
Baxter,8/1/20,0,0,0,0,0,0,0,0,0,60,0,3160,0,47,0,0,0,13,0,3220,0,0,0,0,0,0,0,-2,-2,0,12
Benton,8/1/20,0,0,0,0,0,0,0,0,0,4495,0,50815,0,4061,0,39,0,395,0,55310,0,0,0,0,0,0,0,37,40,1,295
Boone,8/1/20,0,0,0,0,0,0,0,0,0,162,0,3764,0,89,0,1,0,72,0,3926,0,0,0,0,0,0,0,5,1,0,153
Bradley,8/1/20,0,0,0,0,0,0,0,0,0,142,0,1766,0,106,0,3,0,33,0,1908,0,0,0,0,0,0,0,4,1,0,22
Calhoun,8/1/20,0,0,0,0,0,0,0,0,0,13,0,494,0,9,0,0,0,4,0,507,0,0,0,0,0,0,0,1,0,0,8
Carroll,8/1/20,0,0,0,0,0,0,0,0,0,337,0,3871,0,285,0,6,0,46,0,4208,0,0,0,0,0,0,0,6,7,0,41
Chicot,8/1/20,0,0,0,0,0,0,0,0,0,522,0,2552,0,266,0,6,0,250,0,3074,0,0,0,0,0,0,0,16,6,0,104
Clark,8/1/20,0,0,0,0,0,0,0,0,0,152,0,2544,0,123,0,0,0,29,0,2696,0,0,0,0,0,0,0,0,4,0,10
Clay,8/1/20,0,0,0,0,0,0,0,0,0,105,0,2183,0,91,0,4,0,10,0,2288,0,0,0,0,0,0,0,3,1,0,28
Cleburne,8/1/20,0,0,0,0,0,0,0,0,0,179,0,3117,0,155,0,5,0,19,0,3296,0,0,0,0,0,0,0,1,0,0,40
Cleveland,8/1/20,0,0,0,0,0,0,0,0,0,67,0,1177,0,49,0,2,0,16,0,1244,0,0,0,0,0,0,0,4,0,1,113
Columbia,8/1/20,0,0,0,0,0,0,0,0,0,186,0,2295,0,152,0,6,0,28,0,2481,0,0,0,0,0,0,0,2,3,0,11
Conway,8/1/20,0,0,0,0,0,0,0,0,0,134,0,2746,0,118,0,3,0,13,0,2880,0,0,0,0,0,0,0,0,0,0,28
Craighead,8/1/20,0,0,0,0,0,0,0,0,0,1104,0,15839,0,910,0,11,0,183,0,16943,0,0,0,0,0,0,0,16,22,0,157
Crawford,8/1/20,0,0,0,0,0,0,0,0,0,522,0,7617,0,401,0,3,0,118,0,8139,0,0,0,0,0,0,0,8,4,0,133
Crittenden,8/1/20,0,0,0,0,0,0,0,0,0,1191,0,7734,0,1048,0,18,0,125,0,8925,0,0,0,0,0,0,0,19,9,1,99
Cross,8/1/20,0,0,0,0,0,0,0,0,0,162,0,2019,0,138,0,1,0,23,0,2181,0,0,0,0,0,0,0,5,3,0,13
Dallas,8/1/20,0,0,0,0,0,0,0,0,0,56,0,773,0,38,0,0,0,18,0,829,0,0,0,0,0,0,0,0,0,0,13
Desha,8/1/20,0,0,0,0,0,0,0,0,0,144,0,1596,0,117,0,2,0,25,0,1740,0,0,0,0,0,0,0,2,4,0,18
Drew,8/1/20,0,0,0,0,0,0,0,0,0,155,0,2678,0,119,0,2,0,34,0,2833,0,0,0,0,0,0,0,0,2,0,11
Faulkner,8/1/20,0,0,0,0,0,0,0,0,0,1190,0,16283,0,1016,0,5,0,169,0,17473,0,0,0,0,0,0,0,15,24,0,234
Franklin,8/1/20,0,0,0,0,0,0,0,0,0,105,0,2695,0,63,0,2,0,40,0,2800,0,0,0,0,0,0,0,1,9,0,55
Fulton,8/1/20,0,0,0,0,0,0,0,0,0,27,0,1213,0,24,0,0,0,3,0,1240,0,0,0,0,0,0,0,0,3,0,7
Garland,8/1/20,0,0,0,0,0,0,0,0,0,837,0,12649,0,590,0,7,0,240,0,13486,0,0,0,0,0,0,0,23,27,0,159
Grant,8/1/20,0,0,0,0,0,0,0,0,0,124,0,2056,0,91,0,0,0,33,0,2180,0,0,0,0,0,0,0,0,4,0,24
Greene,8/1/20,0,0,0,0,0,0,0,0,0,359,0,6143,0,213,0,1,0,145,0,6502,0,0,0,0,0,0,0,66,8,0,341
Hempstead,8/1/20,0,0,0,0,0,0,0,0,0,207,0,2652,0,159,0,2,0,46,0,2859,0,0,0,0,0,0,0,7,11,0,35
HotSpring,8/1/20,0,0,0,0,0,0,0,0,0,1451,0,5080,0,1370,0,8,0,73,0,6531,0,0,0,0,0,0,0,15,3,0,63
Howard,8/1/20,0,0,0,0,0,0,0,0,0,294,0,2363,0,219,0,2,0,73,0,2657,0,0,0,0,0,0,0,3,3,0,14
Independence,8/1/20,0,0,0,0,0,0,0,0,0,345,0,4259,0,154,0,0,0,191,0,4604,0,0,0,0,0,0,0,14,8,0,45
Izard,8/1/20,0,0,0,0,0,0,0,0,0,44,0,1313,0,30,0,1,0,13,0,1357,0,0,0,0,0,0,0,1,0,0,4
Jackson,8/1/20,0,0,0,0,0,0,0,0,0,58,0,1731,0,43,0,1,0,14,0,1789,0,0,0,0,0,0,0,1,0,0,16
Jefferson,8/1/20,0,0,0,0,0,0,0,0,0,1315,0,12249,0,1056,0,38,0,221,0,13564,0,0,0,0,0,0,0,22,39,1,241
Johnson,8/1/20,0,0,0,0,0,0,0,0,0,617,0,2763,0,544,0,0,0,73,0,3380,0,0,0,0,0,0,0,5,9,0,36
Lafayette,8/1/20,0,0,0,0,0,0,0,0,0,49,0,525,0,40,0,2,0,7,0,574,0,0,0,0,0,0,0,1,1,0,7
Lawrence,8/1/20,0,0,0,0,0,0,0,0,0,182,0,2134,0,149,0,9,0,24,0,2316,0,0,0,0,0,0,0,3,0,0,17
Lee,8/1/20,0,0,0,0,0,0,0,0,0,885,0,2729,0,861,0,6,0,18,0,3614,0,0,0,0,0,0,0,3,0,0,23
Lincoln,8/1/20,0,0,0,0,0,0,0,0,0,1168,0,2507,0,1115,0,11,0,42,0,3675,0,0,0,0,0,0,0,3,1,0,29
LittleRiver,8/1/20,0,0,0,0,0,0,0,0,0,152,0,1182,0,75,0,1,0,76,0,1334,0,0,0,0,0,0,0,3,2,0,12
Logan,8/1/20,0,0,0,0,0,0,0,0,0,141,0,3165,0,117,0,0,0,24,0,3306,0,0,0,0,0,0,0,2,1,0,19
Lonoke,8/1/20,0,0,0,0,0,0,0,0,0,416,0,7258,0,321,0,2,0,93,0,7674,0,0,0,0,0,0,0,11,17,0,84
Madison,8/1/20,0,0,0,0,0,0,0,0,0,254,0,2408,0,242,0,1,0,11,0,2662,0,0,0,0,0,0,0,1,5,0,8
Marion,8/1/20,0,0,0,0,0,0,0,0,0,23,0,1218,0,17,0,0,0,6,0,1241,0,0,0,0,0,0,0,0,0,0,6
Miller,8/1/20,0,0,0,0,0,0,0,0,0,457,0,3872,0,384,0,4,0,69,0,4329,0,0,0,0,0,0,0,6,5,0,113
MissingCountyInfo,8/1/20,0,0,0,0,0,0,0,0,0,1555,0,62244,0,1091,0,0,0,464,0,63799,0,0,0,0,0,0,0,1,24,0,193
Mississippi,8/1/20,0,0,0,0,0,0,0,0,0,752,0,6138,0,510,0,10,0,232,0,6890,0,0,0,0,0,0,0,75,22,1,249
Monroe,8/1/20,0,0,0,0,0,0,0,0,0,51,0,1202,0,36,0,0,0,15,0,1253,0,0,0,0,0,0,0,2,1,0,22
Montgomery,8/1/20,0,0,0,0,0,0,0,0,0,25,0,829,0,19,0,0,0,6,0,854,0,0,0,0,0,0,0,0,0,0,4
Nevada,8/1/20,0,0,0,0,0,0,0,0,0,129,0,1510,0,113,0,9,0,7,0,1639,0,0,0,0,0,0,0,0,0,0,8
Newton,8/1/20,0,0,0,0,0,0,0,0,0,93,0,779,0,19,0,3,0,71,0,872,0,0,0,0,0,0,0,2,0,0,11
Ouachita,8/1/20,0,0,0,0,0,0,0,0,0,76,0,2748,0,58,0,1,0,17,0,2824,0,0,0,0,0,0,0,1,4,0,29
Perry,8/1/20,0,0,0,0,0,0,0,0,0,49,0,1352,0,47,0,0,0,2,0,1401,0,0,0,0,0,0,0,0,2,0,14
Phillips,8/1/20,0,0,0,0,0,0,0,0,0,273,0,3507,0,226,0,6,0,41,0,3780,0,0,0,0,0,0,0,3,2,0,31
Pike,8/1/20,0,0,0,0,0,0,0,0,0,77,0,2612,0,58,0,1,0,18,0,2689,0,0,0,0,0,0,0,0,3,0,18
Poinsett,8/1/20,0,0,0,0,0,0,0,0,0,156,0,2445,0,110,0,3,0,43,0,2601,0,0,0,0,0,0,0,5,3,0,43
Polk,8/1/20,0,0,0,0,0,0,0,0,0,128,0,2101,0,109,0,1,0,18,0,2229,0,0,0,0,0,0,0,3,2,0,27
Pope,8/1/20,0,0,0,0,0,0,0,0,0,1174,0,9307,0,935,0,9,0,230,0,10481,0,0,0,0,0,0,0,13,15,0,87
Prairie,8/1/20,0,0,0,0,0,0,0,0,0,63,0,931,0,52,0,0,0,11,0,994,0,0,0,0,0,0,0,4,2,0,15
Pulaski,8/1/20,0,0,0,0,0,0,0,0,0,4803,0,59432,0,4048,0,77,0,678,0,64235,0,0,0,0,0,0,0,70,101,0,757
Randolph,8/1/20,0,0,0,0,0,0,0,0,0,170,0,2597,0,130,0,2,0,38,0,2767,0,0,0,0,0,0,0,6,10,0,21
Saline,8/1/20,0,0,0,0,0,0,0,0,0,868,0,14559,0,691,0,4,0,173,0,15427,0,0,0,0,0,0,0,13,13,0,245
Scott,8/1/20,0,0,0,0,0,0,0,0,0,41,0,907,0,28,0,0,0,13,0,948,0,0,0,0,0,0,0,0,0,0,7
Searcy,8/1/20,0,0,0,0,0,0,0,0,0,25,0,1048,0,22,0,0,0,3,0,1073,0,0,0,0,0,0,0,0,0,0,6
Sebastian,8/1/20,0,0,0,0,0,0,0,0,0,1724,0,19176,0,1277,0,14,0,433,0,20900,0,0,0,0,0,0,0,35,37,0,304
Sevier,8/1/20,0,0,0,0,0,0,0,0,0,933,0,4401,0,886,0,10,0,37,0,5334,0,0,0,0,0,0,0,4,11,0,21
Sharp,8/1/20,0,0,0,0,0,0,0,0,0,102,0,1518,0,76,0,5,0,21,0,1620,0,0,0,0,0,0,0,3,0,0,15
St.Francis,8/1/20,0,0,0,0,0,0,0,0,0,1117,0,6149,0,977,0,3,0,137,0,7266,0,0,0,0,0,0,0,5,6,0,50
Stone,8/1/20,0,0,0,0,0,0,0,0,0,52,0,1618,0,37,0,1,0,14,0,1670,0,0,0,0,0,0,0,0,0,0,1
Union,8/1/20,0,0,0,0,0,0,0,0,0,430,0,4057,0,338,0,16,0,76,0,4487,0,0,0,0,0,0,0,2,4,0,21
VanBuren,8/1/20,0,0,0,0,0,0,0,0,0,50,0,1486,0,39,0,2,0,9,0,1536,0,0,0,0,0,0,0,0,0,0,12
Washington,8/1/20,0,0,0,0,0,0,0,0,0,5952,0,22205,0,5443,0,46,0,463,0,28157,0,0,0,0,0,0,0,56,47,1,243
White,8/1/20,0,0,0,0,0,0,0,0,0,254,0,5853,0,192,0,2,0,60,0,6107,0,0,0,0,0,0,0,4,8,0,55
Woodruff,8/1/20,0,0,0,0,0,0,0,0,0,19,0,983,0,17,0,0,0,2,0,1002,0,0,0,0,0,0,0,1,0,0,4
Yell,8/1/20,0,0,0,0,0,0,0,0,0,1012,0,3554,0,927,0,14,0,71,0,4566,0,0,0,0,0,0,0,8,2,0,30
Arkansas_all_counties,7/31/20,0,0,0,0,0,0,0,0,2990671,42511,0,NA,0,35413,0,453,0,6645,0,NA,0,0,0,0,0,0,0,752,676,11,7207
Arkansas_county,7/31/20,0,0,0,0,0,0,0,0,0,189,0,2421,0,145,0,1,0,43,0,2610,0,0,0,0,0,0,0,6,7,0,85
Ashley,7/31/20,0,0,0,0,0,0,0,0,0,230,0,2456,0,146,0,4,0,80,0,2686,0,0,0,0,0,0,0,16,8,0,74
Baxter,7/31/20,0,0,0,0,0,0,0,0,0,62,0,3146,0,49,0,0,0,13,0,3208,0,0,0,0,0,0,0,1,4,0,25
Benton,7/31/20,0,0,0,0,0,0,0,0,0,4458,0,50557,0,4021,0,38,0,399,0,55015,0,0,0,0,0,0,0,50,46,3,510
Boone,7/31/20,0,0,0,0,0,0,0,0,0,157,0,3616,0,88,0,1,0,68,0,3773,0,0,0,0,0,0,0,15,3,0,42
Bradley,7/31/20,0,0,0,0,0,0,0,0,0,138,0,1748,0,105,0,3,0,30,0,1886,0,0,0,0,0,0,0,4,6,0,26
Calhoun,7/31/20,0,0,0,0,0,0,0,0,0,12,0,487,0,9,0,0,0,3,0,499,0,0,0,0,0,0,0,0,1,0,5
Carroll,7/31/20,0,0,0,0,0,0,0,0,0,331,0,3836,0,278,0,6,0,47,0,4167,0,0,0,0,0,0,0,0,8,0,40
Chicot,7/31/20,0,0,0,0,0,0,0,0,0,506,0,2464,0,260,0,6,0,240,0,2970,0,0,0,0,0,0,0,8,4,1,18
Clark,7/31/20,0,0,0,0,0,0,0,0,0,152,0,2534,0,119,0,0,0,33,0,2686,0,0,0,0,0,0,0,-1,2,0,31
Clay,7/31/20,0,0,0,0,0,0,0,0,0,102,0,2158,0,90,0,4,0,8,0,2260,0,0,0,0,0,0,0,-1,1,0,12
Cleburne,7/31/20,0,0,0,0,0,0,0,0,0,178,0,3078,0,155,0,5,0,18,0,3256,0,0,0,0,0,0,0,3,0,0,57
Cleveland,7/31/20,0,0,0,0,0,0,0,0,0,63,0,1068,0,49,0,1,0,13,0,1131,0,0,0,0,0,0,0,0,1,0,17
Columbia,7/31/20,0,0,0,0,0,0,0,0,0,184,0,2286,0,149,0,6,0,29,0,2470,0,0,0,0,0,0,0,6,11,0,40
Conway,7/31/20,0,0,0,0,0,0,0,0,0,134,0,2718,0,118,0,3,0,13,0,2852,0,0,0,0,0,0,0,1,2,0,41
Craighead,7/31/20,0,0,0,0,0,0,0,0,0,1088,0,15698,0,888,0,11,0,189,0,16786,0,0,0,0,0,0,0,26,26,0,156
Crawford,7/31/20,0,0,0,0,0,0,0,0,0,514,0,7492,0,397,0,3,0,114,0,8006,0,0,0,0,0,0,0,19,11,0,155
Crittenden,7/31/20,0,0,0,0,0,0,0,0,0,1172,0,7654,0,1039,0,17,0,116,0,8826,0,0,0,0,0,0,0,37,20,0,89
Cross,7/31/20,0,0,0,0,0,0,0,0,0,157,0,2011,0,135,0,1,0,21,0,2168,0,0,0,0,0,0,0,0,7,0,14
Dallas,7/31/20,0,0,0,0,0,0,0,0,0,56,0,760,0,38,0,0,0,18,0,816,0,0,0,0,0,0,0,1,0,0,9
Desha,7/31/20,0,0,0,0,0,0,0,0,0,142,0,1580,0,113,0,2,0,27,0,1722,0,0,0,0,0,0,0,4,8,0,19
Drew,7/31/20,0,0,0,0,0,0,0,0,0,155,0,2667,0,117,0,2,0,36,0,2822,0,0,0,0,0,0,0,3,3,0,49
Faulkner,7/31/20,0,0,0,0,0,0,0,0,0,1175,0,16064,0,992,0,5,0,178,0,17239,0,0,0,0,0,0,0,17,19,0,261
Franklin,7/31/20,0,0,0,0,0,0,0,0,0,104,0,2641,0,54,0,2,0,48,0,2745,0,0,0,0,0,0,0,3,2,0,23
Fulton,7/31/20,0,0,0,0,0,0,0,0,0,27,0,1206,0,21,0,0,0,6,0,1233,0,0,0,0,0,0,0,1,0,0,19
Garland,7/31/20,0,0,0,0,0,0,0,0,0,814,0,12513,0,563,0,7,0,244,0,13327,0,0,0,0,0,0,0,28,22,0,311
Grant,7/31/20,0,0,0,0,0,0,0,0,0,124,0,2032,0,87,0,0,0,37,0,2156,0,0,0,0,0,0,0,2,2,0,30
Greene,7/31/20,0,0,0,0,0,0,0,0,0,293,0,5868,0,205,0,1,0,87,0,6161,0,0,0,0,0,0,0,13,13,0,79
Hempstead,7/31/20,0,0,0,0,0,0,0,0,0,200,0,2624,0,148,0,2,0,50,0,2824,0,0,0,0,0,0,0,8,7,0,79
HotSpring,7/31/20,0,0,0,0,0,0,0,0,0,1436,0,5032,0,1367,0,8,0,61,0,6468,0,0,0,0,0,0,0,7,21,1,97
Howard,7/31/20,0,0,0,0,0,0,0,0,0,291,0,2352,0,216,0,2,0,73,0,2643,0,0,0,0,0,0,0,4,11,0,31
Independence,7/31/20,0,0,0,0,0,0,0,0,0,331,0,4228,0,146,0,0,0,185,0,4559,0,0,0,0,0,0,0,32,13,0,115
Izard,7/31/20,0,0,0,0,0,0,0,0,0,43,0,1310,0,30,0,1,0,12,0,1353,0,0,0,0,0,0,0,5,0,0,27
Jackson,7/31/20,0,0,0,0,0,0,0,0,0,57,0,1716,0,43,0,1,0,13,0,1773,0,0,0,0,0,0,0,1,0,0,25
Jefferson,7/31/20,0,0,0,0,0,0,0,0,0,1293,0,12030,0,1017,0,37,0,239,0,13323,0,0,0,0,0,0,0,23,24,0,189
Johnson,7/31/20,0,0,0,0,0,0,0,0,0,612,0,2732,0,535,0,0,0,77,0,3344,0,0,0,0,0,0,0,6,7,0,-44
Lafayette,7/31/20,0,0,0,0,0,0,0,0,0,48,0,519,0,39,0,2,0,7,0,567,0,0,0,0,0,0,0,0,1,0,9
Lawrence,7/31/20,0,0,0,0,0,0,0,0,0,179,0,2120,0,149,0,9,0,21,0,2299,0,0,0,0,0,0,0,6,3,0,29
Lee,7/31/20,0,0,0,0,0,0,0,0,0,882,0,2709,0,861,0,6,0,15,0,3591,0,0,0,0,0,0,0,3,4,0,36
Lincoln,7/31/20,0,0,0,0,0,0,0,0,0,1165,0,2481,0,1114,0,11,0,40,0,3646,0,0,0,0,0,0,0,4,1,0,40
LittleRiver,7/31/20,0,0,0,0,0,0,0,0,0,149,0,1173,0,73,0,1,0,75,0,1322,0,0,0,0,0,0,0,4,0,0,15
Logan,7/31/20,0,0,0,0,0,0,0,0,0,139,0,3148,0,116,0,0,0,23,0,3287,0,0,0,0,0,0,0,5,4,0,42
Lonoke,7/31/20,0,0,0,0,0,0,0,0,0,405,0,7185,0,304,0,2,0,99,0,7590,0,0,0,0,0,0,0,12,13,0,63
Madison,7/31/20,0,0,0,0,0,0,0,0,0,253,0,2401,0,237,0,1,0,15,0,2654,0,0,0,0,0,0,0,0,2,0,14
Marion,7/31/20,0,0,0,0,0,0,0,0,0,23,0,1212,0,17,0,0,0,6,0,1235,0,0,0,0,0,0,0,1,0,0,12
Miller,7/31/20,0,0,0,0,0,0,0,0,0,451,0,3765,0,379,0,4,0,68,0,4216,0,0,0,0,0,0,0,9,6,0,143
MissingCountyInfo,7/31/20,0,0,0,0,0,0,0,0,0,1554,0,62052,0,1067,0,0,0,487,0,63606,0,0,0,0,0,0,0,-30,20,0,256
Mississippi,7/31/20,0,0,0,0,0,0,0,0,0,677,0,5964,0,488,0,9,0,180,0,6641,0,0,0,0,0,0,0,29,18,1,114
Monroe,7/31/20,0,0,0,0,0,0,0,0,0,49,0,1182,0,35,0,0,0,14,0,1231,0,0,0,0,0,0,0,1,2,0,30
Montgomery,7/31/20,0,0,0,0,0,0,0,0,0,25,0,825,0,19,0,0,0,6,0,850,0,0,0,0,0,0,0,1,0,0,11
Nevada,7/31/20,0,0,0,0,0,0,0,0,0,129,0,1502,0,113,0,9,0,7,0,1631,0,0,0,0,0,0,0,1,1,0,15
Newton,7/31/20,0,0,0,0,0,0,0,0,0,91,0,770,0,19,0,3,0,69,0,861,0,0,0,0,0,0,0,2,1,0,9
Ouachita,7/31/20,0,0,0,0,0,0,0,0,0,75,0,2720,0,54,0,1,0,20,0,2795,0,0,0,0,0,0,0,1,1,0,43
Perry,7/31/20,0,0,0,0,0,0,0,0,0,49,0,1338,0,45,0,0,0,4,0,1387,0,0,0,0,0,0,0,1,2,0,17
Phillips,7/31/20,0,0,0,0,0,0,0,0,0,270,0,3479,0,224,0,6,0,40,0,3749,0,0,0,0,0,0,0,5,8,0,94
Pike,7/31/20,0,0,0,0,0,0,0,0,0,77,0,2594,0,55,0,1,0,21,0,2671,0,0,0,0,0,0,0,8,8,0,39
Poinsett,7/31/20,0,0,0,0,0,0,0,0,0,151,0,2407,0,107,0,3,0,41,0,2558,0,0,0,0,0,0,0,10,5,0,16
Polk,7/31/20,0,0,0,0,0,0,0,0,0,125,0,2077,0,107,0,1,0,17,0,2202,0,0,0,0,0,0,0,0,0,1,30
Pope,7/31/20,0,0,0,0,0,0,0,0,0,1161,0,9233,0,920,0,9,0,232,0,10394,0,0,0,0,0,0,0,11,19,1,-16
Prairie,7/31/20,0,0,0,0,0,0,0,0,0,59,0,920,0,50,0,0,0,9,0,979,0,0,0,0,0,0,0,2,1,0,17
Pulaski,7/31/20,0,0,0,0,0,0,0,0,0,4733,0,58745,0,3947,0,77,0,709,0,63478,0,0,0,0,0,0,0,79,82,1,863
Randolph,7/31/20,0,0,0,0,0,0,0,0,0,164,0,2582,0,120,0,2,0,42,0,2746,0,0,0,0,0,0,0,9,6,0,28
Saline,7/31/20,0,0,0,0,0,0,0,0,0,855,0,14327,0,678,0,4,0,173,0,15182,0,0,0,0,0,0,0,28,17,0,331
Scott,7/31/20,0,0,0,0,0,0,0,0,0,41,0,900,0,28,0,0,0,13,0,941,0,0,0,0,0,0,0,6,1,0,29
Searcy,7/31/20,0,0,0,0,0,0,0,0,0,25,0,1042,0,22,0,0,0,3,0,1067,0,0,0,0,0,0,0,0,0,0,13
Sebastian,7/31/20,0,0,0,0,0,0,0,0,0,1689,0,18907,0,1240,0,14,0,435,0,20596,0,0,0,0,0,0,0,88,44,0,487
Sevier,7/31/20,0,0,0,0,0,0,0,0,0,929,0,4384,0,875,0,10,0,44,0,5313,0,0,0,0,0,0,0,2,8,0,49
Sharp,7/31/20,0,0,0,0,0,0,0,0,0,99,0,1506,0,76,0,5,0,18,0,1605,0,0,0,0,0,0,0,2,2,0,15
St.Francis,7/31/20,0,0,0,0,0,0,0,0,0,1112,0,6104,0,971,0,3,0,138,0,7216,0,0,0,0,0,0,0,8,8,0,100
Stone,7/31/20,0,0,0,0,0,0,0,0,0,52,0,1617,0,37,0,1,0,14,0,1669,0,0,0,0,0,0,0,2,1,0,60
Union,7/31/20,0,0,0,0,0,0,0,0,0,428,0,4038,0,334,0,16,0,78,0,4466,0,0,0,0,0,0,0,32,6,0,90
VanBuren,7/31/20,0,0,0,0,0,0,0,0,0,50,0,1474,0,39,0,2,0,9,0,1524,0,0,0,0,0,0,0,0,0,0,15
Washington,7/31/20,0,0,0,0,0,0,0,0,0,5896,0,22018,0,5396,0,45,0,455,0,27914,0,0,0,0,0,0,0,41,50,2,346
White,7/31/20,0,0,0,0,0,0,0,0,0,250,0,5802,0,184,0,2,0,64,0,6052,0,0,0,0,0,0,0,7,3,0,92
Woodruff,7/31/20,0,0,0,0,0,0,0,0,0,18,0,980,0,17,0,0,0,1,0,998,0,0,0,0,0,0,0,1,0,0,12
Yell,7/31/20,0,0,0,0,0,0,0,0,0,1004,0,3532,0,925,0,14,0,65,0,4536,0,0,0,0,0,0,0,13,8,0,-53
Arkansas_all_counties,7/30/20,0,0,0,0,0,0,0,0,2990671,41759,0,460958,0,34737,0,442,0,6580,0,502717,0,0,0,0,0,0,0,791,799,8,5651
Arkansas_county,7/30/20,0,0,0,0,0,0,0,0,0,183,0,2342,0,138,0,1,0,44,0,2525,0,0,0,0,0,0,0,2,15,0,23
Ashley,7/30/20,0,0,0,0,0,0,0,0,0,214,0,2398,0,138,0,4,0,72,0,2612,0,0,0,0,0,0,0,17,4,0,95
Baxter,7/30/20,0,0,0,0,0,0,0,0,0,61,0,3122,0,45,0,0,0,16,0,3183,0,0,0,0,0,0,0,5,1,0,43
Benton,7/30/20,0,0,0,0,0,0,0,0,0,4408,0,50097,0,3975,0,35,0,398,0,54505,0,0,0,0,0,0,0,53,49,0,586
Boone,7/30/20,0,0,0,0,0,0,0,0,0,142,0,3589,0,85,0,1,0,56,0,3731,0,0,0,0,0,0,0,12,3,0,62
Bradley,7/30/20,0,0,0,0,0,0,0,0,0,134,0,1726,0,99,0,3,0,32,0,1860,0,0,0,0,0,0,0,11,3,0,102
Calhoun,7/30/20,0,0,0,0,0,0,0,0,0,12,0,482,0,8,0,0,0,4,0,494,0,0,0,0,0,0,0,2,1,0,13
Carroll,7/30/20,0,0,0,0,0,0,0,0,0,331,0,3796,0,270,0,6,0,55,0,4127,0,0,0,0,0,0,0,0,6,0,23
Chicot,7/30/20,0,0,0,0,0,0,0,0,0,498,0,2454,0,256,0,5,0,237,0,2952,0,0,0,0,0,0,0,15,4,1,32
Clark,7/30/20,0,0,0,0,0,0,0,0,0,153,0,2502,0,117,0,0,0,36,0,2655,0,0,0,0,0,0,0,5,6,0,34
Clay,7/30/20,0,0,0,0,0,0,0,0,0,103,0,2145,0,89,0,4,0,10,0,2248,0,0,0,0,0,0,0,-1,0,0,28
Cleburne,7/30/20,0,0,0,0,0,0,0,0,0,175,0,3024,0,155,0,5,0,15,0,3199,0,0,0,0,0,0,0,0,3,0,58
Cleveland,7/30/20,0,0,0,0,0,0,0,0,0,63,0,1051,0,48,0,1,0,14,0,1114,0,0,0,0,0,0,0,0,1,0,13
Columbia,7/30/20,0,0,0,0,0,0,0,0,0,178,0,2252,0,138,0,6,0,34,0,2430,0,0,0,0,0,0,0,6,4,0,31
Conway,7/30/20,0,0,0,0,0,0,0,0,0,133,0,2678,0,116,0,3,0,14,0,2811,0,0,0,0,0,0,0,4,5,0,47
Craighead,7/30/20,0,0,0,0,0,0,0,0,0,1062,0,15568,0,862,0,11,0,189,0,16630,0,0,0,0,0,0,0,31,35,0,277
Crawford,7/30/20,0,0,0,0,0,0,0,0,0,495,0,7356,0,386,0,3,0,106,0,7851,0,0,0,0,0,0,0,8,18,0,94
Crittenden,7/30/20,0,0,0,0,0,0,0,0,0,1135,0,7602,0,1019,0,17,0,99,0,8737,0,0,0,0,0,0,0,8,14,0,68
Cross,7/30/20,0,0,0,0,0,0,0,0,0,157,0,1997,0,128,0,1,0,28,0,2154,0,0,0,0,0,0,0,1,4,0,19
Dallas,7/30/20,0,0,0,0,0,0,0,0,0,55,0,752,0,38,0,0,0,17,0,807,0,0,0,0,0,0,0,4,16,0,17
Desha,7/30/20,0,0,0,0,0,0,0,0,0,138,0,1565,0,105,0,2,0,31,0,1703,0,0,0,0,0,0,0,2,4,0,19
Drew,7/30/20,0,0,0,0,0,0,0,0,0,152,0,2621,0,114,0,2,0,36,0,2773,0,0,0,0,0,0,0,3,1,0,39
Faulkner,7/30/20,0,0,0,0,0,0,0,0,0,1158,0,15820,0,973,0,5,0,180,0,16978,0,0,0,0,0,0,0,20,29,1,241
Franklin,7/30/20,0,0,0,0,0,0,0,0,0,101,0,2621,0,52,0,2,0,47,0,2722,0,0,0,0,0,0,0,5,8,0,230
Fulton,7/30/20,0,0,0,0,0,0,0,0,0,26,0,1188,0,21,0,0,0,5,0,1214,0,0,0,0,0,0,0,0,0,0,10
Garland,7/30/20,0,0,0,0,0,0,0,0,0,786,0,12230,0,541,0,7,0,238,0,13016,0,0,0,0,0,0,0,51,32,0,366
Grant,7/30/20,0,0,0,0,0,0,0,0,0,122,0,2004,0,85,0,0,0,37,0,2126,0,0,0,0,0,0,0,0,3,0,27
Greene,7/30/20,0,0,0,0,0,0,0,0,0,280,0,5802,0,192,0,1,0,87,0,6082,0,0,0,0,0,0,0,11,5,0,143
Hempstead,7/30/20,0,0,0,0,0,0,0,0,0,192,0,2553,0,141,0,2,0,49,0,2745,0,0,0,0,0,0,0,2,9,0,32
HotSpring,7/30/20,0,0,0,0,0,0,0,0,0,1429,0,4942,0,1346,0,7,0,76,0,6371,0,0,0,0,0,0,0,10,13,0,69
Howard,7/30/20,0,0,0,0,0,0,0,0,0,287,0,2325,0,205,0,2,0,80,0,2612,0,0,0,0,0,0,0,5,12,0,37
Independence,7/30/20,0,0,0,0,0,0,0,0,0,299,0,4145,0,133,0,0,0,166,0,4444,0,0,0,0,0,0,0,33,10,0,86
Izard,7/30/20,0,0,0,0,0,0,0,0,0,38,0,1288,0,30,0,1,0,7,0,1326,0,0,0,0,0,0,0,1,1,0,22
Jackson,7/30/20,0,0,0,0,0,0,0,0,0,56,0,1692,0,43,0,1,0,12,0,1748,0,0,0,0,0,0,0,1,0,0,13
Jefferson,7/30/20,0,0,0,0,0,0,0,0,0,1270,0,11864,0,993,0,37,0,240,0,13134,0,0,0,0,0,0,0,31,33,0,235
Johnson,7/30/20,0,0,0,0,0,0,0,0,0,606,0,2782,0,528,0,0,0,78,0,3388,0,0,0,0,0,0,0,9,6,0,37
Lafayette,7/30/20,0,0,0,0,0,0,0,0,0,48,0,510,0,38,0,2,0,8,0,558,0,0,0,0,0,0,0,0,3,0,7
Lawrence,7/30/20,0,0,0,0,0,0,0,0,0,173,0,2097,0,146,0,9,0,18,0,2270,0,0,0,0,0,0,0,4,5,0,22
Lee,7/30/20,0,0,0,0,0,0,0,0,0,879,0,2676,0,857,0,6,0,16,0,3555,0,0,0,0,0,0,0,1,2,0,11
Lincoln,7/30/20,0,0,0,0,0,0,0,0,0,1161,0,2445,0,1113,0,11,0,37,0,3606,0,0,0,0,0,0,0,6,38,0,27
LittleRiver,7/30/20,0,0,0,0,0,0,0,0,0,145,0,1162,0,73,0,1,0,71,0,1307,0,0,0,0,0,0,0,7,5,0,21
Logan,7/30/20,0,0,0,0,0,0,0,0,0,134,0,3111,0,112,0,0,0,22,0,3245,0,0,0,0,0,0,0,4,1,0,34
Lonoke,7/30/20,0,0,0,0,0,0,0,0,0,393,0,7134,0,291,0,2,0,100,0,7527,0,0,0,0,0,0,0,10,5,0,85
Madison,7/30/20,0,0,0,0,0,0,0,0,0,253,0,2387,0,235,0,1,0,17,0,2640,0,0,0,0,0,0,0,7,2,0,28
Marion,7/30/20,0,0,0,0,0,0,0,0,0,22,0,1201,0,17,0,0,0,5,0,1223,0,0,0,0,0,0,0,1,0,0,25
Miller,7/30/20,0,0,0,0,0,0,0,0,0,442,0,3631,0,373,0,4,0,65,0,4073,0,0,0,0,0,0,0,4,14,0,33
MissingCountyInfo,7/30/20,0,0,0,0,0,0,0,0,0,1584,0,61766,0,1047,0,0,0,537,0,63350,0,0,0,0,0,0,0,39,45,0,437
Mississippi,7/30/20,0,0,0,0,0,0,0,0,0,648,0,5879,0,470,0,8,0,170,0,6527,0,0,0,0,0,0,0,23,24,0,112
Monroe,7/30/20,0,0,0,0,0,0,0,0,0,48,0,1153,0,33,0,0,0,15,0,1201,0,0,0,0,0,0,0,0,2,0,16
Montgomery,7/30/20,0,0,0,0,0,0,0,0,0,24,0,815,0,19,0,0,0,5,0,839,0,0,0,0,0,0,0,0,0,0,1
Nevada,7/30/20,0,0,0,0,0,0,0,0,0,128,0,1488,0,112,0,9,0,7,0,1616,0,0,0,0,0,0,0,0,-1,1,9
Newton,7/30/20,0,0,0,0,0,0,0,0,0,89,0,763,0,18,0,3,0,68,0,852,0,0,0,0,0,0,0,-1,0,3,8
Ouachita,7/30/20,0,0,0,0,0,0,0,0,0,74,0,2678,0,53,0,1,0,20,0,2752,0,0,0,0,0,0,0,2,3,0,83
Perry,7/30/20,0,0,0,0,0,0,0,0,0,48,0,1322,0,43,0,0,0,5,0,1370,0,0,0,0,0,0,0,2,1,0,18
Phillips,7/30/20,0,0,0,0,0,0,0,0,0,265,0,3390,0,216,0,6,0,43,0,3655,0,0,0,0,0,0,0,5,3,0,17
Pike,7/30/20,0,0,0,0,0,0,0,0,0,69,0,2563,0,47,0,1,0,21,0,2632,0,0,0,0,0,0,0,4,0,0,50
Poinsett,7/30/20,0,0,0,0,0,0,0,0,0,141,0,2401,0,102,0,3,0,36,0,2542,0,0,0,0,0,0,0,8,6,0,57
Polk,7/30/20,0,0,0,0,0,0,0,0,0,125,0,2047,0,107,0,0,0,18,0,2172,0,0,0,0,0,0,0,1,1,0,31
Pope,7/30/20,0,0,0,0,0,0,0,0,0,1150,0,9260,0,901,0,8,0,241,0,10410,0,0,0,0,0,0,0,31,28,0,133
Prairie,7/30/20,0,0,0,0,0,0,0,0,0,57,0,905,0,49,0,0,0,8,0,962,0,0,0,0,0,0,0,0,0,0,12
Pulaski,7/30/20,0,0,0,0,0,0,0,0,0,4654,0,57961,0,3865,0,76,0,713,0,62615,0,0,0,0,0,0,0,79,78,1,953
Randolph,7/30/20,0,0,0,0,0,0,0,0,0,155,0,2563,0,114,0,2,0,39,0,2718,0,0,0,0,0,0,0,3,2,0,33
Saline,7/30/20,0,0,0,0,0,0,0,0,0,827,0,14024,0,661,0,4,0,162,0,14851,0,0,0,0,0,0,0,18,21,0,233
Scott,7/30/20,0,0,0,0,0,0,0,0,0,35,0,877,0,27,0,0,0,8,0,912,0,0,0,0,0,0,0,1,1,0,17
Searcy,7/30/20,0,0,0,0,0,0,0,0,0,25,0,1029,0,22,0,0,0,3,0,1054,0,0,0,0,0,0,0,0,2,0,6
Sebastian,7/30/20,0,0,0,0,0,0,0,0,0,1601,0,18508,0,1196,0,14,0,391,0,20109,0,0,0,0,0,0,0,58,30,1,566
Sevier,7/30/20,0,0,0,0,0,0,0,0,0,927,0,4337,0,867,0,10,0,50,0,5264,0,0,0,0,0,0,0,9,14,0,39
Sharp,7/30/20,0,0,0,0,0,0,0,0,0,97,0,1493,0,74,0,5,0,18,0,1590,0,0,0,0,0,0,0,3,2,0,22
St.Francis,7/30/20,0,0,0,0,0,0,0,0,0,1104,0,6012,0,963,0,3,0,138,0,7116,0,0,0,0,0,0,0,18,6,0,142
Stone,7/30/20,0,0,0,0,0,0,0,0,0,50,0,1559,0,36,0,1,0,13,0,1609,0,0,0,0,0,0,0,5,0,0,41
Union,7/30/20,0,0,0,0,0,0,0,0,0,396,0,3980,0,328,0,16,0,52,0,4376,0,0,0,0,0,0,0,17,8,0,140
VanBuren,7/30/20,0,0,0,0,0,0,0,0,0,50,0,1459,0,39,0,2,0,9,0,1509,0,0,0,0,0,0,0,1,0,0,21
Washington,7/30/20,0,0,0,0,0,0,0,0,0,5855,0,21713,0,5346,0,43,0,466,0,27568,0,0,0,0,0,0,0,43,77,0,207
White,7/30/20,0,0,0,0,0,0,0,0,0,243,0,5717,0,181,0,2,0,60,0,5960,0,0,0,0,0,0,0,2,1,0,97
Woodruff,7/30/20,0,0,0,0,0,0,0,0,0,17,0,969,0,17,0,0,0,0,0,986,0,0,0,0,0,0,0,0,0,0,11
Yell,7/30/20,0,0,0,0,0,0,0,0,0,991,0,3598,0,917,0,14,0,60,0,4589,0,0,0,0,0,0,0,9,12,0,36
Arkansas_all_counties,7/29/20,0,0,0,0,0,0,0,0,2990671,40968,0,454637,0,33938,0,434,0,6596,0,495605,0,0,0,0,0,0,0,787,750,6,4734
Arkansas_county,7/29/20,0,0,0,0,0,0,0,0,0,181,0,2321,0,123,0,1,0,57,0,2502,0,0,0,0,0,0,0,9,11,0,43
Ashley,7/29/20,0,0,0,0,0,0,0,0,0,197,0,2320,0,134,0,4,0,59,0,2517,0,0,0,0,0,0,0,10,4,0,55
Baxter,7/29/20,0,0,0,0,0,0,0,0,0,56,0,3084,0,44,0,0,0,12,0,3140,0,0,0,0,0,0,0,0,1,0,15
Benton,7/29/20,0,0,0,0,0,0,0,0,0,4355,0,49564,0,3926,0,35,0,394,0,53919,0,0,0,0,0,0,0,34,52,0,430
Boone,7/29/20,0,0,0,0,0,0,0,0,0,130,0,3539,0,82,0,1,0,47,0,3669,0,0,0,0,0,0,0,4,4,0,43
Bradley,7/29/20,0,0,0,0,0,0,0,0,0,123,0,1635,0,96,0,3,0,24,0,1758,0,0,0,0,0,0,0,1,2,0,4
Calhoun,7/29/20,0,0,0,0,0,0,0,0,0,10,0,471,0,7,0,0,0,3,0,481,0,0,0,0,0,0,0,0,1,0,2
Carroll,7/29/20,0,0,0,0,0,0,0,0,0,331,0,3773,0,264,0,6,0,61,0,4104,0,0,0,0,0,0,0,3,5,0,37
Chicot,7/29/20,0,0,0,0,0,0,0,0,0,483,0,2437,0,252,0,4,0,227,0,2920,0,0,0,0,0,0,0,152,10,0,645
Clark,7/29/20,0,0,0,0,0,0,0,0,0,148,0,2473,0,111,0,0,0,37,0,2621,0,0,0,0,0,0,0,3,6,0,22
Clay,7/29/20,0,0,0,0,0,0,0,0,0,104,0,2116,0,89,0,4,0,11,0,2220,0,0,0,0,0,0,0,1,1,0,13
Cleburne,7/29/20,0,0,0,0,0,0,0,0,0,175,0,2966,0,152,0,5,0,18,0,3141,0,0,0,0,0,0,0,0,0,0,16
Cleveland,7/29/20,0,0,0,0,0,0,0,0,0,63,0,1038,0,47,0,1,0,15,0,1101,0,0,0,0,0,0,0,1,4,0,7
Columbia,7/29/20,0,0,0,0,0,0,0,0,0,172,0,2227,0,134,0,6,0,32,0,2399,0,0,0,0,0,0,0,3,4,0,13
Conway,7/29/20,0,0,0,0,0,0,0,0,0,129,0,2635,0,111,0,3,0,15,0,2764,0,0,0,0,0,0,0,5,3,0,31
Craighead,7/29/20,0,0,0,0,0,0,0,0,0,1031,0,15322,0,827,0,11,0,193,0,16353,0,0,0,0,0,0,0,25,42,0,152
Crawford,7/29/20,0,0,0,0,0,0,0,0,0,487,0,7270,0,368,0,3,0,116,0,7757,0,0,0,0,0,0,0,14,24,0,131
Crittenden,7/29/20,0,0,0,0,0,0,0,0,0,1127,0,7542,0,1005,0,17,0,105,0,8669,0,0,0,0,0,0,0,14,24,0,33
Cross,7/29/20,0,0,0,0,0,0,0,0,0,156,0,1979,0,124,0,1,0,31,0,2135,0,0,0,0,0,0,0,1,6,0,16
Dallas,7/29/20,0,0,0,0,0,0,0,0,0,51,0,739,0,22,0,0,0,29,0,790,0,0,0,0,0,0,0,2,6,0,11
Desha,7/29/20,0,0,0,0,0,0,0,0,0,136,0,1548,0,101,0,2,0,33,0,1684,0,0,0,0,0,0,0,3,5,0,23
Drew,7/29/20,0,0,0,0,0,0,0,0,0,149,0,2585,0,113,0,2,0,34,0,2734,0,0,0,0,0,0,0,3,6,0,42
Faulkner,7/29/20,0,0,0,0,0,0,0,0,0,1138,0,15599,0,944,0,4,0,190,0,16737,0,0,0,0,0,0,0,18,21,0,269
Franklin,7/29/20,0,0,0,0,0,0,0,0,0,96,0,2396,0,44,0,2,0,50,0,2492,0,0,0,0,0,0,0,11,1,0,67
Fulton,7/29/20,0,0,0,0,0,0,0,0,0,26,0,1178,0,21,0,0,0,5,0,1204,0,0,0,0,0,0,0,0,1,0,14
Garland,7/29/20,0,0,0,0,0,0,0,0,0,735,0,11915,0,509,0,7,0,219,0,12650,0,0,0,0,0,0,0,22,27,0,159
Grant,7/29/20,0,0,0,0,0,0,0,0,0,122,0,1977,0,82,0,0,0,40,0,2099,0,0,0,0,0,0,0,4,0,0,26
Greene,7/29/20,0,0,0,0,0,0,0,0,0,269,0,5670,0,187,0,1,0,81,0,5939,0,0,0,0,0,0,0,22,6,0,88
Hempstead,7/29/20,0,0,0,0,0,0,0,0,0,190,0,2523,0,132,0,2,0,56,0,2713,0,0,0,0,0,0,0,10,6,0,34
HotSpring,7/29/20,0,0,0,0,0,0,0,0,0,1419,0,4883,0,1333,0,7,0,79,0,6302,0,0,0,0,0,0,0,8,12,0,45
Howard,7/29/20,0,0,0,0,0,0,0,0,0,282,0,2293,0,193,0,2,0,87,0,2575,0,0,0,0,0,0,0,7,3,0,29
Independence,7/29/20,0,0,0,0,0,0,0,0,0,266,0,4092,0,123,0,0,0,143,0,4358,0,0,0,0,0,0,0,7,11,0,54
Izard,7/29/20,0,0,0,0,0,0,0,0,0,37,0,1267,0,29,0,1,0,7,0,1304,0,0,0,0,0,0,0,2,1,0,14
Jackson,7/29/20,0,0,0,0,0,0,0,0,0,55,0,1680,0,43,0,1,0,11,0,1735,0,0,0,0,0,0,0,0,-1,0,6
Jefferson,7/29/20,0,0,0,0,0,0,0,0,0,1239,0,11660,0,960,0,37,0,242,0,12899,0,0,0,0,0,0,0,17,15,1,107
Johnson,7/29/20,0,0,0,0,0,0,0,0,0,597,0,2754,0,522,0,0,0,75,0,3351,0,0,0,0,0,0,0,5,10,0,24
Lafayette,7/29/20,0,0,0,0,0,0,0,0,0,48,0,503,0,35,0,2,0,11,0,551,0,0,0,0,0,0,0,0,3,0,5
Lawrence,7/29/20,0,0,0,0,0,0,0,0,0,169,0,2079,0,141,0,9,0,19,0,2248,0,0,0,0,0,0,0,7,6,0,23
Lee,7/29/20,0,0,0,0,0,0,0,0,0,878,0,2666,0,855,0,6,0,17,0,3544,0,0,0,0,0,0,0,2,3,0,14
Lincoln,7/29/20,0,0,0,0,0,0,0,0,0,1155,0,2424,0,1075,0,11,0,69,0,3579,0,0,0,0,0,0,0,0,28,0,15
LittleRiver,7/29/20,0,0,0,0,0,0,0,0,0,138,0,1148,0,68,0,1,0,69,0,1286,0,0,0,0,0,0,0,32,3,0,71
Logan,7/29/20,0,0,0,0,0,0,0,0,0,130,0,3081,0,111,0,0,0,19,0,3211,0,0,0,0,0,0,0,1,6,0,29
Lonoke,7/29/20,0,0,0,0,0,0,0,0,0,383,0,7059,0,286,0,2,0,95,0,7442,0,0,0,0,0,0,0,15,14,0,90
Madison,7/29/20,0,0,0,0,0,0,0,0,0,246,0,2366,0,233,0,1,0,12,0,2612,0,0,0,0,0,0,0,0,1,0,10
Marion,7/29/20,0,0,0,0,0,0,0,0,0,21,0,1177,0,17,0,0,0,4,0,1198,0,0,0,0,0,0,0,3,0,0,12
Miller,7/29/20,0,0,0,0,0,0,0,0,0,438,0,3602,0,359,0,4,0,75,0,4040,0,0,0,0,0,0,0,10,11,0,42
MissingCountyInfo,7/29/20,0,0,0,0,0,0,0,0,0,1545,0,61368,0,1002,0,0,0,543,0,62913,0,0,0,0,0,0,0,31,18,0,279
Mississippi,7/29/20,0,0,0,0,0,0,0,0,0,625,0,5790,0,446,0,8,0,171,0,6415,0,0,0,0,0,0,0,22,9,0,71
Monroe,7/29/20,0,0,0,0,0,0,0,0,0,48,0,1137,0,31,0,0,0,17,0,1185,0,0,0,0,0,0,0,0,0,0,5
Montgomery,7/29/20,0,0,0,0,0,0,0,0,0,24,0,814,0,19,0,0,0,5,0,838,0,0,0,0,0,0,0,1,1,0,6
Nevada,7/29/20,0,0,0,0,0,0,0,0,0,128,0,1479,0,113,0,8,0,7,0,1607,0,0,0,0,0,0,0,1,2,0,8
Newton,7/29/20,0,0,0,0,0,0,0,0,0,90,0,754,0,18,0,0,0,72,0,844,0,0,0,0,0,0,0,1,1,0,17
Ouachita,7/29/20,0,0,0,0,0,0,0,0,0,72,0,2597,0,50,0,1,0,21,0,2669,0,0,0,0,0,0,0,1,2,0,18
Perry,7/29/20,0,0,0,0,0,0,0,0,0,46,0,1306,0,42,0,0,0,4,0,1352,0,0,0,0,0,0,0,1,1,0,14
Phillips,7/29/20,0,0,0,0,0,0,0,0,0,260,0,3378,0,213,0,6,0,41,0,3638,0,0,0,0,0,0,0,4,4,0,61
Pike,7/29/20,0,0,0,0,0,0,0,0,0,65,0,2517,0,47,0,1,0,17,0,2582,0,0,0,0,0,0,0,5,5,0,30
Poinsett,7/29/20,0,0,0,0,0,0,0,0,0,133,0,2352,0,96,0,3,0,34,0,2485,0,0,0,0,0,0,0,3,3,0,26
Polk,7/29/20,0,0,0,0,0,0,0,0,0,124,0,2017,0,106,0,0,0,18,0,2141,0,0,0,0,0,0,0,1,-1,0,21
Pope,7/29/20,0,0,0,0,0,0,0,0,0,1119,0,9158,0,873,0,8,0,238,0,10277,0,0,0,0,0,0,0,9,13,2,100
Prairie,7/29/20,0,0,0,0,0,0,0,0,0,57,0,893,0,49,0,0,0,8,0,950,0,0,0,0,0,0,0,1,0,0,7
Pulaski,7/29/20,0,0,0,0,0,0,0,0,0,4575,0,57087,0,3787,0,75,0,713,0,61662,0,0,0,0,0,0,0,83,111,1,901
Randolph,7/29/20,0,0,0,0,0,0,0,0,0,152,0,2533,0,112,0,2,0,38,0,2685,0,0,0,0,0,0,0,7,2,0,33
Saline,7/29/20,0,0,0,0,0,0,0,0,0,809,0,13809,0,640,0,4,0,165,0,14618,0,0,0,0,0,0,0,11,24,0,193
Scott,7/29/20,0,0,0,0,0,0,0,0,0,34,0,861,0,26,0,0,0,8,0,895,0,0,0,0,0,0,0,1,5,0,12
Searcy,7/29/20,0,0,0,0,0,0,0,0,0,25,0,1023,0,20,0,0,0,5,0,1048,0,0,0,0,0,0,0,2,0,0,14
Sebastian,7/29/20,0,0,0,0,0,0,0,0,0,1543,0,18000,0,1166,0,13,0,364,0,19543,0,0,0,0,0,0,0,44,44,0,291
Sevier,7/29/20,0,0,0,0,0,0,0,0,0,918,0,4307,0,853,0,10,0,55,0,5225,0,0,0,0,0,0,0,5,4,0,38
Sharp,7/29/20,0,0,0,0,0,0,0,0,0,94,0,1474,0,72,0,5,0,17,0,1568,0,0,0,0,0,0,0,5,1,0,26
St.Francis,7/29/20,0,0,0,0,0,0,0,0,0,1086,0,5888,0,957,0,3,0,126,0,6974,0,0,0,0,0,0,0,3,4,0,99
Stone,7/29/20,0,0,0,0,0,0,0,0,0,45,0,1523,0,36,0,1,0,8,0,1568,0,0,0,0,0,0,0,1,2,0,10
Union,7/29/20,0,0,0,0,0,0,0,0,0,379,0,3857,0,320,0,16,0,43,0,4236,0,0,0,0,0,0,0,3,6,1,11
VanBuren,7/29/20,0,0,0,0,0,0,0,0,0,49,0,1439,0,39,0,2,0,8,0,1488,0,0,0,0,0,0,0,3,1,0,8
Washington,7/29/20,0,0,0,0,0,0,0,0,0,5812,0,21549,0,5269,0,43,0,500,0,27361,0,0,0,0,0,0,0,29,68,1,230
White,7/29/20,0,0,0,0,0,0,0,0,0,241,0,5622,0,180,0,2,0,59,0,5863,0,0,0,0,0,0,0,11,3,0,115
Woodruff,7/29/20,0,0,0,0,0,0,0,0,0,17,0,958,0,17,0,0,0,0,0,975,0,0,0,0,0,0,0,0,1,0,0
Yell,7/29/20,0,0,0,0,0,0,0,0,0,982,0,3571,0,905,0,14,0,63,0,4553,0,0,0,0,0,0,0,7,7,0,24
Arkansas_all_counties,7/28/20,0,0,0,0,0,0,0,0,2990671,40181,0,449725,0,33188,0,428,0,6565,0,489906,0,0,0,0,0,0,0,734,823,20,5422
Arkansas_county,7/28/20,0,0,0,0,0,0,0,0,0,172,0,2287,0,112,0,1,0,59,0,2459,0,0,0,0,0,0,0,4,8,0,15
Ashley,7/28/20,0,0,0,0,0,0,0,0,0,187,0,2275,0,130,0,4,0,53,0,2462,0,0,0,0,0,0,0,0,4,0,12
Baxter,7/28/20,0,0,0,0,0,0,0,0,0,56,0,3069,0,43,0,0,0,13,0,3125,0,0,0,0,0,0,0,0,0,0,11
Benton,7/28/20,0,0,0,0,0,0,0,0,0,4321,0,49168,0,3874,0,35,0,412,0,53489,0,0,0,0,0,0,0,58,64,0,486
Boone,7/28/20,0,0,0,0,0,0,0,0,0,126,0,3500,0,78,0,1,0,47,0,3626,0,0,0,0,0,0,0,8,6,0,24
Bradley,7/28/20,0,0,0,0,0,0,0,0,0,122,0,1632,0,94,0,3,0,25,0,1754,0,0,0,0,0,0,0,2,7,1,8
Calhoun,7/28/20,0,0,0,0,0,0,0,0,0,10,0,469,0,6,0,0,0,4,0,479,0,0,0,0,0,0,0,1,1,0,1
Carroll,7/28/20,0,0,0,0,0,0,0,0,0,328,0,3739,0,259,0,6,0,63,0,4067,0,0,0,0,0,0,0,3,1,0,51
Chicot,7/28/20,0,0,0,0,0,0,0,0,0,331,0,1944,0,242,0,4,0,85,0,2275,0,0,0,0,0,0,0,6,3,0,16
Clark,7/28/20,0,0,0,0,0,0,0,0,0,145,0,2454,0,105,0,0,0,40,0,2599,0,0,0,0,0,0,0,7,4,0,18
Clay,7/28/20,0,0,0,0,0,0,0,0,0,103,0,2104,0,88,0,4,0,11,0,2207,0,0,0,0,0,0,0,0,2,0,22
Cleburne,7/28/20,0,0,0,0,0,0,0,0,0,175,0,2950,0,152,0,5,0,18,0,3125,0,0,0,0,0,0,0,0,3,0,12
Cleveland,7/28/20,0,0,0,0,0,0,0,0,0,62,0,1032,0,43,0,1,0,18,0,1094,0,0,0,0,0,0,0,1,2,0,14
Columbia,7/28/20,0,0,0,0,0,0,0,0,0,169,0,2217,0,130,0,6,0,33,0,2386,0,0,0,0,0,0,0,3,1,1,6
Conway,7/28/20,0,0,0,0,0,0,0,0,0,124,0,2609,0,108,0,3,0,13,0,2733,0,0,0,0,0,0,0,2,3,0,27
Craighead,7/28/20,0,0,0,0,0,0,0,0,0,1006,0,15195,0,785,0,11,0,210,0,16201,0,0,0,0,0,0,0,37,28,2,239
Crawford,7/28/20,0,0,0,0,0,0,0,0,0,473,0,7153,0,344,0,3,0,126,0,7626,0,0,0,0,0,0,0,9,14,0,124
Crittenden,7/28/20,0,0,0,0,0,0,0,0,0,1113,0,7523,0,981,0,17,0,115,0,8636,0,0,0,0,0,0,0,13,14,1,110
Cross,7/28/20,0,0,0,0,0,0,0,0,0,155,0,1964,0,118,0,1,0,36,0,2119,0,0,0,0,0,0,0,4,8,0,43
Dallas,7/28/20,0,0,0,0,0,0,0,0,0,49,0,730,0,16,0,0,0,33,0,779,0,0,0,0,0,0,0,1,0,0,6
Desha,7/28/20,0,0,0,0,0,0,0,0,0,133,0,1528,0,96,0,2,0,35,0,1661,0,0,0,0,0,0,0,4,7,1,12
Drew,7/28/20,0,0,0,0,0,0,0,0,0,146,0,2546,0,107,0,2,0,37,0,2692,0,0,0,0,0,0,0,3,1,0,12
Faulkner,7/28/20,0,0,0,0,0,0,0,0,0,1120,0,15348,0,923,0,4,0,193,0,16468,0,0,0,0,0,0,0,39,33,0,210
Franklin,7/28/20,0,0,0,0,0,0,0,0,0,85,0,2340,0,43,0,2,0,40,0,2425,0,0,0,0,0,0,0,2,2,1,49
Fulton,7/28/20,0,0,0,0,0,0,0,0,0,26,0,1164,0,20,0,0,0,6,0,1190,0,0,0,0,0,0,0,3,1,0,10
Garland,7/28/20,0,0,0,0,0,0,0,0,0,713,0,11778,0,482,0,7,0,224,0,12491,0,0,0,0,0,0,0,18,25,2,92
Grant,7/28/20,0,0,0,0,0,0,0,0,0,118,0,1955,0,82,0,0,0,36,0,2073,0,0,0,0,0,0,0,3,2,0,23
Greene,7/28/20,0,0,0,0,0,0,0,0,0,247,0,5604,0,181,0,1,0,65,0,5851,0,0,0,0,0,0,0,17,8,0,60
Hempstead,7/28/20,0,0,0,0,0,0,0,0,0,180,0,2499,0,126,0,2,0,52,0,2679,0,0,0,0,0,0,0,6,3,0,31
HotSpring,7/28/20,0,0,0,0,0,0,0,0,0,1411,0,4846,0,1321,0,7,0,83,0,6257,0,0,0,0,0,0,0,9,12,3,36
Howard,7/28/20,0,0,0,0,0,0,0,0,0,275,0,2271,0,190,0,2,0,83,0,2546,0,0,0,0,0,0,0,29,3,0,116
Independence,7/28/20,0,0,0,0,0,0,0,0,0,259,0,4045,0,112,0,0,0,147,0,4304,0,0,0,0,0,0,0,26,9,0,38
Izard,7/28/20,0,0,0,0,0,0,0,0,0,35,0,1255,0,28,0,1,0,6,0,1290,0,0,0,0,0,0,0,1,1,0,9
Jackson,7/28/20,0,0,0,0,0,0,0,0,0,55,0,1674,0,44,0,1,0,10,0,1729,0,0,0,0,0,0,0,1,0,0,11
Jefferson,7/28/20,0,0,0,0,0,0,0,0,0,1222,0,11570,0,945,0,36,0,241,0,12792,0,0,0,0,0,0,0,18,17,0,141
Johnson,7/28/20,0,0,0,0,0,0,0,0,0,592,0,2735,0,512,0,0,0,80,0,3327,0,0,0,0,0,0,0,7,10,0,54
Lafayette,7/28/20,0,0,0,0,0,0,0,0,0,48,0,498,0,32,0,2,0,14,0,546,0,0,0,0,0,0,0,1,0,0,1
Lawrence,7/28/20,0,0,0,0,0,0,0,0,0,162,0,2063,0,135,0,9,0,18,0,2225,0,0,0,0,0,0,0,4,9,0,26
Lee,7/28/20,0,0,0,0,0,0,0,0,0,876,0,2654,0,852,0,6,0,18,0,3530,0,0,0,0,0,0,0,0,2,0,6
Lincoln,7/28/20,0,0,0,0,0,0,0,0,0,1155,0,2409,0,1047,0,11,0,97,0,3564,0,0,0,0,0,0,0,3,2,0,17
LittleRiver,7/28/20,0,0,0,0,0,0,0,0,0,106,0,1109,0,65,0,1,0,40,0,1215,0,0,0,0,0,0,0,24,4,0,59
Logan,7/28/20,0,0,0,0,0,0,0,0,0,129,0,3053,0,105,0,0,0,24,0,3182,0,0,0,0,0,0,0,2,6,0,74
Lonoke,7/28/20,0,0,0,0,0,0,0,0,0,368,0,6984,0,272,0,2,0,94,0,7352,0,0,0,0,0,0,0,12,18,0,68
Madison,7/28/20,0,0,0,0,0,0,0,0,0,246,0,2356,0,232,0,1,0,13,0,2602,0,0,0,0,0,0,0,0,0,0,38
Marion,7/28/20,0,0,0,0,0,0,0,0,0,18,0,1168,0,17,0,0,0,1,0,1186,0,0,0,0,0,0,0,0,0,0,5
Miller,7/28/20,0,0,0,0,0,0,0,0,0,428,0,3570,0,348,0,4,0,76,0,3998,0,0,0,0,0,0,0,5,6,1,25
MissingCountyInfo,7/28/20,0,0,0,0,0,0,0,0,0,1514,0,61120,0,984,0,0,0,530,0,62634,0,0,0,0,0,0,0,15,35,0,222
Mississippi,7/28/20,0,0,0,0,0,0,0,0,0,603,0,5741,0,437,0,8,0,158,0,6344,0,0,0,0,0,0,0,50,22,0,345
Monroe,7/28/20,0,0,0,0,0,0,0,0,0,48,0,1132,0,31,0,0,0,17,0,1180,0,0,0,0,0,0,0,2,2,0,16
Montgomery,7/28/20,0,0,0,0,0,0,0,0,0,23,0,809,0,18,0,0,0,5,0,832,0,0,0,0,0,0,0,1,1,0,7
Nevada,7/28/20,0,0,0,0,0,0,0,0,0,127,0,1472,0,111,0,8,0,8,0,1599,0,0,0,0,0,0,0,1,3,0,10
Newton,7/28/20,0,0,0,0,0,0,0,0,0,89,0,738,0,17,0,0,0,72,0,827,0,0,0,0,0,0,0,4,1,0,11
Ouachita,7/28/20,0,0,0,0,0,0,0,0,0,71,0,2580,0,48,0,1,0,22,0,2651,0,0,0,0,0,0,0,3,3,0,31
Perry,7/28/20,0,0,0,0,0,0,0,0,0,45,0,1293,0,41,0,0,0,4,0,1338,0,0,0,0,0,0,0,1,0,0,8
Phillips,7/28/20,0,0,0,0,0,0,0,0,0,256,0,3321,0,209,0,6,0,41,0,3577,0,0,0,0,0,0,0,6,8,0,29
Pike,7/28/20,0,0,0,0,0,0,0,0,0,60,0,2492,0,42,0,1,0,17,0,2552,0,0,0,0,0,0,0,2,2,0,29
Poinsett,7/28/20,0,0,0,0,0,0,0,0,0,130,0,2329,0,93,0,3,0,34,0,2459,0,0,0,0,0,0,0,5,5,0,36
Polk,7/28/20,0,0,0,0,0,0,0,0,0,123,0,1997,0,107,0,0,0,16,0,2120,0,0,0,0,0,0,0,2,2,0,18
Pope,7/28/20,0,0,0,0,0,0,0,0,0,1110,0,9067,0,860,0,6,0,244,0,10177,0,0,0,0,0,0,0,36,21,0,270
Prairie,7/28/20,0,0,0,0,0,0,0,0,0,56,0,887,0,49,0,0,0,7,0,943,0,0,0,0,0,0,0,0,1,0,4
Pulaski,7/28/20,0,0,0,0,0,0,0,0,0,4492,0,56269,0,3676,0,74,0,742,0,60761,0,0,0,0,0,0,0,55,179,3,587
Randolph,7/28/20,0,0,0,0,0,0,0,0,0,145,0,2507,0,110,0,2,0,33,0,2652,0,0,0,0,0,0,0,3,11,0,16
Saline,7/28/20,0,0,0,0,0,0,0,0,0,798,0,13627,0,616,0,4,0,178,0,14425,0,0,0,0,0,0,0,21,20,1,155
Scott,7/28/20,0,0,0,0,0,0,0,0,0,33,0,850,0,21,0,0,0,12,0,883,0,0,0,0,0,0,0,2,1,0,12
Searcy,7/28/20,0,0,0,0,0,0,0,0,0,23,0,1011,0,20,0,0,0,3,0,1034,0,0,0,0,0,0,0,0,0,0,4
Sebastian,7/28/20,0,0,0,0,0,0,0,0,0,1499,0,17753,0,1122,0,13,0,364,0,19252,0,0,0,0,0,0,0,45,76,0,335
Sevier,7/28/20,0,0,0,0,0,0,0,0,0,913,0,4274,0,849,0,10,0,54,0,5187,0,0,0,0,0,0,0,7,3,1,32
Sharp,7/28/20,0,0,0,0,0,0,0,0,0,89,0,1453,0,71,0,5,0,13,0,1542,0,0,0,0,0,0,0,-3,-1,0,6
St.Francis,7/28/20,0,0,0,0,0,0,0,0,0,1083,0,5792,0,953,0,3,0,127,0,6875,0,0,0,0,0,0,0,4,2,0,24
Stone,7/28/20,0,0,0,0,0,0,0,0,0,44,0,1514,0,34,0,1,0,9,0,1558,0,0,0,0,0,0,0,1,2,0,4
Union,7/28/20,0,0,0,0,0,0,0,0,0,376,0,3849,0,314,0,15,0,47,0,4225,0,0,0,0,0,0,0,3,9,0,15
VanBuren,7/28/20,0,0,0,0,0,0,0,0,0,46,0,1434,0,38,0,2,0,6,0,1480,0,0,0,0,0,0,0,2,2,0,11
Washington,7/28/20,0,0,0,0,0,0,0,0,0,5783,0,21348,0,5201,0,42,0,540,0,27131,0,0,0,0,0,0,0,54,54,2,236
White,7/28/20,0,0,0,0,0,0,0,0,0,230,0,5518,0,177,0,2,0,51,0,5748,0,0,0,0,0,0,0,8,-1,0,43
Woodruff,7/28/20,0,0,0,0,0,0,0,0,0,17,0,958,0,16,0,0,0,1,0,975,0,0,0,0,0,0,0,0,1,0,4
Yell,7/28/20,0,0,0,0,0,0,0,0,0,975,0,3554,0,898,0,14,0,63,0,4529,0,0,0,0,0,0,0,8,5,0,27
Arkansas_all_counties,7/27/20,0,0,0,0,0,0,0,0,2990671,39447,0,445444,0,32365,0,408,0,6674,0,484891,0,0,0,0,0,0,0,824,743,7,5835
Arkansas_county,7/27/20,0,0,0,0,0,0,0,0,0,168,0,2276,0,104,0,1,0,63,0,2444,0,0,0,0,0,0,0,0,5,0,21
Ashley,7/27/20,0,0,0,0,0,0,0,0,0,187,0,2263,0,126,0,4,0,57,0,2450,0,0,0,0,0,0,0,7,11,0,46
Baxter,7/27/20,0,0,0,0,0,0,0,0,0,56,0,3058,0,43,0,0,0,13,0,3114,0,0,0,0,0,0,0,1,3,0,36
Benton,7/27/20,0,0,0,0,0,0,0,0,0,4263,0,48740,0,3810,0,35,0,418,0,53003,0,0,0,0,0,0,0,54,30,3,644
Boone,7/27/20,0,0,0,0,0,0,0,0,0,118,0,3484,0,72,0,1,0,45,0,3602,0,0,0,0,0,0,0,10,10,0,120
Bradley,7/27/20,0,0,0,0,0,0,0,0,0,120,0,1626,0,87,0,2,0,31,0,1746,0,0,0,0,0,0,0,6,6,0,33
Calhoun,7/27/20,0,0,0,0,0,0,0,0,0,9,0,469,0,5,0,0,0,4,0,478,0,0,0,0,0,0,0,-1,0,0,5
Carroll,7/27/20,0,0,0,0,0,0,0,0,0,325,0,3691,0,258,0,6,0,61,0,4016,0,0,0,0,0,0,0,3,6,0,52
Chicot,7/27/20,0,0,0,0,0,0,0,0,0,325,0,1934,0,239,0,4,0,82,0,2259,0,0,0,0,0,0,0,19,4,0,49
Clark,7/27/20,0,0,0,0,0,0,0,0,0,138,0,2443,0,101,0,0,0,37,0,2581,0,0,0,0,0,0,0,6,4,0,27
Clay,7/27/20,0,0,0,0,0,0,0,0,0,103,0,2082,0,86,0,4,0,13,0,2185,0,0,0,0,0,0,0,-1,2,0,12
Cleburne,7/27/20,0,0,0,0,0,0,0,0,0,175,0,2938,0,149,0,5,0,21,0,3113,0,0,0,0,0,0,0,1,5,0,27
Cleveland,7/27/20,0,0,0,0,0,0,0,0,0,61,0,1019,0,41,0,1,0,19,0,1080,0,0,0,0,0,0,0,4,2,0,15
Columbia,7/27/20,0,0,0,0,0,0,0,0,0,166,0,2214,0,129,0,5,0,32,0,2380,0,0,0,0,0,0,0,0,3,0,34
Conway,7/27/20,0,0,0,0,0,0,0,0,0,122,0,2584,0,105,0,3,0,14,0,2706,0,0,0,0,0,0,0,0,1,0,22
Craighead,7/27/20,0,0,0,0,0,0,0,0,0,969,0,14993,0,757,0,9,0,203,0,15962,0,0,0,0,0,0,0,24,26,1,235
Crawford,7/27/20,0,0,0,0,0,0,0,0,0,464,0,7038,0,330,0,3,0,131,0,7502,0,0,0,0,0,0,0,17,14,0,207
Crittenden,7/27/20,0,0,0,0,0,0,0,0,0,1100,0,7426,0,967,0,16,0,117,0,8526,0,0,0,0,0,0,0,10,20,0,85
Cross,7/27/20,0,0,0,0,0,0,0,0,0,151,0,1925,0,110,0,1,0,40,0,2076,0,0,0,0,0,0,0,1,1,0,39
Dallas,7/27/20,0,0,0,0,0,0,0,0,0,48,0,725,0,16,0,0,0,32,0,773,0,0,0,0,0,0,0,16,0,0,31
Desha,7/27/20,0,0,0,0,0,0,0,0,0,129,0,1520,0,89,0,1,0,39,0,1649,0,0,0,0,0,0,0,1,0,0,24
Drew,7/27/20,0,0,0,0,0,0,0,0,0,143,0,2537,0,106,0,2,0,35,0,2680,0,0,0,0,0,0,0,4,3,0,20
Faulkner,7/27/20,0,0,0,0,0,0,0,0,0,1081,0,15177,0,890,0,4,0,187,0,16258,0,0,0,0,0,0,0,18,19,0,219
Franklin,7/27/20,0,0,0,0,0,0,0,0,0,83,0,2293,0,41,0,1,0,41,0,2376,0,0,0,0,0,0,0,5,4,0,60
Fulton,7/27/20,0,0,0,0,0,0,0,0,0,23,0,1157,0,19,0,0,0,4,0,1180,0,0,0,0,0,0,0,0,0,0,4
Garland,7/27/20,0,0,0,0,0,0,0,0,0,695,0,11704,0,457,0,5,0,233,0,12399,0,0,0,0,0,0,0,43,25,0,375
Grant,7/27/20,0,0,0,0,0,0,0,0,0,115,0,1935,0,80,0,0,0,35,0,2050,0,0,0,0,0,0,0,2,1,0,43
Greene,7/27/20,0,0,0,0,0,0,0,0,0,230,0,5561,0,173,0,1,0,56,0,5791,0,0,0,0,0,0,0,2,5,0,27
Hempstead,7/27/20,0,0,0,0,0,0,0,0,0,174,0,2474,0,123,0,2,0,49,0,2648,0,0,0,0,0,0,0,7,9,0,47
HotSpring,7/27/20,0,0,0,0,0,0,0,0,0,1402,0,4819,0,1309,0,4,0,89,0,6221,0,0,0,0,0,0,0,5,8,0,66
Howard,7/27/20,0,0,0,0,0,0,0,0,0,246,0,2184,0,187,0,2,0,57,0,2430,0,0,0,0,0,0,0,10,25,0,47
Independence,7/27/20,0,0,0,0,0,0,0,0,0,233,0,4033,0,103,0,0,0,130,0,4266,0,0,0,0,0,0,0,23,5,0,87
Izard,7/27/20,0,0,0,0,0,0,0,0,0,34,0,1247,0,27,0,1,0,6,0,1281,0,0,0,0,0,0,0,0,1,0,12
Jackson,7/27/20,0,0,0,0,0,0,0,0,0,54,0,1664,0,44,0,1,0,9,0,1718,0,0,0,0,0,0,0,2,0,0,59
Jefferson,7/27/20,0,0,0,0,0,0,0,0,0,1204,0,11447,0,928,0,36,0,240,0,12651,0,0,0,0,0,0,0,33,21,2,211
Johnson,7/27/20,0,0,0,0,0,0,0,0,0,585,0,2688,0,502,0,0,0,83,0,3273,0,0,0,0,0,0,0,11,16,0,82
Lafayette,7/27/20,0,0,0,0,0,0,0,0,0,47,0,498,0,32,0,2,0,13,0,545,0,0,0,0,0,0,0,1,0,0,5
Lawrence,7/27/20,0,0,0,0,0,0,0,0,0,158,0,2041,0,126,0,9,0,23,0,2199,0,0,0,0,0,0,0,1,4,0,19
Lee,7/27/20,0,0,0,0,0,0,0,0,0,876,0,2648,0,850,0,6,0,20,0,3524,0,0,0,0,0,0,0,0,2,0,11
Lincoln,7/27/20,0,0,0,0,0,0,0,0,0,1152,0,2395,0,1045,0,11,0,96,0,3547,0,0,0,0,0,0,0,4,3,0,19
LittleRiver,7/27/20,0,0,0,0,0,0,0,0,0,82,0,1074,0,61,0,1,0,20,0,1156,0,0,0,0,0,0,0,2,5,0,12
Logan,7/27/20,0,0,0,0,0,0,0,0,0,127,0,2981,0,99,0,0,0,28,0,3108,0,0,0,0,0,0,0,5,4,0,53
Lonoke,7/27/20,0,0,0,0,0,0,0,0,0,356,0,6928,0,254,0,2,0,100,0,7284,0,0,0,0,0,0,0,11,11,0,183
Madison,7/27/20,0,0,0,0,0,0,0,0,0,246,0,2318,0,232,0,1,0,13,0,2564,0,0,0,0,0,0,0,1,3,0,17
Marion,7/27/20,0,0,0,0,0,0,0,0,0,18,0,1163,0,17,0,0,0,1,0,1181,0,0,0,0,0,0,0,0,2,0,8
Miller,7/27/20,0,0,0,0,0,0,0,0,0,423,0,3550,0,342,0,3,0,78,0,3973,0,0,0,0,0,0,0,7,9,0,76
MissingCountyInfo,7/27/20,0,0,0,0,0,0,0,0,0,1499,0,60913,0,949,0,0,0,550,0,62412,0,0,0,0,0,0,0,99,22,0,533
Mississippi,7/27/20,0,0,0,0,0,0,0,0,0,553,0,5446,0,415,0,8,0,130,0,5999,0,0,0,0,0,0,0,14,16,0,89
Monroe,7/27/20,0,0,0,0,0,0,0,0,0,46,0,1118,0,29,0,0,0,17,0,1164,0,0,0,0,0,0,0,3,0,0,44
Montgomery,7/27/20,0,0,0,0,0,0,0,0,0,22,0,803,0,17,0,0,0,5,0,825,0,0,0,0,0,0,0,3,2,0,14
Nevada,7/27/20,0,0,0,0,0,0,0,0,0,126,0,1463,0,108,0,8,0,10,0,1589,0,0,0,0,0,0,0,2,2,0,24
Newton,7/27/20,0,0,0,0,0,0,0,0,0,85,0,731,0,16,0,0,0,69,0,816,0,0,0,0,0,0,0,1,1,0,17
Ouachita,7/27/20,0,0,0,0,0,0,0,0,0,68,0,2552,0,45,0,1,0,22,0,2620,0,0,0,0,0,0,0,4,1,0,76
Perry,7/27/20,0,0,0,0,0,0,0,0,0,44,0,1286,0,41,0,0,0,3,0,1330,0,0,0,0,0,0,0,2,2,0,21
Phillips,7/27/20,0,0,0,0,0,0,0,0,0,250,0,3298,0,201,0,6,0,43,0,3548,0,0,0,0,0,0,0,0,9,0,32
Pike,7/27/20,0,0,0,0,0,0,0,0,0,58,0,2465,0,40,0,1,0,17,0,2523,0,0,0,0,0,0,0,1,1,1,40
Poinsett,7/27/20,0,0,0,0,0,0,0,0,0,125,0,2298,0,88,0,3,0,34,0,2423,0,0,0,0,0,0,0,6,4,0,21
Polk,7/27/20,0,0,0,0,0,0,0,0,0,121,0,1981,0,105,0,0,0,16,0,2102,0,0,0,0,0,0,0,1,2,0,30
Pope,7/27/20,0,0,0,0,0,0,0,0,0,1074,0,8833,0,839,0,6,0,229,0,9907,0,0,0,0,0,0,0,29,21,0,204
Prairie,7/27/20,0,0,0,0,0,0,0,0,0,56,0,883,0,48,0,0,0,8,0,939,0,0,0,0,0,0,0,0,9,0,13
Pulaski,7/27/20,0,0,0,0,0,0,0,0,0,4437,0,55737,0,3497,0,71,0,869,0,60174,0,0,0,0,0,0,0,91,137,0,1164
Randolph,7/27/20,0,0,0,0,0,0,0,0,0,142,0,2494,0,99,0,2,0,41,0,2636,0,0,0,0,0,0,0,5,5,0,15
Saline,7/27/20,0,0,0,0,0,0,0,0,0,777,0,13493,0,596,0,3,0,178,0,14270,0,0,0,0,0,0,0,36,17,0,329
Scott,7/27/20,0,0,0,0,0,0,0,0,0,31,0,840,0,20,0,0,0,11,0,871,0,0,0,0,0,0,0,0,1,0,14
Searcy,7/27/20,0,0,0,0,0,0,0,0,0,23,0,1007,0,20,0,0,0,3,0,1030,0,0,0,0,0,0,0,1,1,0,6
Sebastian,7/27/20,0,0,0,0,0,0,0,0,0,1454,0,17463,0,1046,0,13,0,395,0,18917,0,0,0,0,0,0,0,52,33,0,524
Sevier,7/27/20,0,0,0,0,0,0,0,0,0,906,0,4249,0,846,0,9,0,51,0,5155,0,0,0,0,0,0,0,6,10,0,53
Sharp,7/27/20,0,0,0,0,0,0,0,0,0,92,0,1444,0,72,0,5,0,15,0,1536,0,0,0,0,0,0,0,0,1,0,18
St.Francis,7/27/20,0,0,0,0,0,0,0,0,0,1079,0,5772,0,951,0,3,0,125,0,6851,0,0,0,0,0,0,0,12,9,0,156
Stone,7/27/20,0,0,0,0,0,0,0,0,0,43,0,1511,0,32,0,1,0,10,0,1554,0,0,0,0,0,0,0,0,3,0,6
Union,7/27/20,0,0,0,0,0,0,0,0,0,373,0,3837,0,305,0,15,0,53,0,4210,0,0,0,0,0,0,0,4,5,0,36
VanBuren,7/27/20,0,0,0,0,0,0,0,0,0,44,0,1425,0,36,0,2,0,6,0,1469,0,0,0,0,0,0,0,1,0,0,5
Washington,7/27/20,0,0,0,0,0,0,0,0,0,5729,0,21166,0,5147,0,40,0,542,0,26895,0,0,0,0,0,0,0,67,62,0,474
White,7/27/20,0,0,0,0,0,0,0,0,0,222,0,5483,0,178,0,2,0,42,0,5705,0,0,0,0,0,0,0,2,9,0,50
Woodruff,7/27/20,0,0,0,0,0,0,0,0,0,17,0,954,0,15,0,0,0,2,0,971,0,0,0,0,0,0,0,0,0,0,17
Yell,7/27/20,0,0,0,0,0,0,0,0,0,967,0,3535,0,893,0,14,0,60,0,4502,0,0,0,0,0,0,0,7,20,0,73
Arkansas_all_counties,7/26/20,0,0,0,0,0,0,0,0,2990671,38623,0,438644,0,31622,0,401,0,6600,0,477267,0,0,0,0,0,0,0,642,539,2,5404
Arkansas_county,7/26/20,0,0,0,0,0,0,0,0,0,168,0,2255,0,99,0,1,0,68,0,2423,0,0,0,0,0,0,0,0,5,0,33
Ashley,7/26/20,0,0,0,0,0,0,0,0,0,180,0,2224,0,115,0,4,0,61,0,2404,0,0,0,0,0,0,0,8,2,0,55
Baxter,7/26/20,0,0,0,0,0,0,0,0,0,55,0,3023,0,40,0,0,0,15,0,3078,0,0,0,0,0,0,0,0,1,0,37
Benton,7/26/20,0,0,0,0,0,0,0,0,0,4209,0,48150,0,3780,0,32,0,397,0,52359,0,0,0,0,0,0,0,53,44,1,652
Boone,7/26/20,0,0,0,0,0,0,0,0,0,108,0,3374,0,62,0,1,0,45,0,3482,0,0,0,0,0,0,0,2,0,0,69
Bradley,7/26/20,0,0,0,0,0,0,0,0,0,114,0,1599,0,81,0,2,0,31,0,1713,0,0,0,0,0,0,0,0,1,0,51
Calhoun,7/26/20,0,0,0,0,0,0,0,0,0,10,0,463,0,5,0,0,0,5,0,473,0,0,0,0,0,0,0,0,0,0,10
Carroll,7/26/20,0,0,0,0,0,0,0,0,0,322,0,3642,0,252,0,6,0,64,0,3964,0,0,0,0,0,0,0,8,4,0,33
Chicot,7/26/20,0,0,0,0,0,0,0,0,0,306,0,1904,0,235,0,4,0,67,0,2210,0,0,0,0,0,0,0,14,3,1,59
Clark,7/26/20,0,0,0,0,0,0,0,0,0,132,0,2422,0,97,0,0,0,35,0,2554,0,0,0,0,0,0,0,3,3,0,25
Clay,7/26/20,0,0,0,0,0,0,0,0,0,104,0,2069,0,84,0,4,0,16,0,2173,0,0,0,0,0,0,0,2,2,0,51
Cleburne,7/26/20,0,0,0,0,0,0,0,0,0,174,0,2912,0,144,0,5,0,25,0,3086,0,0,0,0,0,0,0,1,2,0,43
Cleveland,7/26/20,0,0,0,0,0,0,0,0,0,57,0,1008,0,39,0,1,0,17,0,1065,0,0,0,0,0,0,0,2,1,0,20
Columbia,7/26/20,0,0,0,0,0,0,0,0,0,166,0,2180,0,126,0,5,0,35,0,2346,0,0,0,0,0,0,0,4,4,0,29
Conway,7/26/20,0,0,0,0,0,0,0,0,0,122,0,2562,0,104,0,3,0,15,0,2684,0,0,0,0,0,0,0,1,1,0,34
Craighead,7/26/20,0,0,0,0,0,0,0,0,0,945,0,14782,0,731,0,8,0,206,0,15727,0,0,0,0,0,0,0,14,23,0,517
Crawford,7/26/20,0,0,0,0,0,0,0,0,0,447,0,6848,0,316,0,3,0,128,0,7295,0,0,0,0,0,0,0,9,9,0,132
Crittenden,7/26/20,0,0,0,0,0,0,0,0,0,1090,0,7351,0,947,0,16,0,127,0,8441,0,0,0,0,0,0,0,18,27,0,73
Cross,7/26/20,0,0,0,0,0,0,0,0,0,150,0,1887,0,109,0,1,0,40,0,2037,0,0,0,0,0,0,0,3,2,0,49
Dallas,7/26/20,0,0,0,0,0,0,0,0,0,32,0,710,0,16,0,0,0,16,0,742,0,0,0,0,0,0,0,3,0,0,10
Desha,7/26/20,0,0,0,0,0,0,0,0,0,128,0,1497,0,89,0,1,0,38,0,1625,0,0,0,0,0,0,0,3,2,0,37
Drew,7/26/20,0,0,0,0,0,0,0,0,0,139,0,2521,0,103,0,2,0,34,0,2660,0,0,0,0,0,0,0,10,3,0,95
Faulkner,7/26/20,0,0,0,0,0,0,0,0,0,1063,0,14976,0,871,0,4,0,188,0,16039,0,0,0,0,0,0,0,17,23,0,167
Franklin,7/26/20,0,0,0,0,0,0,0,0,0,78,0,2238,0,37,0,1,0,40,0,2316,0,0,0,0,0,0,0,12,2,0,103
Fulton,7/26/20,0,0,0,0,0,0,0,0,0,23,0,1153,0,19,0,0,0,4,0,1176,0,0,0,0,0,0,0,0,0,0,8
Garland,7/26/20,0,0,0,0,0,0,0,0,0,652,0,11372,0,432,0,5,0,215,0,12024,0,0,0,0,0,0,0,10,11,0,204
Grant,7/26/20,0,0,0,0,0,0,0,0,0,113,0,1894,0,79,0,0,0,34,0,2007,0,0,0,0,0,0,0,2,1,0,40
Greene,7/26/20,0,0,0,0,0,0,0,0,0,228,0,5536,0,168,0,1,0,59,0,5764,0,0,0,0,0,0,0,12,1,0,218
Hempstead,7/26/20,0,0,0,0,0,0,0,0,0,167,0,2434,0,114,0,2,0,51,0,2601,0,0,0,0,0,0,0,4,5,0,65
HotSpring,7/26/20,0,0,0,0,0,0,0,0,0,1397,0,4758,0,1301,0,4,0,92,0,6155,0,0,0,0,0,0,0,5,4,0,11
Howard,7/26/20,0,0,0,0,0,0,0,0,0,236,0,2147,0,162,0,2,0,72,0,2383,0,0,0,0,0,0,0,8,3,0,76
Independence,7/26/20,0,0,0,0,0,0,0,0,0,210,0,3969,0,98,0,0,0,112,0,4179,0,0,0,0,0,0,0,23,4,0,108
Izard,7/26/20,0,0,0,0,0,0,0,0,0,34,0,1235,0,26,0,1,0,7,0,1269,0,0,0,0,0,0,0,0,0,0,12
Jackson,7/26/20,0,0,0,0,0,0,0,0,0,52,0,1607,0,44,0,1,0,7,0,1659,0,0,0,0,0,0,0,0,1,0,9
Jefferson,7/26/20,0,0,0,0,0,0,0,0,0,1171,0,11269,0,907,0,34,0,230,0,12440,0,0,0,0,0,0,0,25,15,0,153
Johnson,7/26/20,0,0,0,0,0,0,0,0,0,574,0,2617,0,486,0,0,0,88,0,3191,0,0,0,0,0,0,0,14,16,0,77
Lafayette,7/26/20,0,0,0,0,0,0,0,0,0,46,0,494,0,32,0,2,0,12,0,540,0,0,0,0,0,0,0,1,1,0,6
Lawrence,7/26/20,0,0,0,0,0,0,0,0,0,157,0,2023,0,122,0,9,0,26,0,2180,0,0,0,0,0,0,0,2,4,0,16
Lee,7/26/20,0,0,0,0,0,0,0,0,0,876,0,2637,0,848,0,6,0,22,0,3513,0,0,0,0,0,0,0,5,1,0,44
Lincoln,7/26/20,0,0,0,0,0,0,0,0,0,1148,0,2380,0,1042,0,11,0,95,0,3528,0,0,0,0,0,0,0,5,0,0,2
LittleRiver,7/26/20,0,0,0,0,0,0,0,0,0,80,0,1064,0,56,0,1,0,23,0,1144,0,0,0,0,0,0,0,2,2,0,25
Logan,7/26/20,0,0,0,0,0,0,0,0,0,122,0,2933,0,95,0,0,0,27,0,3055,0,0,0,0,0,0,0,2,3,0,65
Lonoke,7/26/20,0,0,0,0,0,0,0,0,0,345,0,6756,0,243,0,2,0,100,0,7101,0,0,0,0,0,0,0,12,4,0,134
Madison,7/26/20,0,0,0,0,0,0,0,0,0,245,0,2302,0,229,0,1,0,15,0,2547,0,0,0,0,0,0,0,0,0,0,42
Marion,7/26/20,0,0,0,0,0,0,0,0,0,18,0,1155,0,15,0,0,0,3,0,1173,0,0,0,0,0,0,0,0,1,0,4
Miller,7/26/20,0,0,0,0,0,0,0,0,0,416,0,3481,0,333,0,3,0,80,0,3897,0,0,0,0,0,0,0,13,13,0,56
MissingCountyInfo,7/26/20,0,0,0,0,0,0,0,0,0,1400,0,60479,0,927,0,0,0,473,0,61879,0,0,0,0,0,0,0,19,21,0,192
Mississippi,7/26/20,0,0,0,0,0,0,0,0,0,539,0,5371,0,399,0,8,0,132,0,5910,0,0,0,0,0,0,0,4,8,0,113
Monroe,7/26/20,0,0,0,0,0,0,0,0,0,43,0,1077,0,29,0,0,0,14,0,1120,0,0,0,0,0,0,0,2,2,0,17
Montgomery,7/26/20,0,0,0,0,0,0,0,0,0,19,0,792,0,15,0,0,0,4,0,811,0,0,0,0,0,0,0,0,0,0,7
Nevada,7/26/20,0,0,0,0,0,0,0,0,0,124,0,1441,0,106,0,8,0,10,0,1565,0,0,0,0,0,0,0,1,3,0,13
Newton,7/26/20,0,0,0,0,0,0,0,0,0,84,0,715,0,15,0,0,0,69,0,799,0,0,0,0,0,0,0,1,3,0,13
Ouachita,7/26/20,0,0,0,0,0,0,0,0,0,64,0,2480,0,44,0,1,0,19,0,2544,0,0,0,0,0,0,0,3,0,0,28
Perry,7/26/20,0,0,0,0,0,0,0,0,0,42,0,1267,0,39,0,0,0,3,0,1309,0,0,0,0,0,0,0,1,0,0,8
Phillips,7/26/20,0,0,0,0,0,0,0,0,0,250,0,3266,0,192,0,6,0,52,0,3516,0,0,0,0,0,0,0,8,3,0,42
Pike,7/26/20,0,0,0,0,0,0,0,0,0,57,0,2426,0,39,0,0,0,18,0,2483,0,0,0,0,0,0,0,2,3,0,28
Poinsett,7/26/20,0,0,0,0,0,0,0,0,0,119,0,2283,0,84,0,3,0,32,0,2402,0,0,0,0,0,0,0,2,-1,0,83
Polk,7/26/20,0,0,0,0,0,0,0,0,0,120,0,1952,0,103,0,0,0,17,0,2072,0,0,0,0,0,0,0,0,4,0,28
Pope,7/26/20,0,0,0,0,0,0,0,0,0,1045,0,8658,0,818,0,6,0,221,0,9703,0,0,0,0,0,0,0,24,17,0,164
Prairie,7/26/20,0,0,0,0,0,0,0,0,0,56,0,870,0,39,0,0,0,17,0,926,0,0,0,0,0,0,0,0,0,0,18
Pulaski,7/26/20,0,0,0,0,0,0,0,0,0,4346,0,54664,0,3360,0,71,0,915,0,59010,0,0,0,0,0,0,0,49,76,0,709
Randolph,7/26/20,0,0,0,0,0,0,0,0,0,137,0,2484,0,94,0,2,0,41,0,2621,0,0,0,0,0,0,0,1,3,0,44
Saline,7/26/20,0,0,0,0,0,0,0,0,0,741,0,13200,0,579,0,3,0,159,0,13941,0,0,0,0,0,0,0,8,12,0,206
Scott,7/26/20,0,0,0,0,0,0,0,0,0,31,0,826,0,19,0,0,0,12,0,857,0,0,0,0,0,0,0,1,0,0,18
Searcy,7/26/20,0,0,0,0,0,0,0,0,0,22,0,1002,0,19,0,0,0,3,0,1024,0,0,0,0,0,0,0,0,0,0,11
Sebastian,7/26/20,0,0,0,0,0,0,0,0,0,1402,0,16991,0,1013,0,13,0,376,0,18393,0,0,0,0,0,0,0,48,34,0,367
Sevier,7/26/20,0,0,0,0,0,0,0,0,0,900,0,4202,0,836,0,9,0,55,0,5102,0,0,0,0,0,0,0,4,2,0,103
Sharp,7/26/20,0,0,0,0,0,0,0,0,0,92,0,1426,0,71,0,5,0,16,0,1518,0,0,0,0,0,0,0,3,3,0,16
St.Francis,7/26/20,0,0,0,0,0,0,0,0,0,1067,0,5628,0,942,0,3,0,122,0,6695,0,0,0,0,0,0,0,17,7,0,187
Stone,7/26/20,0,0,0,0,0,0,0,0,0,43,0,1505,0,29,0,1,0,13,0,1548,0,0,0,0,0,0,0,1,0,0,17
Union,7/26/20,0,0,0,0,0,0,0,0,0,369,0,3805,0,300,0,15,0,54,0,4174,0,0,0,0,0,0,0,8,4,0,26
VanBuren,7/26/20,0,0,0,0,0,0,0,0,0,43,0,1421,0,36,0,2,0,5,0,1464,0,0,0,0,0,0,0,0,0,0,28
Washington,7/26/20,0,0,0,0,0,0,0,0,0,5662,0,20759,0,5085,0,40,0,537,0,26421,0,0,0,0,0,0,0,86,58,0,435
White,7/26/20,0,0,0,0,0,0,0,0,0,220,0,5435,0,169,0,2,0,49,0,5655,0,0,0,0,0,0,0,8,10,0,118
Woodruff,7/26/20,0,0,0,0,0,0,0,0,0,17,0,937,0,15,0,0,0,2,0,954,0,0,0,0,0,0,0,0,0,0,4
Yell,7/26/20,0,0,0,0,0,0,0,0,0,960,0,3469,0,873,0,14,0,73,0,4429,0,0,0,0,0,0,0,9,13,0,67
Arkansas_all_counties,7/25/20,0,0,0,0,0,0,0,0,2990671,37981,0,432417,0,31083,0,399,0,6499,0,470398,0,0,0,0,0,0,0,732,1256,5,6350
Arkansas_county,7/25/20,0,0,0,0,0,0,0,0,0,168,0,2222,0,94,0,1,0,73,0,2390,0,0,0,0,0,0,0,4,11,0,37
Ashley,7/25/20,0,0,0,0,0,0,0,0,0,172,0,2177,0,113,0,4,0,55,0,2349,0,0,0,0,0,0,0,8,9,0,64
Baxter,7/25/20,0,0,0,0,0,0,0,0,0,55,0,2986,0,39,0,0,0,16,0,3041,0,0,0,0,0,0,0,3,1,0,61
Benton,7/25/20,0,0,0,0,0,0,0,0,0,4156,0,47551,0,3736,0,31,0,389,0,51707,0,0,0,0,0,0,0,30,95,0,738
Boone,7/25/20,0,0,0,0,0,0,0,0,0,106,0,3307,0,62,0,1,0,43,0,3413,0,0,0,0,0,0,0,2,4,0,44
Bradley,7/25/20,0,0,0,0,0,0,0,0,0,114,0,1548,0,80,0,2,0,32,0,1662,0,0,0,0,0,0,0,2,3,0,29
Calhoun,7/25/20,0,0,0,0,0,0,0,0,0,10,0,453,0,5,0,0,0,5,0,463,0,0,0,0,0,0,0,2,0,0,5
Carroll,7/25/20,0,0,0,0,0,0,0,0,0,314,0,3617,0,248,0,6,0,60,0,3931,0,0,0,0,0,0,0,5,10,0,41
Chicot,7/25/20,0,0,0,0,0,0,0,0,0,292,0,1859,0,232,0,3,0,57,0,2151,0,0,0,0,0,0,0,8,23,0,47
Clark,7/25/20,0,0,0,0,0,0,0,0,0,129,0,2400,0,94,0,0,0,35,0,2529,0,0,0,0,0,0,0,4,4,0,62
Clay,7/25/20,0,0,0,0,0,0,0,0,0,102,0,2020,0,82,0,4,0,16,0,2122,0,0,0,0,0,0,0,1,3,0,37
Cleburne,7/25/20,0,0,0,0,0,0,0,0,0,173,0,2870,0,142,0,5,0,26,0,3043,0,0,0,0,0,0,0,6,4,0,66
Cleveland,7/25/20,0,0,0,0,0,0,0,0,0,55,0,990,0,38,0,1,0,16,0,1045,0,0,0,0,0,0,0,0,0,0,26
Columbia,7/25/20,0,0,0,0,0,0,0,0,0,162,0,2155,0,122,0,5,0,35,0,2317,0,0,0,0,0,0,0,4,5,0,87
Conway,7/25/20,0,0,0,0,0,0,0,0,0,121,0,2529,0,103,0,3,0,15,0,2650,0,0,0,0,0,0,0,2,7,0,55
Craighead,7/25/20,0,0,0,0,0,0,0,0,0,931,0,14279,0,708,0,8,0,215,0,15210,0,0,0,0,0,0,0,36,18,0,273
Crawford,7/25/20,0,0,0,0,0,0,0,0,0,438,0,6725,0,307,0,3,0,128,0,7163,0,0,0,0,0,0,0,9,8,0,136
Crittenden,7/25/20,0,0,0,0,0,0,0,0,0,1072,0,7296,0,920,0,16,0,136,0,8368,0,0,0,0,0,0,0,14,24,0,103
Cross,7/25/20,0,0,0,0,0,0,0,0,0,147,0,1841,0,107,0,1,0,39,0,1988,0,0,0,0,0,0,0,10,3,0,54
Dallas,7/25/20,0,0,0,0,0,0,0,0,0,29,0,703,0,16,0,0,0,13,0,732,0,0,0,0,0,0,0,3,3,0,23
Desha,7/25/20,0,0,0,0,0,0,0,0,0,125,0,1463,0,87,0,1,0,37,0,1588,0,0,0,0,0,0,0,0,4,0,33
Drew,7/25/20,0,0,0,0,0,0,0,0,0,129,0,2436,0,100,0,2,0,27,0,2565,0,0,0,0,0,0,0,3,10,0,55
Faulkner,7/25/20,0,0,0,0,0,0,0,0,0,1046,0,14826,0,848,0,4,0,194,0,15872,0,0,0,0,0,0,0,33,25,0,422
Franklin,7/25/20,0,0,0,0,0,0,0,0,0,66,0,2147,0,35,0,1,0,30,0,2213,0,0,0,0,0,0,0,3,1,0,63
Fulton,7/25/20,0,0,0,0,0,0,0,0,0,23,0,1145,0,19,0,0,0,4,0,1168,0,0,0,0,0,0,0,1,0,0,11
Garland,7/25/20,0,0,0,0,0,0,0,0,0,642,0,11178,0,421,0,5,0,216,0,11820,0,0,0,0,0,0,0,38,26,0,436
Grant,7/25/20,0,0,0,0,0,0,0,0,0,111,0,1856,0,78,0,0,0,33,0,1967,0,0,0,0,0,0,0,11,2,0,100
Greene,7/25/20,0,0,0,0,0,0,0,0,0,216,0,5330,0,167,0,1,0,48,0,5546,0,0,0,0,0,0,0,5,7,0,81
Hempstead,7/25/20,0,0,0,0,0,0,0,0,0,163,0,2373,0,109,0,2,0,52,0,2536,0,0,0,0,0,0,0,4,7,0,84
HotSpring,7/25/20,0,0,0,0,0,0,0,0,0,1392,0,4752,0,1297,0,4,0,91,0,6144,0,0,0,0,0,0,0,10,180,0,111
Howard,7/25/20,0,0,0,0,0,0,0,0,0,228,0,2079,0,159,0,2,0,67,0,2307,0,0,0,0,0,0,0,6,7,1,32
Independence,7/25/20,0,0,0,0,0,0,0,0,0,187,0,3884,0,94,0,0,0,93,0,4071,0,0,0,0,0,0,0,6,6,0,96
Izard,7/25/20,0,0,0,0,0,0,0,0,0,34,0,1223,0,26,0,1,0,7,0,1257,0,0,0,0,0,0,0,3,1,0,35
Jackson,7/25/20,0,0,0,0,0,0,0,0,0,52,0,1598,0,43,0,1,0,8,0,1650,0,0,0,0,0,0,0,4,3,0,25
Jefferson,7/25/20,0,0,0,0,0,0,0,0,0,1146,0,11141,0,892,0,34,0,220,0,12287,0,0,0,0,0,0,0,13,41,1,311
Johnson,7/25/20,0,0,0,0,0,0,0,0,0,560,0,2554,0,470,0,0,0,90,0,3114,0,0,0,0,0,0,0,6,14,0,26
Lafayette,7/25/20,0,0,0,0,0,0,0,0,0,45,0,489,0,31,0,2,0,12,0,534,0,0,0,0,0,0,0,2,2,0,7
Lawrence,7/25/20,0,0,0,0,0,0,0,0,0,155,0,2009,0,118,0,9,0,28,0,2164,0,0,0,0,0,0,0,3,7,0,51
Lee,7/25/20,0,0,0,0,0,0,0,0,0,871,0,2598,0,847,0,6,0,18,0,3469,0,0,0,0,0,0,0,2,27,0,14
Lincoln,7/25/20,0,0,0,0,0,0,0,0,0,1143,0,2383,0,1042,0,11,0,90,0,3526,0,0,0,0,0,0,0,2,14,0,24
LittleRiver,7/25/20,0,0,0,0,0,0,0,0,0,78,0,1041,0,54,0,1,0,23,0,1119,0,0,0,0,0,0,0,1,4,0,14
Logan,7/25/20,0,0,0,0,0,0,0,0,0,120,0,2870,0,92,0,0,0,28,0,2990,0,0,0,0,0,0,0,2,4,0,71
Lonoke,7/25/20,0,0,0,0,0,0,0,0,0,333,0,6634,0,239,0,2,0,92,0,6967,0,0,0,0,0,0,0,9,10,0,182
Madison,7/25/20,0,0,0,0,0,0,0,0,0,245,0,2260,0,229,0,1,0,15,0,2505,0,0,0,0,0,0,0,3,6,0,17
Marion,7/25/20,0,0,0,0,0,0,0,0,0,18,0,1151,0,14,0,0,0,4,0,1169,0,0,0,0,0,0,0,0,1,0,9
Miller,7/25/20,0,0,0,0,0,0,0,0,0,403,0,3438,0,320,0,3,0,80,0,3841,0,0,0,0,0,0,0,18,8,1,94
MissingCountyInfo,7/25/20,0,0,0,0,0,0,0,0,0,1381,0,60306,0,906,0,0,0,475,0,61687,0,0,0,0,0,0,0,-17,27,0,367
Mississippi,7/25/20,0,0,0,0,0,0,0,0,0,535,0,5262,0,391,0,8,0,136,0,5797,0,0,0,0,0,0,0,12,16,1,92
Monroe,7/25/20,0,0,0,0,0,0,0,0,0,41,0,1062,0,27,0,0,0,14,0,1103,0,0,0,0,0,0,0,3,0,0,40
Montgomery,7/25/20,0,0,0,0,0,0,0,0,0,19,0,785,0,15,0,0,0,4,0,804,0,0,0,0,0,0,0,0,2,0,15
Nevada,7/25/20,0,0,0,0,0,0,0,0,0,123,0,1429,0,103,0,8,0,12,0,1552,0,0,0,0,0,0,0,4,16,0,16
Newton,7/25/20,0,0,0,0,0,0,0,0,0,83,0,703,0,12,0,0,0,71,0,786,0,0,0,0,0,0,0,10,0,0,37
Ouachita,7/25/20,0,0,0,0,0,0,0,0,0,61,0,2455,0,44,0,1,0,16,0,2516,0,0,0,0,0,0,0,2,1,0,45
Perry,7/25/20,0,0,0,0,0,0,0,0,0,41,0,1260,0,39,0,0,0,2,0,1301,0,0,0,0,0,0,0,0,3,0,24
Phillips,7/25/20,0,0,0,0,0,0,0,0,0,242,0,3232,0,189,0,6,0,47,0,3474,0,0,0,0,0,0,0,12,15,0,44
Pike,7/25/20,0,0,0,0,0,0,0,0,0,55,0,2400,0,36,0,0,0,19,0,2455,0,0,0,0,0,0,0,6,5,0,60
Poinsett,7/25/20,0,0,0,0,0,0,0,0,0,117,0,2202,0,85,0,3,0,29,0,2319,0,0,0,0,0,0,0,5,3,0,38
Polk,7/25/20,0,0,0,0,0,0,0,0,0,120,0,1924,0,99,0,0,0,21,0,2044,0,0,0,0,0,0,0,9,3,0,56
Pope,7/25/20,0,0,0,0,0,0,0,0,0,1021,0,8518,0,801,0,6,0,214,0,9539,0,0,0,0,0,0,0,17,31,1,140
Prairie,7/25/20,0,0,0,0,0,0,0,0,0,56,0,852,0,39,0,0,0,17,0,908,0,0,0,0,0,0,0,0,1,0,35
Pulaski,7/25/20,0,0,0,0,0,0,0,0,0,4297,0,54004,0,3284,0,71,0,942,0,58301,0,0,0,0,0,0,0,114,150,0,1624
Randolph,7/25/20,0,0,0,0,0,0,0,0,0,136,0,2441,0,91,0,2,0,43,0,2577,0,0,0,0,0,0,0,3,13,0,66
Saline,7/25/20,0,0,0,0,0,0,0,0,0,733,0,13002,0,567,0,3,0,163,0,13735,0,0,0,0,0,0,0,32,25,0,409
Scott,7/25/20,0,0,0,0,0,0,0,0,0,30,0,809,0,19,0,0,0,11,0,839,0,0,0,0,0,0,0,4,0,0,18
Searcy,7/25/20,0,0,0,0,0,0,0,0,0,22,0,991,0,19,0,0,0,3,0,1013,0,0,0,0,0,0,0,0,1,0,11
Sebastian,7/25/20,0,0,0,0,0,0,0,0,0,1354,0,16672,0,979,0,13,0,362,0,18026,0,0,0,0,0,0,0,36,63,0,351
Sevier,7/25/20,0,0,0,0,0,0,0,0,0,896,0,4103,0,834,0,9,0,53,0,4999,0,0,0,0,0,0,0,3,11,0,56
Sharp,7/25/20,0,0,0,0,0,0,0,0,0,89,0,1413,0,68,0,5,0,16,0,1502,0,0,0,0,0,0,0,0,4,0,20
St.Francis,7/25/20,0,0,0,0,0,0,0,0,0,1050,0,5458,0,935,0,3,0,112,0,6508,0,0,0,0,0,0,0,52,13,0,198
Stone,7/25/20,0,0,0,0,0,0,0,0,0,42,0,1489,0,29,0,1,0,12,0,1531,0,0,0,0,0,0,0,2,2,0,16
Union,7/25/20,0,0,0,0,0,0,0,0,0,361,0,3787,0,296,0,15,0,50,0,4148,0,0,0,0,0,0,0,11,20,0,102
VanBuren,7/25/20,0,0,0,0,0,0,0,0,0,43,0,1393,0,36,0,2,0,5,0,1436,0,0,0,0,0,0,0,1,0,0,20
Washington,7/25/20,0,0,0,0,0,0,0,0,0,5576,0,20410,0,5027,0,40,0,509,0,25986,0,0,0,0,0,0,0,40,143,0,386
White,7/25/20,0,0,0,0,0,0,0,0,0,212,0,5325,0,159,0,2,0,51,0,5537,0,0,0,0,0,0,0,23,7,0,163
Woodruff,7/25/20,0,0,0,0,0,0,0,0,0,17,0,933,0,15,0,0,0,2,0,950,0,0,0,0,0,0,0,0,0,0,35
Yell,7/25/20,0,0,0,0,0,0,0,0,0,951,0,3411,0,860,0,14,0,77,0,4362,0,0,0,0,0,0,0,7,29,0,58
Arkansas_all_counties,7/24/20,0,0,0,0,0,0,0,0,2990671,37249,0,424215,0,29827,0,394,0,7028,0,461464,0,0,0,0,0,0,0,990,963,8,10080
Arkansas_county,7/24/20,0,0,0,0,0,0,0,0,0,164,0,2189,0,83,0,1,0,80,0,2353,0,0,0,0,0,0,0,7,10,0,115
Ashley,7/24/20,0,0,0,0,0,0,0,0,0,164,0,2121,0,104,0,4,0,56,0,2285,0,0,0,0,0,0,0,11,2,0,26
Baxter,7/24/20,0,0,0,0,0,0,0,0,0,52,0,2928,0,38,0,0,0,14,0,2980,0,0,0,0,0,0,0,3,1,0,20
Benton,7/24/20,0,0,0,0,0,0,0,0,0,4126,0,46843,0,3641,0,31,0,454,0,50969,0,0,0,0,0,0,0,58,46,1,1575
Boone,7/24/20,0,0,0,0,0,0,0,0,0,104,0,3265,0,58,0,1,0,45,0,3369,0,0,0,0,0,0,0,12,2,0,25
Bradley,7/24/20,0,0,0,0,0,0,0,0,0,112,0,1521,0,77,0,2,0,33,0,1633,0,0,0,0,0,0,0,6,2,0,24
Calhoun,7/24/20,0,0,0,0,0,0,0,0,0,8,0,450,0,5,0,0,0,3,0,458,0,0,0,0,0,0,0,0,0,0,1
Carroll,7/24/20,0,0,0,0,0,0,0,0,0,309,0,3581,0,238,0,6,0,65,0,3890,0,0,0,0,0,0,0,5,6,0,41
Chicot,7/24/20,0,0,0,0,0,0,0,0,0,284,0,1820,0,209,0,3,0,72,0,2104,0,0,0,0,0,0,0,2,3,0,15
Clark,7/24/20,0,0,0,0,0,0,0,0,0,125,0,2342,0,90,0,0,0,35,0,2467,0,0,0,0,0,0,0,5,2,0,27
Clay,7/24/20,0,0,0,0,0,0,0,0,0,101,0,1984,0,79,0,4,0,18,0,2085,0,0,0,0,0,0,0,0,1,0,9
Cleburne,7/24/20,0,0,0,0,0,0,0,0,0,167,0,2810,0,138,0,5,0,24,0,2977,0,0,0,0,0,0,0,2,1,0,38
Cleveland,7/24/20,0,0,0,0,0,0,0,0,0,55,0,964,0,38,0,1,0,16,0,1019,0,0,0,0,0,0,0,5,0,1,12
Columbia,7/24/20,0,0,0,0,0,0,0,0,0,158,0,2072,0,117,0,5,0,36,0,2230,0,0,0,0,0,0,0,6,4,0,18
Conway,7/24/20,0,0,0,0,0,0,0,0,0,119,0,2476,0,96,0,3,0,20,0,2595,0,0,0,0,0,0,0,1,3,0,43
Craighead,7/24/20,0,0,0,0,0,0,0,0,0,895,0,14042,0,690,0,8,0,197,0,14937,0,0,0,0,0,0,0,22,18,0,188
Crawford,7/24/20,0,0,0,0,0,0,0,0,0,429,0,6598,0,299,0,3,0,127,0,7027,0,0,0,0,0,0,0,36,10,0,231
Crittenden,7/24/20,0,0,0,0,0,0,0,0,0,1058,0,7207,0,896,0,16,0,146,0,8265,0,0,0,0,0,0,0,14,15,1,97
Cross,7/24/20,0,0,0,0,0,0,0,0,0,137,0,1797,0,104,0,1,0,32,0,1934,0,0,0,0,0,0,0,6,3,0,16
Dallas,7/24/20,0,0,0,0,0,0,0,0,0,26,0,683,0,13,0,0,0,13,0,709,0,0,0,0,0,0,0,2,1,0,3
Desha,7/24/20,0,0,0,0,0,0,0,0,0,125,0,1430,0,83,0,1,0,41,0,1555,0,0,0,0,0,0,0,2,6,0,6
Drew,7/24/20,0,0,0,0,0,0,0,0,0,126,0,2384,0,90,0,2,0,34,0,2510,0,0,0,0,0,0,0,2,3,0,39
Faulkner,7/24/20,0,0,0,0,0,0,0,0,0,1013,0,14437,0,823,0,4,0,186,0,15450,0,0,0,0,0,0,0,17,15,0,225
Franklin,7/24/20,0,0,0,0,0,0,0,0,0,63,0,2087,0,34,0,1,0,28,0,2150,0,0,0,0,0,0,0,2,0,0,32
Fulton,7/24/20,0,0,0,0,0,0,0,0,0,22,0,1135,0,19,0,0,0,3,0,1157,0,0,0,0,0,0,0,0,0,0,4
Garland,7/24/20,0,0,0,0,0,0,0,0,0,604,0,10780,0,395,0,5,0,204,0,11384,0,0,0,0,0,0,0,23,19,0,132
Grant,7/24/20,0,0,0,0,0,0,0,0,0,100,0,1767,0,76,0,0,0,24,0,1867,0,0,0,0,0,0,0,5,5,0,36
Greene,7/24/20,0,0,0,0,0,0,0,0,0,211,0,5254,0,160,0,1,0,50,0,5465,0,0,0,0,0,0,0,3,4,1,65
Hempstead,7/24/20,0,0,0,0,0,0,0,0,0,159,0,2293,0,102,0,2,0,55,0,2452,0,0,0,0,0,0,0,9,8,0,26
HotSpring,7/24/20,0,0,0,0,0,0,0,0,0,1382,0,4651,0,1117,0,4,0,261,0,6033,0,0,0,0,0,0,0,10,317,2,45
Howard,7/24/20,0,0,0,0,0,0,0,0,0,222,0,2053,0,152,0,1,0,69,0,2275,0,0,0,0,0,0,0,5,6,0,25
Independence,7/24/20,0,0,0,0,0,0,0,0,0,181,0,3794,0,88,0,0,0,93,0,3975,0,0,0,0,0,0,0,29,3,0,44
Izard,7/24/20,0,0,0,0,0,0,0,0,0,31,0,1191,0,25,0,1,0,5,0,1222,0,0,0,0,0,0,0,1,0,0,6
Jackson,7/24/20,0,0,0,0,0,0,0,0,0,48,0,1577,0,40,0,1,0,7,0,1625,0,0,0,0,0,0,0,1,2,0,10
Jefferson,7/24/20,0,0,0,0,0,0,0,0,0,1133,0,10843,0,851,0,33,0,249,0,11976,0,0,0,0,0,0,0,39,11,1,129
Johnson,7/24/20,0,0,0,0,0,0,0,0,0,554,0,2534,0,456,0,0,0,98,0,3088,0,0,0,0,0,0,0,14,10,0,156
Lafayette,7/24/20,0,0,0,0,0,0,0,0,0,43,0,484,0,29,0,2,0,12,0,527,0,0,0,0,0,0,0,1,0,0,2
Lawrence,7/24/20,0,0,0,0,0,0,0,0,0,152,0,1961,0,111,0,9,0,32,0,2113,0,0,0,0,0,0,0,2,5,0,17
Lee,7/24/20,0,0,0,0,0,0,0,0,0,869,0,2586,0,820,0,6,0,43,0,3455,0,0,0,0,0,0,0,1,0,0,13
Lincoln,7/24/20,0,0,0,0,0,0,0,0,0,1141,0,2361,0,1028,0,11,0,102,0,3502,0,0,0,0,0,0,0,3,1,0,16
LittleRiver,7/24/20,0,0,0,0,0,0,0,0,0,77,0,1028,0,50,0,1,0,26,0,1105,0,0,0,0,0,0,0,2,2,0,11
Logan,7/24/20,0,0,0,0,0,0,0,0,0,118,0,2801,0,88,0,0,0,30,0,2919,0,0,0,0,0,0,0,1,2,0,30
Lonoke,7/24/20,0,0,0,0,0,0,0,0,0,324,0,6461,0,229,0,2,0,93,0,6785,0,0,0,0,0,0,0,33,16,0,270
Madison,7/24/20,0,0,0,0,0,0,0,0,0,242,0,2246,0,223,0,1,0,18,0,2488,0,0,0,0,0,0,0,4,3,0,47
Marion,7/24/20,0,0,0,0,0,0,0,0,0,18,0,1142,0,13,0,0,0,5,0,1160,0,0,0,0,0,0,0,0,0,0,5
Miller,7/24/20,0,0,0,0,0,0,0,0,0,385,0,3362,0,312,0,2,0,71,0,3747,0,0,0,0,0,0,0,6,15,0,24
MissingCountyInfo,7/24/20,0,0,0,0,0,0,0,0,0,1398,0,59922,0,879,0,0,0,519,0,61320,0,0,0,0,0,0,0,111,29,0,237
Mississippi,7/24/20,0,0,0,0,0,0,0,0,0,523,0,5182,0,375,0,7,0,141,0,5705,0,0,0,0,0,0,0,12,15,0,52
Monroe,7/24/20,0,0,0,0,0,0,0,0,0,38,0,1025,0,27,0,0,0,11,0,1063,0,0,0,0,0,0,0,1,2,0,16
Montgomery,7/24/20,0,0,0,0,0,0,0,0,0,19,0,770,0,13,0,0,0,6,0,789,0,0,0,0,0,0,0,1,1,0,6
Nevada,7/24/20,0,0,0,0,0,0,0,0,0,119,0,1417,0,87,0,8,0,24,0,1536,0,0,0,0,0,0,0,2,1,0,7
Newton,7/24/20,0,0,0,0,0,0,0,0,0,73,0,676,0,12,0,0,0,61,0,749,0,0,0,0,0,0,0,55,1,0,77
Ouachita,7/24/20,0,0,0,0,0,0,0,0,0,59,0,2412,0,43,0,1,0,15,0,2471,0,0,0,0,0,0,0,-2,4,0,14
Perry,7/24/20,0,0,0,0,0,0,0,0,0,41,0,1236,0,36,0,0,0,5,0,1277,0,0,0,0,0,0,0,0,2,0,18
Phillips,7/24/20,0,0,0,0,0,0,0,0,0,230,0,3200,0,174,0,6,0,50,0,3430,0,0,0,0,0,0,0,4,4,0,16
Pike,7/24/20,0,0,0,0,0,0,0,0,0,49,0,2346,0,31,0,0,0,18,0,2395,0,0,0,0,0,0,0,0,2,0,13
Poinsett,7/24/20,0,0,0,0,0,0,0,0,0,112,0,2169,0,82,0,3,0,27,0,2281,0,0,0,0,0,0,0,1,1,0,43
Polk,7/24/20,0,0,0,0,0,0,0,0,0,111,0,1877,0,96,0,0,0,15,0,1988,0,0,0,0,0,0,0,2,1,0,18
Pope,7/24/20,0,0,0,0,0,0,0,0,0,1004,0,8395,0,770,0,5,0,229,0,9399,0,0,0,0,0,0,0,38,24,0,249
Prairie,7/24/20,0,0,0,0,0,0,0,0,0,56,0,817,0,38,0,0,0,18,0,873,0,0,0,0,0,0,0,3,3,0,18
Pulaski,7/24/20,0,0,0,0,0,0,0,0,0,4183,0,52494,0,3134,0,71,0,978,0,56677,0,0,0,0,0,0,0,139,95,1,1668
Randolph,7/24/20,0,0,0,0,0,0,0,0,0,133,0,2378,0,78,0,2,0,53,0,2511,0,0,0,0,0,0,0,12,3,0,23
Saline,7/24/20,0,0,0,0,0,0,0,0,0,701,0,12625,0,542,0,3,0,156,0,13326,0,0,0,0,0,0,0,34,31,0,355
Scott,7/24/20,0,0,0,0,0,0,0,0,0,26,0,795,0,19,0,0,0,7,0,821,0,0,0,0,0,0,0,0,0,0,12
Searcy,7/24/20,0,0,0,0,0,0,0,0,0,22,0,980,0,18,0,0,0,4,0,1002,0,0,0,0,0,0,0,1,0,0,4
Sebastian,7/24/20,0,0,0,0,0,0,0,0,0,1318,0,16357,0,916,0,13,0,389,0,17675,0,0,0,0,0,0,0,40,29,0,167
Sevier,7/24/20,0,0,0,0,0,0,0,0,0,893,0,4050,0,823,0,9,0,61,0,4943,0,0,0,0,0,0,0,0,7,0,20
Sharp,7/24/20,0,0,0,0,0,0,0,0,0,89,0,1393,0,64,0,5,0,20,0,1482,0,0,0,0,0,0,0,3,0,0,15
St.Francis,7/24/20,0,0,0,0,0,0,0,0,0,998,0,5312,0,922,0,3,0,73,0,6310,0,0,0,0,0,0,0,17,7,0,123
Stone,7/24/20,0,0,0,0,0,0,0,0,0,40,0,1475,0,27,0,1,0,12,0,1515,0,0,0,0,0,0,0,1,2,0,13
Union,7/24/20,0,0,0,0,0,0,0,0,0,350,0,3696,0,276,0,15,0,59,0,4046,0,0,0,0,0,0,0,5,6,0,34
VanBuren,7/24/20,0,0,0,0,0,0,0,0,0,42,0,1374,0,36,0,2,0,4,0,1416,0,0,0,0,0,0,0,1,0,0,10
Washington,7/24/20,0,0,0,0,0,0,0,0,0,5536,0,20064,0,4884,0,40,0,612,0,25600,0,0,0,0,0,0,0,85,90,0,469
White,7/24/20,0,0,0,0,0,0,0,0,0,189,0,5185,0,152,0,2,0,35,0,5374,0,0,0,0,0,0,0,4,6,0,97
Woodruff,7/24/20,0,0,0,0,0,0,0,0,0,17,0,898,0,15,0,0,0,2,0,915,0,0,0,0,0,0,0,0,1,0,6
Yell,7/24/20,0,0,0,0,0,0,0,0,0,944,0,3360,0,831,0,14,0,99,0,4304,0,0,0,0,0,0,0,2,13,0,41
Arkansas_all_counties,7/23/20,0,0,0,0,0,0,0,0,2990671,36259,0,417425,0,28864,0,386,0,7009,0,453684,0,0,0,0,0,0,0,1013,874,6,6604
Arkansas_county,7/23/20,0,0,0,0,0,0,0,0,0,157,0,2081,0,73,0,1,0,83,0,2238,0,0,0,0,0,0,0,11,6,0,32
Ashley,7/23/20,0,0,0,0,0,0,0,0,0,153,0,2106,0,102,0,4,0,47,0,2259,0,0,0,0,0,0,0,11,5,0,32
Baxter,7/23/20,0,0,0,0,0,0,0,0,0,49,0,2911,0,37,0,0,0,12,0,2960,0,0,0,0,0,0,0,1,3,0,52
Benton,7/23/20,0,0,0,0,0,0,0,0,0,4068,0,45326,0,3595,0,30,0,443,0,49394,0,0,0,0,0,0,0,83,82,1,944
Boone,7/23/20,0,0,0,0,0,0,0,0,0,92,0,3252,0,56,0,1,0,35,0,3344,0,0,0,0,0,0,0,9,6,0,91
Bradley,7/23/20,0,0,0,0,0,0,0,0,0,106,0,1503,0,75,0,2,0,29,0,1609,0,0,0,0,0,0,0,2,6,0,18
Calhoun,7/23/20,0,0,0,0,0,0,0,0,0,8,0,449,0,5,0,0,0,3,0,457,0,0,0,0,0,0,0,0,0,0,1
Carroll,7/23/20,0,0,0,0,0,0,0,0,0,304,0,3545,0,232,0,6,0,66,0,3849,0,0,0,0,0,0,0,10,8,0,86
Chicot,7/23/20,0,0,0,0,0,0,0,0,0,282,0,1807,0,206,0,3,0,73,0,2089,0,0,0,0,0,0,0,16,5,0,70
Clark,7/23/20,0,0,0,0,0,0,0,0,0,120,0,2320,0,88,0,0,0,32,0,2440,0,0,0,0,0,0,0,13,3,0,39
Clay,7/23/20,0,0,0,0,0,0,0,0,0,101,0,1975,0,78,0,4,0,19,0,2076,0,0,0,0,0,0,0,7,4,0,53
Cleburne,7/23/20,0,0,0,0,0,0,0,0,0,165,0,2774,0,137,0,5,0,23,0,2939,0,0,0,0,0,0,0,5,4,0,33
Cleveland,7/23/20,0,0,0,0,0,0,0,0,0,50,0,957,0,38,0,0,0,12,0,1007,0,0,0,0,0,0,0,1,1,0,11
Columbia,7/23/20,0,0,0,0,0,0,0,0,0,152,0,2060,0,113,0,5,0,34,0,2212,0,0,0,0,0,0,0,5,8,0,39
Conway,7/23/20,0,0,0,0,0,0,0,0,0,118,0,2434,0,93,0,3,0,22,0,2552,0,0,0,0,0,0,0,1,3,0,76
Craighead,7/23/20,0,0,0,0,0,0,0,0,0,873,0,13876,0,672,0,8,0,193,0,14749,0,0,0,0,0,0,0,45,35,0,363
Crawford,7/23/20,0,0,0,0,0,0,0,0,0,393,0,6403,0,289,0,3,0,101,0,6796,0,0,0,0,0,0,0,14,13,0,167
Crittenden,7/23/20,0,0,0,0,0,0,0,0,0,1044,0,7124,0,881,0,15,0,148,0,8168,0,0,0,0,0,0,0,50,23,0,234
Cross,7/23/20,0,0,0,0,0,0,0,0,0,131,0,1787,0,101,0,1,0,29,0,1918,0,0,0,0,0,0,0,7,3,0,29
Dallas,7/23/20,0,0,0,0,0,0,0,0,0,24,0,682,0,12,0,0,0,12,0,706,0,0,0,0,0,0,0,2,0,0,10
Desha,7/23/20,0,0,0,0,0,0,0,0,0,123,0,1426,0,77,0,1,0,45,0,1549,0,0,0,0,0,0,0,6,3,0,39
Drew,7/23/20,0,0,0,0,0,0,0,0,0,124,0,2347,0,87,0,2,0,35,0,2471,0,0,0,0,0,0,0,7,5,0,94
Faulkner,7/23/20,0,0,0,0,0,0,0,0,0,996,0,14229,0,808,0,4,0,184,0,15225,0,0,0,0,0,0,0,26,20,0,325
Franklin,7/23/20,0,0,0,0,0,0,0,0,0,61,0,2057,0,34,0,1,0,26,0,2118,0,0,0,0,0,0,0,1,4,0,53
Fulton,7/23/20,0,0,0,0,0,0,0,0,0,22,0,1131,0,19,0,0,0,3,0,1153,0,0,0,0,0,0,0,1,1,0,18
Garland,7/23/20,0,0,0,0,0,0,0,0,0,581,0,10671,0,376,0,5,0,200,0,11252,0,0,0,0,0,0,0,32,21,0,269
Grant,7/23/20,0,0,0,0,0,0,0,0,0,95,0,1736,0,71,0,0,0,24,0,1831,0,0,0,0,0,0,0,1,5,0,24
Greene,7/23/20,0,0,0,0,0,0,0,0,0,208,0,5192,0,156,0,0,0,52,0,5400,0,0,0,0,0,0,0,17,4,0,229
Hempstead,7/23/20,0,0,0,0,0,0,0,0,0,150,0,2276,0,94,0,2,0,54,0,2426,0,0,0,0,0,0,0,5,6,0,46
HotSpring,7/23/20,0,0,0,0,0,0,0,0,0,1372,0,4616,0,800,0,2,0,570,0,5988,0,0,0,0,0,0,0,5,51,0,66
Howard,7/23/20,0,0,0,0,0,0,0,0,0,217,0,2033,0,146,0,1,0,70,0,2250,0,0,0,0,0,0,0,8,7,0,32
Independence,7/23/20,0,0,0,0,0,0,0,0,0,152,0,3779,0,85,0,0,0,67,0,3931,0,0,0,0,0,0,0,26,8,0,123
Izard,7/23/20,0,0,0,0,0,0,0,0,0,30,0,1186,0,25,0,1,0,4,0,1216,0,0,0,0,0,0,0,1,1,0,18
Jackson,7/23/20,0,0,0,0,0,0,0,0,0,47,0,1568,0,38,0,1,0,8,0,1615,0,0,0,0,0,0,0,0,0,0,22
Jefferson,7/23/20,0,0,0,0,0,0,0,0,0,1094,0,10753,0,840,0,32,0,222,0,11847,0,0,0,0,0,0,0,25,20,0,166
Johnson,7/23/20,0,0,0,0,0,0,0,0,0,540,0,2392,0,446,0,0,0,94,0,2932,0,0,0,0,0,0,0,25,19,0,103
Lafayette,7/23/20,0,0,0,0,0,0,0,0,0,42,0,483,0,29,0,2,0,11,0,525,0,0,0,0,0,0,0,1,1,0,10
Lawrence,7/23/20,0,0,0,0,0,0,0,0,0,150,0,1946,0,106,0,9,0,35,0,2096,0,0,0,0,0,0,0,2,2,0,25
Lee,7/23/20,0,0,0,0,0,0,0,0,0,868,0,2574,0,820,0,6,0,42,0,3442,0,0,0,0,0,0,0,1,6,0,18
Lincoln,7/23/20,0,0,0,0,0,0,0,0,0,1138,0,2348,0,1027,0,11,0,100,0,3486,0,0,0,0,0,0,0,6,1,0,38
LittleRiver,7/23/20,0,0,0,0,0,0,0,0,0,75,0,1019,0,48,0,1,0,26,0,1094,0,0,0,0,0,0,0,3,0,0,9
Logan,7/23/20,0,0,0,0,0,0,0,0,0,117,0,2772,0,86,0,0,0,31,0,2889,0,0,0,0,0,0,0,5,6,0,69
Lonoke,7/23/20,0,0,0,0,0,0,0,0,0,291,0,6224,0,213,0,2,0,76,0,6515,0,0,0,0,0,0,0,15,7,0,89
Madison,7/23/20,0,0,0,0,0,0,0,0,0,238,0,2203,0,220,0,1,0,17,0,2441,0,0,0,0,0,0,0,0,1,0,27
Marion,7/23/20,0,0,0,0,0,0,0,0,0,18,0,1137,0,13,0,0,0,5,0,1155,0,0,0,0,0,0,0,1,1,0,17
Miller,7/23/20,0,0,0,0,0,0,0,0,0,379,0,3344,0,297,0,2,0,80,0,3723,0,0,0,0,0,0,0,11,12,0,40
MissingCountyInfo,7/23/20,0,0,0,0,0,0,0,0,0,1287,0,59796,0,850,0,0,0,437,0,61083,0,0,0,0,0,0,0,21,9,0,401
Mississippi,7/23/20,0,0,0,0,0,0,0,0,0,511,0,5142,0,360,0,7,0,144,0,5653,0,0,0,0,0,0,0,22,21,0,148
Monroe,7/23/20,0,0,0,0,0,0,0,0,0,37,0,1010,0,25,0,0,0,12,0,1047,0,0,0,0,0,0,0,1,0,0,7
Montgomery,7/23/20,0,0,0,0,0,0,0,0,0,18,0,765,0,12,0,0,0,6,0,783,0,0,0,0,0,0,0,2,0,0,8
Nevada,7/23/20,0,0,0,0,0,0,0,0,0,117,0,1412,0,86,0,8,0,23,0,1529,0,0,0,0,0,0,0,0,1,0,13
Newton,7/23/20,0,0,0,0,0,0,0,0,0,18,0,654,0,11,0,0,0,7,0,672,0,0,0,0,0,0,0,0,1,0,12
Ouachita,7/23/20,0,0,0,0,0,0,0,0,0,61,0,2396,0,39,0,1,0,21,0,2457,0,0,0,0,0,0,0,6,4,0,61
Perry,7/23/20,0,0,0,0,0,0,0,0,0,41,0,1218,0,34,0,0,0,7,0,1259,0,0,0,0,0,0,0,2,0,0,37
Phillips,7/23/20,0,0,0,0,0,0,0,0,0,226,0,3188,0,170,0,6,0,50,0,3414,0,0,0,0,0,0,0,7,4,0,75
Pike,7/23/20,0,0,0,0,0,0,0,0,0,49,0,2333,0,29,0,0,0,20,0,2382,0,0,0,0,0,0,0,6,1,0,72
Poinsett,7/23/20,0,0,0,0,0,0,0,0,0,111,0,2127,0,81,0,3,0,27,0,2238,0,0,0,0,0,0,0,2,4,0,50
Polk,7/23/20,0,0,0,0,0,0,0,0,0,109,0,1861,0,95,0,0,0,14,0,1970,0,0,0,0,0,0,0,3,2,0,13
Pope,7/23/20,0,0,0,0,0,0,0,0,0,966,0,8184,0,746,0,5,0,215,0,9150,0,0,0,0,0,0,0,29,25,0,265
Prairie,7/23/20,0,0,0,0,0,0,0,0,0,53,0,802,0,35,0,0,0,18,0,855,0,0,0,0,0,0,0,1,2,0,17
Pulaski,7/23/20,0,0,0,0,0,0,0,0,0,4044,0,50965,0,3039,0,70,0,935,0,55009,0,0,0,0,0,0,0,121,116,1,903
Randolph,7/23/20,0,0,0,0,0,0,0,0,0,121,0,2367,0,75,0,2,0,44,0,2488,0,0,0,0,0,0,0,6,3,0,26
Saline,7/23/20,0,0,0,0,0,0,0,0,0,667,0,12304,0,511,0,3,0,153,0,12971,0,0,0,0,0,0,0,30,25,0,244
Scott,7/23/20,0,0,0,0,0,0,0,0,0,26,0,783,0,19,0,0,0,7,0,809,0,0,0,0,0,0,0,5,2,0,28
Searcy,7/23/20,0,0,0,0,0,0,0,0,0,21,0,977,0,18,0,0,0,3,0,998,0,0,0,0,0,0,0,1,0,0,27
Sebastian,7/23/20,0,0,0,0,0,0,0,0,0,1278,0,16230,0,887,0,13,0,378,0,17508,0,0,0,0,0,0,0,64,48,2,508
Sevier,7/23/20,0,0,0,0,0,0,0,0,0,893,0,4030,0,816,0,9,0,68,0,4923,0,0,0,0,0,0,0,13,11,0,28
Sharp,7/23/20,0,0,0,0,0,0,0,0,0,86,0,1381,0,64,0,5,0,17,0,1467,0,0,0,0,0,0,0,3,2,0,37
St.Francis,7/23/20,0,0,0,0,0,0,0,0,0,981,0,5206,0,915,0,3,0,63,0,6187,0,0,0,0,0,0,0,13,5,0,154
Stone,7/23/20,0,0,0,0,0,0,0,0,0,39,0,1463,0,25,0,1,0,13,0,1502,0,0,0,0,0,0,0,2,4,0,16
Union,7/23/20,0,0,0,0,0,0,0,0,0,345,0,3667,0,270,0,15,0,60,0,4012,0,0,0,0,0,0,0,10,10,1,38
VanBuren,7/23/20,0,0,0,0,0,0,0,0,0,41,0,1365,0,36,0,2,0,3,0,1406,0,0,0,0,0,0,0,1,0,0,19
Washington,7/23/20,0,0,0,0,0,0,0,0,0,5451,0,19680,0,4794,0,40,0,617,0,25131,0,0,0,0,0,0,0,101,123,1,479
White,7/23/20,0,0,0,0,0,0,0,0,0,185,0,5092,0,146,0,2,0,37,0,5277,0,0,0,0,0,0,0,3,5,0,77
Woodruff,7/23/20,0,0,0,0,0,0,0,0,0,17,0,892,0,14,0,0,0,3,0,909,0,0,0,0,0,0,0,0,-1,0,6
Yell,7/23/20,0,0,0,0,0,0,0,0,0,942,0,3321,0,818,0,14,0,110,0,4263,0,0,0,0,0,0,0,14,17,0,56
Arkansas_all_counties,7/22/20,0,0,0,0,0,0,0,0,2990671,35246,0,410221,0,27990,0,380,0,6876,0,445467,0,0,0,0,0,0,0,591,707,6,4599
Arkansas_county,7/22/20,0,0,0,0,0,0,0,0,0,146,0,2060,0,67,0,1,0,78,0,2206,0,0,0,0,0,0,0,2,9,0,24
Ashley,7/22/20,0,0,0,0,0,0,0,0,0,142,0,2042,0,97,0,4,0,41,0,2184,0,0,0,0,0,0,0,4,4,0,53
Baxter,7/22/20,0,0,0,0,0,0,0,0,0,48,0,2860,0,34,0,0,0,14,0,2908,0,0,0,0,0,0,0,2,0,0,7
Benton,7/22/20,0,0,0,0,0,0,0,0,0,3985,0,44465,0,3513,0,29,0,443,0,48450,0,0,0,0,0,0,0,46,73,1,313
Boone,7/22/20,0,0,0,0,0,0,0,0,0,83,0,3170,0,50,0,1,0,32,0,3253,0,0,0,0,0,0,0,2,5,0,11
Bradley,7/22/20,0,0,0,0,0,0,0,0,0,104,0,1487,0,69,0,2,0,33,0,1591,0,0,0,0,0,0,0,1,2,0,9
Calhoun,7/22/20,0,0,0,0,0,0,0,0,0,8,0,448,0,5,0,0,0,3,0,456,0,0,0,0,0,0,0,1,0,0,3
Carroll,7/22/20,0,0,0,0,0,0,0,0,0,294,0,3469,0,224,0,6,0,64,0,3763,0,0,0,0,0,0,0,3,5,0,14
Chicot,7/22/20,0,0,0,0,0,0,0,0,0,266,0,1753,0,201,0,3,0,62,0,2019,0,0,0,0,0,0,0,2,11,0,6
Clark,7/22/20,0,0,0,0,0,0,0,0,0,107,0,2294,0,85,0,0,0,22,0,2401,0,0,0,0,0,0,0,2,5,0,13
Clay,7/22/20,0,0,0,0,0,0,0,0,0,94,0,1929,0,74,0,4,0,16,0,2023,0,0,0,0,0,0,0,2,0,1,26
Cleburne,7/22/20,0,0,0,0,0,0,0,0,0,160,0,2746,0,133,0,5,0,22,0,2906,0,0,0,0,0,0,0,1,4,0,37
Cleveland,7/22/20,0,0,0,0,0,0,0,0,0,49,0,947,0,37,0,0,0,12,0,996,0,0,0,0,0,0,0,3,2,0,10
Columbia,7/22/20,0,0,0,0,0,0,0,0,0,147,0,2026,0,105,0,5,0,37,0,2173,0,0,0,0,0,0,0,6,3,0,19
Conway,7/22/20,0,0,0,0,0,0,0,0,0,117,0,2359,0,90,0,3,0,24,0,2476,0,0,0,0,0,0,0,2,2,0,59
Craighead,7/22/20,0,0,0,0,0,0,0,0,0,828,0,13558,0,637,0,8,0,183,0,14386,0,0,0,0,0,0,0,33,21,0,361
Crawford,7/22/20,0,0,0,0,0,0,0,0,0,379,0,6250,0,276,0,3,0,100,0,6629,0,0,0,0,0,0,0,9,13,0,86
Crittenden,7/22/20,0,0,0,0,0,0,0,0,0,994,0,6940,0,858,0,15,0,121,0,7934,0,0,0,0,0,0,0,22,14,0,121
Cross,7/22/20,0,0,0,0,0,0,0,0,0,124,0,1765,0,98,0,1,0,25,0,1889,0,0,0,0,0,0,0,3,-1,0,26
Dallas,7/22/20,0,0,0,0,0,0,0,0,0,22,0,674,0,12,0,0,0,10,0,696,0,0,0,0,0,0,0,1,0,0,5
Desha,7/22/20,0,0,0,0,0,0,0,0,0,117,0,1393,0,74,0,1,0,42,0,1510,0,0,0,0,0,0,0,1,1,0,8
Drew,7/22/20,0,0,0,0,0,0,0,0,0,117,0,2260,0,82,0,2,0,33,0,2377,0,0,0,0,0,0,0,1,0,0,10
Faulkner,7/22/20,0,0,0,0,0,0,0,0,0,970,0,13930,0,788,0,4,0,178,0,14900,0,0,0,0,0,0,0,30,48,0,505
Franklin,7/22/20,0,0,0,0,0,0,0,0,0,60,0,2005,0,30,0,1,0,29,0,2065,0,0,0,0,0,0,0,1,0,0,41
Fulton,7/22/20,0,0,0,0,0,0,0,0,0,21,0,1114,0,18,0,0,0,3,0,1135,0,0,0,0,0,0,0,0,0,0,2
Garland,7/22/20,0,0,0,0,0,0,0,0,0,549,0,10434,0,355,0,5,0,189,0,10983,0,0,0,0,0,0,0,30,14,0,226
Grant,7/22/20,0,0,0,0,0,0,0,0,0,94,0,1713,0,66,0,0,0,28,0,1807,0,0,0,0,0,0,0,4,3,0,19
Greene,7/22/20,0,0,0,0,0,0,0,0,0,191,0,4980,0,152,0,0,0,39,0,5171,0,0,0,0,0,0,0,6,0,0,93
Hempstead,7/22/20,0,0,0,0,0,0,0,0,0,145,0,2235,0,88,0,2,0,55,0,2380,0,0,0,0,0,0,0,11,6,0,37
HotSpring,7/22/20,0,0,0,0,0,0,0,0,0,1367,0,4555,0,749,0,2,0,616,0,5922,0,0,0,0,0,0,0,5,4,0,39
Howard,7/22/20,0,0,0,0,0,0,0,0,0,209,0,2009,0,139,0,1,0,69,0,2218,0,0,0,0,0,0,0,13,3,0,47
Independence,7/22/20,0,0,0,0,0,0,0,0,0,126,0,3682,0,77,0,0,0,49,0,3808,0,0,0,0,0,0,0,1,3,0,17
Izard,7/22/20,0,0,0,0,0,0,0,0,0,29,0,1169,0,24,0,1,0,4,0,1198,0,0,0,0,0,0,0,0,0,0,3
Jackson,7/22/20,0,0,0,0,0,0,0,0,0,47,0,1546,0,38,0,1,0,8,0,1593,0,0,0,0,0,0,0,0,0,1,10
Jefferson,7/22/20,0,0,0,0,0,0,0,0,0,1069,0,10612,0,820,0,32,0,217,0,11681,0,0,0,0,0,0,0,6,23,0,66
Johnson,7/22/20,0,0,0,0,0,0,0,0,0,515,0,2314,0,427,0,0,0,88,0,2829,0,0,0,0,0,0,0,9,18,0,189
Lafayette,7/22/20,0,0,0,0,0,0,0,0,0,41,0,474,0,28,0,2,0,11,0,515,0,0,0,0,0,0,0,3,2,0,8
Lawrence,7/22/20,0,0,0,0,0,0,0,0,0,148,0,1923,0,104,0,9,0,35,0,2071,0,0,0,0,0,0,0,4,4,0,22
Lee,7/22/20,0,0,0,0,0,0,0,0,0,867,0,2557,0,814,0,6,0,47,0,3424,0,0,0,0,0,0,0,1,2,0,4
Lincoln,7/22/20,0,0,0,0,0,0,0,0,0,1132,0,2316,0,1026,0,11,0,95,0,3448,0,0,0,0,0,0,0,0,2,0,6
LittleRiver,7/22/20,0,0,0,0,0,0,0,0,0,72,0,1013,0,48,0,1,0,23,0,1085,0,0,0,0,0,0,0,5,0,0,17
Logan,7/22/20,0,0,0,0,0,0,0,0,0,112,0,2708,0,80,0,0,0,32,0,2820,0,0,0,0,0,0,0,0,0,0,51
Lonoke,7/22/20,0,0,0,0,0,0,0,0,0,276,0,6150,0,206,0,2,0,68,0,6426,0,0,0,0,0,0,0,10,2,0,81
Madison,7/22/20,0,0,0,0,0,0,0,0,0,238,0,2176,0,219,0,1,0,18,0,2414,0,0,0,0,0,0,0,2,4,0,20
Marion,7/22/20,0,0,0,0,0,0,0,0,0,17,0,1121,0,12,0,0,0,5,0,1138,0,0,0,0,0,0,0,1,0,0,13
Miller,7/22/20,0,0,0,0,0,0,0,0,0,368,0,3315,0,285,0,2,0,81,0,3683,0,0,0,0,0,0,0,5,9,0,51
MissingCountyInfo,7/22/20,0,0,0,0,0,0,0,0,0,1266,0,59416,0,841,0,0,0,425,0,60682,0,0,0,0,0,0,0,59,44,0,242
Mississippi,7/22/20,0,0,0,0,0,0,0,0,0,489,0,5016,0,339,0,7,0,143,0,5505,0,0,0,0,0,0,0,14,19,0,139
Monroe,7/22/20,0,0,0,0,0,0,0,0,0,36,0,1004,0,25,0,0,0,11,0,1040,0,0,0,0,0,0,0,1,1,0,11
Montgomery,7/22/20,0,0,0,0,0,0,0,0,0,16,0,759,0,12,0,0,0,4,0,775,0,0,0,0,0,0,0,1,2,0,6
Nevada,7/22/20,0,0,0,0,0,0,0,0,0,117,0,1399,0,85,0,8,0,24,0,1516,0,0,0,0,0,0,0,0,-1,1,8
Newton,7/22/20,0,0,0,0,0,0,0,0,0,18,0,642,0,10,0,0,0,8,0,660,0,0,0,0,0,0,0,1,0,0,14
Ouachita,7/22/20,0,0,0,0,0,0,0,0,0,55,0,2341,0,35,0,1,0,19,0,2396,0,0,0,0,0,0,0,0,2,0,18
Perry,7/22/20,0,0,0,0,0,0,0,0,0,39,0,1183,0,34,0,0,0,5,0,1222,0,0,0,0,0,0,0,0,0,0,20
Phillips,7/22/20,0,0,0,0,0,0,0,0,0,219,0,3120,0,166,0,6,0,47,0,3339,0,0,0,0,0,0,0,2,7,0,18
Pike,7/22/20,0,0,0,0,0,0,0,0,0,43,0,2267,0,28,0,0,0,15,0,2310,0,0,0,0,0,0,0,4,2,0,29
Poinsett,7/22/20,0,0,0,0,0,0,0,0,0,109,0,2079,0,77,0,3,0,29,0,2188,0,0,0,0,0,0,0,7,7,0,68
Polk,7/22/20,0,0,0,0,0,0,0,0,0,106,0,1851,0,93,0,0,0,13,0,1957,0,0,0,0,0,0,0,0,2,0,14
Pope,7/22/20,0,0,0,0,0,0,0,0,0,937,0,7948,0,721,0,5,0,211,0,8885,0,0,0,0,0,0,0,24,28,0,393
Prairie,7/22/20,0,0,0,0,0,0,0,0,0,52,0,786,0,33,0,0,0,19,0,838,0,0,0,0,0,0,0,0,1,0,4
Pulaski,7/22/20,0,0,0,0,0,0,0,0,0,3923,0,50183,0,2923,0,69,0,931,0,54106,0,0,0,0,0,0,0,80,74,0,1099
Randolph,7/22/20,0,0,0,0,0,0,0,0,0,115,0,2347,0,72,0,2,0,41,0,2462,0,0,0,0,0,0,0,9,2,0,35
Saline,7/22/20,0,0,0,0,0,0,0,0,0,637,0,12090,0,486,0,3,0,148,0,12727,0,0,0,0,0,0,0,12,17,0,154
Scott,7/22/20,0,0,0,0,0,0,0,0,0,21,0,760,0,17,0,0,0,4,0,781,0,0,0,0,0,0,0,0,2,0,5
Searcy,7/22/20,0,0,0,0,0,0,0,0,0,20,0,951,0,18,0,0,0,2,0,971,0,0,0,0,0,0,0,0,1,0,6
Sebastian,7/22/20,0,0,0,0,0,0,0,0,0,1214,0,15786,0,839,0,11,0,364,0,17000,0,0,0,0,0,0,0,17,40,1,173
Sevier,7/22/20,0,0,0,0,0,0,0,0,0,880,0,4015,0,805,0,9,0,66,0,4895,0,0,0,0,0,0,0,11,5,0,64
Sharp,7/22/20,0,0,0,0,0,0,0,0,0,83,0,1347,0,62,0,5,0,16,0,1430,0,0,0,0,0,0,0,2,2,0,8
St.Francis,7/22/20,0,0,0,0,0,0,0,0,0,968,0,5065,0,910,0,3,0,55,0,6033,0,0,0,0,0,0,0,4,6,0,42
Stone,7/22/20,0,0,0,0,0,0,0,0,0,37,0,1449,0,21,0,1,0,15,0,1486,0,0,0,0,0,0,0,0,0,0,5
Union,7/22/20,0,0,0,0,0,0,0,0,0,335,0,3639,0,260,0,14,0,61,0,3974,0,0,0,0,0,0,0,2,4,0,22
VanBuren,7/22/20,0,0,0,0,0,0,0,0,0,40,0,1347,0,36,0,2,0,2,0,1387,0,0,0,0,0,0,0,1,0,0,21
Washington,7/22/20,0,0,0,0,0,0,0,0,0,5350,0,19302,0,4671,0,39,0,640,0,24652,0,0,0,0,0,0,0,38,100,0,197
White,7/22/20,0,0,0,0,0,0,0,0,0,182,0,5018,0,141,0,2,0,39,0,5200,0,0,0,0,0,0,0,5,3,0,31
Woodruff,7/22/20,0,0,0,0,0,0,0,0,0,17,0,886,0,15,0,0,0,2,0,903,0,0,0,0,0,0,0,0,0,0,6
Yell,7/22/20,0,0,0,0,0,0,0,0,0,928,0,3279,0,801,0,14,0,113,0,4207,0,0,0,0,0,0,0,1,17,1,192
Arkansas_all_counties,7/21/20,0,0,0,0,0,0,0,0,2990671,34655,0,404980,0,27283,0,374,0,6998,0,439635,0,0,0,0,0,0,0,728,886,11,6323
Arkansas_county,7/21/20,0,0,0,0,0,0,0,0,0,144,0,2038,0,58,0,1,0,85,0,2182,0,0,0,0,0,0,0,10,6,0,64
Ashley,7/21/20,0,0,0,0,0,0,0,0,0,138,0,1993,0,93,0,4,0,41,0,2131,0,0,0,0,0,0,0,1,2,1,21
Baxter,7/21/20,0,0,0,0,0,0,0,0,0,46,0,2855,0,34,0,0,0,12,0,2901,0,0,0,0,0,0,0,2,1,0,58
Benton,7/21/20,0,0,0,0,0,0,0,0,0,3939,0,44198,0,3440,0,28,0,471,0,48137,0,0,0,0,0,0,0,52,77,1,721
Boone,7/21/20,0,0,0,0,0,0,0,0,0,81,0,3161,0,45,0,1,0,35,0,3242,0,0,0,0,0,0,0,2,3,0,55
Bradley,7/21/20,0,0,0,0,0,0,0,0,0,103,0,1479,0,67,0,2,0,34,0,1582,0,0,0,0,0,0,0,2,4,0,34
Calhoun,7/21/20,0,0,0,0,0,0,0,0,0,7,0,446,0,5,0,0,0,2,0,453,0,0,0,0,0,0,0,1,2,0,8
Carroll,7/21/20,0,0,0,0,0,0,0,0,0,291,0,3458,0,219,0,6,0,66,0,3749,0,0,0,0,0,0,0,5,2,0,51
Chicot,7/21/20,0,0,0,0,0,0,0,0,0,264,0,1749,0,190,0,3,0,71,0,2013,0,0,0,0,0,0,0,4,6,0,7
Clark,7/21/20,0,0,0,0,0,0,0,0,0,105,0,2283,0,80,0,0,0,25,0,2388,0,0,0,0,0,0,0,2,3,0,26
Clay,7/21/20,0,0,0,0,0,0,0,0,0,92,0,1905,0,74,0,3,0,15,0,1997,0,0,0,0,0,0,0,2,2,0,7
Cleburne,7/21/20,0,0,0,0,0,0,0,0,0,159,0,2710,0,129,0,5,0,25,0,2869,0,0,0,0,0,0,0,3,5,0,24
Cleveland,7/21/20,0,0,0,0,0,0,0,0,0,46,0,940,0,35,0,0,0,11,0,986,0,0,0,0,0,0,0,3,1,0,21
Columbia,7/21/20,0,0,0,0,0,0,0,0,0,141,0,2013,0,102,0,5,0,34,0,2154,0,0,0,0,0,0,0,2,7,0,29
Conway,7/21/20,0,0,0,0,0,0,0,0,0,115,0,2302,0,88,0,3,0,24,0,2417,0,0,0,0,0,0,0,1,3,0,48
Craighead,7/21/20,0,0,0,0,0,0,0,0,0,795,0,13230,0,616,0,8,0,171,0,14025,0,0,0,0,0,0,0,56,39,0,187
Crawford,7/21/20,0,0,0,0,0,0,0,0,0,370,0,6173,0,263,0,3,0,104,0,6543,0,0,0,0,0,0,0,10,9,0,138
Crittenden,7/21/20,0,0,0,0,0,0,0,0,0,972,0,6841,0,844,0,15,0,113,0,7813,0,0,0,0,0,0,0,15,19,0,98
Cross,7/21/20,0,0,0,0,0,0,0,0,0,121,0,1742,0,99,0,1,0,21,0,1863,0,0,0,0,0,0,0,4,7,0,27
Dallas,7/21/20,0,0,0,0,0,0,0,0,0,21,0,670,0,12,0,0,0,9,0,691,0,0,0,0,0,0,0,0,0,0,8
Desha,7/21/20,0,0,0,0,0,0,0,0,0,116,0,1386,0,73,0,1,0,42,0,1502,0,0,0,0,0,0,0,6,1,0,20
Drew,7/21/20,0,0,0,0,0,0,0,0,0,116,0,2251,0,82,0,2,0,32,0,2367,0,0,0,0,0,0,0,0,2,0,30
Faulkner,7/21/20,0,0,0,0,0,0,0,0,0,940,0,13455,0,740,0,4,0,196,0,14395,0,0,0,0,0,0,0,14,24,0,275
Franklin,7/21/20,0,0,0,0,0,0,0,0,0,59,0,1965,0,30,0,1,0,28,0,2024,0,0,0,0,0,0,0,15,0,0,126
Fulton,7/21/20,0,0,0,0,0,0,0,0,0,21,0,1112,0,18,0,0,0,3,0,1133,0,0,0,0,0,0,0,1,1,0,6
Garland,7/21/20,0,0,0,0,0,0,0,0,0,519,0,10238,0,341,0,5,0,173,0,10757,0,0,0,0,0,0,0,20,11,0,166
Grant,7/21/20,0,0,0,0,0,0,0,0,0,90,0,1698,0,63,0,0,0,27,0,1788,0,0,0,0,0,0,0,7,2,0,35
Greene,7/21/20,0,0,0,0,0,0,0,0,0,185,0,4893,0,152,0,0,0,33,0,5078,0,0,0,0,0,0,0,10,8,0,26
Hempstead,7/21/20,0,0,0,0,0,0,0,0,0,134,0,2209,0,82,0,2,0,50,0,2343,0,0,0,0,0,0,0,3,2,1,29
HotSpring,7/21/20,0,0,0,0,0,0,0,0,0,1362,0,4521,0,745,0,2,0,615,0,5883,0,0,0,0,0,0,0,8,140,0,38
Howard,7/21/20,0,0,0,0,0,0,0,0,0,196,0,1975,0,136,0,1,0,59,0,2171,0,0,0,0,0,0,0,18,4,0,72
Independence,7/21/20,0,0,0,0,0,0,0,0,0,125,0,3666,0,74,0,0,0,51,0,3791,0,0,0,0,0,0,0,11,4,0,47
Izard,7/21/20,0,0,0,0,0,0,0,0,0,29,0,1166,0,24,0,1,0,4,0,1195,0,0,0,0,0,0,0,1,2,0,12
Jackson,7/21/20,0,0,0,0,0,0,0,0,0,47,0,1536,0,38,0,0,0,9,0,1583,0,0,0,0,0,0,0,-1,2,0,11
Jefferson,7/21/20,0,0,0,0,0,0,0,0,0,1063,0,10552,0,797,0,32,0,234,0,11615,0,0,0,0,0,0,0,34,27,2,202
Johnson,7/21/20,0,0,0,0,0,0,0,0,0,506,0,2134,0,409,0,0,0,97,0,2640,0,0,0,0,0,0,0,6,9,0,141
Lafayette,7/21/20,0,0,0,0,0,0,0,0,0,38,0,469,0,26,0,2,0,10,0,507,0,0,0,0,0,0,0,0,1,0,16
Lawrence,7/21/20,0,0,0,0,0,0,0,0,0,144,0,1905,0,100,0,9,0,35,0,2049,0,0,0,0,0,0,0,2,3,0,17
Lee,7/21/20,0,0,0,0,0,0,0,0,0,866,0,2554,0,812,0,6,0,48,0,3420,0,0,0,0,0,0,0,1,26,1,10
Lincoln,7/21/20,0,0,0,0,0,0,0,0,0,1132,0,2310,0,1024,0,11,0,97,0,3442,0,0,0,0,0,0,0,11,2,0,93
LittleRiver,7/21/20,0,0,0,0,0,0,0,0,0,67,0,1001,0,48,0,1,0,18,0,1068,0,0,0,0,0,0,0,2,1,0,10
Logan,7/21/20,0,0,0,0,0,0,0,0,0,112,0,2657,0,80,0,0,0,32,0,2769,0,0,0,0,0,0,0,2,6,0,66
Lonoke,7/21/20,0,0,0,0,0,0,0,0,0,266,0,6079,0,204,0,2,0,60,0,6345,0,0,0,0,0,0,0,5,6,0,88
Madison,7/21/20,0,0,0,0,0,0,0,0,0,236,0,2158,0,215,0,1,0,20,0,2394,0,0,0,0,0,0,0,5,2,0,39
Marion,7/21/20,0,0,0,0,0,0,0,0,0,16,0,1109,0,12,0,0,0,4,0,1125,0,0,0,0,0,0,0,1,0,0,3
Miller,7/21/20,0,0,0,0,0,0,0,0,0,363,0,3269,0,276,0,2,0,85,0,3632,0,0,0,0,0,0,0,3,4,0,43
MissingCountyInfo,7/21/20,0,0,0,0,0,0,0,0,0,1207,0,59233,0,797,0,0,0,410,0,60440,0,0,0,0,0,0,0,-48,0,0,388
Mississippi,7/21/20,0,0,0,0,0,0,0,0,0,475,0,4891,0,320,0,7,0,148,0,5366,0,0,0,0,0,0,0,25,23,1,90
Monroe,7/21/20,0,0,0,0,0,0,0,0,0,35,0,994,0,24,0,0,0,11,0,1029,0,0,0,0,0,0,0,0,0,0,15
Montgomery,7/21/20,0,0,0,0,0,0,0,0,0,15,0,754,0,10,0,0,0,5,0,769,0,0,0,0,0,0,0,0,1,0,7
Nevada,7/21/20,0,0,0,0,0,0,0,0,0,117,0,1391,0,86,0,7,0,24,0,1508,0,0,0,0,0,0,0,0,1,1,18
Newton,7/21/20,0,0,0,0,0,0,0,0,0,17,0,629,0,10,0,0,0,7,0,646,0,0,0,0,0,0,0,0,1,0,14
Ouachita,7/21/20,0,0,0,0,0,0,0,0,0,55,0,2323,0,33,0,1,0,21,0,2378,0,0,0,0,0,0,0,3,1,0,38
Perry,7/21/20,0,0,0,0,0,0,0,0,0,39,0,1163,0,34,0,0,0,5,0,1202,0,0,0,0,0,0,0,0,1,0,17
Phillips,7/21/20,0,0,0,0,0,0,0,0,0,217,0,3104,0,159,0,6,0,52,0,3321,0,0,0,0,0,0,0,3,4,0,27
Pike,7/21/20,0,0,0,0,0,0,0,0,0,39,0,2242,0,26,0,0,0,13,0,2281,0,0,0,0,0,0,0,4,6,0,36
Poinsett,7/21/20,0,0,0,0,0,0,0,0,0,102,0,2018,0,70,0,3,0,29,0,2120,0,0,0,0,0,0,0,6,1,0,20
Polk,7/21/20,0,0,0,0,0,0,0,0,0,106,0,1837,0,91,0,0,0,15,0,1943,0,0,0,0,0,0,0,2,3,0,25
Pope,7/21/20,0,0,0,0,0,0,0,0,0,913,0,7579,0,693,0,5,0,215,0,8492,0,0,0,0,0,0,0,38,36,1,246
Prairie,7/21/20,0,0,0,0,0,0,0,0,0,52,0,782,0,32,0,0,0,20,0,834,0,0,0,0,0,0,0,3,3,0,10
Pulaski,7/21/20,0,0,0,0,0,0,0,0,0,3843,0,49164,0,2849,0,69,0,925,0,53007,0,0,0,0,0,0,0,126,98,0,1257
Randolph,7/21/20,0,0,0,0,0,0,0,0,0,106,0,2321,0,70,0,2,0,34,0,2427,0,0,0,0,0,0,0,8,3,0,21
Saline,7/21/20,0,0,0,0,0,0,0,0,0,625,0,11948,0,469,0,3,0,153,0,12573,0,0,0,0,0,0,0,31,18,0,189
Scott,7/21/20,0,0,0,0,0,0,0,0,0,21,0,755,0,15,0,0,0,6,0,776,0,0,0,0,0,0,0,0,0,0,20
Searcy,7/21/20,0,0,0,0,0,0,0,0,0,20,0,945,0,17,0,0,0,3,0,965,0,0,0,0,0,0,0,0,2,0,9
Sebastian,7/21/20,0,0,0,0,0,0,0,0,0,1197,0,15630,0,799,0,10,0,388,0,16827,0,0,0,0,0,0,0,31,38,1,255
Sevier,7/21/20,0,0,0,0,0,0,0,0,0,869,0,3962,0,800,0,9,0,60,0,4831,0,0,0,0,0,0,0,8,11,0,31
Sharp,7/21/20,0,0,0,0,0,0,0,0,0,81,0,1341,0,60,0,5,0,16,0,1422,0,0,0,0,0,0,0,0,5,0,8
St.Francis,7/21/20,0,0,0,0,0,0,0,0,0,964,0,5027,0,904,0,3,0,57,0,5991,0,0,0,0,0,0,0,4,3,0,71
Stone,7/21/20,0,0,0,0,0,0,0,0,0,37,0,1444,0,21,0,1,0,15,0,1481,0,0,0,0,0,0,0,5,1,0,12
Union,7/21/20,0,0,0,0,0,0,0,0,0,333,0,3619,0,256,0,14,0,63,0,3952,0,0,0,0,0,0,0,20,4,0,95
VanBuren,7/21/20,0,0,0,0,0,0,0,0,0,39,0,1327,0,36,0,2,0,1,0,1366,0,0,0,0,0,0,0,1,0,0,26
Washington,7/21/20,0,0,0,0,0,0,0,0,0,5312,0,19143,0,4571,0,39,0,702,0,24455,0,0,0,0,0,0,0,78,108,1,430
White,7/21/20,0,0,0,0,0,0,0,0,0,177,0,4992,0,138,0,2,0,37,0,5169,0,0,0,0,0,0,0,8,8,0,58
Woodruff,7/21/20,0,0,0,0,0,0,0,0,0,17,0,880,0,15,0,0,0,2,0,897,0,0,0,0,0,0,0,-1,2,0,12
Yell,7/21/20,0,0,0,0,0,0,0,0,0,927,0,3088,0,784,0,13,0,130,0,4015,0,0,0,0,0,0,0,11,16,0,121
Arkansas_all_counties,7/20/20,0,0,0,0,0,0,0,0,2990671,33927,0,398889,0,26397,0,363,0,7167,0,432816,0,0,0,0,0,0,0,699,545,6,6023
Arkansas_county,7/20/20,0,0,0,0,0,0,0,0,0,134,0,1984,0,52,0,1,0,81,0,2118,0,0,0,0,0,0,0,21,4,0,72
Ashley,7/20/20,0,0,0,0,0,0,0,0,0,137,0,1973,0,91,0,3,0,43,0,2110,0,0,0,0,0,0,0,3,0,0,31
Baxter,7/20/20,0,0,0,0,0,0,0,0,0,44,0,2799,0,33,0,0,0,11,0,2843,0,0,0,0,0,0,0,0,0,0,27
Benton,7/20/20,0,0,0,0,0,0,0,0,0,3887,0,43529,0,3363,0,27,0,497,0,47416,0,0,0,0,0,0,0,55,39,2,545
Boone,7/20/20,0,0,0,0,0,0,0,0,0,79,0,3108,0,42,0,1,0,36,0,3187,0,0,0,0,0,0,0,3,0,0,52
Bradley,7/20/20,0,0,0,0,0,0,0,0,0,101,0,1447,0,63,0,2,0,36,0,1548,0,0,0,0,0,0,0,4,1,0,67
Calhoun,7/20/20,0,0,0,0,0,0,0,0,0,6,0,439,0,3,0,0,0,3,0,445,0,0,0,0,0,0,0,1,0,0,11
Carroll,7/20/20,0,0,0,0,0,0,0,0,0,286,0,3412,0,217,0,6,0,63,0,3698,0,0,0,0,0,0,0,16,4,0,77
Chicot,7/20/20,0,0,0,0,0,0,0,0,0,260,0,1746,0,184,0,3,0,73,0,2006,0,0,0,0,0,0,0,3,1,0,27
Clark,7/20/20,0,0,0,0,0,0,0,0,0,103,0,2259,0,77,0,0,0,26,0,2362,0,0,0,0,0,0,0,6,4,0,33
Clay,7/20/20,0,0,0,0,0,0,0,0,0,90,0,1900,0,72,0,3,0,15,0,1990,0,0,0,0,0,0,0,1,2,0,30
Cleburne,7/20/20,0,0,0,0,0,0,0,0,0,156,0,2689,0,124,0,5,0,27,0,2845,0,0,0,0,0,0,0,2,3,0,38
Cleveland,7/20/20,0,0,0,0,0,0,0,0,0,43,0,922,0,34,0,0,0,9,0,965,0,0,0,0,0,0,0,2,1,0,11
Columbia,7/20/20,0,0,0,0,0,0,0,0,0,139,0,1986,0,95,0,5,0,39,0,2125,0,0,0,0,0,0,0,5,2,0,52
Conway,7/20/20,0,0,0,0,0,0,0,0,0,114,0,2255,0,85,0,3,0,26,0,2369,0,0,0,0,0,0,0,1,1,0,53
Craighead,7/20/20,0,0,0,0,0,0,0,0,0,739,0,13099,0,577,0,8,0,154,0,13838,0,0,0,0,0,0,0,29,25,0,214
Crawford,7/20/20,0,0,0,0,0,0,0,0,0,360,0,6045,0,254,0,3,0,103,0,6405,0,0,0,0,0,0,0,7,13,0,62
Crittenden,7/20/20,0,0,0,0,0,0,0,0,0,957,0,6758,0,825,0,15,0,117,0,7715,0,0,0,0,0,0,0,13,9,1,74
Cross,7/20/20,0,0,0,0,0,0,0,0,0,117,0,1719,0,92,0,1,0,24,0,1836,0,0,0,0,0,0,0,2,4,0,35
Dallas,7/20/20,0,0,0,0,0,0,0,0,0,21,0,662,0,12,0,0,0,9,0,683,0,0,0,0,0,0,0,1,0,0,11
Desha,7/20/20,0,0,0,0,0,0,0,0,0,110,0,1372,0,72,0,1,0,37,0,1482,0,0,0,0,0,0,0,8,0,0,41
Drew,7/20/20,0,0,0,0,0,0,0,0,0,116,0,2221,0,80,0,2,0,34,0,2337,0,0,0,0,0,0,0,3,2,0,48
Faulkner,7/20/20,0,0,0,0,0,0,0,0,0,926,0,13194,0,716,0,4,0,206,0,14120,0,0,0,0,0,0,0,21,25,0,324
Franklin,7/20/20,0,0,0,0,0,0,0,0,0,44,0,1854,0,30,0,1,0,13,0,1898,0,0,0,0,0,0,0,3,0,0,45
Fulton,7/20/20,0,0,0,0,0,0,0,0,0,20,0,1107,0,17,0,0,0,3,0,1127,0,0,0,0,0,0,0,0,1,0,5
Garland,7/20/20,0,0,0,0,0,0,0,0,0,499,0,10092,0,330,0,5,0,164,0,10591,0,0,0,0,0,0,0,26,12,0,220
Grant,7/20/20,0,0,0,0,0,0,0,0,0,83,0,1670,0,61,0,0,0,22,0,1753,0,0,0,0,0,0,0,4,1,0,37
Greene,7/20/20,0,0,0,0,0,0,0,0,0,175,0,4877,0,144,0,0,0,31,0,5052,0,0,0,0,0,0,0,4,2,0,78
Hempstead,7/20/20,0,0,0,0,0,0,0,0,0,131,0,2183,0,80,0,1,0,50,0,2314,0,0,0,0,0,0,0,9,3,0,97
HotSpring,7/20/20,0,0,0,0,0,0,0,0,0,1354,0,4491,0,605,0,2,0,747,0,5845,0,0,0,0,0,0,0,5,4,0,71
Howard,7/20/20,0,0,0,0,0,0,0,0,0,178,0,1921,0,132,0,1,0,45,0,2099,0,0,0,0,0,0,0,9,1,0,114
Independence,7/20/20,0,0,0,0,0,0,0,0,0,114,0,3630,0,70,0,0,0,44,0,3744,0,0,0,0,0,0,0,4,1,0,61
Izard,7/20/20,0,0,0,0,0,0,0,0,0,28,0,1155,0,22,0,1,0,5,0,1183,0,0,0,0,0,0,0,0,0,0,6
Jackson,7/20/20,0,0,0,0,0,0,0,0,0,48,0,1524,0,36,0,0,0,12,0,1572,0,0,0,0,0,0,0,2,1,0,22
Jefferson,7/20/20,0,0,0,0,0,0,0,0,0,1029,0,10384,0,770,0,30,0,229,0,11413,0,0,0,0,0,0,0,6,13,0,127
Johnson,7/20/20,0,0,0,0,0,0,0,0,0,500,0,1999,0,400,0,0,0,100,0,2499,0,0,0,0,0,0,0,15,20,0,150
Lafayette,7/20/20,0,0,0,0,0,0,0,0,0,38,0,453,0,25,0,2,0,11,0,491,0,0,0,0,0,0,0,1,2,0,13
Lawrence,7/20/20,0,0,0,0,0,0,0,0,0,142,0,1890,0,97,0,9,0,36,0,2032,0,0,0,0,0,0,0,7,2,0,26
Lee,7/20/20,0,0,0,0,0,0,0,0,0,865,0,2545,0,786,0,5,0,74,0,3410,0,0,0,0,0,0,0,4,1,0,83
Lincoln,7/20/20,0,0,0,0,0,0,0,0,0,1121,0,2228,0,1022,0,11,0,88,0,3349,0,0,0,0,0,0,0,2,2,0,92
LittleRiver,7/20/20,0,0,0,0,0,0,0,0,0,65,0,993,0,47,0,1,0,17,0,1058,0,0,0,0,0,0,0,2,0,0,36
Logan,7/20/20,0,0,0,0,0,0,0,0,0,110,0,2593,0,74,0,0,0,36,0,2703,0,0,0,0,0,0,0,7,5,0,65
Lonoke,7/20/20,0,0,0,0,0,0,0,0,0,261,0,5996,0,198,0,2,0,61,0,6257,0,0,0,0,0,0,0,4,8,0,68
Madison,7/20/20,0,0,0,0,0,0,0,0,0,231,0,2124,0,213,0,1,0,17,0,2355,0,0,0,0,0,0,0,2,0,0,26
Marion,7/20/20,0,0,0,0,0,0,0,0,0,15,0,1107,0,12,0,0,0,3,0,1122,0,0,0,0,0,0,0,0,0,0,20
Miller,7/20/20,0,0,0,0,0,0,0,0,0,360,0,3229,0,272,0,2,0,86,0,3589,0,0,0,0,0,0,0,24,21,0,329
MissingCountyInfo,7/20/20,0,0,0,0,0,0,0,0,0,1255,0,58797,0,797,0,0,0,458,0,60052,0,0,0,0,0,0,0,52,29,0,369
Mississippi,7/20/20,0,0,0,0,0,0,0,0,0,450,0,4826,0,297,0,6,0,147,0,5276,0,0,0,0,0,0,0,29,9,1,115
Monroe,7/20/20,0,0,0,0,0,0,0,0,0,35,0,979,0,24,0,0,0,11,0,1014,0,0,0,0,0,0,0,2,2,0,13
Montgomery,7/20/20,0,0,0,0,0,0,0,0,0,15,0,747,0,9,0,0,0,6,0,762,0,0,0,0,0,0,0,1,0,0,12
Nevada,7/20/20,0,0,0,0,0,0,0,0,0,117,0,1373,0,85,0,6,0,26,0,1490,0,0,0,0,0,0,0,0,0,0,14
Newton,7/20/20,0,0,0,0,0,0,0,0,0,17,0,615,0,9,0,0,0,8,0,632,0,0,0,0,0,0,0,1,0,0,15
Ouachita,7/20/20,0,0,0,0,0,0,0,0,0,52,0,2288,0,32,0,1,0,19,0,2340,0,0,0,0,0,0,0,3,2,0,75
Perry,7/20/20,0,0,0,0,0,0,0,0,0,39,0,1146,0,33,0,0,0,6,0,1185,0,0,0,0,0,0,0,-1,-1,0,17
Phillips,7/20/20,0,0,0,0,0,0,0,0,0,214,0,3080,0,155,0,6,0,53,0,3294,0,0,0,0,0,0,0,6,3,0,67
Pike,7/20/20,0,0,0,0,0,0,0,0,0,35,0,2210,0,20,0,0,0,15,0,2245,0,0,0,0,0,0,0,3,3,0,43
Poinsett,7/20/20,0,0,0,0,0,0,0,0,0,96,0,2004,0,69,0,3,0,24,0,2100,0,0,0,0,0,0,0,4,3,0,35
Polk,7/20/20,0,0,0,0,0,0,0,0,0,104,0,1814,0,88,0,0,0,16,0,1918,0,0,0,0,0,0,0,1,1,0,22
Pope,7/20/20,0,0,0,0,0,0,0,0,0,875,0,7371,0,657,0,4,0,214,0,8246,0,0,0,0,0,0,0,26,24,0,335
Prairie,7/20/20,0,0,0,0,0,0,0,0,0,49,0,775,0,29,0,0,0,20,0,824,0,0,0,0,0,0,0,4,1,0,21
Pulaski,7/20/20,0,0,0,0,0,0,0,0,0,3717,0,48033,0,2751,0,69,0,897,0,51750,0,0,0,0,0,0,0,65,91,0,803
Randolph,7/20/20,0,0,0,0,0,0,0,0,0,98,0,2308,0,67,0,2,0,29,0,2406,0,0,0,0,0,0,0,1,2,0,37
Saline,7/20/20,0,0,0,0,0,0,0,0,0,594,0,11790,0,451,0,3,0,140,0,12384,0,0,0,0,0,0,0,10,13,0,384
Scott,7/20/20,0,0,0,0,0,0,0,0,0,21,0,735,0,15,0,0,0,6,0,756,0,0,0,0,0,0,0,1,1,0,17
Searcy,7/20/20,0,0,0,0,0,0,0,0,0,20,0,936,0,15,0,0,0,5,0,956,0,0,0,0,0,0,0,1,0,0,19
Sebastian,7/20/20,0,0,0,0,0,0,0,0,0,1166,0,15406,0,761,0,9,0,396,0,16572,0,0,0,0,0,0,0,22,27,0,189
Sevier,7/20/20,0,0,0,0,0,0,0,0,0,861,0,3939,0,789,0,9,0,63,0,4800,0,0,0,0,0,0,0,4,9,0,48
Sharp,7/20/20,0,0,0,0,0,0,0,0,0,81,0,1333,0,55,0,5,0,21,0,1414,0,0,0,0,0,0,0,1,2,0,22
St.Francis,7/20/20,0,0,0,0,0,0,0,0,0,960,0,4960,0,901,0,3,0,56,0,5920,0,0,0,0,0,0,0,7,4,0,84
Stone,7/20/20,0,0,0,0,0,0,0,0,0,32,0,1437,0,20,0,1,0,11,0,1469,0,0,0,0,0,0,0,3,0,0,40
Union,7/20/20,0,0,0,0,0,0,0,0,0,313,0,3544,0,252,0,14,0,47,0,3857,0,0,0,0,0,0,0,7,6,0,50
VanBuren,7/20/20,0,0,0,0,0,0,0,0,0,38,0,1302,0,36,0,2,0,0,0,1340,0,0,0,0,0,0,0,0,1,0,27
Washington,7/20/20,0,0,0,0,0,0,0,0,0,5234,0,18791,0,4463,0,38,0,733,0,24025,0,0,0,0,0,0,0,95,57,1,553
White,7/20/20,0,0,0,0,0,0,0,0,0,169,0,4942,0,130,0,2,0,37,0,5111,0,0,0,0,0,0,0,0,4,0,56
Woodruff,7/20/20,0,0,0,0,0,0,0,0,0,18,0,867,0,13,0,0,0,5,0,885,0,0,0,0,0,0,0,0,2,0,3
Yell,7/20/20,0,0,0,0,0,0,0,0,0,916,0,2978,0,768,0,13,0,135,0,3894,0,0,0,0,0,0,0,4,10,1,148
Arkansas_all_counties,7/19/20,0,0,0,0,0,0,0,0,2990671,33228,0,392229,0,25852,0,357,0,7019,0,425457,0,0,0,0,0,0,0,695,560,0,6798
Arkansas_county,7/19/20,0,0,0,0,0,0,0,0,0,113,0,1933,0,48,0,1,0,64,0,2046,0,0,0,0,0,0,0,5,2,0,51
Ashley,7/19/20,0,0,0,0,0,0,0,0,0,134,0,1945,0,91,0,3,0,40,0,2079,0,0,0,0,0,0,0,9,1,0,45
Baxter,7/19/20,0,0,0,0,0,0,0,0,0,44,0,2772,0,33,0,0,0,11,0,2816,0,0,0,0,0,0,0,4,4,0,37
Benton,7/19/20,0,0,0,0,0,0,0,0,0,3832,0,43039,0,3324,0,25,0,483,0,46871,0,0,0,0,0,0,0,43,56,0,601
Boone,7/19/20,0,0,0,0,0,0,0,0,0,76,0,3059,0,42,0,1,0,33,0,3135,0,0,0,0,0,0,0,2,1,0,30
Bradley,7/19/20,0,0,0,0,0,0,0,0,0,97,0,1384,0,62,0,2,0,33,0,1481,0,0,0,0,0,0,0,6,1,0,16
Calhoun,7/19/20,0,0,0,0,0,0,0,0,0,5,0,429,0,3,0,0,0,2,0,434,0,0,0,0,0,0,0,0,0,0,2
Carroll,7/19/20,0,0,0,0,0,0,0,0,0,270,0,3351,0,213,0,6,0,51,0,3621,0,0,0,0,0,0,0,8,5,0,52
Chicot,7/19/20,0,0,0,0,0,0,0,0,0,257,0,1722,0,183,0,3,0,71,0,1979,0,0,0,0,0,0,0,5,11,0,31
Clark,7/19/20,0,0,0,0,0,0,0,0,0,97,0,2232,0,73,0,0,0,24,0,2329,0,0,0,0,0,0,0,3,1,0,34
Clay,7/19/20,0,0,0,0,0,0,0,0,0,89,0,1871,0,70,0,3,0,16,0,1960,0,0,0,0,0,0,0,1,0,0,28
Cleburne,7/19/20,0,0,0,0,0,0,0,0,0,154,0,2653,0,121,0,5,0,28,0,2807,0,0,0,0,0,0,0,1,1,0,28
Cleveland,7/19/20,0,0,0,0,0,0,0,0,0,41,0,913,0,33,0,0,0,8,0,954,0,0,0,0,0,0,0,0,0,0,10
Columbia,7/19/20,0,0,0,0,0,0,0,0,0,134,0,1939,0,93,0,5,0,36,0,2073,0,0,0,0,0,0,0,2,2,0,18
Conway,7/19/20,0,0,0,0,0,0,0,0,0,113,0,2203,0,84,0,3,0,26,0,2316,0,0,0,0,0,0,0,2,2,0,36
Craighead,7/19/20,0,0,0,0,0,0,0,0,0,710,0,12914,0,552,0,8,0,150,0,13624,0,0,0,0,0,0,0,9,10,1,99
Crawford,7/19/20,0,0,0,0,0,0,0,0,0,353,0,5990,0,241,0,3,0,109,0,6343,0,0,0,0,0,0,0,6,3,0,123
Crittenden,7/19/20,0,0,0,0,0,0,0,0,0,944,0,6697,0,816,0,14,0,114,0,7641,0,0,0,0,0,0,0,15,8,0,71
Cross,7/19/20,0,0,0,0,0,0,0,0,0,115,0,1686,0,88,0,1,0,26,0,1801,0,0,0,0,0,0,0,2,1,0,24
Dallas,7/19/20,0,0,0,0,0,0,0,0,0,20,0,652,0,12,0,0,0,8,0,672,0,0,0,0,0,0,0,0,1,0,11
Desha,7/19/20,0,0,0,0,0,0,0,0,0,102,0,1339,0,72,0,1,0,29,0,1441,0,0,0,0,0,0,0,4,6,0,22
Drew,7/19/20,0,0,0,0,0,0,0,0,0,113,0,2176,0,78,0,2,0,33,0,2289,0,0,0,0,0,0,0,2,1,0,45
Faulkner,7/19/20,0,0,0,0,0,0,0,0,0,905,0,12891,0,691,0,4,0,210,0,13796,0,0,0,0,0,0,0,17,24,0,151
Franklin,7/19/20,0,0,0,0,0,0,0,0,0,41,0,1812,0,30,0,1,0,10,0,1853,0,0,0,0,0,0,0,4,0,0,36
Fulton,7/19/20,0,0,0,0,0,0,0,0,0,20,0,1102,0,16,0,0,0,4,0,1122,0,0,0,0,0,0,0,0,0,0,24
Garland,7/19/20,0,0,0,0,0,0,0,0,0,473,0,9898,0,318,0,5,0,150,0,10371,0,0,0,0,0,0,0,31,6,0,335
Grant,7/19/20,0,0,0,0,0,0,0,0,0,79,0,1637,0,60,0,0,0,19,0,1716,0,0,0,0,0,0,0,2,5,0,27
Greene,7/19/20,0,0,0,0,0,0,0,0,0,171,0,4803,0,142,0,0,0,29,0,4974,0,0,0,0,0,0,0,3,4,0,80
Hempstead,7/19/20,0,0,0,0,0,0,0,0,0,122,0,2095,0,77,0,1,0,44,0,2217,0,0,0,0,0,0,0,10,4,0,59
HotSpring,7/19/20,0,0,0,0,0,0,0,0,0,1349,0,4425,0,601,0,2,0,746,0,5774,0,0,0,0,0,0,0,5,8,0,136
Howard,7/19/20,0,0,0,0,0,0,0,0,0,169,0,1816,0,131,0,1,0,37,0,1985,0,0,0,0,0,0,0,2,3,0,27
Independence,7/19/20,0,0,0,0,0,0,0,0,0,110,0,3573,0,69,0,0,0,41,0,3683,0,0,0,0,0,0,0,3,0,0,56
Izard,7/19/20,0,0,0,0,0,0,0,0,0,28,0,1149,0,22,0,1,0,5,0,1177,0,0,0,0,0,0,0,0,0,0,13
Jackson,7/19/20,0,0,0,0,0,0,0,0,0,46,0,1504,0,35,0,0,0,11,0,1550,0,0,0,0,0,0,0,2,0,0,12
Jefferson,7/19/20,0,0,0,0,0,0,0,0,0,1023,0,10263,0,757,0,30,0,236,0,11286,0,0,0,0,0,0,0,54,9,0,612
Johnson,7/19/20,0,0,0,0,0,0,0,0,0,485,0,1864,0,380,0,0,0,105,0,2349,0,0,0,0,0,0,0,9,7,0,58
Lafayette,7/19/20,0,0,0,0,0,0,0,0,0,37,0,441,0,23,0,2,0,12,0,478,0,0,0,0,0,0,0,1,1,0,6
Lawrence,7/19/20,0,0,0,0,0,0,0,0,0,135,0,1871,0,95,0,9,0,31,0,2006,0,0,0,0,0,0,0,2,0,0,19
Lee,7/19/20,0,0,0,0,0,0,0,0,0,861,0,2466,0,785,0,5,0,71,0,3327,0,0,0,0,0,0,0,2,0,-1,11
Lincoln,7/19/20,0,0,0,0,0,0,0,0,0,1119,0,2138,0,1020,0,11,0,88,0,3257,0,0,0,0,0,0,0,1,0,0,15
LittleRiver,7/19/20,0,0,0,0,0,0,0,0,0,63,0,959,0,47,0,1,0,15,0,1022,0,0,0,0,0,0,0,3,1,0,17
Logan,7/19/20,0,0,0,0,0,0,0,0,0,103,0,2535,0,69,0,0,0,34,0,2638,0,0,0,0,0,0,0,0,2,0,35
Lonoke,7/19/20,0,0,0,0,0,0,0,0,0,257,0,5932,0,190,0,2,0,65,0,6189,0,0,0,0,0,0,0,11,6,0,105
Madison,7/19/20,0,0,0,0,0,0,0,0,0,229,0,2100,0,213,0,1,0,15,0,2329,0,0,0,0,0,0,0,2,1,0,18
Marion,7/19/20,0,0,0,0,0,0,0,0,0,15,0,1087,0,12,0,0,0,3,0,1102,0,0,0,0,0,0,0,0,0,0,4
Miller,7/19/20,0,0,0,0,0,0,0,0,0,336,0,2924,0,251,0,2,0,83,0,3260,0,0,0,0,0,0,0,7,56,0,63
MissingCountyInfo,7/19/20,0,0,0,0,0,0,0,0,0,1203,0,58480,0,768,0,0,0,435,0,59683,0,0,0,0,0,0,0,80,40,0,319
Mississippi,7/19/20,0,0,0,0,0,0,0,0,0,421,0,4740,0,288,0,5,0,128,0,5161,0,0,0,0,0,0,0,20,8,0,94
Monroe,7/19/20,0,0,0,0,0,0,0,0,0,33,0,968,0,22,0,0,0,11,0,1001,0,0,0,0,0,0,0,4,0,0,27
Montgomery,7/19/20,0,0,0,0,0,0,0,0,0,14,0,736,0,9,0,0,0,5,0,750,0,0,0,0,0,0,0,2,2,0,13
Nevada,7/19/20,0,0,0,0,0,0,0,0,0,117,0,1359,0,85,0,6,0,26,0,1476,0,0,0,0,0,0,0,1,0,0,15
Newton,7/19/20,0,0,0,0,0,0,0,0,0,16,0,601,0,9,0,0,0,7,0,617,0,0,0,0,0,0,0,2,1,0,7
Ouachita,7/19/20,0,0,0,0,0,0,0,0,0,49,0,2216,0,30,0,1,0,18,0,2265,0,0,0,0,0,0,0,5,0,0,27
Perry,7/19/20,0,0,0,0,0,0,0,0,0,40,0,1128,0,34,0,0,0,6,0,1168,0,0,0,0,0,0,0,1,2,0,15
Phillips,7/19/20,0,0,0,0,0,0,0,0,0,208,0,3019,0,152,0,6,0,50,0,3227,0,0,0,0,0,0,0,3,0,0,26
Pike,7/19/20,0,0,0,0,0,0,0,0,0,32,0,2170,0,17,0,0,0,15,0,2202,0,0,0,0,0,0,0,2,0,0,18
Poinsett,7/19/20,0,0,0,0,0,0,0,0,0,92,0,1973,0,66,0,3,0,23,0,2065,0,0,0,0,0,0,0,2,3,0,22
Polk,7/19/20,0,0,0,0,0,0,0,0,0,103,0,1793,0,87,0,0,0,16,0,1896,0,0,0,0,0,0,0,2,2,0,36
Pope,7/19/20,0,0,0,0,0,0,0,0,0,849,0,7062,0,633,0,4,0,212,0,7911,0,0,0,0,0,0,0,32,8,0,174
Prairie,7/19/20,0,0,0,0,0,0,0,0,0,45,0,758,0,28,0,0,0,17,0,803,0,0,0,0,0,0,0,1,1,0,16
Pulaski,7/19/20,0,0,0,0,0,0,0,0,0,3652,0,47295,0,2660,0,69,0,923,0,50947,0,0,0,0,0,0,0,74,69,0,868
Randolph,7/19/20,0,0,0,0,0,0,0,0,0,97,0,2272,0,65,0,2,0,30,0,2369,0,0,0,0,0,0,0,3,1,0,26
Saline,7/19/20,0,0,0,0,0,0,0,0,0,584,0,11416,0,438,0,3,0,143,0,12000,0,0,0,0,0,0,0,6,5,0,121
Scott,7/19/20,0,0,0,0,0,0,0,0,0,20,0,719,0,14,0,0,0,6,0,739,0,0,0,0,0,0,0,1,0,0,8
Searcy,7/19/20,0,0,0,0,0,0,0,0,0,19,0,918,0,15,0,0,0,4,0,937,0,0,0,0,0,0,0,1,0,0,6
Sebastian,7/19/20,0,0,0,0,0,0,0,0,0,1144,0,15239,0,734,0,9,0,401,0,16383,0,0,0,0,0,0,0,42,19,0,358
Sevier,7/19/20,0,0,0,0,0,0,0,0,0,857,0,3895,0,780,0,9,0,68,0,4752,0,0,0,0,0,0,0,11,4,0,57
Sharp,7/19/20,0,0,0,0,0,0,0,0,0,80,0,1312,0,53,0,5,0,22,0,1392,0,0,0,0,0,0,0,1,0,0,10
St.Francis,7/19/20,0,0,0,0,0,0,0,0,0,953,0,4883,0,897,0,3,0,53,0,5836,0,0,0,0,0,0,0,11,5,0,170
Stone,7/19/20,0,0,0,0,0,0,0,0,0,29,0,1400,0,20,0,1,0,8,0,1429,0,0,0,0,0,0,0,2,1,0,13
Union,7/19/20,0,0,0,0,0,0,0,0,0,306,0,3501,0,246,0,14,0,46,0,3807,0,0,0,0,0,0,0,1,2,0,20
VanBuren,7/19/20,0,0,0,0,0,0,0,0,0,38,0,1275,0,35,0,2,0,1,0,1313,0,0,0,0,0,0,0,0,1,0,6
Washington,7/19/20,0,0,0,0,0,0,0,0,0,5139,0,18333,0,4406,0,37,0,696,0,23472,0,0,0,0,0,0,0,80,83,0,401
White,7/19/20,0,0,0,0,0,0,0,0,0,169,0,4886,0,126,0,2,0,41,0,5055,0,0,0,0,0,0,0,1,4,0,43
Woodruff,7/19/20,0,0,0,0,0,0,0,0,0,18,0,864,0,11,0,0,0,7,0,882,0,0,0,0,0,0,0,1,0,0,7
Yell,7/19/20,0,0,0,0,0,0,0,0,0,912,0,2834,0,758,0,12,0,142,0,3746,0,0,0,0,0,0,0,3,45,0,30
Arkansas_all_counties,7/18/20,0,0,0,0,0,0,0,0,2990671,32533,0,386638,0,25292,0,357,0,6884,0,419171,0,0,0,0,0,0,0,771,516,4,5424
Arkansas_county,7/18/20,0,0,0,0,0,0,0,0,0,108,0,1887,0,46,0,1,0,61,0,1995,0,0,0,0,0,0,0,1,0,1,25
Ashley,7/18/20,0,0,0,0,0,0,0,0,0,125,0,1909,0,90,0,3,0,32,0,2034,0,0,0,0,0,0,0,6,2,0,44
Baxter,7/18/20,0,0,0,0,0,0,0,0,0,40,0,2739,0,29,0,0,0,11,0,2779,0,0,0,0,0,0,0,5,0,0,21
Benton,7/18/20,0,0,0,0,0,0,0,0,0,3789,0,42481,0,3268,0,25,0,496,0,46270,0,0,0,0,0,0,0,90,53,1,1128
Boone,7/18/20,0,0,0,0,0,0,0,0,0,74,0,3031,0,41,0,1,0,32,0,3105,0,0,0,0,0,0,0,3,0,0,55
Bradley,7/18/20,0,0,0,0,0,0,0,0,0,91,0,1374,0,61,0,2,0,28,0,1465,0,0,0,0,0,0,0,3,1,0,12
Calhoun,7/18/20,0,0,0,0,0,0,0,0,0,5,0,427,0,3,0,0,0,2,0,432,0,0,0,0,0,0,0,0,0,0,4
Carroll,7/18/20,0,0,0,0,0,0,0,0,0,262,0,3307,0,208,0,6,0,48,0,3569,0,0,0,0,0,0,0,9,7,0,40
Chicot,7/18/20,0,0,0,0,0,0,0,0,0,252,0,1696,0,172,0,3,0,77,0,1948,0,0,0,0,0,0,0,4,9,0,22
Clark,7/18/20,0,0,0,0,0,0,0,0,0,94,0,2201,0,72,0,0,0,22,0,2295,0,0,0,0,0,0,0,6,3,0,22
Clay,7/18/20,0,0,0,0,0,0,0,0,0,88,0,1844,0,70,0,3,0,15,0,1932,0,0,0,0,0,0,0,1,1,0,24
Cleburne,7/18/20,0,0,0,0,0,0,0,0,0,153,0,2626,0,120,0,5,0,28,0,2779,0,0,0,0,0,0,0,4,3,0,44
Cleveland,7/18/20,0,0,0,0,0,0,0,0,0,41,0,903,0,33,0,0,0,8,0,944,0,0,0,0,0,0,0,0,0,0,14
Columbia,7/18/20,0,0,0,0,0,0,0,0,0,132,0,1923,0,91,0,5,0,36,0,2055,0,0,0,0,0,0,0,8,4,0,138
Conway,7/18/20,0,0,0,0,0,0,0,0,0,111,0,2169,0,82,0,3,0,26,0,2280,0,0,0,0,0,0,0,4,1,0,57
Craighead,7/18/20,0,0,0,0,0,0,0,0,0,701,0,12824,0,542,0,7,0,152,0,13525,0,0,0,0,0,0,0,19,14,0,106
Crawford,7/18/20,0,0,0,0,0,0,0,0,0,347,0,5873,0,238,0,3,0,106,0,6220,0,0,0,0,0,0,0,20,10,0,153
Crittenden,7/18/20,0,0,0,0,0,0,0,0,0,929,0,6641,0,808,0,14,0,107,0,7570,0,0,0,0,0,0,0,13,11,0,43
Cross,7/18/20,0,0,0,0,0,0,0,0,0,113,0,1664,0,87,0,1,0,25,0,1777,0,0,0,0,0,0,0,3,0,0,17
Dallas,7/18/20,0,0,0,0,0,0,0,0,0,20,0,641,0,11,0,0,0,9,0,661,0,0,0,0,0,0,0,0,0,0,7
Desha,7/18/20,0,0,0,0,0,0,0,0,0,98,0,1321,0,66,0,1,0,31,0,1419,0,0,0,0,0,0,0,8,2,0,27
Drew,7/18/20,0,0,0,0,0,0,0,0,0,111,0,2133,0,77,0,2,0,32,0,2244,0,0,0,0,0,0,0,9,3,0,54
Faulkner,7/18/20,0,0,0,0,0,0,0,0,0,888,0,12757,0,667,0,4,0,217,0,13645,0,0,0,0,0,0,0,19,23,0,151
Franklin,7/18/20,0,0,0,0,0,0,0,0,0,37,0,1780,0,30,0,1,0,6,0,1817,0,0,0,0,0,0,0,2,0,0,36
Fulton,7/18/20,0,0,0,0,0,0,0,0,0,20,0,1078,0,16,0,0,0,4,0,1098,0,0,0,0,0,0,0,1,0,0,14
Garland,7/18/20,0,0,0,0,0,0,0,0,0,442,0,9594,0,312,0,5,0,125,0,10036,0,0,0,0,0,0,0,19,3,0,169
Grant,7/18/20,0,0,0,0,0,0,0,0,0,77,0,1612,0,55,0,0,0,22,0,1689,0,0,0,0,0,0,0,3,3,0,27
Greene,7/18/20,0,0,0,0,0,0,0,0,0,168,0,4726,0,138,0,0,0,30,0,4894,0,0,0,0,0,0,0,6,1,0,86
Hempstead,7/18/20,0,0,0,0,0,0,0,0,0,112,0,2046,0,73,0,1,0,38,0,2158,0,0,0,0,0,0,0,4,2,0,19
HotSpring,7/18/20,0,0,0,0,0,0,0,0,0,1344,0,4294,0,593,0,2,0,749,0,5638,0,0,0,0,0,0,0,5,1,0,40
Howard,7/18/20,0,0,0,0,0,0,0,0,0,167,0,1791,0,128,0,1,0,38,0,1958,0,0,0,0,0,0,0,6,7,0,27
Independence,7/18/20,0,0,0,0,0,0,0,0,0,107,0,3520,0,69,0,0,0,38,0,3627,0,0,0,0,0,0,0,10,4,0,87
Izard,7/18/20,0,0,0,0,0,0,0,0,0,28,0,1136,0,22,0,1,0,5,0,1164,0,0,0,0,0,0,0,0,0,0,10
Jackson,7/18/20,0,0,0,0,0,0,0,0,0,44,0,1494,0,35,0,0,0,9,0,1538,0,0,0,0,0,0,0,1,1,0,11
Jefferson,7/18/20,0,0,0,0,0,0,0,0,0,969,0,9705,0,748,0,30,0,191,0,10674,0,0,0,0,0,0,0,19,13,0,349
Johnson,7/18/20,0,0,0,0,0,0,0,0,0,476,0,1815,0,373,0,0,0,103,0,2291,0,0,0,0,0,0,0,5,12,0,27
Lafayette,7/18/20,0,0,0,0,0,0,0,0,0,36,0,436,0,22,0,2,0,12,0,472,0,0,0,0,0,0,0,2,0,0,10
Lawrence,7/18/20,0,0,0,0,0,0,0,0,0,133,0,1854,0,95,0,9,0,29,0,1987,0,0,0,0,0,0,0,4,1,0,10
Lee,7/18/20,0,0,0,0,0,0,0,0,0,859,0,2457,0,785,0,6,0,68,0,3316,0,0,0,0,0,0,0,4,1,0,14
Lincoln,7/18/20,0,0,0,0,0,0,0,0,0,1118,0,2124,0,1020,0,11,0,87,0,3242,0,0,0,0,0,0,0,3,1,0,14
LittleRiver,7/18/20,0,0,0,0,0,0,0,0,0,60,0,945,0,46,0,1,0,13,0,1005,0,0,0,0,0,0,0,2,1,0,4
Logan,7/18/20,0,0,0,0,0,0,0,0,0,103,0,2500,0,67,0,0,0,36,0,2603,0,0,0,0,0,0,0,3,3,0,42
Lonoke,7/18/20,0,0,0,0,0,0,0,0,0,246,0,5838,0,184,0,2,0,60,0,6084,0,0,0,0,0,0,0,6,3,0,64
Madison,7/18/20,0,0,0,0,0,0,0,0,0,227,0,2084,0,212,0,1,0,14,0,2311,0,0,0,0,0,0,0,1,2,0,31
Marion,7/18/20,0,0,0,0,0,0,0,0,0,15,0,1083,0,12,0,0,0,3,0,1098,0,0,0,0,0,0,0,1,0,0,11
Miller,7/18/20,0,0,0,0,0,0,0,0,0,329,0,2868,0,195,0,2,0,132,0,3197,0,0,0,0,0,0,0,5,43,0,33
MissingCountyInfo,7/18/20,0,0,0,0,0,0,0,0,0,1123,0,58241,0,728,0,0,0,395,0,59364,0,0,0,0,0,0,0,24,4,0,304
Mississippi,7/18/20,0,0,0,0,0,0,0,0,0,401,0,4666,0,280,0,5,0,116,0,5067,0,0,0,0,0,0,0,20,10,1,112
Monroe,7/18/20,0,0,0,0,0,0,0,0,0,29,0,945,0,22,0,0,0,7,0,974,0,0,0,0,0,0,0,0,0,0,9
Montgomery,7/18/20,0,0,0,0,0,0,0,0,0,12,0,725,0,7,0,0,0,5,0,737,0,0,0,0,0,0,0,0,0,0,4
Nevada,7/18/20,0,0,0,0,0,0,0,0,0,116,0,1345,0,85,0,6,0,25,0,1461,0,0,0,0,0,0,0,0,-1,0,13
Newton,7/18/20,0,0,0,0,0,0,0,0,0,14,0,596,0,8,0,0,0,6,0,610,0,0,0,0,0,0,0,1,0,0,6
Ouachita,7/18/20,0,0,0,0,0,0,0,0,0,44,0,2194,0,30,0,1,0,13,0,2238,0,0,0,0,0,0,0,3,0,0,22
Perry,7/18/20,0,0,0,0,0,0,0,0,0,39,0,1114,0,32,0,0,0,7,0,1153,0,0,0,0,0,0,0,1,1,0,18
Phillips,7/18/20,0,0,0,0,0,0,0,0,0,205,0,2996,0,152,0,6,0,47,0,3201,0,0,0,0,0,0,0,12,2,0,138
Pike,7/18/20,0,0,0,0,0,0,0,0,0,30,0,2154,0,17,0,0,0,13,0,2184,0,0,0,0,0,0,0,3,2,0,27
Poinsett,7/18/20,0,0,0,0,0,0,0,0,0,90,0,1953,0,63,0,3,0,24,0,2043,0,0,0,0,0,0,0,7,0,0,28
Polk,7/18/20,0,0,0,0,0,0,0,0,0,101,0,1759,0,85,0,0,0,16,0,1860,0,0,0,0,0,0,0,3,1,0,10
Pope,7/18/20,0,0,0,0,0,0,0,0,0,817,0,6920,0,625,0,4,0,188,0,7737,0,0,0,0,0,0,0,16,7,0,72
Prairie,7/18/20,0,0,0,0,0,0,0,0,0,44,0,743,0,27,0,0,0,17,0,787,0,0,0,0,0,0,0,4,1,0,13
Pulaski,7/18/20,0,0,0,0,0,0,0,0,0,3578,0,46501,0,2591,0,69,0,918,0,50079,0,0,0,0,0,0,0,81,79,0,748
Randolph,7/18/20,0,0,0,0,0,0,0,0,0,94,0,2249,0,64,0,2,0,28,0,2343,0,0,0,0,0,0,0,2,3,0,17
Saline,7/18/20,0,0,0,0,0,0,0,0,0,578,0,11301,0,433,0,3,0,142,0,11879,0,0,0,0,0,0,0,13,19,0,111
Scott,7/18/20,0,0,0,0,0,0,0,0,0,19,0,712,0,14,0,0,0,5,0,731,0,0,0,0,0,0,0,1,0,0,15
Searcy,7/18/20,0,0,0,0,0,0,0,0,0,18,0,913,0,15,0,0,0,3,0,931,0,0,0,0,0,0,0,0,1,0,5
Sebastian,7/18/20,0,0,0,0,0,0,0,0,0,1102,0,14923,0,715,0,9,0,378,0,16025,0,0,0,0,0,0,0,54,31,0,376
Sevier,7/18/20,0,0,0,0,0,0,0,0,0,846,0,3849,0,776,0,9,0,61,0,4695,0,0,0,0,0,0,0,4,4,0,27
Sharp,7/18/20,0,0,0,0,0,0,0,0,0,79,0,1303,0,53,0,5,0,21,0,1382,0,0,0,0,0,0,0,2,0,0,17
St.Francis,7/18/20,0,0,0,0,0,0,0,0,0,942,0,4724,0,892,0,3,0,47,0,5666,0,0,0,0,0,0,0,4,2,0,40
Stone,7/18/20,0,0,0,0,0,0,0,0,0,27,0,1389,0,19,0,1,0,7,0,1416,0,0,0,0,0,0,0,3,0,0,17
Union,7/18/20,0,0,0,0,0,0,0,0,0,305,0,3482,0,244,0,14,0,47,0,3787,0,0,0,0,0,0,0,13,2,0,41
VanBuren,7/18/20,0,0,0,0,0,0,0,0,0,38,0,1269,0,34,0,2,0,2,0,1307,0,0,0,0,0,0,0,1,0,0,16
Washington,7/18/20,0,0,0,0,0,0,0,0,0,5059,0,18012,0,4323,0,37,0,699,0,23071,0,0,0,0,0,0,0,146,84,0,552
White,7/18/20,0,0,0,0,0,0,0,0,0,168,0,4844,0,122,0,2,0,44,0,5012,0,0,0,0,0,0,0,1,6,0,29
Woodruff,7/18/20,0,0,0,0,0,0,0,0,0,17,0,858,0,11,0,0,0,6,0,875,0,0,0,0,0,0,0,1,1,0,3
Yell,7/18/20,0,0,0,0,0,0,0,0,0,909,0,2807,0,713,0,12,0,184,0,3716,0,0,0,0,0,0,0,4,8,1,33
Arkansas_all_counties,7/17/20,0,0,0,0,0,0,0,0,2990671,31762,0,381243,0,24776,0,353,0,6633,0,413005,0,0,0,0,0,0,0,648,581,12,6684
Arkansas_county,7/17/20,0,0,0,0,0,0,0,0,0,107,0,1863,0,46,0,0,0,61,0,1970,0,0,0,0,0,0,0,9,5,0,73
Ashley,7/17/20,0,0,0,0,0,0,0,0,0,119,0,1871,0,88,0,3,0,28,0,1990,0,0,0,0,0,0,0,2,2,0,24
Baxter,7/17/20,0,0,0,0,0,0,0,0,0,35,0,2723,0,29,0,0,0,6,0,2758,0,0,0,0,0,0,0,1,0,0,47
Benton,7/17/20,0,0,0,0,0,0,0,0,0,3699,0,41443,0,3215,0,24,0,460,0,45142,0,0,0,0,0,0,0,38,50,1,535
Boone,7/17/20,0,0,0,0,0,0,0,0,0,71,0,2979,0,41,0,1,0,29,0,3050,0,0,0,0,0,0,0,1,2,0,8
Bradley,7/17/20,0,0,0,0,0,0,0,0,0,88,0,1365,0,60,0,2,0,26,0,1453,0,0,0,0,0,0,0,1,3,0,41
Calhoun,7/17/20,0,0,0,0,0,0,0,0,0,5,0,423,0,3,0,0,0,2,0,428,0,0,0,0,0,0,0,0,0,0,9
Carroll,7/17/20,0,0,0,0,0,0,0,0,0,253,0,3276,0,201,0,6,0,46,0,3529,0,0,0,0,0,0,0,2,5,0,28
Chicot,7/17/20,0,0,0,0,0,0,0,0,0,248,0,1678,0,163,0,3,0,82,0,1926,0,0,0,0,0,0,0,3,3,0,13
Clark,7/17/20,0,0,0,0,0,0,0,0,0,88,0,2185,0,69,0,0,0,19,0,2273,0,0,0,0,0,0,0,5,2,0,81
Clay,7/17/20,0,0,0,0,0,0,0,0,0,87,0,1821,0,69,0,3,0,15,0,1908,0,0,0,0,0,0,0,1,2,0,10
Cleburne,7/17/20,0,0,0,0,0,0,0,0,0,149,0,2586,0,117,0,5,0,27,0,2735,0,0,0,0,0,0,0,1,4,1,82
Cleveland,7/17/20,0,0,0,0,0,0,0,0,0,41,0,889,0,33,0,0,0,8,0,930,0,0,0,0,0,0,0,1,1,0,8
Columbia,7/17/20,0,0,0,0,0,0,0,0,0,124,0,1793,0,87,0,5,0,32,0,1917,0,0,0,0,0,0,0,5,0,0,92
Conway,7/17/20,0,0,0,0,0,0,0,0,0,107,0,2116,0,81,0,3,0,23,0,2223,0,0,0,0,0,0,0,3,7,0,96
Craighead,7/17/20,0,0,0,0,0,0,0,0,0,682,0,12737,0,528,0,7,0,147,0,13419,0,0,0,0,0,0,0,32,11,0,139
Crawford,7/17/20,0,0,0,0,0,0,0,0,0,327,0,5740,0,228,0,3,0,96,0,6067,0,0,0,0,0,0,0,17,7,0,148
Crittenden,7/17/20,0,0,0,0,0,0,0,0,0,916,0,6611,0,797,0,14,0,105,0,7527,0,0,0,0,0,0,0,10,9,0,42
Cross,7/17/20,0,0,0,0,0,0,0,0,0,110,0,1650,0,87,0,1,0,22,0,1760,0,0,0,0,0,0,0,3,1,0,20
Dallas,7/17/20,0,0,0,0,0,0,0,0,0,20,0,634,0,11,0,0,0,9,0,654,0,0,0,0,0,0,0,0,0,0,18
Desha,7/17/20,0,0,0,0,0,0,0,0,0,90,0,1302,0,64,0,1,0,25,0,1392,0,0,0,0,0,0,0,1,5,0,18
Drew,7/17/20,0,0,0,0,0,0,0,0,0,102,0,2088,0,74,0,2,0,26,0,2190,0,0,0,0,0,0,0,0,2,0,12
Faulkner,7/17/20,0,0,0,0,0,0,0,0,0,869,0,12625,0,644,0,4,0,221,0,13494,0,0,0,0,0,0,0,12,25,0,184
Franklin,7/17/20,0,0,0,0,0,0,0,0,0,35,0,1746,0,30,0,1,0,4,0,1781,0,0,0,0,0,0,0,0,1,0,40
Fulton,7/17/20,0,0,0,0,0,0,0,0,0,19,0,1065,0,16,0,0,0,3,0,1084,0,0,0,0,0,0,0,1,0,0,5
Garland,7/17/20,0,0,0,0,0,0,0,0,0,423,0,9444,0,309,0,5,0,109,0,9867,0,0,0,0,0,0,0,29,13,0,208
Grant,7/17/20,0,0,0,0,0,0,0,0,0,74,0,1588,0,52,0,0,0,22,0,1662,0,0,0,0,0,0,0,5,1,0,55
Greene,7/17/20,0,0,0,0,0,0,0,0,0,162,0,4646,0,137,0,0,0,25,0,4808,0,0,0,0,0,0,0,4,2,0,40
Hempstead,7/17/20,0,0,0,0,0,0,0,0,0,108,0,2031,0,71,0,1,0,36,0,2139,0,0,0,0,0,0,0,7,3,0,52
HotSpring,7/17/20,0,0,0,0,0,0,0,0,0,1339,0,4259,0,592,0,2,0,745,0,5598,0,0,0,0,0,0,0,29,3,0,154
Howard,7/17/20,0,0,0,0,0,0,0,0,0,161,0,1770,0,121,0,1,0,39,0,1931,0,0,0,0,0,0,0,3,0,0,22
Independence,7/17/20,0,0,0,0,0,0,0,0,0,97,0,3443,0,65,0,0,0,32,0,3540,0,0,0,0,0,0,0,4,2,0,22
Izard,7/17/20,0,0,0,0,0,0,0,0,0,28,0,1126,0,22,0,1,0,5,0,1154,0,0,0,0,0,0,0,2,0,0,17
Jackson,7/17/20,0,0,0,0,0,0,0,0,0,43,0,1484,0,34,0,0,0,9,0,1527,0,0,0,0,0,0,0,0,0,0,24
Jefferson,7/17/20,0,0,0,0,0,0,0,0,0,950,0,9375,0,735,0,30,0,185,0,10325,0,0,0,0,0,0,0,13,12,1,113
Johnson,7/17/20,0,0,0,0,0,0,0,0,0,471,0,1793,0,361,0,0,0,110,0,2264,0,0,0,0,0,0,0,16,16,0,79
Lafayette,7/17/20,0,0,0,0,0,0,0,0,0,34,0,428,0,22,0,2,0,10,0,462,0,0,0,0,0,0,0,2,0,0,16
Lawrence,7/17/20,0,0,0,0,0,0,0,0,0,129,0,1848,0,94,0,9,0,26,0,1977,0,0,0,0,0,0,0,6,2,0,27
Lee,7/17/20,0,0,0,0,0,0,0,0,0,855,0,2447,0,784,0,6,0,65,0,3302,0,0,0,0,0,0,0,1,34,1,28
Lincoln,7/17/20,0,0,0,0,0,0,0,0,0,1115,0,2113,0,1019,0,11,0,85,0,3228,0,0,0,0,0,0,0,10,2,0,35
LittleRiver,7/17/20,0,0,0,0,0,0,0,0,0,58,0,943,0,45,0,1,0,12,0,1001,0,0,0,0,0,0,0,3,2,1,11
Logan,7/17/20,0,0,0,0,0,0,0,0,0,100,0,2461,0,64,0,0,0,36,0,2561,0,0,0,0,0,0,0,3,2,0,39
Lonoke,7/17/20,0,0,0,0,0,0,0,0,0,240,0,5780,0,181,0,2,0,57,0,6020,0,0,0,0,0,0,0,6,4,0,112
Madison,7/17/20,0,0,0,0,0,0,0,0,0,226,0,2054,0,210,0,1,0,15,0,2280,0,0,0,0,0,0,0,0,4,0,12
Marion,7/17/20,0,0,0,0,0,0,0,0,0,14,0,1073,0,12,0,0,0,2,0,1087,0,0,0,0,0,0,0,0,1,0,8
Miller,7/17/20,0,0,0,0,0,0,0,0,0,324,0,2840,0,152,0,2,0,170,0,3164,0,0,0,0,0,0,0,20,4,0,75
MissingCountyInfo,7/17/20,0,0,0,0,0,0,0,0,0,1099,0,57961,0,724,0,0,0,375,0,59060,0,0,0,0,0,0,0,79,57,0,528
Mississippi,7/17/20,0,0,0,0,0,0,0,0,0,381,0,4574,0,270,0,4,0,107,0,4955,0,0,0,0,0,0,0,6,10,0,49
Monroe,7/17/20,0,0,0,0,0,0,0,0,0,29,0,936,0,22,0,0,0,7,0,965,0,0,0,0,0,0,0,0,3,0,35
Montgomery,7/17/20,0,0,0,0,0,0,0,0,0,12,0,721,0,7,0,0,0,5,0,733,0,0,0,0,0,0,0,0,0,0,10
Nevada,7/17/20,0,0,0,0,0,0,0,0,0,116,0,1332,0,86,0,6,0,24,0,1448,0,0,0,0,0,0,0,2,-1,3,33
Newton,7/17/20,0,0,0,0,0,0,0,0,0,13,0,591,0,8,0,0,0,5,0,604,0,0,0,0,0,0,0,0,0,0,8
Ouachita,7/17/20,0,0,0,0,0,0,0,0,0,41,0,2175,0,30,0,1,0,10,0,2216,0,0,0,0,0,0,0,3,3,1,41
Perry,7/17/20,0,0,0,0,0,0,0,0,0,38,0,1097,0,31,0,0,0,7,0,1135,0,0,0,0,0,0,0,1,0,0,13
Phillips,7/17/20,0,0,0,0,0,0,0,0,0,193,0,2870,0,150,0,6,0,37,0,3063,0,0,0,0,0,0,0,0,0,0,17
Pike,7/17/20,0,0,0,0,0,0,0,0,0,27,0,2130,0,15,0,0,0,12,0,2157,0,0,0,0,0,0,0,0,0,0,42
Poinsett,7/17/20,0,0,0,0,0,0,0,0,0,83,0,1932,0,63,0,3,0,17,0,2015,0,0,0,0,0,0,0,1,3,0,21
Polk,7/17/20,0,0,0,0,0,0,0,0,0,98,0,1752,0,84,0,0,0,14,0,1850,0,0,0,0,0,0,0,0,2,0,20
Pope,7/17/20,0,0,0,0,0,0,0,0,0,801,0,6864,0,618,0,4,0,179,0,7665,0,0,0,0,0,0,0,32,20,0,140
Prairie,7/17/20,0,0,0,0,0,0,0,0,0,40,0,734,0,26,0,0,0,14,0,774,0,0,0,0,0,0,0,1,1,0,17
Pulaski,7/17/20,0,0,0,0,0,0,0,0,0,3497,0,45834,0,2512,0,69,0,916,0,49331,0,0,0,0,0,0,0,72,61,2,886
Randolph,7/17/20,0,0,0,0,0,0,0,0,0,92,0,2234,0,61,0,2,0,29,0,2326,0,0,0,0,0,0,0,5,7,0,41
Saline,7/17/20,0,0,0,0,0,0,0,0,0,565,0,11203,0,414,0,3,0,148,0,11768,0,0,0,0,0,0,0,25,16,0,235
Scott,7/17/20,0,0,0,0,0,0,0,0,0,18,0,698,0,14,0,0,0,4,0,716,0,0,0,0,0,0,0,0,1,0,27
Searcy,7/17/20,0,0,0,0,0,0,0,0,0,18,0,908,0,14,0,0,0,4,0,926,0,0,0,0,0,0,0,0,0,0,2
Sebastian,7/17/20,0,0,0,0,0,0,0,0,0,1048,0,14601,0,684,0,9,0,355,0,15649,0,0,0,0,0,0,0,23,21,1,307
Sevier,7/17/20,0,0,0,0,0,0,0,0,0,842,0,3826,0,772,0,9,0,61,0,4668,0,0,0,0,0,0,0,13,4,0,57
Sharp,7/17/20,0,0,0,0,0,0,0,0,0,77,0,1288,0,53,0,5,0,19,0,1365,0,0,0,0,0,0,0,2,0,0,16
St.Francis,7/17/20,0,0,0,0,0,0,0,0,0,938,0,4688,0,890,0,3,0,45,0,5626,0,0,0,0,0,0,0,7,4,0,45
Stone,7/17/20,0,0,0,0,0,0,0,0,0,24,0,1375,0,19,0,1,0,4,0,1399,0,0,0,0,0,0,0,0,1,0,13
Union,7/17/20,0,0,0,0,0,0,0,0,0,292,0,3454,0,242,0,14,0,36,0,3746,0,0,0,0,0,0,0,5,3,0,54
VanBuren,7/17/20,0,0,0,0,0,0,0,0,0,37,0,1254,0,34,0,2,0,1,0,1291,0,0,0,0,0,0,0,0,0,0,25
Washington,7/17/20,0,0,0,0,0,0,0,0,0,4913,0,17606,0,4239,0,37,0,637,0,22519,0,0,0,0,0,0,0,53,98,0,411
White,7/17/20,0,0,0,0,0,0,0,0,0,167,0,4816,0,116,0,2,0,49,0,4983,0,0,0,0,0,0,0,2,3,0,77
Woodruff,7/17/20,0,0,0,0,0,0,0,0,0,16,0,856,0,10,0,0,0,6,0,872,0,0,0,0,0,0,0,0,1,0,23
Yell,7/17/20,0,0,0,0,0,0,0,0,0,905,0,2778,0,705,0,11,0,189,0,3683,0,0,0,0,0,0,0,4,9,1,41
Arkansas_all_counties,7/16/20,0,0,0,0,0,0,0,0,2990671,31114,0,375735,0,24195,0,341,0,6578,0,406849,0,0,0,0,0,0,0,817,672,6,6783
Arkansas_county,7/16/20,0,0,0,0,0,0,0,0,0,98,0,1799,0,41,0,0,0,57,0,1897,0,0,0,0,0,0,0,25,9,0,88
Ashley,7/16/20,0,0,0,0,0,0,0,0,0,117,0,1849,0,86,0,3,0,28,0,1966,0,0,0,0,0,0,0,3,4,0,52
Baxter,7/16/20,0,0,0,0,0,0,0,0,0,34,0,2677,0,29,0,0,0,5,0,2711,0,0,0,0,0,0,0,0,1,0,29
Benton,7/16/20,0,0,0,0,0,0,0,0,0,3661,0,40946,0,3165,0,23,0,473,0,44607,0,0,0,0,0,0,0,63,57,0,470
Boone,7/16/20,0,0,0,0,0,0,0,0,0,70,0,2972,0,39,0,1,0,30,0,3042,0,0,0,0,0,0,0,4,6,0,43
Bradley,7/16/20,0,0,0,0,0,0,0,0,0,87,0,1325,0,57,0,2,0,28,0,1412,0,0,0,0,0,0,0,2,3,0,15
Calhoun,7/16/20,0,0,0,0,0,0,0,0,0,5,0,414,0,3,0,0,0,2,0,419,0,0,0,0,0,0,0,1,1,0,10
Carroll,7/16/20,0,0,0,0,0,0,0,0,0,251,0,3250,0,196,0,6,0,49,0,3501,0,0,0,0,0,0,0,12,8,0,28
Chicot,7/16/20,0,0,0,0,0,0,0,0,0,245,0,1668,0,160,0,3,0,82,0,1913,0,0,0,0,0,0,0,16,1,0,57
Clark,7/16/20,0,0,0,0,0,0,0,0,0,83,0,2109,0,67,0,0,0,16,0,2192,0,0,0,0,0,0,0,3,2,0,50
Clay,7/16/20,0,0,0,0,0,0,0,0,0,86,0,1812,0,67,0,3,0,16,0,1898,0,0,0,0,0,0,0,2,2,0,38
Cleburne,7/16/20,0,0,0,0,0,0,0,0,0,148,0,2505,0,113,0,4,0,31,0,2653,0,0,0,0,0,0,0,10,6,0,90
Cleveland,7/16/20,0,0,0,0,0,0,0,0,0,40,0,882,0,32,0,0,0,8,0,922,0,0,0,0,0,0,0,1,2,0,26
Columbia,7/16/20,0,0,0,0,0,0,0,0,0,119,0,1706,0,87,0,5,0,27,0,1825,0,0,0,0,0,0,0,5,1,0,30
Conway,7/16/20,0,0,0,0,0,0,0,0,0,104,0,2023,0,74,0,3,0,27,0,2127,0,0,0,0,0,0,0,1,3,0,66
Craighead,7/16/20,0,0,0,0,0,0,0,0,0,650,0,12630,0,517,0,7,0,126,0,13280,0,0,0,0,0,0,0,24,13,0,237
Crawford,7/16/20,0,0,0,0,0,0,0,0,0,310,0,5609,0,221,0,3,0,86,0,5919,0,0,0,0,0,0,0,14,10,0,105
Crittenden,7/16/20,0,0,0,0,0,0,0,0,0,906,0,6579,0,788,0,14,0,104,0,7485,0,0,0,0,0,0,0,13,15,0,67
Cross,7/16/20,0,0,0,0,0,0,0,0,0,107,0,1633,0,86,0,1,0,20,0,1740,0,0,0,0,0,0,0,4,0,0,33
Dallas,7/16/20,0,0,0,0,0,0,0,0,0,20,0,616,0,11,0,0,0,9,0,636,0,0,0,0,0,0,0,6,0,0,25
Desha,7/16/20,0,0,0,0,0,0,0,0,0,89,0,1285,0,59,0,1,0,29,0,1374,0,0,0,0,0,0,0,3,2,0,48
Drew,7/16/20,0,0,0,0,0,0,0,0,0,102,0,2076,0,72,0,2,0,28,0,2178,0,0,0,0,0,0,0,4,2,0,64
Faulkner,7/16/20,0,0,0,0,0,0,0,0,0,857,0,12453,0,619,0,4,0,234,0,13310,0,0,0,0,0,0,0,27,19,0,228
Franklin,7/16/20,0,0,0,0,0,0,0,0,0,35,0,1706,0,29,0,1,0,5,0,1741,0,0,0,0,0,0,0,1,3,0,18
Fulton,7/16/20,0,0,0,0,0,0,0,0,0,18,0,1061,0,16,0,0,0,2,0,1079,0,0,0,0,0,0,0,0,0,0,10
Garland,7/16/20,0,0,0,0,0,0,0,0,0,394,0,9265,0,296,0,5,0,93,0,9659,0,0,0,0,0,0,0,28,4,0,297
Grant,7/16/20,0,0,0,0,0,0,0,0,0,69,0,1538,0,51,0,0,0,18,0,1607,0,0,0,0,0,0,0,5,1,0,48
Greene,7/16/20,0,0,0,0,0,0,0,0,0,158,0,4610,0,135,0,0,0,23,0,4768,0,0,0,0,0,0,0,2,2,0,70
Hempstead,7/16/20,0,0,0,0,0,0,0,0,0,101,0,1986,0,68,0,1,0,32,0,2087,0,0,0,0,0,0,0,5,7,0,23
HotSpring,7/16/20,0,0,0,0,0,0,0,0,0,1310,0,4134,0,589,0,2,0,719,0,5444,0,0,0,0,0,0,0,10,81,1,46
Howard,7/16/20,0,0,0,0,0,0,0,0,0,158,0,1751,0,121,0,1,0,36,0,1909,0,0,0,0,0,0,0,1,3,0,19
Independence,7/16/20,0,0,0,0,0,0,0,0,0,93,0,3425,0,63,0,0,0,30,0,3518,0,0,0,0,0,0,0,10,1,0,56
Izard,7/16/20,0,0,0,0,0,0,0,0,0,26,0,1111,0,22,0,1,0,3,0,1137,0,0,0,0,0,0,0,0,0,0,12
Jackson,7/16/20,0,0,0,0,0,0,0,0,0,43,0,1460,0,34,0,0,0,9,0,1503,0,0,0,0,0,0,0,0,3,0,23
Jefferson,7/16/20,0,0,0,0,0,0,0,0,0,937,0,9275,0,723,0,29,0,185,0,10212,0,0,0,0,0,0,0,20,14,0,550
Johnson,7/16/20,0,0,0,0,0,0,0,0,0,455,0,1730,0,345,0,0,0,110,0,2185,0,0,0,0,0,0,0,11,11,0,20
Lafayette,7/16/20,0,0,0,0,0,0,0,0,0,32,0,414,0,22,0,2,0,8,0,446,0,0,0,0,0,0,0,0,1,0,6
Lawrence,7/16/20,0,0,0,0,0,0,0,0,0,123,0,1827,0,92,0,9,0,22,0,1950,0,0,0,0,0,0,0,2,1,0,12
Lee,7/16/20,0,0,0,0,0,0,0,0,0,854,0,2420,0,750,0,5,0,99,0,3274,0,0,0,0,0,0,0,3,5,0,14
Lincoln,7/16/20,0,0,0,0,0,0,0,0,0,1105,0,2088,0,1017,0,11,0,77,0,3193,0,0,0,0,0,0,0,53,1,0,133
LittleRiver,7/16/20,0,0,0,0,0,0,0,0,0,55,0,935,0,43,0,0,0,12,0,990,0,0,0,0,0,0,0,1,2,0,6
Logan,7/16/20,0,0,0,0,0,0,0,0,0,97,0,2425,0,62,0,0,0,35,0,2522,0,0,0,0,0,0,0,6,8,0,46
Lonoke,7/16/20,0,0,0,0,0,0,0,0,0,234,0,5674,0,177,0,2,0,55,0,5908,0,0,0,0,0,0,0,16,11,0,130
Madison,7/16/20,0,0,0,0,0,0,0,0,0,226,0,2042,0,206,0,1,0,19,0,2268,0,0,0,0,0,0,0,3,1,0,10
Marion,7/16/20,0,0,0,0,0,0,0,0,0,14,0,1065,0,11,0,0,0,3,0,1079,0,0,0,0,0,0,0,0,0,0,9
Miller,7/16/20,0,0,0,0,0,0,0,0,0,304,0,2785,0,148,0,2,0,154,0,3089,0,0,0,0,0,0,0,11,4,0,51
MissingCountyInfo,7/16/20,0,0,0,0,0,0,0,0,0,1020,0,57512,0,667,0,0,0,353,0,58532,0,0,0,0,0,0,0,-29,-5,0,410
Mississippi,7/16/20,0,0,0,0,0,0,0,0,0,375,0,4531,0,260,0,4,0,111,0,4906,0,0,0,0,0,0,0,18,16,1,76
Monroe,7/16/20,0,0,0,0,0,0,0,0,0,29,0,901,0,19,0,0,0,10,0,930,0,0,0,0,0,0,0,3,0,0,22
Montgomery,7/16/20,0,0,0,0,0,0,0,0,0,12,0,711,0,7,0,0,0,5,0,723,0,0,0,0,0,0,0,4,1,0,11
Nevada,7/16/20,0,0,0,0,0,0,0,0,0,114,0,1301,0,87,0,3,0,24,0,1415,0,0,0,0,0,0,0,2,0,0,15
Newton,7/16/20,0,0,0,0,0,0,0,0,0,13,0,583,0,8,0,0,0,5,0,596,0,0,0,0,0,0,0,0,1,0,6
Ouachita,7/16/20,0,0,0,0,0,0,0,0,0,38,0,2137,0,27,0,0,0,11,0,2175,0,0,0,0,0,0,0,1,0,0,22
Perry,7/16/20,0,0,0,0,0,0,0,0,0,37,0,1085,0,31,0,0,0,6,0,1122,0,0,0,0,0,0,0,1,0,0,23
Phillips,7/16/20,0,0,0,0,0,0,0,0,0,193,0,2853,0,150,0,6,0,37,0,3046,0,0,0,0,0,0,0,1,6,1,18
Pike,7/16/20,0,0,0,0,0,0,0,0,0,27,0,2088,0,15,0,0,0,12,0,2115,0,0,0,0,0,0,0,4,4,0,33
Poinsett,7/16/20,0,0,0,0,0,0,0,0,0,82,0,1912,0,60,0,3,0,19,0,1994,0,0,0,0,0,0,0,3,2,0,28
Polk,7/16/20,0,0,0,0,0,0,0,0,0,98,0,1732,0,82,0,0,0,16,0,1830,0,0,0,0,0,0,0,4,2,0,22
Pope,7/16/20,0,0,0,0,0,0,0,0,0,769,0,6756,0,598,0,4,0,167,0,7525,0,0,0,0,0,0,0,40,17,0,95
Prairie,7/16/20,0,0,0,0,0,0,0,0,0,39,0,718,0,25,0,0,0,14,0,757,0,0,0,0,0,0,0,0,3,0,16
Pulaski,7/16/20,0,0,0,0,0,0,0,0,0,3425,0,45020,0,2451,0,67,0,907,0,48445,0,0,0,0,0,0,0,127,107,0,1142
Randolph,7/16/20,0,0,0,0,0,0,0,0,0,87,0,2198,0,54,0,2,0,31,0,2285,0,0,0,0,0,0,0,4,3,0,37
Saline,7/16/20,0,0,0,0,0,0,0,0,0,540,0,10993,0,398,0,3,0,139,0,11533,0,0,0,0,0,0,0,19,18,0,218
Scott,7/16/20,0,0,0,0,0,0,0,0,0,18,0,671,0,13,0,0,0,5,0,689,0,0,0,0,0,0,0,0,-1,0,10
Searcy,7/16/20,0,0,0,0,0,0,0,0,0,18,0,906,0,14,0,0,0,4,0,924,0,0,0,0,0,0,0,1,2,0,7
Sebastian,7/16/20,0,0,0,0,0,0,0,0,0,1025,0,14317,0,663,0,8,0,354,0,15342,0,0,0,0,0,0,0,44,41,0,288
Sevier,7/16/20,0,0,0,0,0,0,0,0,0,829,0,3782,0,768,0,9,0,52,0,4611,0,0,0,0,0,0,0,7,17,0,20
Sharp,7/16/20,0,0,0,0,0,0,0,0,0,75,0,1274,0,53,0,5,0,17,0,1349,0,0,0,0,0,0,0,3,0,0,22
St.Francis,7/16/20,0,0,0,0,0,0,0,0,0,931,0,4650,0,886,0,3,0,42,0,5581,0,0,0,0,0,0,0,5,7,0,30
Stone,7/16/20,0,0,0,0,0,0,0,0,0,24,0,1362,0,18,0,1,0,5,0,1386,0,0,0,0,0,0,0,1,2,0,12
Union,7/16/20,0,0,0,0,0,0,0,0,0,287,0,3405,0,239,0,14,0,34,0,3692,0,0,0,0,0,0,0,3,1,0,51
VanBuren,7/16/20,0,0,0,0,0,0,0,0,0,37,0,1229,0,34,0,2,0,1,0,1266,0,0,0,0,0,0,0,0,0,0,15
Washington,7/16/20,0,0,0,0,0,0,0,0,0,4860,0,17248,0,4141,0,37,0,682,0,22108,0,0,0,0,0,0,0,82,80,0,280
White,7/16/20,0,0,0,0,0,0,0,0,0,165,0,4741,0,113,0,2,0,50,0,4906,0,0,0,0,0,0,0,8,7,0,137
Woodruff,7/16/20,0,0,0,0,0,0,0,0,0,16,0,833,0,9,0,0,0,7,0,849,0,0,0,0,0,0,0,2,1,0,36
Yell,7/16/20,0,0,0,0,0,0,0,0,0,901,0,2741,0,696,0,10,0,195,0,3642,0,0,0,0,0,0,0,28,13,2,95
Arkansas_all_counties,7/15/20,0,0,0,0,0,0,0,0,2990671,30297,0,369847,0,23523,0,335,0,6439,0,400144,0,0,0,0,0,0,0,564,679,4,6315
Arkansas_county,7/15/20,0,0,0,0,0,0,0,0,0,73,0,1736,0,32,0,0,0,41,0,1809,0,0,0,0,0,0,0,7,0,0,14
Ashley,7/15/20,0,0,0,0,0,0,0,0,0,114,0,1800,0,82,0,3,0,29,0,1914,0,0,0,0,0,0,0,3,5,0,18
Baxter,7/15/20,0,0,0,0,0,0,0,0,0,34,0,2648,0,28,0,0,0,6,0,2682,0,0,0,0,0,0,0,3,4,0,10
Benton,7/15/20,0,0,0,0,0,0,0,0,0,3598,0,40539,0,3108,0,23,0,467,0,44137,0,0,0,0,0,0,0,47,53,0,576
Boone,7/15/20,0,0,0,0,0,0,0,0,0,66,0,2933,0,33,0,1,0,32,0,2999,0,0,0,0,0,0,0,3,0,0,67
Bradley,7/15/20,0,0,0,0,0,0,0,0,0,85,0,1312,0,54,0,2,0,29,0,1397,0,0,0,0,0,0,0,3,0,0,12
Calhoun,7/15/20,0,0,0,0,0,0,0,0,0,4,0,405,0,2,0,0,0,2,0,409,0,0,0,0,0,0,0,0,0,0,2
Carroll,7/15/20,0,0,0,0,0,0,0,0,0,239,0,3234,0,188,0,6,0,45,0,3473,0,0,0,0,0,0,0,3,6,0,36
Chicot,7/15/20,0,0,0,0,0,0,0,0,0,229,0,1627,0,159,0,3,0,67,0,1856,0,0,0,0,0,0,0,5,2,0,28
Clark,7/15/20,0,0,0,0,0,0,0,0,0,80,0,2062,0,65,0,0,0,15,0,2142,0,0,0,0,0,0,0,4,1,0,12
Clay,7/15/20,0,0,0,0,0,0,0,0,0,84,0,1776,0,65,0,3,0,16,0,1860,0,0,0,0,0,0,0,0,0,0,14
Cleburne,7/15/20,0,0,0,0,0,0,0,0,0,138,0,2425,0,107,0,4,0,27,0,2563,0,0,0,0,0,0,0,1,3,0,19
Cleveland,7/15/20,0,0,0,0,0,0,0,0,0,39,0,857,0,30,0,0,0,9,0,896,0,0,0,0,0,0,0,1,1,0,7
Columbia,7/15/20,0,0,0,0,0,0,0,0,0,114,0,1681,0,86,0,5,0,23,0,1795,0,0,0,0,0,0,0,2,2,0,25
Conway,7/15/20,0,0,0,0,0,0,0,0,0,103,0,1958,0,71,0,3,0,29,0,2061,0,0,0,0,0,0,0,5,5,0,34
Craighead,7/15/20,0,0,0,0,0,0,0,0,0,626,0,12417,0,504,0,7,0,115,0,13043,0,0,0,0,0,0,0,16,17,0,141
Crawford,7/15/20,0,0,0,0,0,0,0,0,0,296,0,5518,0,211,0,3,0,82,0,5814,0,0,0,0,0,0,0,5,13,0,110
Crittenden,7/15/20,0,0,0,0,0,0,0,0,0,893,0,6525,0,773,0,14,0,106,0,7418,0,0,0,0,0,0,0,14,9,0,38
Cross,7/15/20,0,0,0,0,0,0,0,0,0,103,0,1604,0,86,0,1,0,16,0,1707,0,0,0,0,0,0,0,1,1,0,10
Dallas,7/15/20,0,0,0,0,0,0,0,0,0,14,0,597,0,11,0,0,0,3,0,611,0,0,0,0,0,0,0,1,1,0,3
Desha,7/15/20,0,0,0,0,0,0,0,0,0,86,0,1240,0,57,0,1,0,28,0,1326,0,0,0,0,0,0,0,1,2,0,26
Drew,7/15/20,0,0,0,0,0,0,0,0,0,98,0,2016,0,70,0,2,0,26,0,2114,0,0,0,0,0,0,0,2,0,0,49
Faulkner,7/15/20,0,0,0,0,0,0,0,0,0,830,0,12252,0,600,0,4,0,226,0,13082,0,0,0,0,0,0,0,20,30,0,179
Franklin,7/15/20,0,0,0,0,0,0,0,0,0,34,0,1689,0,26,0,1,0,7,0,1723,0,0,0,0,0,0,0,0,2,0,36
Fulton,7/15/20,0,0,0,0,0,0,0,0,0,18,0,1051,0,16,0,0,0,2,0,1069,0,0,0,0,0,0,0,0,0,0,6
Garland,7/15/20,0,0,0,0,0,0,0,0,0,366,0,8996,0,292,0,5,0,69,0,9362,0,0,0,0,0,0,0,19,19,2,122
Grant,7/15/20,0,0,0,0,0,0,0,0,0,64,0,1495,0,50,0,0,0,14,0,1559,0,0,0,0,0,0,0,2,4,0,13
Greene,7/15/20,0,0,0,0,0,0,0,0,0,156,0,4542,0,133,0,0,0,23,0,4698,0,0,0,0,0,0,0,2,3,0,73
Hempstead,7/15/20,0,0,0,0,0,0,0,0,0,96,0,1968,0,61,0,1,0,34,0,2064,0,0,0,0,0,0,0,0,1,0,12
HotSpring,7/15/20,0,0,0,0,0,0,0,0,0,1300,0,4098,0,508,0,1,0,791,0,5398,0,0,0,0,0,0,0,6,65,0,32
Howard,7/15/20,0,0,0,0,0,0,0,0,0,157,0,1733,0,118,0,1,0,38,0,1890,0,0,0,0,0,0,0,3,3,0,5
Independence,7/15/20,0,0,0,0,0,0,0,0,0,83,0,3379,0,62,0,0,0,21,0,3462,0,0,0,0,0,0,0,4,1,0,34
Izard,7/15/20,0,0,0,0,0,0,0,0,0,26,0,1099,0,22,0,1,0,3,0,1125,0,0,0,0,0,0,0,0,0,0,3
Jackson,7/15/20,0,0,0,0,0,0,0,0,0,43,0,1437,0,31,0,0,0,12,0,1480,0,0,0,0,0,0,0,1,3,0,22
Jefferson,7/15/20,0,0,0,0,0,0,0,0,0,917,0,8745,0,709,0,29,0,179,0,9662,0,0,0,0,0,0,0,17,11,0,100
Johnson,7/15/20,0,0,0,0,0,0,0,0,0,444,0,1721,0,334,0,0,0,110,0,2165,0,0,0,0,0,0,0,17,23,0,19
Lafayette,7/15/20,0,0,0,0,0,0,0,0,0,32,0,408,0,21,0,2,0,9,0,440,0,0,0,0,0,0,0,0,2,0,2
Lawrence,7/15/20,0,0,0,0,0,0,0,0,0,121,0,1817,0,91,0,9,0,21,0,1938,0,0,0,0,0,0,0,-2,0,0,5
Lee,7/15/20,0,0,0,0,0,0,0,0,0,851,0,2409,0,745,0,5,0,101,0,3260,0,0,0,0,0,0,0,1,3,0,8
Lincoln,7/15/20,0,0,0,0,0,0,0,0,0,1052,0,2008,0,1016,0,11,0,25,0,3060,0,0,0,0,0,0,0,0,0,0,15
LittleRiver,7/15/20,0,0,0,0,0,0,0,0,0,54,0,930,0,41,0,0,0,13,0,984,0,0,0,0,0,0,0,4,0,0,6
Logan,7/15/20,0,0,0,0,0,0,0,0,0,91,0,2385,0,54,0,0,0,37,0,2476,0,0,0,0,0,0,0,2,1,0,35
Lonoke,7/15/20,0,0,0,0,0,0,0,0,0,218,0,5560,0,166,0,2,0,50,0,5778,0,0,0,0,0,0,0,5,7,1,52
Madison,7/15/20,0,0,0,0,0,0,0,0,0,223,0,2035,0,205,0,1,0,17,0,2258,0,0,0,0,0,0,0,-1,6,0,8
Marion,7/15/20,0,0,0,0,0,0,0,0,0,14,0,1056,0,11,0,0,0,3,0,1070,0,0,0,0,0,0,0,0,0,0,5
Miller,7/15/20,0,0,0,0,0,0,0,0,0,293,0,2745,0,144,0,2,0,147,0,3038,0,0,0,0,0,0,0,2,5,0,27
MissingCountyInfo,7/15/20,0,0,0,0,0,0,0,0,0,1049,0,57073,0,672,0,0,0,377,0,58122,0,0,0,0,0,0,0,6,13,0,178
Mississippi,7/15/20,0,0,0,0,0,0,0,0,0,357,0,4473,0,244,0,3,0,110,0,4830,0,0,0,0,0,0,0,8,14,0,53
Monroe,7/15/20,0,0,0,0,0,0,0,0,0,26,0,882,0,19,0,0,0,7,0,908,0,0,0,0,0,0,0,-1,3,0,7
Montgomery,7/15/20,0,0,0,0,0,0,0,0,0,8,0,704,0,6,0,0,0,2,0,712,0,0,0,0,0,0,0,1,0,0,9
Nevada,7/15/20,0,0,0,0,0,0,0,0,0,112,0,1288,0,87,0,3,0,22,0,1400,0,0,0,0,0,0,0,0,1,0,2
Newton,7/15/20,0,0,0,0,0,0,0,0,0,13,0,577,0,7,0,0,0,6,0,590,0,0,0,0,0,0,0,1,0,0,11
Ouachita,7/15/20,0,0,0,0,0,0,0,0,0,37,0,2116,0,27,0,0,0,10,0,2153,0,0,0,0,0,0,0,0,0,0,11
Perry,7/15/20,0,0,0,0,0,0,0,0,0,36,0,1063,0,31,0,0,0,5,0,1099,0,0,0,0,0,0,0,2,1,0,117
Phillips,7/15/20,0,0,0,0,0,0,0,0,0,192,0,2836,0,144,0,5,0,43,0,3028,0,0,0,0,0,0,0,1,2,0,7
Pike,7/15/20,0,0,0,0,0,0,0,0,0,23,0,2059,0,11,0,0,0,12,0,2082,0,0,0,0,0,0,0,3,1,0,18
Poinsett,7/15/20,0,0,0,0,0,0,0,0,0,79,0,1887,0,58,0,3,0,18,0,1966,0,0,0,0,0,0,0,1,3,0,9
Polk,7/15/20,0,0,0,0,0,0,0,0,0,94,0,1714,0,80,0,0,0,14,0,1808,0,0,0,0,0,0,0,4,2,0,20
Pope,7/15/20,0,0,0,0,0,0,0,0,0,729,0,6701,0,581,0,4,0,144,0,7430,0,0,0,0,0,0,0,10,21,0,76
Prairie,7/15/20,0,0,0,0,0,0,0,0,0,39,0,702,0,22,0,0,0,17,0,741,0,0,0,0,0,0,0,1,0,0,10
Pulaski,7/15/20,0,0,0,0,0,0,0,0,0,3298,0,44005,0,2344,0,67,0,887,0,47303,0,0,0,0,0,0,0,150,90,0,674
Randolph,7/15/20,0,0,0,0,0,0,0,0,0,83,0,2165,0,51,0,2,0,30,0,2248,0,0,0,0,0,0,0,3,0,0,15
Saline,7/15/20,0,0,0,0,0,0,0,0,0,521,0,10794,0,380,0,3,0,138,0,11315,0,0,0,0,0,0,0,9,21,0,118
Scott,7/15/20,0,0,0,0,0,0,0,0,0,18,0,661,0,14,0,0,0,4,0,679,0,0,0,0,0,0,0,1,2,0,15
Searcy,7/15/20,0,0,0,0,0,0,0,0,0,17,0,900,0,12,0,0,0,5,0,917,0,0,0,0,0,0,0,0,1,0,5
Sebastian,7/15/20,0,0,0,0,0,0,0,0,0,981,0,14073,0,622,0,8,0,351,0,15054,0,0,0,0,0,0,0,52,34,0,363
Sevier,7/15/20,0,0,0,0,0,0,0,0,0,822,0,3769,0,751,0,9,0,62,0,4591,0,0,0,0,0,0,0,3,16,0,15
Sharp,7/15/20,0,0,0,0,0,0,0,0,0,72,0,1255,0,53,0,5,0,14,0,1327,0,0,0,0,0,0,0,3,2,0,9
St.Francis,7/15/20,0,0,0,0,0,0,0,0,0,926,0,4625,0,879,0,3,0,44,0,5551,0,0,0,0,0,0,0,6,1,0,29
Stone,7/15/20,0,0,0,0,0,0,0,0,0,23,0,1351,0,16,0,1,0,6,0,1374,0,0,0,0,0,0,0,1,1,0,6
Union,7/15/20,0,0,0,0,0,0,0,0,0,284,0,3357,0,238,0,14,0,32,0,3641,0,0,0,0,0,0,0,2,8,0,16
VanBuren,7/15/20,0,0,0,0,0,0,0,0,0,37,0,1214,0,34,0,2,0,1,0,1251,0,0,0,0,0,0,0,0,0,0,5
Washington,7/15/20,0,0,0,0,0,0,0,0,0,4778,0,17050,0,4061,0,37,0,680,0,21828,0,0,0,0,0,0,0,57,105,0,855
White,7/15/20,0,0,0,0,0,0,0,0,0,157,0,4612,0,106,0,2,0,49,0,4769,0,0,0,0,0,0,0,1,3,0,31
Woodruff,7/15/20,0,0,0,0,0,0,0,0,0,14,0,799,0,8,0,0,0,6,0,813,0,0,0,0,0,0,0,0,1,0,7
Yell,7/15/20,0,0,0,0,0,0,0,0,0,873,0,2674,0,683,0,8,0,182,0,3547,0,0,0,0,0,0,0,10,15,1,171
Arkansas_all_counties,7/14/20,0,0,0,0,0,0,0,0,2990671,29733,0,365479,0,22844,0,331,0,6558,0,395212,0,0,0,0,0,0,0,794,738,8,7343
Arkansas_county,7/14/20,0,0,0,0,0,0,0,0,0,66,0,1729,0,32,0,0,0,34,0,1795,0,0,0,0,0,0,0,6,1,0,27
Ashley,7/14/20,0,0,0,0,0,0,0,0,0,111,0,1785,0,77,0,3,0,31,0,1896,0,0,0,0,0,0,0,1,3,0,12
Baxter,7/14/20,0,0,0,0,0,0,0,0,0,31,0,2641,0,24,0,0,0,7,0,2672,0,0,0,0,0,0,0,0,1,0,39
Benton,7/14/20,0,0,0,0,0,0,0,0,0,3551,0,40010,0,3055,0,23,0,473,0,43561,0,0,0,0,0,0,0,55,81,1,414
Boone,7/14/20,0,0,0,0,0,0,0,0,0,63,0,2869,0,33,0,1,0,29,0,2932,0,0,0,0,0,0,0,10,4,0,55
Bradley,7/14/20,0,0,0,0,0,0,0,0,0,82,0,1303,0,54,0,2,0,26,0,1385,0,0,0,0,0,0,0,1,1,0,3
Calhoun,7/14/20,0,0,0,0,0,0,0,0,0,4,0,403,0,2,0,0,0,2,0,407,0,0,0,0,0,0,0,1,0,0,5
Carroll,7/14/20,0,0,0,0,0,0,0,0,0,236,0,3201,0,182,0,6,0,48,0,3437,0,0,0,0,0,0,0,6,3,0,50
Chicot,7/14/20,0,0,0,0,0,0,0,0,0,224,0,1604,0,157,0,3,0,64,0,1828,0,0,0,0,0,0,0,6,7,0,14
Clark,7/14/20,0,0,0,0,0,0,0,0,0,76,0,2054,0,64,0,0,0,12,0,2130,0,0,0,0,0,0,0,3,4,0,16
Clay,7/14/20,0,0,0,0,0,0,0,0,0,84,0,1762,0,65,0,3,0,16,0,1846,0,0,0,0,0,0,0,2,0,0,17
Cleburne,7/14/20,0,0,0,0,0,0,0,0,0,137,0,2407,0,104,0,4,0,29,0,2544,0,0,0,0,0,0,0,4,5,0,28
Cleveland,7/14/20,0,0,0,0,0,0,0,0,0,38,0,851,0,29,0,0,0,9,0,889,0,0,0,0,0,0,0,0,2,0,2
Columbia,7/14/20,0,0,0,0,0,0,0,0,0,112,0,1658,0,84,0,5,0,23,0,1770,0,0,0,0,0,0,0,3,1,0,15
Conway,7/14/20,0,0,0,0,0,0,0,0,0,98,0,1929,0,66,0,3,0,29,0,2027,0,0,0,0,0,0,0,1,7,0,46
Craighead,7/14/20,0,0,0,0,0,0,0,0,0,610,0,12292,0,487,0,7,0,116,0,12902,0,0,0,0,0,0,0,45,12,0,183
Crawford,7/14/20,0,0,0,0,0,0,0,0,0,291,0,5413,0,198,0,3,0,90,0,5704,0,0,0,0,0,0,0,7,16,0,82
Crittenden,7/14/20,0,0,0,0,0,0,0,0,0,879,0,6501,0,764,0,14,0,101,0,7380,0,0,0,0,0,0,0,14,8,0,44
Cross,7/14/20,0,0,0,0,0,0,0,0,0,102,0,1595,0,85,0,1,0,16,0,1697,0,0,0,0,0,0,0,1,0,0,7
Dallas,7/14/20,0,0,0,0,0,0,0,0,0,13,0,595,0,10,0,0,0,3,0,608,0,0,0,0,0,0,0,1,0,0,8
Desha,7/14/20,0,0,0,0,0,0,0,0,0,85,0,1215,0,55,0,1,0,29,0,1300,0,0,0,0,0,0,0,1,2,0,22
Drew,7/14/20,0,0,0,0,0,0,0,0,0,96,0,1969,0,70,0,2,0,24,0,2065,0,0,0,0,0,0,0,1,3,0,19
Faulkner,7/14/20,0,0,0,0,0,0,0,0,0,810,0,12093,0,570,0,4,0,236,0,12903,0,0,0,0,0,0,0,22,25,1,218
Franklin,7/14/20,0,0,0,0,0,0,0,0,0,34,0,1653,0,24,0,1,0,9,0,1687,0,0,0,0,0,0,0,1,0,0,25
Fulton,7/14/20,0,0,0,0,0,0,0,0,0,18,0,1045,0,16,0,0,0,2,0,1063,0,0,0,0,0,0,0,0,1,0,8
Garland,7/14/20,0,0,0,0,0,0,0,0,0,347,0,8893,0,273,0,3,0,71,0,9240,0,0,0,0,0,0,0,6,5,0,81
Grant,7/14/20,0,0,0,0,0,0,0,0,0,62,0,1484,0,46,0,0,0,16,0,1546,0,0,0,0,0,0,0,4,2,0,36
Greene,7/14/20,0,0,0,0,0,0,0,0,0,154,0,4471,0,130,0,0,0,24,0,4625,0,0,0,0,0,0,0,4,3,0,40
Hempstead,7/14/20,0,0,0,0,0,0,0,0,0,96,0,1956,0,60,0,1,0,35,0,2052,0,0,0,0,0,0,0,9,2,0,85
HotSpring,7/14/20,0,0,0,0,0,0,0,0,0,1294,0,4072,0,443,0,1,0,850,0,5366,0,0,0,0,0,0,0,24,2,0,45
Howard,7/14/20,0,0,0,0,0,0,0,0,0,154,0,1731,0,115,0,1,0,38,0,1885,0,0,0,0,0,0,0,16,7,0,73
Independence,7/14/20,0,0,0,0,0,0,0,0,0,79,0,3349,0,61,0,0,0,18,0,3428,0,0,0,0,0,0,0,5,2,0,40
Izard,7/14/20,0,0,0,0,0,0,0,0,0,26,0,1096,0,22,0,1,0,3,0,1122,0,0,0,0,0,0,0,1,1,0,21
Jackson,7/14/20,0,0,0,0,0,0,0,0,0,42,0,1416,0,28,0,0,0,14,0,1458,0,0,0,0,0,0,0,1,0,0,26
Jefferson,7/14/20,0,0,0,0,0,0,0,0,0,900,0,8662,0,698,0,29,0,173,0,9562,0,0,0,0,0,0,0,16,15,0,282
Johnson,7/14/20,0,0,0,0,0,0,0,0,0,427,0,1719,0,311,0,0,0,116,0,2146,0,0,0,0,0,0,0,46,18,0,49
Lafayette,7/14/20,0,0,0,0,0,0,0,0,0,32,0,406,0,19,0,2,0,11,0,438,0,0,0,0,0,0,0,2,0,0,4
Lawrence,7/14/20,0,0,0,0,0,0,0,0,0,123,0,1810,0,91,0,9,0,23,0,1933,0,0,0,0,0,0,0,8,1,0,32
Lee,7/14/20,0,0,0,0,0,0,0,0,0,850,0,2402,0,742,0,5,0,103,0,3252,0,0,0,0,0,0,0,22,87,1,31
Lincoln,7/14/20,0,0,0,0,0,0,0,0,0,1052,0,1993,0,1016,0,11,0,25,0,3045,0,0,0,0,0,0,0,4,1,0,15
LittleRiver,7/14/20,0,0,0,0,0,0,0,0,0,50,0,928,0,41,0,0,0,9,0,978,0,0,0,0,0,0,0,5,1,0,12
Logan,7/14/20,0,0,0,0,0,0,0,0,0,89,0,2352,0,53,0,0,0,36,0,2441,0,0,0,0,0,0,0,2,2,0,22
Lonoke,7/14/20,0,0,0,0,0,0,0,0,0,213,0,5513,0,159,0,1,0,53,0,5726,0,0,0,0,0,0,0,12,7,0,84
Madison,7/14/20,0,0,0,0,0,0,0,0,0,224,0,2026,0,199,0,1,0,24,0,2250,0,0,0,0,0,0,0,1,1,0,15
Marion,7/14/20,0,0,0,0,0,0,0,0,0,14,0,1051,0,11,0,0,0,3,0,1065,0,0,0,0,0,0,0,0,1,0,13
Miller,7/14/20,0,0,0,0,0,0,0,0,0,291,0,2720,0,139,0,2,0,150,0,3011,0,0,0,0,0,0,0,11,7,0,46
MissingCountyInfo,7/14/20,0,0,0,0,0,0,0,0,0,1043,0,56901,0,659,0,0,0,384,0,57944,0,0,0,0,0,0,0,-78,-19,0,533
Mississippi,7/14/20,0,0,0,0,0,0,0,0,0,349,0,4428,0,230,0,3,0,116,0,4777,0,0,0,0,0,0,0,12,18,0,62
Monroe,7/14/20,0,0,0,0,0,0,0,0,0,27,0,874,0,16,0,0,0,11,0,901,0,0,0,0,0,0,0,5,0,0,29
Montgomery,7/14/20,0,0,0,0,0,0,0,0,0,7,0,696,0,6,0,0,0,1,0,703,0,0,0,0,0,0,0,0,0,0,2
Nevada,7/14/20,0,0,0,0,0,0,0,0,0,112,0,1286,0,86,0,3,0,23,0,1398,0,0,0,0,0,0,0,2,0,0,25
Newton,7/14/20,0,0,0,0,0,0,0,0,0,12,0,567,0,7,0,0,0,5,0,579,0,0,0,0,0,0,0,1,0,0,10
Ouachita,7/14/20,0,0,0,0,0,0,0,0,0,37,0,2105,0,27,0,0,0,10,0,2142,0,0,0,0,0,0,0,1,1,0,22
Perry,7/14/20,0,0,0,0,0,0,0,0,0,34,0,948,0,30,0,0,0,4,0,982,0,0,0,0,0,0,0,0,1,0,18
Phillips,7/14/20,0,0,0,0,0,0,0,0,0,191,0,2830,0,142,0,5,0,44,0,3021,0,0,0,0,0,0,0,16,6,0,87
Pike,7/14/20,0,0,0,0,0,0,0,0,0,20,0,2044,0,10,0,0,0,10,0,2064,0,0,0,0,0,0,0,0,1,0,24
Poinsett,7/14/20,0,0,0,0,0,0,0,0,0,78,0,1879,0,55,0,3,0,20,0,1957,0,0,0,0,0,0,0,2,0,0,15
Polk,7/14/20,0,0,0,0,0,0,0,0,0,90,0,1698,0,78,0,0,0,12,0,1788,0,0,0,0,0,0,0,1,0,0,16
Pope,7/14/20,0,0,0,0,0,0,0,0,0,719,0,6635,0,560,0,4,0,155,0,7354,0,0,0,0,0,0,0,40,28,0,105
Prairie,7/14/20,0,0,0,0,0,0,0,0,0,38,0,693,0,22,0,0,0,16,0,731,0,0,0,0,0,0,0,8,1,0,26
Pulaski,7/14/20,0,0,0,0,0,0,0,0,0,3148,0,43481,0,2254,0,67,0,827,0,46629,0,0,0,0,0,0,0,129,111,2,1027
Randolph,7/14/20,0,0,0,0,0,0,0,0,0,80,0,2153,0,51,0,2,0,27,0,2233,0,0,0,0,0,0,0,2,2,1,10
Saline,7/14/20,0,0,0,0,0,0,0,0,0,512,0,10685,0,359,0,3,0,150,0,11197,0,0,0,0,0,0,0,22,17,0,155
Scott,7/14/20,0,0,0,0,0,0,0,0,0,17,0,647,0,12,0,0,0,5,0,664,0,0,0,0,0,0,0,0,0,0,6
Searcy,7/14/20,0,0,0,0,0,0,0,0,0,17,0,895,0,11,0,0,0,6,0,912,0,0,0,0,0,0,0,-1,0,0,2
Sebastian,7/14/20,0,0,0,0,0,0,0,0,0,929,0,13762,0,588,0,8,0,333,0,14691,0,0,0,0,0,0,0,55,47,1,474
Sevier,7/14/20,0,0,0,0,0,0,0,0,0,819,0,3757,0,735,0,9,0,75,0,4576,0,0,0,0,0,0,0,8,15,0,40
Sharp,7/14/20,0,0,0,0,0,0,0,0,0,69,0,1249,0,51,0,5,0,13,0,1318,0,0,0,0,0,0,0,0,0,0,4
St.Francis,7/14/20,0,0,0,0,0,0,0,0,0,920,0,4602,0,878,0,3,0,39,0,5522,0,0,0,0,0,0,0,9,3,0,24
Stone,7/14/20,0,0,0,0,0,0,0,0,0,22,0,1346,0,15,0,1,0,6,0,1368,0,0,0,0,0,0,0,0,1,0,10
Union,7/14/20,0,0,0,0,0,0,0,0,0,282,0,3343,0,230,0,14,0,38,0,3625,0,0,0,0,0,0,0,7,2,0,29
VanBuren,7/14/20,0,0,0,0,0,0,0,0,0,37,0,1209,0,34,0,2,0,1,0,1246,0,0,0,0,0,0,0,1,2,0,10
Washington,7/14/20,0,0,0,0,0,0,0,0,0,4721,0,16252,0,3956,0,37,0,728,0,20973,0,0,0,0,0,0,0,127,131,1,437
White,7/14/20,0,0,0,0,0,0,0,0,0,156,0,4582,0,103,0,2,0,51,0,4738,0,0,0,0,0,0,0,7,4,0,45
Woodruff,7/14/20,0,0,0,0,0,0,0,0,0,14,0,792,0,7,0,0,0,7,0,806,0,0,0,0,0,0,0,2,0,0,6
Yell,7/14/20,0,0,0,0,0,0,0,0,0,863,0,2513,0,668,0,7,0,188,0,3376,0,0,0,0,0,0,0,25,14,2,43
Arkansas_all_counties,7/13/20,0,0,0,0,0,0,0,0,2990671,28939,0,360566,0,22106,0,323,0,6510,0,389505,0,0,0,0,0,0,0,572,515,2,5733
Arkansas_county,7/13/20,0,0,0,0,0,0,0,0,0,60,0,1708,0,31,0,0,0,29,0,1768,0,0,0,0,0,0,0,1,1,0,15
Ashley,7/13/20,0,0,0,0,0,0,0,0,0,110,0,1774,0,74,0,3,0,33,0,1884,0,0,0,0,0,0,0,10,3,0,52
Baxter,7/13/20,0,0,0,0,0,0,0,0,0,31,0,2602,0,23,0,0,0,8,0,2633,0,0,0,0,0,0,0,1,1,0,30
Benton,7/13/20,0,0,0,0,0,0,0,0,0,3496,0,39651,0,2974,0,22,0,500,0,43147,0,0,0,0,0,0,0,26,51,0,599
Boone,7/13/20,0,0,0,0,0,0,0,0,0,53,0,2824,0,29,0,1,0,23,0,2877,0,0,0,0,0,0,0,2,1,0,85
Bradley,7/13/20,0,0,0,0,0,0,0,0,0,81,0,1301,0,53,0,2,0,26,0,1382,0,0,0,0,0,0,0,1,1,0,17
Calhoun,7/13/20,0,0,0,0,0,0,0,0,0,3,0,399,0,2,0,0,0,1,0,402,0,0,0,0,0,0,0,0,0,0,23
Carroll,7/13/20,0,0,0,0,0,0,0,0,0,230,0,3157,0,179,0,6,0,45,0,3387,0,0,0,0,0,0,0,2,3,0,19
Chicot,7/13/20,0,0,0,0,0,0,0,0,0,218,0,1596,0,150,0,3,0,65,0,1814,0,0,0,0,0,0,0,1,7,0,12
Clark,7/13/20,0,0,0,0,0,0,0,0,0,73,0,2041,0,60,0,0,0,13,0,2114,0,0,0,0,0,0,0,2,2,0,13
Clay,7/13/20,0,0,0,0,0,0,0,0,0,82,0,1747,0,65,0,3,0,14,0,1829,0,0,0,0,0,0,0,1,3,0,19
Cleburne,7/13/20,0,0,0,0,0,0,0,0,0,133,0,2383,0,99,0,4,0,30,0,2516,0,0,0,0,0,0,0,1,2,0,42
Cleveland,7/13/20,0,0,0,0,0,0,0,0,0,38,0,849,0,27,0,0,0,11,0,887,0,0,0,0,0,0,0,1,0,0,9
Columbia,7/13/20,0,0,0,0,0,0,0,0,0,109,0,1646,0,83,0,5,0,21,0,1755,0,0,0,0,0,0,0,0,2,0,24
Conway,7/13/20,0,0,0,0,0,0,0,0,0,97,0,1884,0,59,0,3,0,35,0,1981,0,0,0,0,0,0,0,5,4,0,38
Craighead,7/13/20,0,0,0,0,0,0,0,0,0,565,0,12154,0,475,0,7,0,83,0,12719,0,0,0,0,0,0,0,20,9,0,203
Crawford,7/13/20,0,0,0,0,0,0,0,0,0,284,0,5338,0,182,0,3,0,99,0,5622,0,0,0,0,0,0,0,9,5,0,149
Crittenden,7/13/20,0,0,0,0,0,0,0,0,0,865,0,6471,0,756,0,14,0,95,0,7336,0,0,0,0,0,0,0,24,10,0,74
Cross,7/13/20,0,0,0,0,0,0,0,0,0,101,0,1589,0,85,0,1,0,15,0,1690,0,0,0,0,0,0,0,0,0,0,9
Dallas,7/13/20,0,0,0,0,0,0,0,0,0,12,0,588,0,10,0,0,0,2,0,600,0,0,0,0,0,0,0,0,0,0,4
Desha,7/13/20,0,0,0,0,0,0,0,0,0,84,0,1194,0,53,0,1,0,30,0,1278,0,0,0,0,0,0,0,3,1,0,11
Drew,7/13/20,0,0,0,0,0,0,0,0,0,95,0,1951,0,67,0,2,0,26,0,2046,0,0,0,0,0,0,0,3,1,0,38
Faulkner,7/13/20,0,0,0,0,0,0,0,0,0,788,0,11897,0,545,0,3,0,240,0,12685,0,0,0,0,0,0,0,17,24,0,196
Franklin,7/13/20,0,0,0,0,0,0,0,0,0,33,0,1629,0,24,0,1,0,8,0,1662,0,0,0,0,0,0,0,3,2,0,38
Fulton,7/13/20,0,0,0,0,0,0,0,0,0,18,0,1037,0,15,0,0,0,3,0,1055,0,0,0,0,0,0,0,0,2,0,13
Garland,7/13/20,0,0,0,0,0,0,0,0,0,341,0,8818,0,268,0,3,0,70,0,9159,0,0,0,0,0,0,0,9,4,0,94
Grant,7/13/20,0,0,0,0,0,0,0,0,0,58,0,1452,0,44,0,0,0,14,0,1510,0,0,0,0,0,0,0,3,0,0,44
Greene,7/13/20,0,0,0,0,0,0,0,0,0,150,0,4435,0,127,0,0,0,23,0,4585,0,0,0,0,0,0,0,2,2,0,63
Hempstead,7/13/20,0,0,0,0,0,0,0,0,0,87,0,1880,0,58,0,1,0,28,0,1967,0,0,0,0,0,0,0,8,1,0,37
HotSpring,7/13/20,0,0,0,0,0,0,0,0,0,1270,0,4051,0,441,0,1,0,828,0,5321,0,0,0,0,0,0,0,4,2,0,35
Howard,7/13/20,0,0,0,0,0,0,0,0,0,138,0,1674,0,108,0,1,0,29,0,1812,0,0,0,0,0,0,0,1,2,0,39
Independence,7/13/20,0,0,0,0,0,0,0,0,0,74,0,3314,0,59,0,0,0,15,0,3388,0,0,0,0,0,0,0,1,0,0,50
Izard,7/13/20,0,0,0,0,0,0,0,0,0,25,0,1076,0,21,0,1,0,3,0,1101,0,0,0,0,0,0,0,0,0,0,10
Jackson,7/13/20,0,0,0,0,0,0,0,0,0,41,0,1391,0,28,0,0,0,13,0,1432,0,0,0,0,0,0,0,0,0,0,28
Jefferson,7/13/20,0,0,0,0,0,0,0,0,0,884,0,8396,0,683,0,29,0,172,0,9280,0,0,0,0,0,0,0,23,7,0,519
Johnson,7/13/20,0,0,0,0,0,0,0,0,0,381,0,1716,0,293,0,0,0,88,0,2097,0,0,0,0,0,0,0,15,7,0,75
Lafayette,7/13/20,0,0,0,0,0,0,0,0,0,30,0,404,0,19,0,2,0,9,0,434,0,0,0,0,0,0,0,1,2,0,13
Lawrence,7/13/20,0,0,0,0,0,0,0,0,0,115,0,1786,0,90,0,9,0,16,0,1901,0,0,0,0,0,0,0,0,0,0,31
Lee,7/13/20,0,0,0,0,0,0,0,0,0,828,0,2393,0,655,0,4,0,169,0,3221,0,0,0,0,0,0,0,1,13,0,61
Lincoln,7/13/20,0,0,0,0,0,0,0,0,0,1048,0,1982,0,1015,0,11,0,22,0,3030,0,0,0,0,0,0,0,0,0,0,10
LittleRiver,7/13/20,0,0,0,0,0,0,0,0,0,45,0,921,0,40,0,0,0,5,0,966,0,0,0,0,0,0,0,2,0,0,19
Logan,7/13/20,0,0,0,0,0,0,0,0,0,87,0,2332,0,51,0,0,0,36,0,2419,0,0,0,0,0,0,0,6,2,0,77
Lonoke,7/13/20,0,0,0,0,0,0,0,0,0,201,0,5441,0,152,0,1,0,48,0,5642,0,0,0,0,0,0,0,4,6,0,142
Madison,7/13/20,0,0,0,0,0,0,0,0,0,223,0,2012,0,198,0,1,0,24,0,2235,0,0,0,0,0,0,0,0,1,0,16
Marion,7/13/20,0,0,0,0,0,0,0,0,0,14,0,1038,0,10,0,0,0,4,0,1052,0,0,0,0,0,0,0,1,0,0,6
Miller,7/13/20,0,0,0,0,0,0,0,0,0,280,0,2685,0,132,0,2,0,146,0,2965,0,0,0,0,0,0,0,15,4,0,89
MissingCountyInfo,7/13/20,0,0,0,0,0,0,0,0,0,1121,0,56290,0,678,0,0,0,443,0,57411,0,0,0,0,0,0,0,48,34,0,435
Mississippi,7/13/20,0,0,0,0,0,0,0,0,0,337,0,4378,0,212,0,3,0,122,0,4715,0,0,0,0,0,0,0,23,27,0,78
Monroe,7/13/20,0,0,0,0,0,0,0,0,0,22,0,850,0,16,0,0,0,6,0,872,0,0,0,0,0,0,0,1,1,0,12
Montgomery,7/13/20,0,0,0,0,0,0,0,0,0,7,0,694,0,6,0,0,0,1,0,701,0,0,0,0,0,0,0,0,0,0,8
Nevada,7/13/20,0,0,0,0,0,0,0,0,0,110,0,1263,0,86,0,3,0,21,0,1373,0,0,0,0,0,0,0,1,-1,0,14
Newton,7/13/20,0,0,0,0,0,0,0,0,0,11,0,558,0,7,0,0,0,4,0,569,0,0,0,0,0,0,0,1,0,0,7
Ouachita,7/13/20,0,0,0,0,0,0,0,0,0,36,0,2084,0,26,0,0,0,10,0,2120,0,0,0,0,0,0,0,2,2,0,41
Perry,7/13/20,0,0,0,0,0,0,0,0,0,34,0,930,0,29,0,0,0,5,0,964,0,0,0,0,0,0,0,0,0,0,7
Phillips,7/13/20,0,0,0,0,0,0,0,0,0,175,0,2759,0,136,0,5,0,34,0,2934,0,0,0,0,0,0,0,2,3,0,40
Pike,7/13/20,0,0,0,0,0,0,0,0,0,20,0,2020,0,9,0,0,0,11,0,2040,0,0,0,0,0,0,0,1,0,0,47
Poinsett,7/13/20,0,0,0,0,0,0,0,0,0,76,0,1866,0,55,0,3,0,18,0,1942,0,0,0,0,0,0,0,1,1,0,59
Polk,7/13/20,0,0,0,0,0,0,0,0,0,89,0,1683,0,78,0,0,0,11,0,1772,0,0,0,0,0,0,0,1,1,0,39
Pope,7/13/20,0,0,0,0,0,0,0,0,0,679,0,6570,0,532,0,4,0,143,0,7249,0,0,0,0,0,0,0,24,25,0,152
Prairie,7/13/20,0,0,0,0,0,0,0,0,0,30,0,675,0,21,0,0,0,9,0,705,0,0,0,0,0,0,0,0,0,0,12
Pulaski,7/13/20,0,0,0,0,0,0,0,0,0,3019,0,42583,0,2143,0,65,0,811,0,45602,0,0,0,0,0,0,0,81,89,0,1460
Randolph,7/13/20,0,0,0,0,0,0,0,0,0,78,0,2145,0,49,0,1,0,28,0,2223,0,0,0,0,0,0,0,2,0,0,23
Saline,7/13/20,0,0,0,0,0,0,0,0,0,490,0,10552,0,342,0,3,0,145,0,11042,0,0,0,0,0,0,0,19,13,0,233
Scott,7/13/20,0,0,0,0,0,0,0,0,0,17,0,641,0,12,0,0,0,5,0,658,0,0,0,0,0,0,0,1,0,0,44
Searcy,7/13/20,0,0,0,0,0,0,0,0,0,18,0,892,0,11,0,0,0,7,0,910,0,0,0,0,0,0,0,1,0,0,13
Sebastian,7/13/20,0,0,0,0,0,0,0,0,0,874,0,13343,0,541,0,7,0,326,0,14217,0,0,0,0,0,0,0,40,23,0,531
Sevier,7/13/20,0,0,0,0,0,0,0,0,0,811,0,3725,0,720,0,9,0,82,0,4536,0,0,0,0,0,0,0,4,10,0,34
Sharp,7/13/20,0,0,0,0,0,0,0,0,0,69,0,1245,0,51,0,5,0,13,0,1314,0,0,0,0,0,0,0,1,0,0,10
St.Francis,7/13/20,0,0,0,0,0,0,0,0,0,911,0,4587,0,875,0,3,0,33,0,5498,0,0,0,0,0,0,0,5,1,0,44
Stone,7/13/20,0,0,0,0,0,0,0,0,0,22,0,1336,0,14,0,1,0,7,0,1358,0,0,0,0,0,0,0,0,0,0,22
Union,7/13/20,0,0,0,0,0,0,0,0,0,275,0,3321,0,228,0,14,0,33,0,3596,0,0,0,0,0,0,0,1,2,0,34
VanBuren,7/13/20,0,0,0,0,0,0,0,0,0,36,0,1200,0,32,0,2,0,2,0,1236,0,0,0,0,0,0,0,1,1,0,10
Washington,7/13/20,0,0,0,0,0,0,0,0,0,4594,0,15942,0,3825,0,36,0,733,0,20536,0,0,0,0,0,0,0,68,69,0,391
White,7/13/20,0,0,0,0,0,0,0,0,0,149,0,4544,0,99,0,2,0,48,0,4693,0,0,0,0,0,0,0,8,3,0,79
Woodruff,7/13/20,0,0,0,0,0,0,0,0,0,12,0,788,0,7,0,0,0,5,0,800,0,0,0,0,0,0,0,0,0,0,17
Yell,7/13/20,0,0,0,0,0,0,0,0,0,838,0,2495,0,654,0,5,0,179,0,3333,0,0,0,0,0,0,0,6,23,0,17
Arkansas_all_counties,7/12/20,0,0,0,0,0,0,0,0,2990671,28367,0,354035,0,21591,0,321,0,6455,0,382402,0,0,0,0,0,0,0,503,401,2,6665
Arkansas_county,7/12/20,0,0,0,0,0,0,0,0,0,59,0,1694,0,30,0,0,0,29,0,1753,0,0,0,0,0,0,0,3,1,0,28
Ashley,7/12/20,0,0,0,0,0,0,0,0,0,100,0,1732,0,71,0,3,0,26,0,1832,0,0,0,0,0,0,0,3,4,0,49
Baxter,7/12/20,0,0,0,0,0,0,0,0,0,30,0,2573,0,22,0,0,0,8,0,2603,0,0,0,0,0,0,0,1,0,0,51
Benton,7/12/20,0,0,0,0,0,0,0,0,0,3470,0,39078,0,2923,0,22,0,525,0,42548,0,0,0,0,0,0,0,54,40,0,670
Boone,7/12/20,0,0,0,0,0,0,0,0,0,51,0,2741,0,28,0,1,0,22,0,2792,0,0,0,0,0,0,0,5,0,0,26
Bradley,7/12/20,0,0,0,0,0,0,0,0,0,80,0,1285,0,52,0,2,0,26,0,1365,0,0,0,0,0,0,0,5,5,0,26
Calhoun,7/12/20,0,0,0,0,0,0,0,0,0,3,0,376,0,2,0,0,0,1,0,379,0,0,0,0,0,0,0,1,2,0,3
Carroll,7/12/20,0,0,0,0,0,0,0,0,0,228,0,3140,0,176,0,6,0,46,0,3368,0,0,0,0,0,0,0,3,4,0,41
Chicot,7/12/20,0,0,0,0,0,0,0,0,0,217,0,1585,0,143,0,3,0,71,0,1802,0,0,0,0,0,0,0,7,1,0,20
Clark,7/12/20,0,0,0,0,0,0,0,0,0,71,0,2030,0,58,0,0,0,13,0,2101,0,0,0,0,0,0,0,-4,-1,0,14
Clay,7/12/20,0,0,0,0,0,0,0,0,0,81,0,1729,0,62,0,3,0,16,0,1810,0,0,0,0,0,0,0,1,3,0,31
Cleburne,7/12/20,0,0,0,0,0,0,0,0,0,132,0,2342,0,97,0,4,0,31,0,2474,0,0,0,0,0,0,0,2,6,0,27
Cleveland,7/12/20,0,0,0,0,0,0,0,0,0,37,0,841,0,27,0,0,0,10,0,878,0,0,0,0,0,0,0,2,0,0,15
Columbia,7/12/20,0,0,0,0,0,0,0,0,0,109,0,1622,0,81,0,5,0,23,0,1731,0,0,0,0,0,0,0,2,2,0,47
Conway,7/12/20,0,0,0,0,0,0,0,0,0,92,0,1851,0,55,0,3,0,34,0,1943,0,0,0,0,0,0,0,3,2,0,39
Craighead,7/12/20,0,0,0,0,0,0,0,0,0,545,0,11971,0,466,0,7,0,72,0,12516,0,0,0,0,0,0,0,4,11,0,122
Crawford,7/12/20,0,0,0,0,0,0,0,0,0,275,0,5198,0,177,0,3,0,95,0,5473,0,0,0,0,0,0,0,5,6,1,82
Crittenden,7/12/20,0,0,0,0,0,0,0,0,0,841,0,6421,0,746,0,14,0,81,0,7262,0,0,0,0,0,0,0,8,30,0,55
Cross,7/12/20,0,0,0,0,0,0,0,0,0,101,0,1580,0,85,0,1,0,15,0,1681,0,0,0,0,0,0,0,6,0,0,25
Dallas,7/12/20,0,0,0,0,0,0,0,0,0,12,0,584,0,10,0,0,0,2,0,596,0,0,0,0,0,0,0,2,0,0,32
Desha,7/12/20,0,0,0,0,0,0,0,0,0,81,0,1186,0,52,0,1,0,28,0,1267,0,0,0,0,0,0,0,2,4,0,11
Drew,7/12/20,0,0,0,0,0,0,0,0,0,92,0,1916,0,66,0,2,0,24,0,2008,0,0,0,0,0,0,0,3,2,0,37
Faulkner,7/12/20,0,0,0,0,0,0,0,0,0,771,0,11718,0,521,0,3,0,247,0,12489,0,0,0,0,0,0,0,14,15,0,286
Franklin,7/12/20,0,0,0,0,0,0,0,0,0,30,0,1594,0,22,0,1,0,7,0,1624,0,0,0,0,0,0,0,0,0,0,22
Fulton,7/12/20,0,0,0,0,0,0,0,0,0,18,0,1024,0,13,0,0,0,5,0,1042,0,0,0,0,0,0,0,1,0,0,9
Garland,7/12/20,0,0,0,0,0,0,0,0,0,332,0,8733,0,264,0,3,0,65,0,9065,0,0,0,0,0,0,0,12,4,0,160
Grant,7/12/20,0,0,0,0,0,0,0,0,0,55,0,1411,0,44,0,0,0,11,0,1466,0,0,0,0,0,0,0,2,2,0,26
Greene,7/12/20,0,0,0,0,0,0,0,0,0,148,0,4374,0,125,0,0,0,23,0,4522,0,0,0,0,0,0,0,1,0,0,41
Hempstead,7/12/20,0,0,0,0,0,0,0,0,0,79,0,1851,0,57,0,1,0,21,0,1930,0,0,0,0,0,0,0,3,1,0,30
HotSpring,7/12/20,0,0,0,0,0,0,0,0,0,1266,0,4020,0,439,0,1,0,826,0,5286,0,0,0,0,0,0,0,53,1,0,83
Howard,7/12/20,0,0,0,0,0,0,0,0,0,137,0,1636,0,106,0,1,0,30,0,1773,0,0,0,0,0,0,0,2,4,0,32
Independence,7/12/20,0,0,0,0,0,0,0,0,0,73,0,3265,0,59,0,0,0,14,0,3338,0,0,0,0,0,0,0,2,1,0,39
Izard,7/12/20,0,0,0,0,0,0,0,0,0,25,0,1066,0,21,0,1,0,3,0,1091,0,0,0,0,0,0,0,0,0,0,10
Jackson,7/12/20,0,0,0,0,0,0,0,0,0,41,0,1363,0,28,0,0,0,13,0,1404,0,0,0,0,0,0,0,0,1,0,19
Jefferson,7/12/20,0,0,0,0,0,0,0,0,0,861,0,7900,0,676,0,29,0,156,0,8761,0,0,0,0,0,0,0,11,4,0,175
Johnson,7/12/20,0,0,0,0,0,0,0,0,0,366,0,1656,0,286,0,0,0,80,0,2022,0,0,0,0,0,0,0,3,19,0,12
Lafayette,7/12/20,0,0,0,0,0,0,0,0,0,29,0,392,0,17,0,2,0,10,0,421,0,0,0,0,0,0,0,5,0,0,15
Lawrence,7/12/20,0,0,0,0,0,0,0,0,0,115,0,1755,0,90,0,9,0,16,0,1870,0,0,0,0,0,0,0,0,0,0,11
Lee,7/12/20,0,0,0,0,0,0,0,0,0,827,0,2333,0,642,0,4,0,181,0,3160,0,0,0,0,0,0,0,2,1,1,21
Lincoln,7/12/20,0,0,0,0,0,0,0,0,0,1048,0,1972,0,1015,0,11,0,22,0,3020,0,0,0,0,0,0,0,0,0,0,21
LittleRiver,7/12/20,0,0,0,0,0,0,0,0,0,43,0,904,0,40,0,0,0,3,0,947,0,0,0,0,0,0,0,1,0,0,9
Logan,7/12/20,0,0,0,0,0,0,0,0,0,81,0,2261,0,49,0,0,0,32,0,2342,0,0,0,0,0,0,0,4,1,0,64
Lonoke,7/12/20,0,0,0,0,0,0,0,0,0,197,0,5303,0,146,0,1,0,50,0,5500,0,0,0,0,0,0,0,3,10,0,160
Madison,7/12/20,0,0,0,0,0,0,0,0,0,223,0,1996,0,197,0,1,0,25,0,2219,0,0,0,0,0,0,0,1,0,0,29
Marion,7/12/20,0,0,0,0,0,0,0,0,0,13,0,1033,0,10,0,0,0,3,0,1046,0,0,0,0,0,0,0,0,0,0,9
Miller,7/12/20,0,0,0,0,0,0,0,0,0,265,0,2611,0,128,0,2,0,135,0,2876,0,0,0,0,0,0,0,11,2,0,79
MissingCountyInfo,7/12/20,0,0,0,0,0,0,0,0,0,1073,0,55903,0,644,0,0,0,429,0,56976,0,0,0,0,0,0,0,25,20,0,395
Mississippi,7/12/20,0,0,0,0,0,0,0,0,0,314,0,4323,0,185,0,3,0,126,0,4637,0,0,0,0,0,0,0,10,7,0,63
Monroe,7/12/20,0,0,0,0,0,0,0,0,0,21,0,839,0,15,0,0,0,6,0,860,0,0,0,0,0,0,0,1,0,0,17
Montgomery,7/12/20,0,0,0,0,0,0,0,0,0,7,0,686,0,6,0,0,0,1,0,693,0,0,0,0,0,0,0,-1,0,0,9
Nevada,7/12/20,0,0,0,0,0,0,0,0,0,109,0,1250,0,87,0,3,0,19,0,1359,0,0,0,0,0,0,0,0,0,0,15
Newton,7/12/20,0,0,0,0,0,0,0,0,0,10,0,552,0,7,0,0,0,3,0,562,0,0,0,0,0,0,0,2,0,0,7
Ouachita,7/12/20,0,0,0,0,0,0,0,0,0,34,0,2045,0,24,0,0,0,10,0,2079,0,0,0,0,0,0,0,1,0,0,29
Perry,7/12/20,0,0,0,0,0,0,0,0,0,34,0,923,0,29,0,0,0,5,0,957,0,0,0,0,0,0,0,1,0,0,6
Phillips,7/12/20,0,0,0,0,0,0,0,0,0,173,0,2721,0,133,0,5,0,35,0,2894,0,0,0,0,0,0,0,1,2,0,76
Pike,7/12/20,0,0,0,0,0,0,0,0,0,19,0,1974,0,9,0,0,0,10,0,1993,0,0,0,0,0,0,0,-4,2,0,9
Poinsett,7/12/20,0,0,0,0,0,0,0,0,0,75,0,1808,0,54,0,3,0,18,0,1883,0,0,0,0,0,0,0,3,0,0,15
Polk,7/12/20,0,0,0,0,0,0,0,0,0,88,0,1645,0,77,0,0,0,11,0,1733,0,0,0,0,0,0,0,2,1,0,15
Pope,7/12/20,0,0,0,0,0,0,0,0,0,655,0,6442,0,507,0,4,0,144,0,7097,0,0,0,0,0,0,0,14,7,0,85
Prairie,7/12/20,0,0,0,0,0,0,0,0,0,30,0,663,0,21,0,0,0,9,0,693,0,0,0,0,0,0,0,2,0,0,19
Pulaski,7/12/20,0,0,0,0,0,0,0,0,0,2938,0,41204,0,2054,0,65,0,819,0,44142,0,0,0,0,0,0,0,52,36,0,1052
Randolph,7/12/20,0,0,0,0,0,0,0,0,0,76,0,2124,0,49,0,1,0,26,0,2200,0,0,0,0,0,0,0,1,1,0,16
Saline,7/12/20,0,0,0,0,0,0,0,0,0,471,0,10338,0,329,0,3,0,139,0,10809,0,0,0,0,0,0,0,13,11,0,179
Scott,7/12/20,0,0,0,0,0,0,0,0,0,16,0,598,0,12,0,0,0,4,0,614,0,0,0,0,0,0,0,0,1,0,6
Searcy,7/12/20,0,0,0,0,0,0,0,0,0,17,0,880,0,11,0,0,0,6,0,897,0,0,0,0,0,0,0,1,0,0,3
Sebastian,7/12/20,0,0,0,0,0,0,0,0,0,834,0,12852,0,518,0,7,0,309,0,13686,0,0,0,0,0,0,0,28,28,0,449
Sevier,7/12/20,0,0,0,0,0,0,0,0,0,807,0,3695,0,710,0,9,0,88,0,4502,0,0,0,0,0,0,0,7,8,0,45
Sharp,7/12/20,0,0,0,0,0,0,0,0,0,68,0,1236,0,51,0,5,0,12,0,1304,0,0,0,0,0,0,0,4,1,0,23
St.Francis,7/12/20,0,0,0,0,0,0,0,0,0,906,0,4548,0,874,0,3,0,29,0,5454,0,0,0,0,0,0,0,3,3,0,98
Stone,7/12/20,0,0,0,0,0,0,0,0,0,22,0,1314,0,14,0,1,0,7,0,1336,0,0,0,0,0,0,0,0,0,0,12
Union,7/12/20,0,0,0,0,0,0,0,0,0,274,0,3288,0,226,0,14,0,34,0,3562,0,0,0,0,0,0,0,1,1,0,25
VanBuren,7/12/20,0,0,0,0,0,0,0,0,0,35,0,1191,0,31,0,2,0,2,0,1226,0,0,0,0,0,0,0,0,0,0,24
Washington,7/12/20,0,0,0,0,0,0,0,0,0,4526,0,15619,0,3756,0,36,0,734,0,20145,0,0,0,0,0,0,0,70,73,0,234
White,7/12/20,0,0,0,0,0,0,0,0,0,141,0,4473,0,96,0,2,0,43,0,4614,0,0,0,0,0,0,0,13,3,0,72
Woodruff,7/12/20,0,0,0,0,0,0,0,0,0,12,0,771,0,7,0,0,0,5,0,783,0,0,0,0,0,0,0,0,1,0,13
Yell,7/12/20,0,0,0,0,0,0,0,0,0,832,0,2484,0,631,0,5,0,196,0,3316,0,0,0,0,0,0,0,4,9,0,13
Arkansas_all_counties,7/11/20,0,0,0,0,0,0,0,0,2990671,27864,0,348701,0,21190,0,319,0,6355,0,376565,0,0,0,0,0,0,0,1061,548,6,6730
Arkansas_county,7/11/20,0,0,0,0,0,0,0,0,0,56,0,1669,0,29,0,0,0,27,0,1725,0,0,0,0,0,0,0,4,1,0,24
Ashley,7/11/20,0,0,0,0,0,0,0,0,0,97,0,1686,0,67,0,3,0,27,0,1783,0,0,0,0,0,0,0,4,1,0,59
Baxter,7/11/20,0,0,0,0,0,0,0,0,0,29,0,2523,0,22,0,0,0,7,0,2552,0,0,0,0,0,0,0,1,1,0,62
Benton,7/11/20,0,0,0,0,0,0,0,0,0,3416,0,38462,0,2883,0,22,0,511,0,41878,0,0,0,0,0,0,0,61,83,0,719
Boone,7/11/20,0,0,0,0,0,0,0,0,0,46,0,2720,0,28,0,1,0,17,0,2766,0,0,0,0,0,0,0,1,3,0,42
Bradley,7/11/20,0,0,0,0,0,0,0,0,0,75,0,1264,0,47,0,2,0,26,0,1339,0,0,0,0,0,0,0,6,1,0,45
Calhoun,7/11/20,0,0,0,0,0,0,0,0,0,2,0,374,0,0,0,0,0,2,0,376,0,0,0,0,0,0,0,0,0,0,12
Carroll,7/11/20,0,0,0,0,0,0,0,0,0,225,0,3102,0,172,0,6,0,47,0,3327,0,0,0,0,0,0,0,5,10,0,32
Chicot,7/11/20,0,0,0,0,0,0,0,0,0,210,0,1572,0,142,0,3,0,65,0,1782,0,0,0,0,0,0,0,3,2,0,16
Clark,7/11/20,0,0,0,0,0,0,0,0,0,75,0,2012,0,59,0,0,0,16,0,2087,0,0,0,0,0,0,0,5,1,0,24
Clay,7/11/20,0,0,0,0,0,0,0,0,0,80,0,1699,0,59,0,3,0,18,0,1779,0,0,0,0,0,0,0,2,1,0,25
Cleburne,7/11/20,0,0,0,0,0,0,0,0,0,130,0,2317,0,91,0,4,0,35,0,2447,0,0,0,0,0,0,0,2,2,0,24
Cleveland,7/11/20,0,0,0,0,0,0,0,0,0,35,0,828,0,27,0,0,0,8,0,863,0,0,0,0,0,0,0,4,1,0,14
Columbia,7/11/20,0,0,0,0,0,0,0,0,0,107,0,1577,0,79,0,5,0,23,0,1684,0,0,0,0,0,0,0,2,2,0,34
Conway,7/11/20,0,0,0,0,0,0,0,0,0,89,0,1815,0,53,0,3,0,33,0,1904,0,0,0,0,0,0,0,3,3,0,46
Craighead,7/11/20,0,0,0,0,0,0,0,0,0,541,0,11853,0,455,0,7,0,79,0,12394,0,0,0,0,0,0,0,17,8,0,109
Crawford,7/11/20,0,0,0,0,0,0,0,0,0,270,0,5121,0,171,0,2,0,97,0,5391,0,0,0,0,0,0,0,10,4,0,167
Crittenden,7/11/20,0,0,0,0,0,0,0,0,0,833,0,6374,0,716,0,14,0,103,0,7207,0,0,0,0,0,0,0,16,11,1,40
Cross,7/11/20,0,0,0,0,0,0,0,0,0,95,0,1561,0,85,0,1,0,9,0,1656,0,0,0,0,0,0,0,1,1,0,25
Dallas,7/11/20,0,0,0,0,0,0,0,0,0,10,0,554,0,10,0,0,0,0,0,564,0,0,0,0,0,0,0,0,0,0,25
Desha,7/11/20,0,0,0,0,0,0,0,0,0,79,0,1177,0,48,0,1,0,30,0,1256,0,0,0,0,0,0,0,4,1,0,31
Drew,7/11/20,0,0,0,0,0,0,0,0,0,89,0,1882,0,64,0,2,0,23,0,1971,0,0,0,0,0,0,0,4,4,0,61
Faulkner,7/11/20,0,0,0,0,0,0,0,0,0,757,0,11446,0,506,0,3,0,248,0,12203,0,0,0,0,0,0,0,30,36,0,252
Franklin,7/11/20,0,0,0,0,0,0,0,0,0,30,0,1572,0,22,0,1,0,7,0,1602,0,0,0,0,0,0,0,2,0,0,34
Fulton,7/11/20,0,0,0,0,0,0,0,0,0,17,0,1016,0,13,0,0,0,4,0,1033,0,0,0,0,0,0,0,0,0,0,9
Garland,7/11/20,0,0,0,0,0,0,0,0,0,320,0,8585,0,260,0,3,0,57,0,8905,0,0,0,0,0,0,0,9,4,0,208
Grant,7/11/20,0,0,0,0,0,0,0,0,0,53,0,1387,0,42,0,0,0,11,0,1440,0,0,0,0,0,0,0,1,2,0,37
Greene,7/11/20,0,0,0,0,0,0,0,0,0,147,0,4334,0,125,0,0,0,22,0,4481,0,0,0,0,0,0,0,2,5,0,54
Hempstead,7/11/20,0,0,0,0,0,0,0,0,0,76,0,1824,0,56,0,1,0,19,0,1900,0,0,0,0,0,0,0,6,3,0,18
HotSpring,7/11/20,0,0,0,0,0,0,0,0,0,1213,0,3990,0,438,0,1,0,774,0,5203,0,0,0,0,0,0,0,326,2,0,441
Howard,7/11/20,0,0,0,0,0,0,0,0,0,135,0,1606,0,102,0,1,0,32,0,1741,0,0,0,0,0,0,0,4,6,0,27
Independence,7/11/20,0,0,0,0,0,0,0,0,0,71,0,3228,0,58,0,0,0,13,0,3299,0,0,0,0,0,0,0,5,0,0,46
Izard,7/11/20,0,0,0,0,0,0,0,0,0,25,0,1056,0,21,0,1,0,3,0,1081,0,0,0,0,0,0,0,1,0,0,9
Jackson,7/11/20,0,0,0,0,0,0,0,0,0,41,0,1344,0,27,0,0,0,14,0,1385,0,0,0,0,0,0,0,3,2,0,77
Jefferson,7/11/20,0,0,0,0,0,0,0,0,0,850,0,7736,0,672,0,29,0,149,0,8586,0,0,0,0,0,0,0,19,8,1,271
Johnson,7/11/20,0,0,0,0,0,0,0,0,0,363,0,1647,0,267,0,0,0,96,0,2010,0,0,0,0,0,0,0,12,14,0,49
Lafayette,7/11/20,0,0,0,0,0,0,0,0,0,24,0,382,0,17,0,2,0,5,0,406,0,0,0,0,0,0,0,0,0,0,11
Lawrence,7/11/20,0,0,0,0,0,0,0,0,0,115,0,1744,0,90,0,9,0,16,0,1859,0,0,0,0,0,0,0,3,1,0,21
Lee,7/11/20,0,0,0,0,0,0,0,0,0,825,0,2314,0,641,0,3,0,181,0,3139,0,0,0,0,0,0,0,7,2,0,35
Lincoln,7/11/20,0,0,0,0,0,0,0,0,0,1048,0,1951,0,1015,0,11,0,22,0,2999,0,0,0,0,0,0,0,0,3,0,10
LittleRiver,7/11/20,0,0,0,0,0,0,0,0,0,42,0,896,0,40,0,0,0,2,0,938,0,0,0,0,0,0,0,2,0,0,10
Logan,7/11/20,0,0,0,0,0,0,0,0,0,77,0,2201,0,48,0,0,0,29,0,2278,0,0,0,0,0,0,0,5,1,0,54
Lonoke,7/11/20,0,0,0,0,0,0,0,0,0,194,0,5146,0,136,0,1,0,57,0,5340,0,0,0,0,0,0,0,5,2,0,94
Madison,7/11/20,0,0,0,0,0,0,0,0,0,222,0,1968,0,197,0,1,0,24,0,2190,0,0,0,0,0,0,0,7,2,1,21
Marion,7/11/20,0,0,0,0,0,0,0,0,0,13,0,1024,0,10,0,0,0,3,0,1037,0,0,0,0,0,0,0,1,0,0,40
Miller,7/11/20,0,0,0,0,0,0,0,0,0,254,0,2543,0,126,0,2,0,126,0,2797,0,0,0,0,0,0,0,13,3,0,56
MissingCountyInfo,7/11/20,0,0,0,0,0,0,0,0,0,1048,0,55533,0,624,0,0,0,424,0,56581,0,0,0,0,0,0,0,82,20,0,419
Mississippi,7/11/20,0,0,0,0,0,0,0,0,0,304,0,4270,0,178,0,3,0,123,0,4574,0,0,0,0,0,0,0,14,12,0,125
Monroe,7/11/20,0,0,0,0,0,0,0,0,0,20,0,823,0,15,0,0,0,5,0,843,0,0,0,0,0,0,0,1,1,0,21
Montgomery,7/11/20,0,0,0,0,0,0,0,0,0,8,0,676,0,6,0,0,0,2,0,684,0,0,0,0,0,0,0,0,1,0,12
Nevada,7/11/20,0,0,0,0,0,0,0,0,0,109,0,1235,0,87,0,3,0,19,0,1344,0,0,0,0,0,0,0,1,1,0,6
Newton,7/11/20,0,0,0,0,0,0,0,0,0,8,0,547,0,7,0,0,0,1,0,555,0,0,0,0,0,0,0,0,0,0,6
Ouachita,7/11/20,0,0,0,0,0,0,0,0,0,33,0,2017,0,24,0,0,0,9,0,2050,0,0,0,0,0,0,0,1,1,0,31
Perry,7/11/20,0,0,0,0,0,0,0,0,0,33,0,918,0,29,0,0,0,4,0,951,0,0,0,0,0,0,0,0,1,0,16
Phillips,7/11/20,0,0,0,0,0,0,0,0,0,172,0,2646,0,131,0,5,0,36,0,2818,0,0,0,0,0,0,0,1,4,0,38
Pike,7/11/20,0,0,0,0,0,0,0,0,0,23,0,1961,0,7,0,0,0,16,0,1984,0,0,0,0,0,0,0,3,0,0,33
Poinsett,7/11/20,0,0,0,0,0,0,0,0,0,72,0,1796,0,54,0,3,0,15,0,1868,0,0,0,0,0,0,0,3,0,0,16
Polk,7/11/20,0,0,0,0,0,0,0,0,0,86,0,1632,0,76,0,0,0,10,0,1718,0,0,0,0,0,0,0,0,0,0,20
Pope,7/11/20,0,0,0,0,0,0,0,0,0,641,0,6371,0,500,0,4,0,137,0,7012,0,0,0,0,0,0,0,15,23,0,93
Prairie,7/11/20,0,0,0,0,0,0,0,0,0,28,0,646,0,21,0,0,0,7,0,674,0,0,0,0,0,0,0,0,0,0,12
Pulaski,7/11/20,0,0,0,0,0,0,0,0,0,2886,0,40204,0,2018,0,65,0,803,0,43090,0,0,0,0,0,0,0,76,64,2,939
Randolph,7/11/20,0,0,0,0,0,0,0,0,0,75,0,2109,0,48,0,1,0,26,0,2184,0,0,0,0,0,0,0,11,3,0,47
Saline,7/11/20,0,0,0,0,0,0,0,0,0,458,0,10172,0,318,0,3,0,137,0,10630,0,0,0,0,0,0,0,25,9,0,166
Scott,7/11/20,0,0,0,0,0,0,0,0,0,16,0,592,0,11,0,0,0,5,0,608,0,0,0,0,0,0,0,0,0,0,12
Searcy,7/11/20,0,0,0,0,0,0,0,0,0,16,0,878,0,11,0,0,0,5,0,894,0,0,0,0,0,0,0,0,4,0,4
Sebastian,7/11/20,0,0,0,0,0,0,0,0,0,806,0,12431,0,490,0,7,0,309,0,13237,0,0,0,0,0,0,0,59,43,0,604
Sevier,7/11/20,0,0,0,0,0,0,0,0,0,800,0,3657,0,702,0,9,0,89,0,4457,0,0,0,0,0,0,0,12,6,0,65
Sharp,7/11/20,0,0,0,0,0,0,0,0,0,64,0,1217,0,50,0,5,0,9,0,1281,0,0,0,0,0,0,0,2,4,0,10
St.Francis,7/11/20,0,0,0,0,0,0,0,0,0,903,0,4453,0,871,0,3,0,29,0,5356,0,0,0,0,0,0,0,2,2,0,75
Stone,7/11/20,0,0,0,0,0,0,0,0,0,22,0,1302,0,14,0,1,0,7,0,1324,0,0,0,0,0,0,0,3,1,0,174
Union,7/11/20,0,0,0,0,0,0,0,0,0,273,0,3264,0,225,0,14,0,34,0,3537,0,0,0,0,0,0,0,6,1,1,49
VanBuren,7/11/20,0,0,0,0,0,0,0,0,0,35,0,1167,0,31,0,2,0,2,0,1202,0,0,0,0,0,0,0,-1,0,0,9
Washington,7/11/20,0,0,0,0,0,0,0,0,0,4456,0,15455,0,3683,0,36,0,737,0,19911,0,0,0,0,0,0,0,112,88,0,295
White,7/11/20,0,0,0,0,0,0,0,0,0,128,0,4414,0,93,0,2,0,33,0,4542,0,0,0,0,0,0,0,7,2,0,61
Woodruff,7/11/20,0,0,0,0,0,0,0,0,0,12,0,758,0,6,0,0,0,6,0,770,0,0,0,0,0,0,0,2,0,0,17
Yell,7/11/20,0,0,0,0,0,0,0,0,0,828,0,2475,0,622,0,5,0,201,0,3303,0,0,0,0,0,0,0,6,20,0,21
Arkansas_all_counties,7/10/20,0,0,0,0,0,0,0,0,2990671,26803,0,342846,0,20642,0,313,0,5848,0,369649,0,0,0,0,0,0,0,751,650,4,6338
Arkansas_county,7/10/20,0,0,0,0,0,0,0,0,0,52,0,1649,0,28,0,0,0,24,0,1701,0,0,0,0,0,0,0,1,0,0,14
Ashley,7/10/20,0,0,0,0,0,0,0,0,0,93,0,1631,0,66,0,3,0,24,0,1724,0,0,0,0,0,0,0,3,1,1,42
Baxter,7/10/20,0,0,0,0,0,0,0,0,0,28,0,2462,0,21,0,0,0,7,0,2490,0,0,0,0,0,0,0,2,2,0,34
Benton,7/10/20,0,0,0,0,0,0,0,0,0,3355,0,37804,0,2800,0,22,0,533,0,41159,0,0,0,0,0,0,0,85,95,0,726
Boone,7/10/20,0,0,0,0,0,0,0,0,0,45,0,2679,0,25,0,1,0,19,0,2724,0,0,0,0,0,0,0,3,1,0,48
Bradley,7/10/20,0,0,0,0,0,0,0,0,0,69,0,1225,0,46,0,2,0,21,0,1294,0,0,0,0,0,0,0,11,1,0,32
Calhoun,7/10/20,0,0,0,0,0,0,0,0,0,2,0,362,0,0,0,0,0,2,0,364,0,0,0,0,0,0,0,0,0,0,9
Carroll,7/10/20,0,0,0,0,0,0,0,0,0,220,0,3075,0,162,0,6,0,52,0,3295,0,0,0,0,0,0,0,8,5,1,76
Chicot,7/10/20,0,0,0,0,0,0,0,0,0,207,0,1559,0,140,0,3,0,64,0,1766,0,0,0,0,0,0,0,6,9,0,42
Clark,7/10/20,0,0,0,0,0,0,0,0,0,70,0,1993,0,58,0,0,0,12,0,2063,0,0,0,0,0,0,0,4,0,0,17
Clay,7/10/20,0,0,0,0,0,0,0,0,0,78,0,1676,0,58,0,3,0,17,0,1754,0,0,0,0,0,0,0,1,1,0,21
Cleburne,7/10/20,0,0,0,0,0,0,0,0,0,128,0,2295,0,89,0,4,0,35,0,2423,0,0,0,0,0,0,0,4,6,0,31
Cleveland,7/10/20,0,0,0,0,0,0,0,0,0,31,0,818,0,26,0,0,0,5,0,849,0,0,0,0,0,0,0,-1,0,0,9
Columbia,7/10/20,0,0,0,0,0,0,0,0,0,105,0,1545,0,77,0,5,0,23,0,1650,0,0,0,0,0,0,0,2,2,0,33
Conway,7/10/20,0,0,0,0,0,0,0,0,0,86,0,1772,0,50,0,3,0,33,0,1858,0,0,0,0,0,0,0,2,1,0,32
Craighead,7/10/20,0,0,0,0,0,0,0,0,0,524,0,11761,0,447,0,7,0,70,0,12285,0,0,0,0,0,0,0,10,7,0,111
Crawford,7/10/20,0,0,0,0,0,0,0,0,0,260,0,4964,0,167,0,2,0,91,0,5224,0,0,0,0,0,0,0,13,4,1,103
Crittenden,7/10/20,0,0,0,0,0,0,0,0,0,817,0,6350,0,705,0,13,0,99,0,7167,0,0,0,0,0,0,0,2,21,0,39
Cross,7/10/20,0,0,0,0,0,0,0,0,0,94,0,1537,0,84,0,1,0,9,0,1631,0,0,0,0,0,0,0,1,0,0,10
Dallas,7/10/20,0,0,0,0,0,0,0,0,0,10,0,529,0,10,0,0,0,0,0,539,0,0,0,0,0,0,0,0,3,0,27
Desha,7/10/20,0,0,0,0,0,0,0,0,0,75,0,1150,0,47,0,1,0,27,0,1225,0,0,0,0,0,0,0,4,2,0,15
Drew,7/10/20,0,0,0,0,0,0,0,0,0,85,0,1825,0,60,0,2,0,23,0,1910,0,0,0,0,0,0,0,0,9,0,32
Faulkner,7/10/20,0,0,0,0,0,0,0,0,0,727,0,11224,0,470,0,3,0,254,0,11951,0,0,0,0,0,0,0,26,33,0,189
Franklin,7/10/20,0,0,0,0,0,0,0,0,0,28,0,1540,0,22,0,1,0,5,0,1568,0,0,0,0,0,0,0,0,0,0,13
Fulton,7/10/20,0,0,0,0,0,0,0,0,0,17,0,1007,0,13,0,0,0,4,0,1024,0,0,0,0,0,0,0,0,2,0,5
Garland,7/10/20,0,0,0,0,0,0,0,0,0,311,0,8386,0,256,0,3,0,52,0,8697,0,0,0,0,0,0,0,8,20,0,84
Grant,7/10/20,0,0,0,0,0,0,0,0,0,52,0,1351,0,40,0,0,0,12,0,1403,0,0,0,0,0,0,0,1,1,0,20
Greene,7/10/20,0,0,0,0,0,0,0,0,0,145,0,4282,0,120,0,0,0,25,0,4427,0,0,0,0,0,0,0,4,5,0,41
Hempstead,7/10/20,0,0,0,0,0,0,0,0,0,70,0,1812,0,53,0,1,0,16,0,1882,0,0,0,0,0,0,0,0,0,0,10
HotSpring,7/10/20,0,0,0,0,0,0,0,0,0,887,0,3875,0,436,0,1,0,450,0,4762,0,0,0,0,0,0,0,144,2,0,175
Howard,7/10/20,0,0,0,0,0,0,0,0,0,131,0,1583,0,96,0,1,0,34,0,1714,0,0,0,0,0,0,0,10,6,0,27
Independence,7/10/20,0,0,0,0,0,0,0,0,0,66,0,3187,0,58,0,0,0,8,0,3253,0,0,0,0,0,0,0,0,2,0,22
Izard,7/10/20,0,0,0,0,0,0,0,0,0,24,0,1048,0,21,0,1,0,2,0,1072,0,0,0,0,0,0,0,0,0,0,7
Jackson,7/10/20,0,0,0,0,0,0,0,0,0,38,0,1270,0,25,0,0,0,13,0,1308,0,0,0,0,0,0,0,-1,-1,0,6
Jefferson,7/10/20,0,0,0,0,0,0,0,0,0,831,0,7484,0,664,0,28,0,139,0,8315,0,0,0,0,0,0,0,23,7,0,136
Johnson,7/10/20,0,0,0,0,0,0,0,0,0,351,0,1610,0,253,0,0,0,98,0,1961,0,0,0,0,0,0,0,12,15,0,36
Lafayette,7/10/20,0,0,0,0,0,0,0,0,0,24,0,371,0,17,0,2,0,5,0,395,0,0,0,0,0,0,0,0,1,0,6
Lawrence,7/10/20,0,0,0,0,0,0,0,0,0,112,0,1726,0,89,0,9,0,14,0,1838,0,0,0,0,0,0,0,1,2,0,12
Lee,7/10/20,0,0,0,0,0,0,0,0,0,818,0,2286,0,639,0,3,0,176,0,3104,0,0,0,0,0,0,0,1,1,0,16
Lincoln,7/10/20,0,0,0,0,0,0,0,0,0,1048,0,1941,0,1012,0,11,0,25,0,2989,0,0,0,0,0,0,0,2,0,0,21
LittleRiver,7/10/20,0,0,0,0,0,0,0,0,0,40,0,888,0,40,0,0,0,0,0,928,0,0,0,0,0,0,0,0,0,0,6
Logan,7/10/20,0,0,0,0,0,0,0,0,0,72,0,2152,0,47,0,0,0,25,0,2224,0,0,0,0,0,0,0,7,0,0,31
Lonoke,7/10/20,0,0,0,0,0,0,0,0,0,189,0,5057,0,134,0,1,0,54,0,5246,0,0,0,0,0,0,0,7,6,0,80
Madison,7/10/20,0,0,0,0,0,0,0,0,0,215,0,1954,0,195,0,0,0,20,0,2169,0,0,0,0,0,0,0,1,3,0,16
Marion,7/10/20,0,0,0,0,0,0,0,0,0,12,0,985,0,10,0,0,0,2,0,997,0,0,0,0,0,0,0,0,0,0,23
Miller,7/10/20,0,0,0,0,0,0,0,0,0,241,0,2500,0,123,0,2,0,116,0,2741,0,0,0,0,0,0,0,4,3,0,42
MissingCountyInfo,7/10/20,0,0,0,0,0,0,0,0,0,966,0,55196,0,604,0,0,0,362,0,56162,0,0,0,0,0,0,0,31,14,0,377
Mississippi,7/10/20,0,0,0,0,0,0,0,0,0,290,0,4159,0,166,0,3,0,121,0,4449,0,0,0,0,0,0,0,15,14,0,56
Monroe,7/10/20,0,0,0,0,0,0,0,0,0,19,0,803,0,14,0,0,0,5,0,822,0,0,0,0,0,0,0,0,0,0,15
Montgomery,7/10/20,0,0,0,0,0,0,0,0,0,8,0,664,0,5,0,0,0,3,0,672,0,0,0,0,0,0,0,0,0,0,6
Nevada,7/10/20,0,0,0,0,0,0,0,0,0,108,0,1230,0,86,0,3,0,19,0,1338,0,0,0,0,0,0,0,1,4,0,8
Newton,7/10/20,0,0,0,0,0,0,0,0,0,8,0,541,0,7,0,0,0,1,0,549,0,0,0,0,0,0,0,1,0,0,6
Ouachita,7/10/20,0,0,0,0,0,0,0,0,0,32,0,1987,0,23,0,0,0,9,0,2019,0,0,0,0,0,0,0,3,3,0,78
Perry,7/10/20,0,0,0,0,0,0,0,0,0,33,0,902,0,28,0,0,0,5,0,935,0,0,0,0,0,0,0,1,1,0,9
Phillips,7/10/20,0,0,0,0,0,0,0,0,0,171,0,2609,0,127,0,5,0,39,0,2780,0,0,0,0,0,0,0,6,10,0,57
Pike,7/10/20,0,0,0,0,0,0,0,0,0,20,0,1931,0,7,0,0,0,13,0,1951,0,0,0,0,0,0,0,1,0,0,38
Poinsett,7/10/20,0,0,0,0,0,0,0,0,0,69,0,1783,0,54,0,3,0,12,0,1852,0,0,0,0,0,0,0,5,0,0,18
Polk,7/10/20,0,0,0,0,0,0,0,0,0,86,0,1612,0,76,0,0,0,10,0,1698,0,0,0,0,0,0,0,2,0,0,20
Pope,7/10/20,0,0,0,0,0,0,0,0,0,626,0,6293,0,477,0,4,0,145,0,6919,0,0,0,0,0,0,0,41,38,0,96
Prairie,7/10/20,0,0,0,0,0,0,0,0,0,28,0,634,0,21,0,0,0,7,0,662,0,0,0,0,0,0,0,2,2,0,8
Pulaski,7/10/20,0,0,0,0,0,0,0,0,0,2810,0,39341,0,1954,0,63,0,793,0,42151,0,0,0,0,0,0,0,97,70,0,784
Randolph,7/10/20,0,0,0,0,0,0,0,0,0,64,0,2073,0,45,0,1,0,18,0,2137,0,0,0,0,0,0,0,3,2,0,17
Saline,7/10/20,0,0,0,0,0,0,0,0,0,433,0,10031,0,309,0,3,0,121,0,10464,0,0,0,0,0,0,0,13,16,0,158
Scott,7/10/20,0,0,0,0,0,0,0,0,0,16,0,580,0,11,0,0,0,5,0,596,0,0,0,0,0,0,0,0,2,0,9
Searcy,7/10/20,0,0,0,0,0,0,0,0,0,16,0,874,0,7,0,0,0,9,0,890,0,0,0,0,0,0,0,3,0,0,9
Sebastian,7/10/20,0,0,0,0,0,0,0,0,0,747,0,11886,0,447,0,7,0,293,0,12633,0,0,0,0,0,0,0,42,32,0,287
Sevier,7/10/20,0,0,0,0,0,0,0,0,0,788,0,3604,0,696,0,9,0,83,0,4392,0,0,0,0,0,0,0,7,12,0,22
Sharp,7/10/20,0,0,0,0,0,0,0,0,0,62,0,1209,0,46,0,5,0,11,0,1271,0,0,0,0,0,0,0,1,0,0,39
St.Francis,7/10/20,0,0,0,0,0,0,0,0,0,901,0,4380,0,869,0,3,0,29,0,5281,0,0,0,0,0,0,0,3,1,0,40
Stone,7/10/20,0,0,0,0,0,0,0,0,0,19,0,1131,0,13,0,1,0,5,0,1150,0,0,0,0,0,0,0,0,0,0,19
Union,7/10/20,0,0,0,0,0,0,0,0,0,267,0,3221,0,224,0,13,0,30,0,3488,0,0,0,0,0,0,0,1,4,0,19
VanBuren,7/10/20,0,0,0,0,0,0,0,0,0,36,0,1157,0,31,0,2,0,3,0,1193,0,0,0,0,0,0,0,0,0,0,5
Washington,7/10/20,0,0,0,0,0,0,0,0,0,4344,0,15272,0,3595,0,36,0,713,0,19616,0,0,0,0,0,0,0,35,116,1,173
White,7/10/20,0,0,0,0,0,0,0,0,0,121,0,4360,0,91,0,2,0,28,0,4481,0,0,0,0,0,0,0,6,6,0,35
Woodruff,7/10/20,0,0,0,0,0,0,0,0,0,10,0,743,0,6,0,0,0,4,0,753,0,0,0,0,0,0,0,0,0,0,3
Yell,7/10/20,0,0,0,0,0,0,0,0,0,822,0,2460,0,602,0,5,0,215,0,3282,0,0,0,0,0,0,0,23,23,0,64
Arkansas_all_counties,7/9/20,0,0,0,0,0,0,0,0,2990671,26052,0,338609,0,19992,0,309,0,5751,0,364661,0,0,0,0,0,0,0,806,596,4,5498
Arkansas_county,7/9/20,0,0,0,0,0,0,0,0,0,51,0,1636,0,28,0,0,0,23,0,1687,0,0,0,0,0,0,0,5,3,0,27
Ashley,7/9/20,0,0,0,0,0,0,0,0,0,90,0,1592,0,65,0,2,0,23,0,1682,0,0,0,0,0,0,0,7,0,0,36
Baxter,7/9/20,0,0,0,0,0,0,0,0,0,26,0,2430,0,19,0,0,0,7,0,2456,0,0,0,0,0,0,0,1,0,0,36
Benton,7/9/20,0,0,0,0,0,0,0,0,0,3270,0,37163,0,2705,0,22,0,543,0,40433,0,0,0,0,0,0,0,106,90,1,616
Boone,7/9/20,0,0,0,0,0,0,0,0,0,42,0,2634,0,24,0,1,0,17,0,2676,0,0,0,0,0,0,0,12,3,0,29
Bradley,7/9/20,0,0,0,0,0,0,0,0,0,58,0,1204,0,45,0,2,0,11,0,1262,0,0,0,0,0,0,0,2,2,0,16
Calhoun,7/9/20,0,0,0,0,0,0,0,0,0,2,0,353,0,0,0,0,0,2,0,355,0,0,0,0,0,0,0,0,0,0,13
Carroll,7/9/20,0,0,0,0,0,0,0,0,0,212,0,3007,0,157,0,5,0,50,0,3219,0,0,0,0,0,0,0,12,3,0,24
Chicot,7/9/20,0,0,0,0,0,0,0,0,0,201,0,1523,0,131,0,3,0,67,0,1724,0,0,0,0,0,0,0,12,6,0,23
Clark,7/9/20,0,0,0,0,0,0,0,0,0,66,0,1980,0,58,0,0,0,8,0,2046,0,0,0,0,0,0,0,5,0,0,20
Clay,7/9/20,0,0,0,0,0,0,0,0,0,77,0,1656,0,57,0,3,0,17,0,1733,0,0,0,0,0,0,0,4,3,0,26
Cleburne,7/9/20,0,0,0,0,0,0,0,0,0,124,0,2268,0,83,0,4,0,37,0,2392,0,0,0,0,0,0,0,5,1,0,21
Cleveland,7/9/20,0,0,0,0,0,0,0,0,0,32,0,808,0,26,0,0,0,6,0,840,0,0,0,0,0,0,0,1,0,0,22
Columbia,7/9/20,0,0,0,0,0,0,0,0,0,103,0,1514,0,75,0,5,0,23,0,1617,0,0,0,0,0,0,0,3,0,1,34
Conway,7/9/20,0,0,0,0,0,0,0,0,0,84,0,1742,0,49,0,3,0,32,0,1826,0,0,0,0,0,0,0,2,1,0,31
Craighead,7/9/20,0,0,0,0,0,0,0,0,0,514,0,11660,0,440,0,7,0,67,0,12174,0,0,0,0,0,0,0,16,6,0,157
Crawford,7/9/20,0,0,0,0,0,0,0,0,0,247,0,4874,0,163,0,1,0,83,0,5121,0,0,0,0,0,0,0,20,12,0,141
Crittenden,7/9/20,0,0,0,0,0,0,0,0,0,815,0,6313,0,684,0,13,0,118,0,7128,0,0,0,0,0,0,0,16,20,0,74
Cross,7/9/20,0,0,0,0,0,0,0,0,0,93,0,1528,0,84,0,1,0,8,0,1621,0,0,0,0,0,0,0,3,1,0,25
Dallas,7/9/20,0,0,0,0,0,0,0,0,0,10,0,502,0,7,0,0,0,3,0,512,0,0,0,0,0,0,0,-1,0,0,35
Desha,7/9/20,0,0,0,0,0,0,0,0,0,71,0,1139,0,45,0,1,0,25,0,1210,0,0,0,0,0,0,0,5,0,0,21
Drew,7/9/20,0,0,0,0,0,0,0,0,0,85,0,1793,0,51,0,2,0,32,0,1878,0,0,0,0,0,0,0,5,1,0,47
Faulkner,7/9/20,0,0,0,0,0,0,0,0,0,701,0,11061,0,437,0,3,0,261,0,11762,0,0,0,0,0,0,0,53,21,0,526
Franklin,7/9/20,0,0,0,0,0,0,0,0,0,28,0,1527,0,22,0,1,0,5,0,1555,0,0,0,0,0,0,0,1,2,0,25
Fulton,7/9/20,0,0,0,0,0,0,0,0,0,17,0,1002,0,11,0,0,0,6,0,1019,0,0,0,0,0,0,0,1,0,0,15
Garland,7/9/20,0,0,0,0,0,0,0,0,0,303,0,8310,0,236,0,3,0,64,0,8613,0,0,0,0,0,0,0,3,9,1,109
Grant,7/9/20,0,0,0,0,0,0,0,0,0,51,0,1332,0,39,0,0,0,12,0,1383,0,0,0,0,0,0,0,0,1,0,25
Greene,7/9/20,0,0,0,0,0,0,0,0,0,141,0,4245,0,115,0,0,0,26,0,4386,0,0,0,0,0,0,0,7,3,0,54
Hempstead,7/9/20,0,0,0,0,0,0,0,0,0,70,0,1802,0,53,0,1,0,16,0,1872,0,0,0,0,0,0,0,1,2,0,24
HotSpring,7/9/20,0,0,0,0,0,0,0,0,0,743,0,3844,0,434,0,1,0,308,0,4587,0,0,0,0,0,0,0,94,9,0,111
Howard,7/9/20,0,0,0,0,0,0,0,0,0,121,0,1566,0,90,0,1,0,30,0,1687,0,0,0,0,0,0,0,6,5,0,41
Independence,7/9/20,0,0,0,0,0,0,0,0,0,66,0,3165,0,56,0,0,0,10,0,3231,0,0,0,0,0,0,0,5,1,0,73
Izard,7/9/20,0,0,0,0,0,0,0,0,0,24,0,1041,0,21,0,1,0,2,0,1065,0,0,0,0,0,0,0,0,0,0,14
Jackson,7/9/20,0,0,0,0,0,0,0,0,0,39,0,1263,0,26,0,0,0,13,0,1302,0,0,0,0,0,0,0,2,0,0,22
Jefferson,7/9/20,0,0,0,0,0,0,0,0,0,808,0,7371,0,657,0,28,0,123,0,8179,0,0,0,0,0,0,0,24,9,0,165
Johnson,7/9/20,0,0,0,0,0,0,0,0,0,339,0,1586,0,238,0,0,0,101,0,1925,0,0,0,0,0,0,0,32,6,0,42
Lafayette,7/9/20,0,0,0,0,0,0,0,0,0,24,0,365,0,16,0,2,0,6,0,389,0,0,0,0,0,0,0,1,0,0,5
Lawrence,7/9/20,0,0,0,0,0,0,0,0,0,111,0,1715,0,87,0,9,0,15,0,1826,0,0,0,0,0,0,0,4,1,0,26
Lee,7/9/20,0,0,0,0,0,0,0,0,0,817,0,2271,0,638,0,3,0,176,0,3088,0,0,0,0,0,0,0,2,2,0,15
Lincoln,7/9/20,0,0,0,0,0,0,0,0,0,1046,0,1922,0,1012,0,11,0,23,0,2968,0,0,0,0,0,0,0,2,1,0,11
LittleRiver,7/9/20,0,0,0,0,0,0,0,0,0,40,0,882,0,40,0,0,0,0,0,922,0,0,0,0,0,0,0,0,0,0,5
Logan,7/9/20,0,0,0,0,0,0,0,0,0,65,0,2128,0,47,0,0,0,18,0,2193,0,0,0,0,0,0,0,1,1,0,29
Lonoke,7/9/20,0,0,0,0,0,0,0,0,0,182,0,4984,0,128,0,1,0,53,0,5166,0,0,0,0,0,0,0,2,6,0,59
Madison,7/9/20,0,0,0,0,0,0,0,0,0,214,0,1939,0,192,0,0,0,22,0,2153,0,0,0,0,0,0,0,0,3,0,3
Marion,7/9/20,0,0,0,0,0,0,0,0,0,12,0,962,0,10,0,0,0,2,0,974,0,0,0,0,0,0,0,0,0,0,14
Miller,7/9/20,0,0,0,0,0,0,0,0,0,237,0,2462,0,120,0,2,0,115,0,2699,0,0,0,0,0,0,0,4,8,0,33
MissingCountyInfo,7/9/20,0,0,0,0,0,0,0,0,0,935,0,54850,0,590,0,0,0,345,0,55785,0,0,0,0,0,0,0,-10,15,0,457
Mississippi,7/9/20,0,0,0,0,0,0,0,0,0,275,0,4118,0,152,0,3,0,120,0,4393,0,0,0,0,0,0,0,10,7,0,88
Monroe,7/9/20,0,0,0,0,0,0,0,0,0,19,0,788,0,14,0,0,0,5,0,807,0,0,0,0,0,0,0,2,1,0,15
Montgomery,7/9/20,0,0,0,0,0,0,0,0,0,8,0,658,0,5,0,0,0,3,0,666,0,0,0,0,0,0,0,1,1,0,9
Nevada,7/9/20,0,0,0,0,0,0,0,0,0,107,0,1223,0,82,0,3,0,22,0,1330,0,0,0,0,0,0,0,1,1,0,9
Newton,7/9/20,0,0,0,0,0,0,0,0,0,7,0,536,0,7,0,0,0,0,0,543,0,0,0,0,0,0,0,0,1,0,5
Ouachita,7/9/20,0,0,0,0,0,0,0,0,0,29,0,1912,0,20,0,0,0,9,0,1941,0,0,0,0,0,0,0,1,1,0,111
Perry,7/9/20,0,0,0,0,0,0,0,0,0,32,0,894,0,27,0,0,0,5,0,926,0,0,0,0,0,0,0,0,0,0,14
Phillips,7/9/20,0,0,0,0,0,0,0,0,0,165,0,2558,0,117,0,5,0,43,0,2723,0,0,0,0,0,0,0,5,9,0,58
Pike,7/9/20,0,0,0,0,0,0,0,0,0,19,0,1894,0,7,0,0,0,12,0,1913,0,0,0,0,0,0,0,7,0,0,18
Poinsett,7/9/20,0,0,0,0,0,0,0,0,0,64,0,1770,0,54,0,3,0,7,0,1834,0,0,0,0,0,0,0,0,2,0,38
Polk,7/9/20,0,0,0,0,0,0,0,0,0,84,0,1594,0,76,0,0,0,8,0,1678,0,0,0,0,0,0,0,3,4,0,11
Pope,7/9/20,0,0,0,0,0,0,0,0,0,585,0,6238,0,439,0,4,0,142,0,6823,0,0,0,0,0,0,0,23,22,0,47
Prairie,7/9/20,0,0,0,0,0,0,0,0,0,26,0,628,0,19,0,0,0,7,0,654,0,0,0,0,0,0,0,1,1,0,7
Pulaski,7/9/20,0,0,0,0,0,0,0,0,0,2713,0,38654,0,1884,0,63,0,766,0,41367,0,0,0,0,0,0,0,102,76,1,729
Randolph,7/9/20,0,0,0,0,0,0,0,0,0,61,0,2059,0,43,0,1,0,17,0,2120,0,0,0,0,0,0,0,2,1,0,32
Saline,7/9/20,0,0,0,0,0,0,0,0,0,420,0,9886,0,293,0,3,0,124,0,10306,0,0,0,0,0,0,0,21,18,0,152
Scott,7/9/20,0,0,0,0,0,0,0,0,0,16,0,571,0,9,0,0,0,7,0,587,0,0,0,0,0,0,0,2,0,0,20
Searcy,7/9/20,0,0,0,0,0,0,0,0,0,13,0,868,0,7,0,0,0,6,0,881,0,0,0,0,0,0,0,0,0,0,4
Sebastian,7/9/20,0,0,0,0,0,0,0,0,0,705,0,11641,0,415,0,7,0,283,0,12346,0,0,0,0,0,0,0,56,27,0,476
Sevier,7/9/20,0,0,0,0,0,0,0,0,0,781,0,3589,0,684,0,9,0,88,0,4370,0,0,0,0,0,0,0,12,13,0,42
Sharp,7/9/20,0,0,0,0,0,0,0,0,0,61,0,1171,0,46,0,5,0,10,0,1232,0,0,0,0,0,0,0,3,2,0,6
St.Francis,7/9/20,0,0,0,0,0,0,0,0,0,898,0,4343,0,868,0,3,0,27,0,5241,0,0,0,0,0,0,0,4,2,0,47
Stone,7/9/20,0,0,0,0,0,0,0,0,0,19,0,1112,0,13,0,1,0,5,0,1131,0,0,0,0,0,0,0,0,0,0,14
Union,7/9/20,0,0,0,0,0,0,0,0,0,266,0,3203,0,220,0,13,0,33,0,3469,0,0,0,0,0,0,0,2,1,0,55
VanBuren,7/9/20,0,0,0,0,0,0,0,0,0,36,0,1152,0,31,0,2,0,3,0,1188,0,0,0,0,0,0,0,0,0,0,13
Washington,7/9/20,0,0,0,0,0,0,0,0,0,4309,0,15134,0,3479,0,35,0,795,0,19443,0,0,0,0,0,0,0,43,118,0,178
White,7/9/20,0,0,0,0,0,0,0,0,0,115,0,4331,0,85,0,2,0,28,0,4446,0,0,0,0,0,0,0,8,4,0,53
Woodruff,7/9/20,0,0,0,0,0,0,0,0,0,10,0,740,0,6,0,0,0,4,0,750,0,0,0,0,0,0,0,2,0,0,28
Yell,7/9/20,0,0,0,0,0,0,0,0,0,799,0,2419,0,579,0,5,0,215,0,3218,0,0,0,0,0,0,0,16,27,0,65
Arkansas_all_counties,7/8/20,0,0,0,0,0,0,0,0,2990671,25246,0,333671,0,19396,0,305,0,5545,0,358917,0,0,0,0,0,0,0,734,671,4,5527
Arkansas_county,7/8/20,0,0,0,0,0,0,0,0,0,46,0,1614,0,25,0,0,0,21,0,1660,0,0,0,0,0,0,0,5,0,0,97
Ashley,7/8/20,0,0,0,0,0,0,0,0,0,83,0,1563,0,65,0,2,0,16,0,1646,0,0,0,0,0,0,0,-1,2,1,23
Baxter,7/8/20,0,0,0,0,0,0,0,0,0,25,0,2395,0,19,0,0,0,6,0,2420,0,0,0,0,0,0,0,0,0,0,18
Benton,7/8/20,0,0,0,0,0,0,0,0,0,3164,0,36653,0,2615,0,21,0,528,0,39817,0,0,0,0,0,0,0,69,48,0,339
Boone,7/8/20,0,0,0,0,0,0,0,0,0,30,0,2617,0,21,0,1,0,8,0,2647,0,0,0,0,0,0,0,0,1,0,71
Bradley,7/8/20,0,0,0,0,0,0,0,0,0,56,0,1190,0,43,0,2,0,11,0,1246,0,0,0,0,0,0,0,1,3,0,15
Calhoun,7/8/20,0,0,0,0,0,0,0,0,0,2,0,340,0,0,0,0,0,2,0,342,0,0,0,0,0,0,0,0,0,0,0
Carroll,7/8/20,0,0,0,0,0,0,0,0,0,200,0,2995,0,154,0,5,0,41,0,3195,0,0,0,0,0,0,0,3,6,0,49
Chicot,7/8/20,0,0,0,0,0,0,0,0,0,189,0,1512,0,125,0,3,0,61,0,1701,0,0,0,0,0,0,0,6,9,0,71
Clark,7/8/20,0,0,0,0,0,0,0,0,0,61,0,1965,0,58,0,0,0,3,0,2026,0,0,0,0,0,0,0,2,1,0,17
Clay,7/8/20,0,0,0,0,0,0,0,0,0,73,0,1634,0,54,0,3,0,16,0,1707,0,0,0,0,0,0,0,2,2,0,15
Cleburne,7/8/20,0,0,0,0,0,0,0,0,0,119,0,2252,0,82,0,4,0,33,0,2371,0,0,0,0,0,0,0,2,3,0,57
Cleveland,7/8/20,0,0,0,0,0,0,0,0,0,31,0,787,0,26,0,0,0,5,0,818,0,0,0,0,0,0,0,1,0,0,12
Columbia,7/8/20,0,0,0,0,0,0,0,0,0,100,0,1483,0,75,0,4,0,21,0,1583,0,0,0,0,0,0,0,10,7,0,105
Conway,7/8/20,0,0,0,0,0,0,0,0,0,82,0,1713,0,48,0,3,0,31,0,1795,0,0,0,0,0,0,0,5,2,0,38
Craighead,7/8/20,0,0,0,0,0,0,0,0,0,498,0,11519,0,434,0,7,0,57,0,12017,0,0,0,0,0,0,0,13,9,0,92
Crawford,7/8/20,0,0,0,0,0,0,0,0,0,227,0,4753,0,151,0,1,0,75,0,4980,0,0,0,0,0,0,0,9,11,0,150
Crittenden,7/8/20,0,0,0,0,0,0,0,0,0,799,0,6255,0,664,0,13,0,122,0,7054,0,0,0,0,0,0,0,13,33,0,95
Cross,7/8/20,0,0,0,0,0,0,0,0,0,90,0,1506,0,83,0,1,0,6,0,1596,0,0,0,0,0,0,0,0,0,0,4
Dallas,7/8/20,0,0,0,0,0,0,0,0,0,11,0,466,0,7,0,0,0,4,0,477,0,0,0,0,0,0,0,1,0,0,5
Desha,7/8/20,0,0,0,0,0,0,0,0,0,66,0,1123,0,45,0,1,0,20,0,1189,0,0,0,0,0,0,0,0,1,0,23
Drew,7/8/20,0,0,0,0,0,0,0,0,0,80,0,1751,0,50,0,2,0,28,0,1831,0,0,0,0,0,0,0,1,1,0,42
Faulkner,7/8/20,0,0,0,0,0,0,0,0,0,648,0,10588,0,416,0,3,0,229,0,11236,0,0,0,0,0,0,0,26,17,0,215
Franklin,7/8/20,0,0,0,0,0,0,0,0,0,27,0,1503,0,20,0,1,0,6,0,1530,0,0,0,0,0,0,0,0,0,0,33
Fulton,7/8/20,0,0,0,0,0,0,0,0,0,16,0,988,0,11,0,0,0,5,0,1004,0,0,0,0,0,0,0,0,1,0,15
Garland,7/8/20,0,0,0,0,0,0,0,0,0,300,0,8204,0,227,0,2,0,71,0,8504,0,0,0,0,0,0,0,7,9,1,53
Grant,7/8/20,0,0,0,0,0,0,0,0,0,51,0,1307,0,38,0,0,0,13,0,1358,0,0,0,0,0,0,0,0,1,0,28
Greene,7/8/20,0,0,0,0,0,0,0,0,0,134,0,4198,0,112,0,0,0,22,0,4332,0,0,0,0,0,0,0,6,8,0,46
Hempstead,7/8/20,0,0,0,0,0,0,0,0,0,69,0,1779,0,51,0,1,0,17,0,1848,0,0,0,0,0,0,0,4,1,0,17
HotSpring,7/8/20,0,0,0,0,0,0,0,0,0,649,0,3827,0,425,0,1,0,223,0,4476,0,0,0,0,0,0,0,62,14,0,82
Howard,7/8/20,0,0,0,0,0,0,0,0,0,115,0,1531,0,85,0,1,0,29,0,1646,0,0,0,0,0,0,0,9,4,0,32
Independence,7/8/20,0,0,0,0,0,0,0,0,0,61,0,3097,0,55,0,0,0,6,0,3158,0,0,0,0,0,0,0,1,2,0,32
Izard,7/8/20,0,0,0,0,0,0,0,0,0,24,0,1027,0,21,0,1,0,2,0,1051,0,0,0,0,0,0,0,-1,1,0,2
Jackson,7/8/20,0,0,0,0,0,0,0,0,0,37,0,1243,0,26,0,0,0,11,0,1280,0,0,0,0,0,0,0,2,1,0,6
Jefferson,7/8/20,0,0,0,0,0,0,0,0,0,784,0,7230,0,648,0,28,0,108,0,8014,0,0,0,0,0,0,0,10,8,0,150
Johnson,7/8/20,0,0,0,0,0,0,0,0,0,307,0,1576,0,232,0,0,0,75,0,1883,0,0,0,0,0,0,0,26,15,0,36
Lafayette,7/8/20,0,0,0,0,0,0,0,0,0,23,0,361,0,16,0,2,0,5,0,384,0,0,0,0,0,0,0,1,1,0,3
Lawrence,7/8/20,0,0,0,0,0,0,0,0,0,107,0,1693,0,86,0,9,0,12,0,1800,0,0,0,0,0,0,0,4,1,0,21
Lee,7/8/20,0,0,0,0,0,0,0,0,0,815,0,2258,0,636,0,3,0,176,0,3073,0,0,0,0,0,0,0,10,1,0,27
Lincoln,7/8/20,0,0,0,0,0,0,0,0,0,1044,0,1913,0,1011,0,11,0,22,0,2957,0,0,0,0,0,0,0,0,0,0,9
LittleRiver,7/8/20,0,0,0,0,0,0,0,0,0,40,0,877,0,40,0,0,0,0,0,917,0,0,0,0,0,0,0,0,1,0,2
Logan,7/8/20,0,0,0,0,0,0,0,0,0,64,0,2100,0,46,0,0,0,18,0,2164,0,0,0,0,0,0,0,2,6,0,32
Lonoke,7/8/20,0,0,0,0,0,0,0,0,0,180,0,4927,0,122,0,1,0,57,0,5107,0,0,0,0,0,0,0,2,9,0,73
Madison,7/8/20,0,0,0,0,0,0,0,0,0,214,0,1936,0,189,0,0,0,25,0,2150,0,0,0,0,0,0,0,3,11,0,28
Marion,7/8/20,0,0,0,0,0,0,0,0,0,12,0,948,0,10,0,0,0,2,0,960,0,0,0,0,0,0,0,0,4,0,10
Miller,7/8/20,0,0,0,0,0,0,0,0,0,233,0,2433,0,112,0,2,0,119,0,2666,0,0,0,0,0,0,0,1,4,0,24
MissingCountyInfo,7/8/20,0,0,0,0,0,0,0,0,0,945,0,54383,0,575,0,0,0,370,0,55328,0,0,0,0,0,0,0,31,46,0,613
Mississippi,7/8/20,0,0,0,0,0,0,0,0,0,265,0,4040,0,145,0,3,0,117,0,4305,0,0,0,0,0,0,0,40,9,0,141
Monroe,7/8/20,0,0,0,0,0,0,0,0,0,17,0,775,0,13,0,0,0,4,0,792,0,0,0,0,0,0,0,0,2,0,33
Montgomery,7/8/20,0,0,0,0,0,0,0,0,0,7,0,650,0,4,0,0,0,3,0,657,0,0,0,0,0,0,0,0,0,0,7
Nevada,7/8/20,0,0,0,0,0,0,0,0,0,106,0,1215,0,81,0,3,0,22,0,1321,0,0,0,0,0,0,0,2,-2,0,2
Newton,7/8/20,0,0,0,0,0,0,0,0,0,7,0,531,0,6,0,0,0,1,0,538,0,0,0,0,0,0,0,0,1,0,7
Ouachita,7/8/20,0,0,0,0,0,0,0,0,0,28,0,1802,0,19,0,0,0,9,0,1830,0,0,0,0,0,0,0,3,0,0,18
Perry,7/8/20,0,0,0,0,0,0,0,0,0,32,0,880,0,27,0,0,0,5,0,912,0,0,0,0,0,0,0,-2,2,0,13
Phillips,7/8/20,0,0,0,0,0,0,0,0,0,160,0,2505,0,108,0,5,0,47,0,2665,0,0,0,0,0,0,0,1,4,0,23
Pike,7/8/20,0,0,0,0,0,0,0,0,0,12,0,1883,0,7,0,0,0,5,0,1895,0,0,0,0,0,0,0,1,0,0,19
Poinsett,7/8/20,0,0,0,0,0,0,0,0,0,64,0,1732,0,52,0,3,0,9,0,1796,0,0,0,0,0,0,0,1,0,0,10
Polk,7/8/20,0,0,0,0,0,0,0,0,0,81,0,1586,0,72,0,0,0,9,0,1667,0,0,0,0,0,0,0,1,1,0,13
Pope,7/8/20,0,0,0,0,0,0,0,0,0,562,0,6214,0,417,0,4,0,141,0,6776,0,0,0,0,0,0,0,46,22,0,103
Prairie,7/8/20,0,0,0,0,0,0,0,0,0,25,0,622,0,18,0,0,0,7,0,647,0,0,0,0,0,0,0,3,1,0,15
Pulaski,7/8/20,0,0,0,0,0,0,0,0,0,2611,0,38027,0,1808,0,62,0,741,0,40638,0,0,0,0,0,0,0,89,83,0,728
Randolph,7/8/20,0,0,0,0,0,0,0,0,0,59,0,2029,0,42,0,1,0,16,0,2088,0,0,0,0,0,0,0,3,2,0,14
Saline,7/8/20,0,0,0,0,0,0,0,0,0,399,0,9755,0,275,0,3,0,121,0,10154,0,0,0,0,0,0,0,24,19,1,178
Scott,7/8/20,0,0,0,0,0,0,0,0,0,14,0,553,0,9,0,0,0,5,0,567,0,0,0,0,0,0,0,0,0,0,9
Searcy,7/8/20,0,0,0,0,0,0,0,0,0,13,0,864,0,7,0,0,0,6,0,877,0,0,0,0,0,0,0,1,0,0,7
Sebastian,7/8/20,0,0,0,0,0,0,0,0,0,649,0,11221,0,388,0,7,0,254,0,11870,0,0,0,0,0,0,0,15,323,0,346
Sevier,7/8/20,0,0,0,0,0,0,0,0,0,769,0,3559,0,671,0,9,0,89,0,4328,0,0,0,0,0,0,0,11,8,0,32
Sharp,7/8/20,0,0,0,0,0,0,0,0,0,58,0,1168,0,44,0,5,0,9,0,1226,0,0,0,0,0,0,0,2,0,0,24
St.Francis,7/8/20,0,0,0,0,0,0,0,0,0,894,0,4300,0,866,0,3,0,25,0,5194,0,0,0,0,0,0,0,1,6,0,25
Stone,7/8/20,0,0,0,0,0,0,0,0,0,19,0,1098,0,13,0,1,0,5,0,1117,0,0,0,0,0,0,0,0,0,0,26
Union,7/8/20,0,0,0,0,0,0,0,0,0,264,0,3150,0,219,0,13,0,32,0,3414,0,0,0,0,0,0,0,8,0,0,15
VanBuren,7/8/20,0,0,0,0,0,0,0,0,0,36,0,1139,0,31,0,2,0,3,0,1175,0,0,0,0,0,0,0,2,1,0,12
Washington,7/8/20,0,0,0,0,0,0,0,0,0,4266,0,14999,0,3361,0,35,0,870,0,19265,0,0,0,0,0,0,0,95,156,1,328
White,7/8/20,0,0,0,0,0,0,0,0,0,107,0,4286,0,81,0,2,0,24,0,4393,0,0,0,0,0,0,0,6,6,0,60
Woodruff,7/8/20,0,0,0,0,0,0,0,0,0,8,0,714,0,6,0,0,0,2,0,722,0,0,0,0,0,0,0,0,0,0,6
Yell,7/8/20,0,0,0,0,0,0,0,0,0,783,0,2370,0,552,0,5,0,226,0,3153,0,0,0,0,0,0,0,33,22,0,75
Arkansas_all_counties,7/7/20,0,0,0,0,0,0,0,0,2990671,24512,0,328760,0,18725,0,301,0,5486,0,353272,0,0,0,0,0,0,0,259,891,9,4121
Arkansas_county,7/7/20,0,0,0,0,0,0,0,0,0,41,0,1522,0,25,0,0,0,16,0,1563,0,0,0,0,0,0,0,4,2,0,11
Ashley,7/7/20,0,0,0,0,0,0,0,0,0,84,0,1539,0,63,0,1,0,20,0,1623,0,0,0,0,0,0,0,0,2,0,26
Baxter,7/7/20,0,0,0,0,0,0,0,0,0,25,0,2377,0,19,0,0,0,6,0,2402,0,0,0,0,0,0,0,0,2,0,14
Benton,7/7/20,0,0,0,0,0,0,0,0,0,3095,0,35945,0,2567,0,21,0,507,0,39040,0,0,0,0,0,0,0,52,141,1,338
Boone,7/7/20,0,0,0,0,0,0,0,0,0,30,0,2546,0,20,0,1,0,9,0,2576,0,0,0,0,0,0,0,0,1,0,1
Bradley,7/7/20,0,0,0,0,0,0,0,0,0,55,0,1176,0,40,0,2,0,13,0,1231,0,0,0,0,0,0,0,-1,2,0,4
Calhoun,7/7/20,0,0,0,0,0,0,0,0,0,2,0,340,0,0,0,0,0,2,0,342,0,0,0,0,0,0,0,0,0,0,9
Carroll,7/7/20,0,0,0,0,0,0,0,0,0,197,0,2949,0,148,0,5,0,44,0,3146,0,0,0,0,0,0,0,2,6,0,9
Chicot,7/7/20,0,0,0,0,0,0,0,0,0,183,0,1447,0,116,0,3,0,64,0,1630,0,0,0,0,0,0,0,0,3,0,4
Clark,7/7/20,0,0,0,0,0,0,0,0,0,59,0,1950,0,57,0,0,0,2,0,2009,0,0,0,0,0,0,0,0,0,0,8
Clay,7/7/20,0,0,0,0,0,0,0,0,0,71,0,1621,0,52,0,3,0,16,0,1692,0,0,0,0,0,0,0,1,0,0,20
Cleburne,7/7/20,0,0,0,0,0,0,0,0,0,117,0,2197,0,79,0,4,0,34,0,2314,0,0,0,0,0,0,0,2,4,0,12
Cleveland,7/7/20,0,0,0,0,0,0,0,0,0,30,0,776,0,26,0,0,0,4,0,806,0,0,0,0,0,0,0,1,0,0,10
Columbia,7/7/20,0,0,0,0,0,0,0,0,0,90,0,1388,0,68,0,4,0,18,0,1478,0,0,0,0,0,0,0,0,1,0,9
Conway,7/7/20,0,0,0,0,0,0,0,0,0,77,0,1680,0,46,0,3,0,28,0,1757,0,0,0,0,0,0,0,3,3,0,32
Craighead,7/7/20,0,0,0,0,0,0,0,0,0,485,0,11440,0,425,0,7,0,53,0,11925,0,0,0,0,0,0,0,3,10,0,93
Crawford,7/7/20,0,0,0,0,0,0,0,0,0,218,0,4612,0,140,0,1,0,77,0,4830,0,0,0,0,0,0,0,2,7,0,30
Crittenden,7/7/20,0,0,0,0,0,0,0,0,0,786,0,6173,0,631,0,13,0,142,0,6959,0,0,0,0,0,0,0,3,11,0,32
Cross,7/7/20,0,0,0,0,0,0,0,0,0,90,0,1502,0,83,0,1,0,6,0,1592,0,0,0,0,0,0,0,0,2,0,5
Dallas,7/7/20,0,0,0,0,0,0,0,0,0,10,0,462,0,7,0,0,0,3,0,472,0,0,0,0,0,0,0,0,0,0,2
Desha,7/7/20,0,0,0,0,0,0,0,0,0,66,0,1100,0,44,0,1,0,21,0,1166,0,0,0,0,0,0,0,1,7,0,5
Drew,7/7/20,0,0,0,0,0,0,0,0,0,79,0,1710,0,49,0,2,0,28,0,1789,0,0,0,0,0,0,0,2,2,0,5
Faulkner,7/7/20,0,0,0,0,0,0,0,0,0,622,0,10399,0,399,0,3,0,220,0,11021,0,0,0,0,0,0,0,10,26,0,147
Franklin,7/7/20,0,0,0,0,0,0,0,0,0,27,0,1470,0,20,0,1,0,6,0,1497,0,0,0,0,0,0,0,0,2,0,9
Fulton,7/7/20,0,0,0,0,0,0,0,0,0,16,0,973,0,10,0,0,0,6,0,989,0,0,0,0,0,0,0,1,0,0,5
Garland,7/7/20,0,0,0,0,0,0,0,0,0,293,0,8158,0,218,0,1,0,74,0,8451,0,0,0,0,0,0,0,5,6,0,48
Grant,7/7/20,0,0,0,0,0,0,0,0,0,51,0,1279,0,37,0,0,0,14,0,1330,0,0,0,0,0,0,0,1,1,0,23
Greene,7/7/20,0,0,0,0,0,0,0,0,0,128,0,4158,0,104,0,0,0,24,0,4286,0,0,0,0,0,0,0,4,2,0,20
Hempstead,7/7/20,0,0,0,0,0,0,0,0,0,65,0,1766,0,50,0,1,0,14,0,1831,0,0,0,0,0,0,0,1,1,0,5
HotSpring,7/7/20,0,0,0,0,0,0,0,0,0,587,0,3807,0,411,0,1,0,175,0,4394,0,0,0,0,0,0,0,3,202,0,17
Howard,7/7/20,0,0,0,0,0,0,0,0,0,106,0,1508,0,81,0,1,0,24,0,1614,0,0,0,0,0,0,0,4,5,0,26
Independence,7/7/20,0,0,0,0,0,0,0,0,0,60,0,3066,0,53,0,0,0,7,0,3126,0,0,0,0,0,0,0,-1,0,0,8
Izard,7/7/20,0,0,0,0,0,0,0,0,0,25,0,1024,0,20,0,1,0,4,0,1049,0,0,0,0,0,0,0,2,0,0,10
Jackson,7/7/20,0,0,0,0,0,0,0,0,0,35,0,1239,0,25,0,0,0,10,0,1274,0,0,0,0,0,0,0,2,0,0,19
Jefferson,7/7/20,0,0,0,0,0,0,0,0,0,774,0,7090,0,640,0,28,0,106,0,7864,0,0,0,0,0,0,0,13,8,0,121
Johnson,7/7/20,0,0,0,0,0,0,0,0,0,281,0,1566,0,217,0,0,0,64,0,1847,0,0,0,0,0,0,0,10,12,0,30
Lafayette,7/7/20,0,0,0,0,0,0,0,0,0,22,0,359,0,15,0,2,0,5,0,381,0,0,0,0,0,0,0,0,0,1,1
Lawrence,7/7/20,0,0,0,0,0,0,0,0,0,103,0,1676,0,85,0,9,0,9,0,1779,0,0,0,0,0,0,0,0,0,0,4
Lee,7/7/20,0,0,0,0,0,0,0,0,0,805,0,2241,0,635,0,3,0,167,0,3046,0,0,0,0,0,0,0,2,3,0,5
Lincoln,7/7/20,0,0,0,0,0,0,0,0,0,1044,0,1904,0,1011,0,11,0,22,0,2948,0,0,0,0,0,0,0,1,0,0,6
LittleRiver,7/7/20,0,0,0,0,0,0,0,0,0,40,0,875,0,39,0,0,0,1,0,915,0,0,0,0,0,0,0,0,1,0,6
Logan,7/7/20,0,0,0,0,0,0,0,0,0,62,0,2070,0,40,0,0,0,22,0,2132,0,0,0,0,0,0,0,1,2,0,15
Lonoke,7/7/20,0,0,0,0,0,0,0,0,0,178,0,4856,0,113,0,1,0,64,0,5034,0,0,0,0,0,0,0,7,5,0,55
Madison,7/7/20,0,0,0,0,0,0,0,0,0,211,0,1911,0,178,0,0,0,33,0,2122,0,0,0,0,0,0,0,8,2,0,31
Marion,7/7/20,0,0,0,0,0,0,0,0,0,12,0,938,0,6,0,0,0,6,0,950,0,0,0,0,0,0,0,0,2,0,1
Miller,7/7/20,0,0,0,0,0,0,0,0,0,232,0,2410,0,108,0,2,0,122,0,2642,0,0,0,0,0,0,0,4,2,0,26
MissingCountyInfo,7/7/20,0,0,0,0,0,0,0,0,0,914,0,53801,0,529,0,0,0,385,0,54715,0,0,0,0,0,0,0,-51,6,0,241
Mississippi,7/7/20,0,0,0,0,0,0,0,0,0,225,0,3939,0,136,0,3,0,86,0,4164,0,0,0,0,0,0,0,1,4,0,13
Monroe,7/7/20,0,0,0,0,0,0,0,0,0,17,0,742,0,11,0,0,0,6,0,759,0,0,0,0,0,0,0,0,1,0,4
Montgomery,7/7/20,0,0,0,0,0,0,0,0,0,7,0,643,0,4,0,0,0,3,0,650,0,0,0,0,0,0,0,1,1,0,5
Nevada,7/7/20,0,0,0,0,0,0,0,0,0,104,0,1215,0,83,0,3,0,18,0,1319,0,0,0,0,0,0,0,0,1,0,3
Newton,7/7/20,0,0,0,0,0,0,0,0,0,7,0,524,0,5,0,0,0,2,0,531,0,0,0,0,0,0,0,0,0,0,1
Ouachita,7/7/20,0,0,0,0,0,0,0,0,0,25,0,1787,0,19,0,0,0,6,0,1812,0,0,0,0,0,0,0,3,1,0,13
Perry,7/7/20,0,0,0,0,0,0,0,0,0,34,0,865,0,25,0,0,0,9,0,899,0,0,0,0,0,0,0,0,0,0,13
Phillips,7/7/20,0,0,0,0,0,0,0,0,0,159,0,2483,0,104,0,5,0,50,0,2642,0,0,0,0,0,0,0,3,3,0,10
Pike,7/7/20,0,0,0,0,0,0,0,0,0,11,0,1865,0,7,0,0,0,4,0,1876,0,0,0,0,0,0,0,1,0,0,14
Poinsett,7/7/20,0,0,0,0,0,0,0,0,0,63,0,1723,0,52,0,3,0,8,0,1786,0,0,0,0,0,0,0,0,1,0,9
Polk,7/7/20,0,0,0,0,0,0,0,0,0,80,0,1574,0,71,0,0,0,9,0,1654,0,0,0,0,0,0,0,0,0,0,11
Pope,7/7/20,0,0,0,0,0,0,0,0,0,516,0,6157,0,395,0,4,0,117,0,6673,0,0,0,0,0,0,0,16,20,0,166
Prairie,7/7/20,0,0,0,0,0,0,0,0,0,22,0,610,0,17,0,0,0,5,0,632,0,0,0,0,0,0,0,0,0,0,4
Pulaski,7/7/20,0,0,0,0,0,0,0,0,0,2522,0,37388,0,1725,0,62,0,735,0,39910,0,0,0,0,0,0,0,50,72,1,722
Randolph,7/7/20,0,0,0,0,0,0,0,0,0,56,0,2018,0,40,0,1,0,15,0,2074,0,0,0,0,0,0,0,0,0,0,6
Saline,7/7/20,0,0,0,0,0,0,0,0,0,375,0,9601,0,256,0,2,0,117,0,9976,0,0,0,0,0,0,0,16,15,0,133
Scott,7/7/20,0,0,0,0,0,0,0,0,0,14,0,544,0,9,0,0,0,5,0,558,0,0,0,0,0,0,0,0,1,0,4
Searcy,7/7/20,0,0,0,0,0,0,0,0,0,12,0,858,0,7,0,0,0,5,0,870,0,0,0,0,0,0,0,0,0,0,0
Sebastian,7/7/20,0,0,0,0,0,0,0,0,0,634,0,10890,0,365,0,7,0,262,0,11524,0,0,0,0,0,0,0,12,30,2,61
Sevier,7/7/20,0,0,0,0,0,0,0,0,0,758,0,3538,0,663,0,9,0,86,0,4296,0,0,0,0,0,0,0,10,13,0,36
Sharp,7/7/20,0,0,0,0,0,0,0,0,0,56,0,1146,0,44,0,5,0,7,0,1202,0,0,0,0,0,0,0,-2,0,0,-1
St.Francis,7/7/20,0,0,0,0,0,0,0,0,0,893,0,4276,0,860,0,3,0,30,0,5169,0,0,0,0,0,0,0,1,4,0,9
Stone,7/7/20,0,0,0,0,0,0,0,0,0,19,0,1072,0,13,0,1,0,5,0,1091,0,0,0,0,0,0,0,0,0,1,0
Union,7/7/20,0,0,0,0,0,0,0,0,0,256,0,3143,0,219,0,13,0,24,0,3399,0,0,0,0,0,0,0,3,2,0,17
VanBuren,7/7/20,0,0,0,0,0,0,0,0,0,34,0,1129,0,30,0,2,0,2,0,1163,0,0,0,0,0,0,0,0,0,0,10
Washington,7/7/20,0,0,0,0,0,0,0,0,0,4171,0,14766,0,3205,0,34,0,932,0,18937,0,0,0,0,0,0,0,34,207,1,58
White,7/7/20,0,0,0,0,0,0,0,0,0,101,0,4232,0,75,0,2,0,24,0,4333,0,0,0,0,0,0,0,3,0,0,40
Woodruff,7/7/20,0,0,0,0,0,0,0,0,0,8,0,708,0,6,0,0,0,2,0,716,0,0,0,0,0,0,0,0,0,0,2
Yell,7/7/20,0,0,0,0,0,0,0,0,0,750,0,2328,0,530,0,5,0,215,0,3078,0,0,0,0,0,0,0,5,21,2,75
Arkansas_all_counties,7/6/20,0,0,0,0,0,0,0,0,2990671,24253,0,326143,0,17834,0,292,0,6127,0,350396,0,0,0,0,0,0,0,439,701,5,4056
Arkansas_county,7/6/20,0,0,0,0,0,0,0,0,0,37,0,1515,0,23,0,0,0,14,0,1552,0,0,0,0,0,0,0,0,0,0,28
Ashley,7/6/20,0,0,0,0,0,0,0,0,0,84,0,1513,0,61,0,1,0,22,0,1597,0,0,0,0,0,0,0,1,2,0,21
Baxter,7/6/20,0,0,0,0,0,0,0,0,0,25,0,2363,0,17,0,0,0,8,0,2388,0,0,0,0,0,0,0,1,0,0,25
Benton,7/6/20,0,0,0,0,0,0,0,0,0,3043,0,35997,0,2426,0,20,0,597,0,39040,0,0,0,0,0,0,0,43,61,0,851
Boone,7/6/20,0,0,0,0,0,0,0,0,0,30,0,2545,0,19,0,1,0,10,0,2575,0,0,0,0,0,0,0,0,1,0,88
Bradley,7/6/20,0,0,0,0,0,0,0,0,0,56,0,1171,0,38,0,2,0,16,0,1227,0,0,0,0,0,0,0,0,1,0,29
Calhoun,7/6/20,0,0,0,0,0,0,0,0,0,2,0,331,0,0,0,0,0,2,0,333,0,0,0,0,0,0,0,0,0,0,10
Carroll,7/6/20,0,0,0,0,0,0,0,0,0,195,0,2942,0,142,0,5,0,48,0,3137,0,0,0,0,0,0,0,5,4,0,69
Chicot,7/6/20,0,0,0,0,0,0,0,0,0,183,0,1443,0,113,0,3,0,67,0,1626,0,0,0,0,0,0,0,3,5,0,36
Clark,7/6/20,0,0,0,0,0,0,0,0,0,59,0,1942,0,57,0,0,0,2,0,2001,0,0,0,0,0,0,0,1,1,0,23
Clay,7/6/20,0,0,0,0,0,0,0,0,0,70,0,1602,0,52,0,3,0,15,0,1672,0,0,0,0,0,0,0,4,2,0,25
Cleburne,7/6/20,0,0,0,0,0,0,0,0,0,115,0,2187,0,75,0,4,0,36,0,2302,0,0,0,0,0,0,0,4,1,0,50
Cleveland,7/6/20,0,0,0,0,0,0,0,0,0,29,0,767,0,26,0,0,0,3,0,796,0,0,0,0,0,0,0,0,0,0,17
Columbia,7/6/20,0,0,0,0,0,0,0,0,0,90,0,1379,0,67,0,4,0,19,0,1469,0,0,0,0,0,0,0,0,23,0,57
Conway,7/6/20,0,0,0,0,0,0,0,0,0,74,0,1651,0,43,0,3,0,28,0,1725,0,0,0,0,0,0,0,2,1,0,42
Craighead,7/6/20,0,0,0,0,0,0,0,0,0,482,0,11350,0,415,0,7,0,60,0,11832,0,0,0,0,0,0,0,2,8,0,187
Crawford,7/6/20,0,0,0,0,0,0,0,0,0,216,0,4584,0,133,0,1,0,82,0,4800,0,0,0,0,0,0,0,1,13,0,111
Crittenden,7/6/20,0,0,0,0,0,0,0,0,0,783,0,6144,0,620,0,13,0,150,0,6927,0,0,0,0,0,0,0,17,8,0,336
Cross,7/6/20,0,0,0,0,0,0,0,0,0,90,0,1497,0,81,0,1,0,8,0,1587,0,0,0,0,0,0,0,1,1,0,-9
Dallas,7/6/20,0,0,0,0,0,0,0,0,0,10,0,460,0,7,0,0,0,3,0,470,0,0,0,0,0,0,0,0,1,0,8
Desha,7/6/20,0,0,0,0,0,0,0,0,0,65,0,1096,0,37,0,1,0,27,0,1161,0,0,0,0,0,0,0,1,2,0,36
Drew,7/6/20,0,0,0,0,0,0,0,0,0,77,0,1707,0,47,0,2,0,28,0,1784,0,0,0,0,0,0,0,1,4,0,24
Faulkner,7/6/20,0,0,0,0,0,0,0,0,0,612,0,10262,0,373,0,3,0,236,0,10874,0,0,0,0,0,0,0,19,17,0,180
Franklin,7/6/20,0,0,0,0,0,0,0,0,0,27,0,1461,0,18,0,1,0,8,0,1488,0,0,0,0,0,0,0,0,2,0,15
Fulton,7/6/20,0,0,0,0,0,0,0,0,0,15,0,969,0,10,0,0,0,5,0,984,0,0,0,0,0,0,0,0,0,0,16
Garland,7/6/20,0,0,0,0,0,0,0,0,0,288,0,8115,0,212,0,1,0,75,0,8403,0,0,0,0,0,0,0,3,3,0,70
Grant,7/6/20,0,0,0,0,0,0,0,0,0,50,0,1257,0,36,0,0,0,14,0,1307,0,0,0,0,0,0,0,4,2,0,26
Greene,7/6/20,0,0,0,0,0,0,0,0,0,124,0,4142,0,102,0,0,0,22,0,4266,0,0,0,0,0,0,0,2,0,0,47
Hempstead,7/6/20,0,0,0,0,0,0,0,0,0,64,0,1762,0,49,0,1,0,14,0,1826,0,0,0,0,0,0,0,1,0,0,21
HotSpring,7/6/20,0,0,0,0,0,0,0,0,0,584,0,3793,0,209,0,1,0,374,0,4377,0,0,0,0,0,0,0,1,141,0,242
Howard,7/6/20,0,0,0,0,0,0,0,0,0,102,0,1486,0,76,0,1,0,25,0,1588,0,0,0,0,0,0,0,1,3,0,37
Independence,7/6/20,0,0,0,0,0,0,0,0,0,61,0,3057,0,53,0,0,0,8,0,3118,0,0,0,0,0,0,0,1,1,0,36
Izard,7/6/20,0,0,0,0,0,0,0,0,0,23,0,1016,0,20,0,1,0,2,0,1039,0,0,0,0,0,0,0,0,1,0,13
Jackson,7/6/20,0,0,0,0,0,0,0,0,0,33,0,1222,0,25,0,0,0,8,0,1255,0,0,0,0,0,0,0,1,0,0,62
Jefferson,7/6/20,0,0,0,0,0,0,0,0,0,761,0,6982,0,632,0,28,0,101,0,7743,0,0,0,0,0,0,0,9,9,0,268
Johnson,7/6/20,0,0,0,0,0,0,0,0,0,271,0,1546,0,205,0,0,0,66,0,1817,0,0,0,0,0,0,0,0,5,0,43
Lafayette,7/6/20,0,0,0,0,0,0,0,0,0,22,0,358,0,15,0,1,0,6,0,380,0,0,0,0,0,0,0,1,1,0,7
Lawrence,7/6/20,0,0,0,0,0,0,0,0,0,103,0,1672,0,85,0,9,0,9,0,1775,0,0,0,0,0,0,0,0,1,0,33
Lee,7/6/20,0,0,0,0,0,0,0,0,0,803,0,2238,0,632,0,3,0,168,0,3041,0,0,0,0,0,0,0,0,44,1,182
Lincoln,7/6/20,0,0,0,0,0,0,0,0,0,1043,0,1899,0,1011,0,11,0,21,0,2942,0,0,0,0,0,0,0,0,0,0,115
LittleRiver,7/6/20,0,0,0,0,0,0,0,0,0,40,0,869,0,38,0,0,0,2,0,909,0,0,0,0,0,0,0,0,0,0,2
Logan,7/6/20,0,0,0,0,0,0,0,0,0,61,0,2056,0,38,0,0,0,23,0,2117,0,0,0,0,0,0,0,0,1,0,30
Lonoke,7/6/20,0,0,0,0,0,0,0,0,0,171,0,4808,0,108,0,1,0,62,0,4979,0,0,0,0,0,0,0,4,6,0,139
Madison,7/6/20,0,0,0,0,0,0,0,0,0,203,0,1888,0,176,0,0,0,27,0,2091,0,0,0,0,0,0,0,-3,3,0,15
Marion,7/6/20,0,0,0,0,0,0,0,0,0,12,0,937,0,4,0,0,0,8,0,949,0,0,0,0,0,0,0,0,0,0,14
Miller,7/6/20,0,0,0,0,0,0,0,0,0,228,0,2388,0,106,0,2,0,120,0,2616,0,0,0,0,0,0,0,8,4,0,48
MissingCountyInfo,7/6/20,0,0,0,0,0,0,0,0,0,965,0,53509,0,523,0,0,0,442,0,54474,0,0,0,0,0,0,0,58,32,0,-184
Mississippi,7/6/20,0,0,0,0,0,0,0,0,0,224,0,3927,0,132,0,3,0,89,0,4151,0,0,0,0,0,0,0,10,4,0,124
Monroe,7/6/20,0,0,0,0,0,0,0,0,0,17,0,738,0,10,0,0,0,7,0,755,0,0,0,0,0,0,0,1,1,0,23
Montgomery,7/6/20,0,0,0,0,0,0,0,0,0,6,0,639,0,3,0,0,0,3,0,645,0,0,0,0,0,0,0,1,0,0,5
Nevada,7/6/20,0,0,0,0,0,0,0,0,0,104,0,1212,0,82,0,3,0,19,0,1316,0,0,0,0,0,0,0,0,1,0,18
Newton,7/6/20,0,0,0,0,0,0,0,0,0,7,0,523,0,5,0,0,0,2,0,530,0,0,0,0,0,0,0,0,0,0,16
Ouachita,7/6/20,0,0,0,0,0,0,0,0,0,22,0,1777,0,18,0,0,0,4,0,1799,0,0,0,0,0,0,0,1,0,0,65
Perry,7/6/20,0,0,0,0,0,0,0,0,0,34,0,852,0,25,0,0,0,9,0,886,0,0,0,0,0,0,0,0,0,0,22
Phillips,7/6/20,0,0,0,0,0,0,0,0,0,156,0,2476,0,101,0,5,0,50,0,2632,0,0,0,0,0,0,0,1,3,1,118
Pike,7/6/20,0,0,0,0,0,0,0,0,0,10,0,1852,0,7,0,0,0,3,0,1862,0,0,0,0,0,0,0,0,0,0,13
Poinsett,7/6/20,0,0,0,0,0,0,0,0,0,63,0,1714,0,51,0,3,0,9,0,1777,0,0,0,0,0,0,0,1,0,0,43
Polk,7/6/20,0,0,0,0,0,0,0,0,0,80,0,1563,0,71,0,0,0,9,0,1643,0,0,0,0,0,0,0,3,1,0,26
Pope,7/6/20,0,0,0,0,0,0,0,0,0,500,0,6007,0,375,0,4,0,121,0,6507,0,0,0,0,0,0,0,5,6,0,99
Prairie,7/6/20,0,0,0,0,0,0,0,0,0,22,0,606,0,17,0,0,0,5,0,628,0,0,0,0,0,0,0,0,0,0,22
Pulaski,7/6/20,0,0,0,0,0,0,0,0,0,2472,0,36716,0,1653,0,61,0,758,0,39188,0,0,0,0,0,0,0,47,51,1,897
Randolph,7/6/20,0,0,0,0,0,0,0,0,0,56,0,2012,0,40,0,1,0,15,0,2068,0,0,0,0,0,0,0,1,1,0,30
Saline,7/6/20,0,0,0,0,0,0,0,0,0,359,0,9484,0,241,0,2,0,116,0,9843,0,0,0,0,0,0,0,6,9,0,132
Scott,7/6/20,0,0,0,0,0,0,0,0,0,14,0,540,0,8,0,0,0,6,0,554,0,0,0,0,0,0,0,2,0,0,11
Searcy,7/6/20,0,0,0,0,0,0,0,0,0,12,0,858,0,7,0,0,0,5,0,870,0,0,0,0,0,0,0,0,0,0,6
Sebastian,7/6/20,0,0,0,0,0,0,0,0,0,622,0,10841,0,335,0,5,0,282,0,11463,0,0,0,0,0,0,0,20,18,0,209
Sevier,7/6/20,0,0,0,0,0,0,0,0,0,748,0,3512,0,650,0,9,0,89,0,4260,0,0,0,0,0,0,0,5,15,1,30
Sharp,7/6/20,0,0,0,0,0,0,0,0,0,58,0,1145,0,44,0,5,0,9,0,1203,0,0,0,0,0,0,0,0,0,0,28
St.Francis,7/6/20,0,0,0,0,0,0,0,0,0,892,0,4268,0,856,0,3,0,33,0,5160,0,0,0,0,0,0,0,9,8,0,-290
Stone,7/6/20,0,0,0,0,0,0,0,0,0,19,0,1072,0,13,0,0,0,6,0,1091,0,0,0,0,0,0,0,0,0,0,31
Union,7/6/20,0,0,0,0,0,0,0,0,0,253,0,3129,0,217,0,13,0,23,0,3382,0,0,0,0,0,0,0,1,1,0,24
VanBuren,7/6/20,0,0,0,0,0,0,0,0,0,34,0,1119,0,30,0,2,0,2,0,1153,0,0,0,0,0,0,0,1,1,0,14
Washington,7/6/20,0,0,0,0,0,0,0,0,0,4137,0,14742,0,2998,0,33,0,1106,0,18879,0,0,0,0,0,0,0,87,147,1,646
White,7/6/20,0,0,0,0,0,0,0,0,0,98,0,4195,0,75,0,2,0,21,0,4293,0,0,0,0,0,0,0,2,0,0,80
Woodruff,7/6/20,0,0,0,0,0,0,0,0,0,8,0,706,0,6,0,0,0,2,0,714,0,0,0,0,0,0,0,0,0,0,1
Yell,7/6/20,0,0,0,0,0,0,0,0,0,745,0,2258,0,509,0,3,0,233,0,3003,0,0,0,0,0,0,0,38,19,0,101
Arkansas_all_counties,7/5/20,0,0,0,0,0,0,0,0,2990671,23814,0,320715,0,17133,0,287,0,6394,0,344529,0,0,0,0,0,0,0,605,407,1,6046
Arkansas_county,7/5/20,0,0,0,0,0,0,0,0,0,37,0,1487,0,23,0,0,0,14,0,1524,0,0,0,0,0,0,0,0,0,0,7
Ashley,7/5/20,0,0,0,0,0,0,0,0,0,83,0,1493,0,59,0,1,0,23,0,1576,0,0,0,0,0,0,0,3,3,0,21
Baxter,7/5/20,0,0,0,0,0,0,0,0,0,24,0,2339,0,17,0,0,0,7,0,2363,0,0,0,0,0,0,0,0,2,0,11
Benton,7/5/20,0,0,0,0,0,0,0,0,0,3000,0,35189,0,2365,0,20,0,615,0,38189,0,0,0,0,0,0,0,39,70,0,529
Boone,7/5/20,0,0,0,0,0,0,0,0,0,30,0,2457,0,18,0,1,0,11,0,2487,0,0,0,0,0,0,0,1,1,0,144
Bradley,7/5/20,0,0,0,0,0,0,0,0,0,56,0,1142,0,37,0,2,0,17,0,1198,0,0,0,0,0,0,0,0,1,0,17
Calhoun,7/5/20,0,0,0,0,0,0,0,0,0,2,0,321,0,0,0,0,0,2,0,323,0,0,0,0,0,0,0,0,0,0,24
Carroll,7/5/20,0,0,0,0,0,0,0,0,0,190,0,2878,0,138,0,5,0,47,0,3068,0,0,0,0,0,0,0,3,0,0,27
Chicot,7/5/20,0,0,0,0,0,0,0,0,0,180,0,1410,0,108,0,3,0,69,0,1590,0,0,0,0,0,0,0,21,7,0,28
Clark,7/5/20,0,0,0,0,0,0,0,0,0,58,0,1920,0,56,0,0,0,2,0,1978,0,0,0,0,0,0,0,0,0,0,3
Clay,7/5/20,0,0,0,0,0,0,0,0,0,66,0,1581,0,50,0,3,0,13,0,1647,0,0,0,0,0,0,0,1,0,0,6
Cleburne,7/5/20,0,0,0,0,0,0,0,0,0,111,0,2141,0,74,0,4,0,33,0,2252,0,0,0,0,0,0,0,1,1,0,70
Cleveland,7/5/20,0,0,0,0,0,0,0,0,0,29,0,750,0,26,0,0,0,3,0,779,0,0,0,0,0,0,0,0,0,0,9
Columbia,7/5/20,0,0,0,0,0,0,0,0,0,90,0,1322,0,44,0,4,0,42,0,1412,0,0,0,0,0,0,0,1,3,0,18
Conway,7/5/20,0,0,0,0,0,0,0,0,0,72,0,1611,0,42,0,3,0,27,0,1683,0,0,0,0,0,0,0,3,5,0,56
Craighead,7/5/20,0,0,0,0,0,0,0,0,0,480,0,11165,0,407,0,7,0,66,0,11645,0,0,0,0,0,0,0,8,2,0,78
Crawford,7/5/20,0,0,0,0,0,0,0,0,0,215,0,4474,0,120,0,1,0,94,0,4689,0,0,0,0,0,0,0,7,3,0,144
Crittenden,7/5/20,0,0,0,0,0,0,0,0,0,766,0,5825,0,612,0,13,0,141,0,6591,0,0,0,0,0,0,0,0,5,0,23
Cross,7/5/20,0,0,0,0,0,0,0,0,0,89,0,1507,0,80,0,1,0,8,0,1596,0,0,0,0,0,0,0,1,0,0,12
Dallas,7/5/20,0,0,0,0,0,0,0,0,0,10,0,452,0,6,0,0,0,4,0,462,0,0,0,0,0,0,0,0,0,0,6
Desha,7/5/20,0,0,0,0,0,0,0,0,0,64,0,1061,0,35,0,1,0,28,0,1125,0,0,0,0,0,0,0,5,1,0,21
Drew,7/5/20,0,0,0,0,0,0,0,0,0,76,0,1684,0,43,0,2,0,31,0,1760,0,0,0,0,0,0,0,3,0,0,27
Faulkner,7/5/20,0,0,0,0,0,0,0,0,0,593,0,10101,0,356,0,3,0,234,0,10694,0,0,0,0,0,0,0,29,16,0,204
Franklin,7/5/20,0,0,0,0,0,0,0,0,0,27,0,1446,0,16,0,1,0,10,0,1473,0,0,0,0,0,0,0,1,3,0,52
Fulton,7/5/20,0,0,0,0,0,0,0,0,0,15,0,953,0,10,0,0,0,5,0,968,0,0,0,0,0,0,0,0,1,0,7
Garland,7/5/20,0,0,0,0,0,0,0,0,0,285,0,8048,0,209,0,1,0,75,0,8333,0,0,0,0,0,0,0,8,8,0,139
Grant,7/5/20,0,0,0,0,0,0,0,0,0,46,0,1235,0,34,0,0,0,12,0,1281,0,0,0,0,0,0,0,1,0,0,21
Greene,7/5/20,0,0,0,0,0,0,0,0,0,122,0,4097,0,102,0,0,0,20,0,4219,0,0,0,0,0,0,0,1,3,0,13
Hempstead,7/5/20,0,0,0,0,0,0,0,0,0,63,0,1742,0,49,0,1,0,13,0,1805,0,0,0,0,0,0,0,3,1,0,34
HotSpring,7/5/20,0,0,0,0,0,0,0,0,0,583,0,3552,0,68,0,1,0,514,0,4135,0,0,0,0,0,0,0,0,4,0,14
Howard,7/5/20,0,0,0,0,0,0,0,0,0,101,0,1450,0,73,0,1,0,27,0,1551,0,0,0,0,0,0,0,1,0,0,43
Independence,7/5/20,0,0,0,0,0,0,0,0,0,60,0,3022,0,52,0,0,0,8,0,3082,0,0,0,0,0,0,0,0,2,0,121
Izard,7/5/20,0,0,0,0,0,0,0,0,0,23,0,1003,0,19,0,1,0,3,0,1026,0,0,0,0,0,0,0,0,0,0,70
Jackson,7/5/20,0,0,0,0,0,0,0,0,0,32,0,1161,0,25,0,0,0,7,0,1193,0,0,0,0,0,0,0,0,0,0,23
Jefferson,7/5/20,0,0,0,0,0,0,0,0,0,752,0,6723,0,623,0,28,0,101,0,7475,0,0,0,0,0,0,0,15,3,0,148
Johnson,7/5/20,0,0,0,0,0,0,0,0,0,271,0,1503,0,200,0,0,0,71,0,1774,0,0,0,0,0,0,0,2,13,0,10
Lafayette,7/5/20,0,0,0,0,0,0,0,0,0,21,0,352,0,14,0,1,0,6,0,373,0,0,0,0,0,0,0,0,0,0,0
Lawrence,7/5/20,0,0,0,0,0,0,0,0,0,103,0,1639,0,84,0,9,0,10,0,1742,0,0,0,0,0,0,0,1,1,0,25
Lee,7/5/20,0,0,0,0,0,0,0,0,0,803,0,2056,0,588,0,2,0,213,0,2859,0,0,0,0,0,0,0,5,3,0,62
Lincoln,7/5/20,0,0,0,0,0,0,0,0,0,1043,0,1784,0,1011,0,11,0,21,0,2827,0,0,0,0,0,0,0,2,0,0,10
LittleRiver,7/5/20,0,0,0,0,0,0,0,0,0,40,0,867,0,38,0,0,0,2,0,907,0,0,0,0,0,0,0,0,0,0,3
Logan,7/5/20,0,0,0,0,0,0,0,0,0,61,0,2026,0,37,0,0,0,24,0,2087,0,0,0,0,0,0,0,3,2,0,67
Lonoke,7/5/20,0,0,0,0,0,0,0,0,0,167,0,4673,0,102,0,1,0,64,0,4840,0,0,0,0,0,0,0,3,5,0,81
Madison,7/5/20,0,0,0,0,0,0,0,0,0,206,0,1870,0,173,0,0,0,33,0,2076,0,0,0,0,0,0,0,6,9,0,15
Marion,7/5/20,0,0,0,0,0,0,0,0,0,12,0,923,0,4,0,0,0,8,0,935,0,0,0,0,0,0,0,0,0,0,29
Miller,7/5/20,0,0,0,0,0,0,0,0,0,220,0,2348,0,102,0,2,0,116,0,2568,0,0,0,0,0,0,0,91,2,0,351
MissingCountyInfo,7/5/20,0,0,0,0,0,0,0,0,0,907,0,53751,0,491,0,0,0,416,0,54658,0,0,0,0,0,0,0,20,18,0,433
Mississippi,7/5/20,0,0,0,0,0,0,0,0,0,214,0,3813,0,128,0,3,0,83,0,4027,0,0,0,0,0,0,0,12,4,0,24
Monroe,7/5/20,0,0,0,0,0,0,0,0,0,16,0,716,0,9,0,0,0,7,0,732,0,0,0,0,0,0,0,0,1,0,5
Montgomery,7/5/20,0,0,0,0,0,0,0,0,0,5,0,635,0,3,0,0,0,2,0,640,0,0,0,0,0,0,0,0,0,0,4
Nevada,7/5/20,0,0,0,0,0,0,0,0,0,104,0,1194,0,81,0,3,0,20,0,1298,0,0,0,0,0,0,0,0,0,0,2
Newton,7/5/20,0,0,0,0,0,0,0,0,0,7,0,507,0,5,0,0,0,2,0,514,0,0,0,0,0,0,0,-1,0,0,11
Ouachita,7/5/20,0,0,0,0,0,0,0,0,0,21,0,1713,0,18,0,0,0,3,0,1734,0,0,0,0,0,0,0,0,0,0,40
Perry,7/5/20,0,0,0,0,0,0,0,0,0,34,0,830,0,25,0,0,0,9,0,864,0,0,0,0,0,0,0,-1,0,0,14
Phillips,7/5/20,0,0,0,0,0,0,0,0,0,155,0,2359,0,98,0,4,0,53,0,2514,0,0,0,0,0,0,0,0,4,0,60
Pike,7/5/20,0,0,0,0,0,0,0,0,0,10,0,1839,0,7,0,0,0,3,0,1849,0,0,0,0,0,0,0,0,0,0,24
Poinsett,7/5/20,0,0,0,0,0,0,0,0,0,62,0,1672,0,51,0,3,0,8,0,1734,0,0,0,0,0,0,0,1,0,0,5
Polk,7/5/20,0,0,0,0,0,0,0,0,0,77,0,1540,0,70,0,0,0,7,0,1617,0,0,0,0,0,0,0,1,1,0,16
Pope,7/5/20,0,0,0,0,0,0,0,0,0,495,0,5913,0,369,0,4,0,122,0,6408,0,0,0,0,0,0,0,19,7,0,109
Prairie,7/5/20,0,0,0,0,0,0,0,0,0,22,0,584,0,17,0,0,0,5,0,606,0,0,0,0,0,0,0,1,1,0,21
Pulaski,7/5/20,0,0,0,0,0,0,0,0,0,2425,0,35866,0,1602,0,60,0,763,0,38291,0,0,0,0,0,0,0,80,39,0,749
Randolph,7/5/20,0,0,0,0,0,0,0,0,0,55,0,1983,0,39,0,1,0,15,0,2038,0,0,0,0,0,0,0,1,0,0,29
Saline,7/5/20,0,0,0,0,0,0,0,0,0,353,0,9358,0,232,0,2,0,119,0,9711,0,0,0,0,0,0,0,16,9,0,158
Scott,7/5/20,0,0,0,0,0,0,0,0,0,12,0,531,0,8,0,0,0,4,0,543,0,0,0,0,0,0,0,0,0,0,11
Searcy,7/5/20,0,0,0,0,0,0,0,0,0,12,0,852,0,7,0,0,0,5,0,864,0,0,0,0,0,0,0,0,0,0,5
Sebastian,7/5/20,0,0,0,0,0,0,0,0,0,602,0,10652,0,317,0,5,0,280,0,11254,0,0,0,0,0,0,0,25,15,0,407
Sevier,7/5/20,0,0,0,0,0,0,0,0,0,743,0,3487,0,635,0,8,0,100,0,4230,0,0,0,0,0,0,0,11,14,1,51
Sharp,7/5/20,0,0,0,0,0,0,0,0,0,58,0,1117,0,44,0,5,0,9,0,1175,0,0,0,0,0,0,0,0,1,0,22
St.Francis,7/5/20,0,0,0,0,0,0,0,0,0,883,0,4567,0,848,0,3,0,32,0,5450,0,0,0,0,0,0,0,2,0,0,22
Stone,7/5/20,0,0,0,0,0,0,0,0,0,19,0,1041,0,13,0,0,0,6,0,1060,0,0,0,0,0,0,0,1,1,0,40
Union,7/5/20,0,0,0,0,0,0,0,0,0,252,0,3106,0,216,0,13,0,23,0,3358,0,0,0,0,0,0,0,0,2,0,21
VanBuren,7/5/20,0,0,0,0,0,0,0,0,0,33,0,1106,0,29,0,2,0,2,0,1139,0,0,0,0,0,0,0,0,0,0,4
Washington,7/5/20,0,0,0,0,0,0,0,0,0,4050,0,14183,0,2851,0,32,0,1167,0,18233,0,0,0,0,0,0,0,118,93,0,374
White,7/5/20,0,0,0,0,0,0,0,0,0,96,0,4117,0,75,0,2,0,19,0,4213,0,0,0,0,0,0,0,3,0,0,71
Woodruff,7/5/20,0,0,0,0,0,0,0,0,0,8,0,705,0,6,0,0,0,2,0,713,0,0,0,0,0,0,0,0,0,0,8
Yell,7/5/20,0,0,0,0,0,0,0,0,0,707,0,2195,0,490,0,3,0,214,0,2902,0,0,0,0,0,0,0,27,17,0,75
Arkansas_all_counties,7/4/20,0,0,0,0,0,0,0,0,2990671,23209,0,315684,0,16726,0,286,0,6197,0,338893,0,0,0,0,0,0,0,587,562,5,8373
Arkansas_county,7/4/20,0,0,0,0,0,0,0,0,0,37,0,1480,0,23,0,0,0,14,0,1517,0,0,0,0,0,0,0,-1,1,0,13
Ashley,7/4/20,0,0,0,0,0,0,0,0,0,80,0,1475,0,56,0,1,0,23,0,1555,0,0,0,0,0,0,0,2,1,0,30
Baxter,7/4/20,0,0,0,0,0,0,0,0,0,24,0,2328,0,15,0,0,0,9,0,2352,0,0,0,0,0,0,0,0,0,0,128
Benton,7/4/20,0,0,0,0,0,0,0,0,0,2961,0,34699,0,2295,0,20,0,646,0,37660,0,0,0,0,0,0,0,44,89,0,531
Boone,7/4/20,0,0,0,0,0,0,0,0,0,29,0,2314,0,17,0,1,0,11,0,2343,0,0,0,0,0,0,0,0,2,0,300
Bradley,7/4/20,0,0,0,0,0,0,0,0,0,56,0,1125,0,36,0,2,0,18,0,1181,0,0,0,0,0,0,0,4,2,0,31
Calhoun,7/4/20,0,0,0,0,0,0,0,0,0,2,0,297,0,0,0,0,0,2,0,299,0,0,0,0,0,0,0,1,0,0,46
Carroll,7/4/20,0,0,0,0,0,0,0,0,0,187,0,2854,0,138,0,5,0,44,0,3041,0,0,0,0,0,0,0,0,5,0,20
Chicot,7/4/20,0,0,0,0,0,0,0,0,0,159,0,1403,0,101,0,3,0,55,0,1562,0,0,0,0,0,0,0,5,5,0,40
Clark,7/4/20,0,0,0,0,0,0,0,0,0,58,0,1917,0,56,0,0,0,2,0,1975,0,0,0,0,0,0,0,0,1,0,15
Clay,7/4/20,0,0,0,0,0,0,0,0,0,65,0,1576,0,50,0,3,0,12,0,1641,0,0,0,0,0,0,0,1,6,0,18
Cleburne,7/4/20,0,0,0,0,0,0,0,0,0,110,0,2072,0,73,0,4,0,33,0,2182,0,0,0,0,0,0,0,8,1,0,227
Cleveland,7/4/20,0,0,0,0,0,0,0,0,0,29,0,741,0,26,0,0,0,3,0,770,0,0,0,0,0,0,0,2,0,0,14
Columbia,7/4/20,0,0,0,0,0,0,0,0,0,89,0,1305,0,41,0,4,0,44,0,1394,0,0,0,0,0,0,0,4,6,0,34
Conway,7/4/20,0,0,0,0,0,0,0,0,0,69,0,1558,0,37,0,3,0,29,0,1627,0,0,0,0,0,0,0,3,3,0,68
Craighead,7/4/20,0,0,0,0,0,0,0,0,0,472,0,11095,0,405,0,7,0,60,0,11567,0,0,0,0,0,0,0,5,2,0,78
Crawford,7/4/20,0,0,0,0,0,0,0,0,0,208,0,4337,0,117,0,1,0,90,0,4545,0,0,0,0,0,0,0,12,10,0,179
Crittenden,7/4/20,0,0,0,0,0,0,0,0,0,766,0,5802,0,607,0,13,0,146,0,6568,0,0,0,0,0,0,0,1,13,0,30
Cross,7/4/20,0,0,0,0,0,0,0,0,0,88,0,1496,0,80,0,1,0,7,0,1584,0,0,0,0,0,0,0,0,0,0,23
Dallas,7/4/20,0,0,0,0,0,0,0,0,0,10,0,446,0,6,0,0,0,4,0,456,0,0,0,0,0,0,0,0,0,0,16
Desha,7/4/20,0,0,0,0,0,0,0,0,0,59,0,1045,0,34,0,1,0,24,0,1104,0,0,0,0,0,0,0,5,1,0,25
Drew,7/4/20,0,0,0,0,0,0,0,0,0,73,0,1660,0,43,0,2,0,28,0,1733,0,0,0,0,0,0,0,3,3,0,53
Faulkner,7/4/20,0,0,0,0,0,0,0,0,0,564,0,9926,0,340,0,3,0,221,0,10490,0,0,0,0,0,0,0,19,25,0,278
Franklin,7/4/20,0,0,0,0,0,0,0,0,0,26,0,1395,0,13,0,1,0,12,0,1421,0,0,0,0,0,0,0,0,1,0,43
Fulton,7/4/20,0,0,0,0,0,0,0,0,0,15,0,946,0,9,0,0,0,6,0,961,0,0,0,0,0,0,0,0,0,0,21
Garland,7/4/20,0,0,0,0,0,0,0,0,0,277,0,7917,0,201,0,1,0,75,0,8194,0,0,0,0,0,0,0,6,14,0,189
Grant,7/4/20,0,0,0,0,0,0,0,0,0,45,0,1215,0,34,0,0,0,11,0,1260,0,0,0,0,0,0,0,1,3,0,14
Greene,7/4/20,0,0,0,0,0,0,0,0,0,121,0,4085,0,99,0,0,0,22,0,4206,0,0,0,0,0,0,0,0,0,0,33
Hempstead,7/4/20,0,0,0,0,0,0,0,0,0,60,0,1711,0,48,0,1,0,11,0,1771,0,0,0,0,0,0,0,3,3,0,24
HotSpring,7/4/20,0,0,0,0,0,0,0,0,0,583,0,3538,0,64,0,1,0,518,0,4121,0,0,0,0,0,0,0,1,9,1,37
Howard,7/4/20,0,0,0,0,0,0,0,0,0,100,0,1408,0,73,0,1,0,26,0,1508,0,0,0,0,0,0,0,2,2,0,41
Independence,7/4/20,0,0,0,0,0,0,0,0,0,60,0,2901,0,50,0,0,0,10,0,2961,0,0,0,0,0,0,0,-1,1,0,95
Izard,7/4/20,0,0,0,0,0,0,0,0,0,23,0,933,0,19,0,1,0,3,0,956,0,0,0,0,0,0,0,0,0,0,211
Jackson,7/4/20,0,0,0,0,0,0,0,0,0,32,0,1138,0,25,0,0,0,7,0,1170,0,0,0,0,0,0,0,1,0,0,75
Jefferson,7/4/20,0,0,0,0,0,0,0,0,0,737,0,6590,0,620,0,28,0,89,0,7327,0,0,0,0,0,0,0,11,4,0,194
Johnson,7/4/20,0,0,0,0,0,0,0,0,0,269,0,1495,0,187,0,0,0,82,0,1764,0,0,0,0,0,0,0,16,13,0,53
Lafayette,7/4/20,0,0,0,0,0,0,0,0,0,21,0,352,0,14,0,1,0,6,0,373,0,0,0,0,0,0,0,0,0,0,3
Lawrence,7/4/20,0,0,0,0,0,0,0,0,0,102,0,1615,0,83,0,9,0,10,0,1717,0,0,0,0,0,0,0,0,0,0,27
Lee,7/4/20,0,0,0,0,0,0,0,0,0,798,0,1999,0,585,0,2,0,211,0,2797,0,0,0,0,0,0,0,37,2,0,85
Lincoln,7/4/20,0,0,0,0,0,0,0,0,0,1041,0,1776,0,1011,0,11,0,19,0,2817,0,0,0,0,0,0,0,0,0,0,8
LittleRiver,7/4/20,0,0,0,0,0,0,0,0,0,40,0,864,0,38,0,0,0,2,0,904,0,0,0,0,0,0,0,0,0,0,6
Logan,7/4/20,0,0,0,0,0,0,0,0,0,58,0,1962,0,35,0,0,0,23,0,2020,0,0,0,0,0,0,0,5,3,0,47
Lonoke,7/4/20,0,0,0,0,0,0,0,0,0,164,0,4595,0,97,0,1,0,66,0,4759,0,0,0,0,0,0,0,2,4,0,143
Madison,7/4/20,0,0,0,0,0,0,0,0,0,200,0,1861,0,164,0,0,0,36,0,2061,0,0,0,0,0,0,0,2,6,0,21
Marion,7/4/20,0,0,0,0,0,0,0,0,0,12,0,894,0,4,0,0,0,8,0,906,0,0,0,0,0,0,0,1,1,0,83
Miller,7/4/20,0,0,0,0,0,0,0,0,0,129,0,2088,0,100,0,2,0,27,0,2217,0,0,0,0,0,0,0,3,1,0,37
MissingCountyInfo,7/4/20,0,0,0,0,0,0,0,0,0,887,0,53338,0,473,0,0,0,414,0,54225,0,0,0,0,0,0,0,104,38,0,669
Mississippi,7/4/20,0,0,0,0,0,0,0,0,0,202,0,3801,0,124,0,3,0,75,0,4003,0,0,0,0,0,0,0,8,1,0,59
Monroe,7/4/20,0,0,0,0,0,0,0,0,0,16,0,711,0,8,0,0,0,8,0,727,0,0,0,0,0,0,0,0,1,0,3
Montgomery,7/4/20,0,0,0,0,0,0,0,0,0,5,0,631,0,3,0,0,0,2,0,636,0,0,0,0,0,0,0,0,0,0,45
Nevada,7/4/20,0,0,0,0,0,0,0,0,0,104,0,1192,0,81,0,3,0,20,0,1296,0,0,0,0,0,0,0,0,3,0,16
Newton,7/4/20,0,0,0,0,0,0,0,0,0,8,0,495,0,5,0,0,0,3,0,503,0,0,0,0,0,0,0,1,0,0,13
Ouachita,7/4/20,0,0,0,0,0,0,0,0,0,21,0,1673,0,18,0,0,0,3,0,1694,0,0,0,0,0,0,0,1,0,0,29
Perry,7/4/20,0,0,0,0,0,0,0,0,0,35,0,815,0,25,0,0,0,10,0,850,0,0,0,0,0,0,0,1,0,0,20
Phillips,7/4/20,0,0,0,0,0,0,0,0,0,155,0,2299,0,94,0,4,0,57,0,2454,0,0,0,0,0,0,0,0,3,1,48
Pike,7/4/20,0,0,0,0,0,0,0,0,0,10,0,1815,0,7,0,0,0,3,0,1825,0,0,0,0,0,0,0,1,0,0,14
Poinsett,7/4/20,0,0,0,0,0,0,0,0,0,61,0,1668,0,51,0,3,0,7,0,1729,0,0,0,0,0,0,0,0,0,0,9
Polk,7/4/20,0,0,0,0,0,0,0,0,0,76,0,1525,0,69,0,0,0,7,0,1601,0,0,0,0,0,0,0,1,0,0,52
Pope,7/4/20,0,0,0,0,0,0,0,0,0,476,0,5823,0,362,0,4,0,110,0,6299,0,0,0,0,0,0,0,8,10,0,126
Prairie,7/4/20,0,0,0,0,0,0,0,0,0,21,0,564,0,16,0,0,0,5,0,585,0,0,0,0,0,0,0,0,2,0,15
Pulaski,7/4/20,0,0,0,0,0,0,0,0,0,2345,0,35197,0,1563,0,60,0,722,0,37542,0,0,0,0,0,0,0,87,59,1,773
Randolph,7/4/20,0,0,0,0,0,0,0,0,0,54,0,1955,0,39,0,1,0,14,0,2009,0,0,0,0,0,0,0,1,0,0,12
Saline,7/4/20,0,0,0,0,0,0,0,0,0,337,0,9216,0,223,0,2,0,112,0,9553,0,0,0,0,0,0,0,18,4,0,144
Scott,7/4/20,0,0,0,0,0,0,0,0,0,12,0,520,0,8,0,0,0,4,0,532,0,0,0,0,0,0,0,0,1,0,7
Searcy,7/4/20,0,0,0,0,0,0,0,0,0,12,0,847,0,7,0,0,0,5,0,859,0,0,0,0,0,0,0,0,0,0,15
Sebastian,7/4/20,0,0,0,0,0,0,0,0,0,577,0,10270,0,302,0,5,0,270,0,10847,0,0,0,0,0,0,0,29,16,0,727
Sevier,7/4/20,0,0,0,0,0,0,0,0,0,732,0,3447,0,621,0,7,0,104,0,4179,0,0,0,0,0,0,0,6,16,0,20
Sharp,7/4/20,0,0,0,0,0,0,0,0,0,58,0,1095,0,43,0,5,0,10,0,1153,0,0,0,0,0,0,0,1,1,0,126
St.Francis,7/4/20,0,0,0,0,0,0,0,0,0,881,0,4547,0,848,0,3,0,30,0,5428,0,0,0,0,0,0,0,18,16,0,128
Stone,7/4/20,0,0,0,0,0,0,0,0,0,18,0,1002,0,12,0,0,0,6,0,1020,0,0,0,0,0,0,0,1,0,0,135
Union,7/4/20,0,0,0,0,0,0,0,0,0,252,0,3085,0,214,0,13,0,25,0,3337,0,0,0,0,0,0,0,0,2,0,14
VanBuren,7/4/20,0,0,0,0,0,0,0,0,0,33,0,1102,0,29,0,2,0,2,0,1135,0,0,0,0,0,0,0,0,0,0,24
Washington,7/4/20,0,0,0,0,0,0,0,0,0,3932,0,13927,0,2758,0,32,0,1142,0,17859,0,0,0,0,0,0,0,79,121,1,518
White,7/4/20,0,0,0,0,0,0,0,0,0,93,0,4049,0,75,0,2,0,16,0,4142,0,0,0,0,0,0,0,1,2,1,119
Woodruff,7/4/20,0,0,0,0,0,0,0,0,0,8,0,697,0,6,0,0,0,2,0,705,0,0,0,0,0,0,0,1,1,0,52
Yell,7/4/20,0,0,0,0,0,0,0,0,0,680,0,2147,0,473,0,3,0,204,0,2827,0,0,0,0,0,0,0,12,22,0,35
Arkansas_all_counties,7/3/20,0,0,0,0,0,0,0,0,2990671,22622,0,308615,0,16164,0,281,0,6177,0,331237,0,0,0,0,0,0,0,547,466,2,7944
Arkansas_county,7/3/20,0,0,0,0,0,0,0,0,0,38,0,1466,0,22,0,0,0,16,0,1504,0,0,0,0,0,0,0,8,1,0,29
Ashley,7/3/20,0,0,0,0,0,0,0,0,0,78,0,1447,0,55,0,1,0,22,0,1525,0,0,0,0,0,0,0,1,0,0,19
Baxter,7/3/20,0,0,0,0,0,0,0,0,0,24,0,2200,0,15,0,0,0,9,0,2224,0,0,0,0,0,0,0,0,0,0,213
Benton,7/3/20,0,0,0,0,0,0,0,0,0,2917,0,34212,0,2206,0,20,0,691,0,37129,0,0,0,0,0,0,0,83,70,0,642
Boone,7/3/20,0,0,0,0,0,0,0,0,0,29,0,2014,0,15,0,1,0,13,0,2043,0,0,0,0,0,0,0,1,3,0,79
Bradley,7/3/20,0,0,0,0,0,0,0,0,0,52,0,1098,0,34,0,2,0,16,0,1150,0,0,0,0,0,0,0,0,0,0,14
Calhoun,7/3/20,0,0,0,0,0,0,0,0,0,1,0,252,0,0,0,0,0,1,0,253,0,0,0,0,0,0,0,0,0,0,4
Carroll,7/3/20,0,0,0,0,0,0,0,0,0,187,0,2834,0,133,0,5,0,49,0,3021,0,0,0,0,0,0,0,15,2,0,75
Chicot,7/3/20,0,0,0,0,0,0,0,0,0,154,0,1368,0,96,0,3,0,55,0,1522,0,0,0,0,0,0,0,4,3,0,30
Clark,7/3/20,0,0,0,0,0,0,0,0,0,58,0,1902,0,55,0,0,0,3,0,1960,0,0,0,0,0,0,0,1,1,0,11
Clay,7/3/20,0,0,0,0,0,0,0,0,0,64,0,1559,0,44,0,3,0,17,0,1623,0,0,0,0,0,0,0,2,6,0,13
Cleburne,7/3/20,0,0,0,0,0,0,0,0,0,102,0,1853,0,72,0,4,0,26,0,1955,0,0,0,0,0,0,0,1,1,0,91
Cleveland,7/3/20,0,0,0,0,0,0,0,0,0,27,0,729,0,26,0,0,0,1,0,756,0,0,0,0,0,0,0,0,0,0,6
Columbia,7/3/20,0,0,0,0,0,0,0,0,0,85,0,1275,0,35,0,4,0,46,0,1360,0,0,0,0,0,0,0,1,3,0,22
Conway,7/3/20,0,0,0,0,0,0,0,0,0,66,0,1493,0,34,0,3,0,29,0,1559,0,0,0,0,0,0,0,5,0,0,60
Craighead,7/3/20,0,0,0,0,0,0,0,0,0,467,0,11022,0,403,0,7,0,57,0,11489,0,0,0,0,0,0,0,9,5,0,134
Crawford,7/3/20,0,0,0,0,0,0,0,0,0,196,0,4170,0,107,0,1,0,88,0,4366,0,0,0,0,0,0,0,6,6,0,76
Crittenden,7/3/20,0,0,0,0,0,0,0,0,0,765,0,5773,0,594,0,13,0,158,0,6538,0,0,0,0,0,0,0,6,8,0,66
Cross,7/3/20,0,0,0,0,0,0,0,0,0,88,0,1473,0,80,0,1,0,7,0,1561,0,0,0,0,0,0,0,0,1,0,29
Dallas,7/3/20,0,0,0,0,0,0,0,0,0,10,0,430,0,6,0,0,0,4,0,440,0,0,0,0,0,0,0,0,1,0,4
Desha,7/3/20,0,0,0,0,0,0,0,0,0,54,0,1025,0,33,0,1,0,20,0,1079,0,0,0,0,0,0,0,2,0,0,22
Drew,7/3/20,0,0,0,0,0,0,0,0,0,70,0,1610,0,40,0,2,0,28,0,1680,0,0,0,0,0,0,0,1,3,0,44
Faulkner,7/3/20,0,0,0,0,0,0,0,0,0,545,0,9667,0,315,0,3,0,227,0,10212,0,0,0,0,0,0,0,16,32,0,180
Franklin,7/3/20,0,0,0,0,0,0,0,0,0,26,0,1352,0,12,0,1,0,13,0,1378,0,0,0,0,0,0,0,0,0,1,98
Fulton,7/3/20,0,0,0,0,0,0,0,0,0,15,0,925,0,9,0,0,0,6,0,940,0,0,0,0,0,0,0,0,0,0,74
Garland,7/3/20,0,0,0,0,0,0,0,0,0,271,0,7734,0,187,0,1,0,83,0,8005,0,0,0,0,0,0,0,4,2,0,191
Grant,7/3/20,0,0,0,0,0,0,0,0,0,44,0,1202,0,31,0,0,0,13,0,1246,0,0,0,0,0,0,0,0,2,0,26
Greene,7/3/20,0,0,0,0,0,0,0,0,0,121,0,4052,0,99,0,0,0,22,0,4173,0,0,0,0,0,0,0,2,5,0,60
Hempstead,7/3/20,0,0,0,0,0,0,0,0,0,57,0,1690,0,45,0,1,0,11,0,1747,0,0,0,0,0,0,0,1,0,0,38
HotSpring,7/3/20,0,0,0,0,0,0,0,0,0,582,0,3502,0,55,0,0,0,527,0,4084,0,0,0,0,0,0,0,2,0,0,43
Howard,7/3/20,0,0,0,0,0,0,0,0,0,98,0,1369,0,71,0,1,0,26,0,1467,0,0,0,0,0,0,0,2,4,0,59
Independence,7/3/20,0,0,0,0,0,0,0,0,0,61,0,2805,0,49,0,0,0,12,0,2866,0,0,0,0,0,0,0,2,2,0,46
Izard,7/3/20,0,0,0,0,0,0,0,0,0,23,0,722,0,19,0,1,0,3,0,745,0,0,0,0,0,0,0,0,0,0,48
Jackson,7/3/20,0,0,0,0,0,0,0,0,0,31,0,1064,0,25,0,0,0,6,0,1095,0,0,0,0,0,0,0,3,1,0,21
Jefferson,7/3/20,0,0,0,0,0,0,0,0,0,726,0,6407,0,616,0,28,0,82,0,7133,0,0,0,0,0,0,0,6,3,0,171
Johnson,7/3/20,0,0,0,0,0,0,0,0,0,253,0,1458,0,174,0,0,0,79,0,1711,0,0,0,0,0,0,0,2,10,0,21
Lafayette,7/3/20,0,0,0,0,0,0,0,0,0,21,0,349,0,14,0,1,0,6,0,370,0,0,0,0,0,0,0,2,0,0,9
Lawrence,7/3/20,0,0,0,0,0,0,0,0,0,102,0,1588,0,83,0,9,0,10,0,1690,0,0,0,0,0,0,0,0,1,0,11
Lee,7/3/20,0,0,0,0,0,0,0,0,0,761,0,1951,0,583,0,2,0,176,0,2712,0,0,0,0,0,0,0,6,3,0,37
Lincoln,7/3/20,0,0,0,0,0,0,0,0,0,1041,0,1768,0,1011,0,11,0,19,0,2809,0,0,0,0,0,0,0,0,26,0,7
LittleRiver,7/3/20,0,0,0,0,0,0,0,0,0,40,0,858,0,38,0,0,0,2,0,898,0,0,0,0,0,0,0,0,-1,0,4
Logan,7/3/20,0,0,0,0,0,0,0,0,0,53,0,1920,0,32,0,0,0,21,0,1973,0,0,0,0,0,0,0,4,1,0,54
Lonoke,7/3/20,0,0,0,0,0,0,0,0,0,162,0,4454,0,93,0,1,0,68,0,4616,0,0,0,0,0,0,0,4,1,0,235
Madison,7/3/20,0,0,0,0,0,0,0,0,0,198,0,1842,0,158,0,0,0,40,0,2040,0,0,0,0,0,0,0,1,1,0,60
Marion,7/3/20,0,0,0,0,0,0,0,0,0,11,0,812,0,3,0,0,0,8,0,823,0,0,0,0,0,0,0,0,0,0,104
Miller,7/3/20,0,0,0,0,0,0,0,0,0,126,0,2054,0,99,0,2,0,25,0,2180,0,0,0,0,0,0,0,4,1,0,27
MissingCountyInfo,7/3/20,0,0,0,0,0,0,0,0,0,783,0,52773,0,435,0,0,0,348,0,53556,0,0,0,0,0,0,0,46,15,0,548
Mississippi,7/3/20,0,0,0,0,0,0,0,0,0,194,0,3750,0,123,0,3,0,68,0,3944,0,0,0,0,0,0,0,9,2,0,71
Monroe,7/3/20,0,0,0,0,0,0,0,0,0,16,0,708,0,7,0,0,0,9,0,724,0,0,0,0,0,0,0,1,0,0,22
Montgomery,7/3/20,0,0,0,0,0,0,0,0,0,5,0,586,0,3,0,0,0,2,0,591,0,0,0,0,0,0,0,0,0,0,2
Nevada,7/3/20,0,0,0,0,0,0,0,0,0,104,0,1176,0,78,0,3,0,23,0,1280,0,0,0,0,0,0,0,0,1,0,8
Newton,7/3/20,0,0,0,0,0,0,0,0,0,7,0,483,0,5,0,0,0,2,0,490,0,0,0,0,0,0,0,1,0,0,12
Ouachita,7/3/20,0,0,0,0,0,0,0,0,0,20,0,1645,0,18,0,0,0,2,0,1665,0,0,0,0,0,0,0,0,0,0,8
Perry,7/3/20,0,0,0,0,0,0,0,0,0,34,0,796,0,25,0,0,0,9,0,830,0,0,0,0,0,0,0,1,0,0,17
Phillips,7/3/20,0,0,0,0,0,0,0,0,0,155,0,2251,0,91,0,3,0,61,0,2406,0,0,0,0,0,0,0,6,1,0,59
Pike,7/3/20,0,0,0,0,0,0,0,0,0,9,0,1802,0,7,0,0,0,2,0,1811,0,0,0,0,0,0,0,0,0,0,53
Poinsett,7/3/20,0,0,0,0,0,0,0,0,0,61,0,1659,0,51,0,3,0,7,0,1720,0,0,0,0,0,0,0,0,0,0,13
Polk,7/3/20,0,0,0,0,0,0,0,0,0,75,0,1474,0,69,0,0,0,6,0,1549,0,0,0,0,0,0,0,0,3,0,9
Pope,7/3/20,0,0,0,0,0,0,0,0,0,468,0,5705,0,352,0,4,0,112,0,6173,0,0,0,0,0,0,0,17,14,1,270
Prairie,7/3/20,0,0,0,0,0,0,0,0,0,21,0,549,0,14,0,0,0,7,0,570,0,0,0,0,0,0,0,0,0,0,37
Pulaski,7/3/20,0,0,0,0,0,0,0,0,0,2258,0,34511,0,1504,0,59,0,695,0,36769,0,0,0,0,0,0,0,75,27,0,1068
Randolph,7/3/20,0,0,0,0,0,0,0,0,0,53,0,1944,0,39,0,1,0,13,0,1997,0,0,0,0,0,0,0,0,1,0,10
Saline,7/3/20,0,0,0,0,0,0,0,0,0,319,0,9090,0,219,0,2,0,98,0,9409,0,0,0,0,0,0,0,8,2,0,140
Scott,7/3/20,0,0,0,0,0,0,0,0,0,12,0,513,0,7,0,0,0,5,0,525,0,0,0,0,0,0,0,0,0,0,7
Searcy,7/3/20,0,0,0,0,0,0,0,0,0,12,0,832,0,7,0,0,0,5,0,844,0,0,0,0,0,0,0,5,0,0,32
Sebastian,7/3/20,0,0,0,0,0,0,0,0,0,548,0,9572,0,286,0,5,0,257,0,10120,0,0,0,0,0,0,0,15,15,0,300
Sevier,7/3/20,0,0,0,0,0,0,0,0,0,726,0,3433,0,605,0,7,0,114,0,4159,0,0,0,0,0,0,0,9,19,0,32
Sharp,7/3/20,0,0,0,0,0,0,0,0,0,57,0,970,0,42,0,5,0,10,0,1027,0,0,0,0,0,0,0,3,0,0,62
St.Francis,7/3/20,0,0,0,0,0,0,0,0,0,863,0,4437,0,832,0,3,0,28,0,5300,0,0,0,0,0,0,0,45,41,0,162
Stone,7/3/20,0,0,0,0,0,0,0,0,0,17,0,868,0,12,0,0,0,5,0,885,0,0,0,0,0,0,0,0,0,0,67
Union,7/3/20,0,0,0,0,0,0,0,0,0,252,0,3071,0,212,0,13,0,27,0,3323,0,0,0,0,0,0,0,2,1,0,30
VanBuren,7/3/20,0,0,0,0,0,0,0,0,0,33,0,1078,0,29,0,2,0,2,0,1111,0,0,0,0,0,0,0,0,1,0,64
Washington,7/3/20,0,0,0,0,0,0,0,0,0,3853,0,13488,0,2637,0,31,0,1185,0,17341,0,0,0,0,0,0,0,87,96,0,587
White,7/3/20,0,0,0,0,0,0,0,0,0,92,0,3931,0,73,0,1,0,18,0,4023,0,0,0,0,0,0,0,0,1,0,104
Woodruff,7/3/20,0,0,0,0,0,0,0,0,0,7,0,646,0,5,0,0,0,2,0,653,0,0,0,0,0,0,0,0,0,0,92
Yell,7/3/20,0,0,0,0,0,0,0,0,0,668,0,2124,0,451,0,3,0,214,0,2792,0,0,0,0,0,0,0,10,18,0,57
Arkansas_all_counties,7/2/20,0,0,0,0,0,0,0,0,2990671,22075,0,301912,0,15698,0,279,0,6098,0,323987,0,0,0,0,0,0,0,878,535,2,7868
Arkansas_county,7/2/20,0,0,0,0,0,0,0,0,0,30,0,1445,0,21,0,0,0,9,0,1475,0,0,0,0,0,0,0,-1,1,0,32
Ashley,7/2/20,0,0,0,0,0,0,0,0,0,77,0,1429,0,55,0,1,0,21,0,1506,0,0,0,0,0,0,0,3,1,0,30
Baxter,7/2/20,0,0,0,0,0,0,0,0,0,24,0,1987,0,15,0,0,0,9,0,2011,0,0,0,0,0,0,0,4,0,0,112
Benton,7/2/20,0,0,0,0,0,0,0,0,0,2834,0,33653,0,2136,0,20,0,678,0,36487,0,0,0,0,0,0,0,82,77,1,940
Boone,7/2/20,0,0,0,0,0,0,0,0,0,28,0,1936,0,12,0,1,0,15,0,1964,0,0,0,0,0,0,0,1,0,0,94
Bradley,7/2/20,0,0,0,0,0,0,0,0,0,52,0,1084,0,34,0,2,0,16,0,1136,0,0,0,0,0,0,0,0,2,0,7
Calhoun,7/2/20,0,0,0,0,0,0,0,0,0,1,0,248,0,0,0,0,0,1,0,249,0,0,0,0,0,0,0,1,0,0,9
Carroll,7/2/20,0,0,0,0,0,0,0,0,0,172,0,2774,0,131,0,5,0,36,0,2946,0,0,0,0,0,0,0,4,13,0,51
Chicot,7/2/20,0,0,0,0,0,0,0,0,0,150,0,1342,0,93,0,3,0,54,0,1492,0,0,0,0,0,0,0,11,9,0,81
Clark,7/2/20,0,0,0,0,0,0,0,0,0,57,0,1892,0,54,0,0,0,3,0,1949,0,0,0,0,0,0,0,0,2,0,16
Clay,7/2/20,0,0,0,0,0,0,0,0,0,62,0,1548,0,38,0,3,0,21,0,1610,0,0,0,0,0,0,0,3,3,0,27
Cleburne,7/2/20,0,0,0,0,0,0,0,0,0,101,0,1763,0,71,0,4,0,26,0,1864,0,0,0,0,0,0,0,9,0,0,31
Cleveland,7/2/20,0,0,0,0,0,0,0,0,0,27,0,723,0,26,0,0,0,1,0,750,0,0,0,0,0,0,0,1,2,0,27
Columbia,7/2/20,0,0,0,0,0,0,0,0,0,84,0,1254,0,32,0,4,0,48,0,1338,0,0,0,0,0,0,0,0,2,0,32
Conway,7/2/20,0,0,0,0,0,0,0,0,0,61,0,1438,0,34,0,3,0,24,0,1499,0,0,0,0,0,0,0,1,3,0,55
Craighead,7/2/20,0,0,0,0,0,0,0,0,0,458,0,10897,0,398,0,7,0,53,0,11355,0,0,0,0,0,0,0,5,3,0,178
Crawford,7/2/20,0,0,0,0,0,0,0,0,0,190,0,4100,0,101,0,1,0,88,0,4290,0,0,0,0,0,0,0,24,3,0,238
Crittenden,7/2/20,0,0,0,0,0,0,0,0,0,759,0,5713,0,586,0,13,0,160,0,6472,0,0,0,0,0,0,0,10,13,0,100
Cross,7/2/20,0,0,0,0,0,0,0,0,0,88,0,1444,0,79,0,1,0,8,0,1532,0,0,0,0,0,0,0,2,1,0,35
Dallas,7/2/20,0,0,0,0,0,0,0,0,0,10,0,426,0,5,0,0,0,5,0,436,0,0,0,0,0,0,0,0,0,0,7
Desha,7/2/20,0,0,0,0,0,0,0,0,0,52,0,1005,0,33,0,1,0,18,0,1057,0,0,0,0,0,0,0,5,3,0,59
Drew,7/2/20,0,0,0,0,0,0,0,0,0,69,0,1567,0,37,0,2,0,30,0,1636,0,0,0,0,0,0,0,4,3,0,92
Faulkner,7/2/20,0,0,0,0,0,0,0,0,0,529,0,9503,0,283,0,3,0,243,0,10032,0,0,0,0,0,0,0,37,17,0,291
Franklin,7/2/20,0,0,0,0,0,0,0,0,0,26,0,1254,0,12,0,0,0,14,0,1280,0,0,0,0,0,0,0,5,0,0,92
Fulton,7/2/20,0,0,0,0,0,0,0,0,0,15,0,851,0,9,0,0,0,6,0,866,0,0,0,0,0,0,0,0,0,0,91
Garland,7/2/20,0,0,0,0,0,0,0,0,0,267,0,7547,0,185,0,1,0,81,0,7814,0,0,0,0,0,0,0,14,8,0,435
Grant,7/2/20,0,0,0,0,0,0,0,0,0,44,0,1176,0,29,0,0,0,15,0,1220,0,0,0,0,0,0,0,3,1,0,32
Greene,7/2/20,0,0,0,0,0,0,0,0,0,119,0,3994,0,94,0,0,0,25,0,4113,0,0,0,0,0,0,0,0,3,0,60
Hempstead,7/2/20,0,0,0,0,0,0,0,0,0,56,0,1653,0,45,0,1,0,10,0,1709,0,0,0,0,0,0,0,6,2,0,35
HotSpring,7/2/20,0,0,0,0,0,0,0,0,0,580,0,3461,0,55,0,0,0,525,0,4041,0,0,0,0,0,0,0,151,2,0,155
Howard,7/2/20,0,0,0,0,0,0,0,0,0,96,0,1312,0,67,0,1,0,28,0,1408,0,0,0,0,0,0,0,2,5,0,81
Independence,7/2/20,0,0,0,0,0,0,0,0,0,59,0,2761,0,47,0,0,0,12,0,2820,0,0,0,0,0,0,0,4,1,0,46
Izard,7/2/20,0,0,0,0,0,0,0,0,0,23,0,674,0,19,0,1,0,3,0,697,0,0,0,0,0,0,0,0,0,0,16
Jackson,7/2/20,0,0,0,0,0,0,0,0,0,28,0,1046,0,24,0,0,0,4,0,1074,0,0,0,0,0,0,0,1,1,0,14
Jefferson,7/2/20,0,0,0,0,0,0,0,0,0,720,0,6242,0,613,0,28,0,79,0,6962,0,0,0,0,0,0,0,14,6,0,315
Johnson,7/2/20,0,0,0,0,0,0,0,0,0,251,0,1439,0,164,0,0,0,87,0,1690,0,0,0,0,0,0,0,15,8,0,44
Lafayette,7/2/20,0,0,0,0,0,0,0,0,0,19,0,342,0,14,0,1,0,4,0,361,0,0,0,0,0,0,0,0,0,0,6
Lawrence,7/2/20,0,0,0,0,0,0,0,0,0,102,0,1577,0,82,0,9,0,11,0,1679,0,0,0,0,0,0,0,2,2,0,75
Lee,7/2/20,0,0,0,0,0,0,0,0,0,755,0,1920,0,580,0,2,0,173,0,2675,0,0,0,0,0,0,0,9,4,0,34
Lincoln,7/2/20,0,0,0,0,0,0,0,0,0,1041,0,1761,0,985,0,11,0,45,0,2802,0,0,0,0,0,0,0,1,12,0,24
LittleRiver,7/2/20,0,0,0,0,0,0,0,0,0,40,0,854,0,39,0,0,0,1,0,894,0,0,0,0,0,0,0,2,1,0,10
Logan,7/2/20,0,0,0,0,0,0,0,0,0,49,0,1870,0,31,0,0,0,18,0,1919,0,0,0,0,0,0,0,3,2,0,64
Lonoke,7/2/20,0,0,0,0,0,0,0,0,0,158,0,4223,0,92,0,1,0,65,0,4381,0,0,0,0,0,0,0,14,4,0,328
Madison,7/2/20,0,0,0,0,0,0,0,0,0,197,0,1783,0,157,0,0,0,40,0,1980,0,0,0,0,0,0,0,3,7,0,31
Marion,7/2/20,0,0,0,0,0,0,0,0,0,11,0,708,0,3,0,0,0,8,0,719,0,0,0,0,0,0,0,5,-1,0,40
Miller,7/2/20,0,0,0,0,0,0,0,0,0,122,0,2031,0,98,0,2,0,22,0,2153,0,0,0,0,0,0,0,4,1,0,41
MissingCountyInfo,7/2/20,0,0,0,0,0,0,0,0,0,737,0,52271,0,420,0,0,0,317,0,53008,0,0,0,0,0,0,0,31,116,0,957
Mississippi,7/2/20,0,0,0,0,0,0,0,0,0,185,0,3688,0,121,0,3,0,61,0,3873,0,0,0,0,0,0,0,5,6,0,88
Monroe,7/2/20,0,0,0,0,0,0,0,0,0,15,0,687,0,7,0,0,0,8,0,702,0,0,0,0,0,0,0,2,0,0,15
Montgomery,7/2/20,0,0,0,0,0,0,0,0,0,5,0,584,0,3,0,0,0,2,0,589,0,0,0,0,0,0,0,0,0,0,22
Nevada,7/2/20,0,0,0,0,0,0,0,0,0,104,0,1168,0,77,0,3,0,24,0,1272,0,0,0,0,0,0,0,2,0,0,5
Newton,7/2/20,0,0,0,0,0,0,0,0,0,6,0,472,0,5,0,0,0,1,0,478,0,0,0,0,0,0,0,0,1,0,15
Ouachita,7/2/20,0,0,0,0,0,0,0,0,0,20,0,1637,0,18,0,0,0,2,0,1657,0,0,0,0,0,0,0,0,0,0,11
Perry,7/2/20,0,0,0,0,0,0,0,0,0,33,0,780,0,25,0,0,0,8,0,813,0,0,0,0,0,0,0,1,2,0,10
Phillips,7/2/20,0,0,0,0,0,0,0,0,0,149,0,2198,0,90,0,3,0,56,0,2347,0,0,0,0,0,0,0,6,9,0,75
Pike,7/2/20,0,0,0,0,0,0,0,0,0,9,0,1749,0,7,0,0,0,2,0,1758,0,0,0,0,0,0,0,2,0,0,23
Poinsett,7/2/20,0,0,0,0,0,0,0,0,0,61,0,1646,0,51,0,3,0,7,0,1707,0,0,0,0,0,0,0,2,0,0,20
Polk,7/2/20,0,0,0,0,0,0,0,0,0,75,0,1465,0,66,0,0,0,9,0,1540,0,0,0,0,0,0,0,0,3,0,25
Pope,7/2/20,0,0,0,0,0,0,0,0,0,451,0,5452,0,338,0,3,0,110,0,5903,0,0,0,0,0,0,0,9,5,0,93
Prairie,7/2/20,0,0,0,0,0,0,0,0,0,21,0,512,0,14,0,0,0,7,0,533,0,0,0,0,0,0,0,0,2,0,27
Pulaski,7/2/20,0,0,0,0,0,0,0,0,0,2183,0,33518,0,1477,0,59,0,647,0,35701,0,0,0,0,0,0,0,103,60,0,1210
Randolph,7/2/20,0,0,0,0,0,0,0,0,0,53,0,1934,0,38,0,1,0,14,0,1987,0,0,0,0,0,0,0,3,1,0,30
Saline,7/2/20,0,0,0,0,0,0,0,0,0,311,0,8958,0,217,0,2,0,92,0,9269,0,0,0,0,0,0,0,19,8,0,202
Scott,7/2/20,0,0,0,0,0,0,0,0,0,12,0,506,0,7,0,0,0,5,0,518,0,0,0,0,0,0,0,0,1,0,14
Searcy,7/2/20,0,0,0,0,0,0,0,0,0,7,0,805,0,7,0,0,0,0,0,812,0,0,0,0,0,0,0,0,0,0,22
Sebastian,7/2/20,0,0,0,0,0,0,0,0,0,533,0,9287,0,271,0,5,0,257,0,9820,0,0,0,0,0,0,0,57,23,0,735
Sevier,7/2/20,0,0,0,0,0,0,0,0,0,717,0,3410,0,586,0,7,0,124,0,4127,0,0,0,0,0,0,0,11,21,0,62
Sharp,7/2/20,0,0,0,0,0,0,0,0,0,54,0,911,0,42,0,5,0,7,0,965,0,0,0,0,0,0,0,1,0,0,20
St.Francis,7/2/20,0,0,0,0,0,0,0,0,0,818,0,4320,0,791,0,3,0,24,0,5138,0,0,0,0,0,0,0,4,3,0,38
Stone,7/2/20,0,0,0,0,0,0,0,0,0,17,0,801,0,12,0,0,0,5,0,818,0,0,0,0,0,0,0,3,0,0,30
Union,7/2/20,0,0,0,0,0,0,0,0,0,250,0,3043,0,211,0,13,0,26,0,3293,0,0,0,0,0,0,0,1,3,0,14
VanBuren,7/2/20,0,0,0,0,0,0,0,0,0,33,0,1014,0,28,0,2,0,3,0,1047,0,0,0,0,0,0,0,0,0,0,28
Washington,7/2/20,0,0,0,0,0,0,0,0,0,3766,0,12988,0,2541,0,31,0,1194,0,16754,0,0,0,0,0,0,0,132,124,1,424
White,7/2/20,0,0,0,0,0,0,0,0,0,92,0,3827,0,72,0,1,0,19,0,3919,0,0,0,0,0,0,0,5,2,0,181
Woodruff,7/2/20,0,0,0,0,0,0,0,0,0,7,0,554,0,5,0,0,0,2,0,561,0,0,0,0,0,0,0,1,0,0,65
Yell,7/2/20,0,0,0,0,0,0,0,0,0,658,0,2077,0,433,0,3,0,222,0,2735,0,0,0,0,0,0,0,14,14,0,73
Arkansas_all_counties,7/1/20,0,0,0,0,0,0,0,0,2990671,21197,0,293661,0,15163,0,277,0,5757,0,314858,0,0,0,0,0,0,0,420,632,7,8741
Arkansas_county,7/1/20,0,0,0,0,0,0,0,0,0,31,0,1412,0,20,0,0,0,11,0,1443,0,0,0,0,0,0,0,3,1,0,47
Ashley,7/1/20,0,0,0,0,0,0,0,0,0,74,0,1402,0,54,0,1,0,19,0,1476,0,0,0,0,0,0,0,3,3,0,8
Baxter,7/1/20,0,0,0,0,0,0,0,0,0,20,0,1879,0,15,0,0,0,5,0,1899,0,0,0,0,0,0,0,0,0,0,8
Benton,7/1/20,0,0,0,0,0,0,0,0,0,2752,0,32795,0,2059,0,19,0,674,0,35547,0,0,0,0,0,0,0,29,131,1,236
Boone,7/1/20,0,0,0,0,0,0,0,0,0,27,0,1843,0,12,0,1,0,14,0,1870,0,0,0,0,0,0,0,1,0,0,13
Bradley,7/1/20,0,0,0,0,0,0,0,0,0,52,0,1077,0,32,0,2,0,18,0,1129,0,0,0,0,0,0,0,0,0,0,7
Calhoun,7/1/20,0,0,0,0,0,0,0,0,0,0,0,240,0,0,0,0,0,0,0,240,0,0,0,0,0,0,0,0,0,0,4
Carroll,7/1/20,0,0,0,0,0,0,0,0,0,168,0,2727,0,118,0,5,0,45,0,2895,0,0,0,0,0,0,0,0,10,0,5
Chicot,7/1/20,0,0,0,0,0,0,0,0,0,139,0,1272,0,84,0,3,0,52,0,1411,0,0,0,0,0,0,0,5,5,0,7
Clark,7/1/20,0,0,0,0,0,0,0,0,0,57,0,1876,0,52,0,0,0,5,0,1933,0,0,0,0,0,0,0,1,1,0,11
Clay,7/1/20,0,0,0,0,0,0,0,0,0,59,0,1524,0,35,0,3,0,21,0,1583,0,0,0,0,0,0,0,5,3,0,21
Cleburne,7/1/20,0,0,0,0,0,0,0,0,0,92,0,1741,0,71,0,4,0,17,0,1833,0,0,0,0,0,0,0,7,1,0,37
Cleveland,7/1/20,0,0,0,0,0,0,0,0,0,26,0,697,0,24,0,0,0,2,0,723,0,0,0,0,0,0,0,1,0,0,5
Columbia,7/1/20,0,0,0,0,0,0,0,0,0,84,0,1222,0,30,0,4,0,50,0,1306,0,0,0,0,0,0,0,1,1,1,16
Conway,7/1/20,0,0,0,0,0,0,0,0,0,60,0,1384,0,31,0,3,0,26,0,1444,0,0,0,0,0,0,0,5,0,0,42
Craighead,7/1/20,0,0,0,0,0,0,0,0,0,453,0,10724,0,395,0,7,0,51,0,11177,0,0,0,0,0,0,0,2,9,1,144
Crawford,7/1/20,0,0,0,0,0,0,0,0,0,166,0,3886,0,98,0,1,0,67,0,4052,0,0,0,0,0,0,0,7,10,0,39
Crittenden,7/1/20,0,0,0,0,0,0,0,0,0,749,0,5623,0,573,0,13,0,163,0,6372,0,0,0,0,0,0,0,3,9,1,40
Cross,7/1/20,0,0,0,0,0,0,0,0,0,86,0,1411,0,78,0,1,0,7,0,1497,0,0,0,0,0,0,0,1,0,0,8
Dallas,7/1/20,0,0,0,0,0,0,0,0,0,10,0,419,0,5,0,0,0,5,0,429,0,0,0,0,0,0,0,0,0,0,13
Desha,7/1/20,0,0,0,0,0,0,0,0,0,47,0,951,0,30,0,1,0,16,0,998,0,0,0,0,0,0,0,0,0,0,12
Drew,7/1/20,0,0,0,0,0,0,0,0,0,65,0,1479,0,34,0,2,0,29,0,1544,0,0,0,0,0,0,0,0,2,1,4
Faulkner,7/1/20,0,0,0,0,0,0,0,0,0,492,0,9249,0,266,0,3,0,223,0,9741,0,0,0,0,0,0,0,15,22,0,202
Franklin,7/1/20,0,0,0,0,0,0,0,0,0,21,0,1167,0,12,0,0,0,9,0,1188,0,0,0,0,0,0,0,0,0,0,9
Fulton,7/1/20,0,0,0,0,0,0,0,0,0,15,0,760,0,9,0,0,0,6,0,775,0,0,0,0,0,0,0,3,0,0,11
Garland,7/1/20,0,0,0,0,0,0,0,0,0,253,0,7126,0,177,0,1,0,75,0,7379,0,0,0,0,0,0,0,5,3,0,46
Grant,7/1/20,0,0,0,0,0,0,0,0,0,41,0,1147,0,28,0,0,0,13,0,1188,0,0,0,0,0,0,0,1,0,0,22
Greene,7/1/20,0,0,0,0,0,0,0,0,0,119,0,3934,0,91,0,0,0,28,0,4053,0,0,0,0,0,0,0,5,2,0,38
Hempstead,7/1/20,0,0,0,0,0,0,0,0,0,50,0,1624,0,43,0,1,0,6,0,1674,0,0,0,0,0,0,0,0,-1,0,25
HotSpring,7/1/20,0,0,0,0,0,0,0,0,0,429,0,3457,0,53,0,0,0,376,0,3886,0,0,0,0,0,0,0,3,1,0,23
Howard,7/1/20,0,0,0,0,0,0,0,0,0,94,0,1233,0,62,0,1,0,31,0,1327,0,0,0,0,0,0,0,5,1,0,32
Independence,7/1/20,0,0,0,0,0,0,0,0,0,55,0,2719,0,46,0,0,0,9,0,2774,0,0,0,0,0,0,0,0,1,0,7
Izard,7/1/20,0,0,0,0,0,0,0,0,0,23,0,658,0,19,0,1,0,3,0,681,0,0,0,0,0,0,0,3,0,0,18
Jackson,7/1/20,0,0,0,0,0,0,0,0,0,27,0,1033,0,23,0,0,0,4,0,1060,0,0,0,0,0,0,0,0,4,0,7
Jefferson,7/1/20,0,0,0,0,0,0,0,0,0,706,0,5941,0,607,0,28,0,71,0,6647,0,0,0,0,0,0,0,6,6,0,49
Johnson,7/1/20,0,0,0,0,0,0,0,0,0,236,0,1410,0,156,0,0,0,80,0,1646,0,0,0,0,0,0,0,9,13,0,68
Lafayette,7/1/20,0,0,0,0,0,0,0,0,0,19,0,336,0,14,0,1,0,4,0,355,0,0,0,0,0,0,0,1,0,0,5
Lawrence,7/1/20,0,0,0,0,0,0,0,0,0,100,0,1504,0,80,0,9,0,11,0,1604,0,0,0,0,0,0,0,1,1,0,7
Lee,7/1/20,0,0,0,0,0,0,0,0,0,746,0,1895,0,576,0,2,0,168,0,2641,0,0,0,0,0,0,0,95,14,0,66
Lincoln,7/1/20,0,0,0,0,0,0,0,0,0,1040,0,1738,0,973,0,11,0,56,0,2778,0,0,0,0,0,0,0,2,0,0,5
LittleRiver,7/1/20,0,0,0,0,0,0,0,0,0,38,0,846,0,38,0,0,0,0,0,884,0,0,0,0,0,0,0,0,1,0,5
Logan,7/1/20,0,0,0,0,0,0,0,0,0,46,0,1809,0,29,0,0,0,17,0,1855,0,0,0,0,0,0,0,0,1,0,22
Lonoke,7/1/20,0,0,0,0,0,0,0,0,0,144,0,3909,0,88,0,1,0,55,0,4053,0,0,0,0,0,0,0,6,2,0,71
Madison,7/1/20,0,0,0,0,0,0,0,0,0,194,0,1755,0,150,0,0,0,44,0,1949,0,0,0,0,0,0,0,2,4,0,13
Marion,7/1/20,0,0,0,0,0,0,0,0,0,6,0,673,0,4,0,0,0,2,0,679,0,0,0,0,0,0,0,0,0,0,16
Miller,7/1/20,0,0,0,0,0,0,0,0,0,118,0,1994,0,97,0,2,0,19,0,2112,0,0,0,0,0,0,0,4,2,0,34
MissingCountyInfo,7/1/20,0,0,0,0,0,0,0,0,0,706,0,51345,0,304,0,0,0,402,0,52051,0,0,0,0,0,0,0,-15,-8,0,354
Mississippi,7/1/20,0,0,0,0,0,0,0,0,0,180,0,3605,0,115,0,3,0,62,0,3785,0,0,0,0,0,0,0,12,3,0,30
Monroe,7/1/20,0,0,0,0,0,0,0,0,0,13,0,674,0,7,0,0,0,6,0,687,0,0,0,0,0,0,0,1,0,0,7
Montgomery,7/1/20,0,0,0,0,0,0,0,0,0,5,0,562,0,3,0,0,0,2,0,567,0,0,0,0,0,0,0,1,0,0,7
Nevada,7/1/20,0,0,0,0,0,0,0,0,0,102,0,1165,0,77,0,3,0,22,0,1267,0,0,0,0,0,0,0,1,4,0,3
Newton,7/1/20,0,0,0,0,0,0,0,0,0,6,0,457,0,4,0,0,0,2,0,463,0,0,0,0,0,0,0,1,0,0,4
Ouachita,7/1/20,0,0,0,0,0,0,0,0,0,20,0,1626,0,18,0,0,0,2,0,1646,0,0,0,0,0,0,0,0,1,0,19
Perry,7/1/20,0,0,0,0,0,0,0,0,0,32,0,771,0,23,0,0,0,9,0,803,0,0,0,0,0,0,0,3,2,0,17
Phillips,7/1/20,0,0,0,0,0,0,0,0,0,143,0,2129,0,81,0,3,0,59,0,2272,0,0,0,0,0,0,0,1,8,0,11
Pike,7/1/20,0,0,0,0,0,0,0,0,0,7,0,1728,0,7,0,0,0,0,0,1735,0,0,0,0,0,0,0,-1,0,0,49
Poinsett,7/1/20,0,0,0,0,0,0,0,0,0,59,0,1628,0,51,0,3,0,5,0,1687,0,0,0,0,0,0,0,1,1,0,24
Polk,7/1/20,0,0,0,0,0,0,0,0,0,75,0,1440,0,63,0,0,0,12,0,1515,0,0,0,0,0,0,0,1,0,0,8
Pope,7/1/20,0,0,0,0,0,0,0,0,0,442,0,5368,0,333,0,3,0,106,0,5810,0,0,0,0,0,0,0,9,10,0,112
Prairie,7/1/20,0,0,0,0,0,0,0,0,0,21,0,485,0,12,0,0,0,9,0,506,0,0,0,0,0,0,0,1,1,0,12
Pulaski,7/1/20,0,0,0,0,0,0,0,0,0,2080,0,32411,0,1417,0,59,0,604,0,34491,0,0,0,0,0,0,0,44,43,1,771
Randolph,7/1/20,0,0,0,0,0,0,0,0,0,50,0,1907,0,37,0,1,0,12,0,1957,0,0,0,0,0,0,0,2,1,0,15
Saline,7/1/20,0,0,0,0,0,0,0,0,0,292,0,8775,0,209,0,2,0,81,0,9067,0,0,0,0,0,0,0,17,3,0,165
Scott,7/1/20,0,0,0,0,0,0,0,0,0,12,0,492,0,6,0,0,0,6,0,504,0,0,0,0,0,0,0,1,0,0,11
Searcy,7/1/20,0,0,0,0,0,0,0,0,0,7,0,783,0,7,0,0,0,0,0,790,0,0,0,0,0,0,0,0,0,0,2
Sebastian,7/1/20,0,0,0,0,0,0,0,0,0,476,0,8609,0,248,0,5,0,223,0,9085,0,0,0,0,0,0,0,8,17,0,89
Sevier,7/1/20,0,0,0,0,0,0,0,0,0,706,0,3359,0,565,0,7,0,134,0,4065,0,0,0,0,0,0,0,6,24,0,37
Sharp,7/1/20,0,0,0,0,0,0,0,0,0,53,0,892,0,42,0,5,0,6,0,945,0,0,0,0,0,0,0,0,-1,1,5
St.Francis,7/1/20,0,0,0,0,0,0,0,0,0,814,0,4286,0,788,0,3,0,23,0,5100,0,0,0,0,0,0,0,2,1,0,8
Stone,7/1/20,0,0,0,0,0,0,0,0,0,14,0,774,0,12,0,0,0,2,0,788,0,0,0,0,0,0,0,0,0,0,2
Union,7/1/20,0,0,0,0,0,0,0,0,0,249,0,3030,0,208,0,13,0,28,0,3279,0,0,0,0,0,0,0,1,7,0,23
VanBuren,7/1/20,0,0,0,0,0,0,0,0,0,33,0,986,0,28,0,2,0,3,0,1019,0,0,0,0,0,0,0,-2,0,0,8
Washington,7/1/20,0,0,0,0,0,0,0,0,0,3634,0,12696,0,2417,0,30,0,1187,0,16330,0,0,0,0,0,0,0,56,123,0,185
White,7/1/20,0,0,0,0,0,0,0,0,0,87,0,3651,0,70,0,1,0,16,0,3738,0,0,0,0,0,0,0,1,2,0,23
Woodruff,7/1/20,0,0,0,0,0,0,0,0,0,6,0,490,0,5,0,0,0,1,0,496,0,0,0,0,0,0,0,0,0,0,7
Yell,7/1/20,0,0,0,0,0,0,0,0,0,644,0,2018,0,419,0,3,0,222,0,2662,0,0,0,0,0,0,0,28,29,0,101
Arkansas_all_counties,6/30/20,0,0,0,0,0,0,0,0,2990671,20777,0,290426,0,14531,0,270,0,5976,0,311203,0,0,0,0,0,0,0,520,465,5,8667
Arkansas_county,6/30/20,0,0,0,0,0,0,0,0,0,28,0,1368,0,19,0,0,0,9,0,1396,0,0,0,0,0,0,0,0,1,0,16
Ashley,6/30/20,0,0,0,0,0,0,0,0,0,71,0,1397,0,51,0,1,0,19,0,1468,0,0,0,0,0,0,0,1,0,0,14
Baxter,6/30/20,0,0,0,0,0,0,0,0,0,20,0,1871,0,15,0,0,0,5,0,1891,0,0,0,0,0,0,0,0,1,0,251
Benton,6/30/20,0,0,0,0,0,0,0,0,0,2723,0,32588,0,1928,0,18,0,777,0,35311,0,0,0,0,0,0,0,44,93,0,708
Boone,6/30/20,0,0,0,0,0,0,0,0,0,26,0,1831,0,12,0,1,0,13,0,1857,0,0,0,0,0,0,0,4,1,0,26
Bradley,6/30/20,0,0,0,0,0,0,0,0,0,52,0,1070,0,32,0,2,0,18,0,1122,0,0,0,0,0,0,0,1,0,0,31
Calhoun,6/30/20,0,0,0,0,0,0,0,0,0,0,0,236,0,0,0,0,0,0,0,236,0,0,0,0,0,0,0,0,0,0,2
Carroll,6/30/20,0,0,0,0,0,0,0,0,0,168,0,2722,0,108,0,5,0,55,0,2890,0,0,0,0,0,0,0,-1,9,0,25
Chicot,6/30/20,0,0,0,0,0,0,0,0,0,134,0,1270,0,79,0,3,0,52,0,1404,0,0,0,0,0,0,0,5,3,0,75
Clark,6/30/20,0,0,0,0,0,0,0,0,0,56,0,1866,0,51,0,0,0,5,0,1922,0,0,0,0,0,0,0,0,1,0,35
Clay,6/30/20,0,0,0,0,0,0,0,0,0,54,0,1508,0,32,0,3,0,19,0,1562,0,0,0,0,0,0,0,0,5,0,14
Cleburne,6/30/20,0,0,0,0,0,0,0,0,0,85,0,1711,0,70,0,4,0,11,0,1796,0,0,0,0,0,0,0,0,0,0,61
Cleveland,6/30/20,0,0,0,0,0,0,0,0,0,25,0,693,0,24,0,0,0,1,0,718,0,0,0,0,0,0,0,0,1,0,31
Columbia,6/30/20,0,0,0,0,0,0,0,0,0,83,0,1207,0,29,0,3,0,51,0,1290,0,0,0,0,0,0,0,-1,0,0,7
Conway,6/30/20,0,0,0,0,0,0,0,0,0,55,0,1347,0,31,0,3,0,21,0,1402,0,0,0,0,0,0,0,7,2,0,125
Craighead,6/30/20,0,0,0,0,0,0,0,0,0,451,0,10582,0,386,0,6,0,59,0,11033,0,0,0,0,0,0,0,4,8,0,138
Crawford,6/30/20,0,0,0,0,0,0,0,0,0,159,0,3854,0,88,0,1,0,70,0,4013,0,0,0,0,0,0,0,4,7,1,88
Crittenden,6/30/20,0,0,0,0,0,0,0,0,0,746,0,5586,0,564,0,12,0,170,0,6332,0,0,0,0,0,0,0,9,8,1,89
Cross,6/30/20,0,0,0,0,0,0,0,0,0,85,0,1404,0,78,0,1,0,6,0,1489,0,0,0,0,0,0,0,0,1,0,11
Dallas,6/30/20,0,0,0,0,0,0,0,0,0,10,0,406,0,5,0,0,0,5,0,416,0,0,0,0,0,0,0,0,0,0,9
Desha,6/30/20,0,0,0,0,0,0,0,0,0,47,0,939,0,30,0,1,0,16,0,986,0,0,0,0,0,0,0,2,1,1,15
Drew,6/30/20,0,0,0,0,0,0,0,0,0,65,0,1475,0,32,0,1,0,32,0,1540,0,0,0,0,0,0,0,1,2,0,31
Faulkner,6/30/20,0,0,0,0,0,0,0,0,0,477,0,9062,0,244,0,3,0,230,0,9539,0,0,0,0,0,0,0,24,16,0,234
Franklin,6/30/20,0,0,0,0,0,0,0,0,0,21,0,1158,0,12,0,0,0,9,0,1179,0,0,0,0,0,0,0,3,0,0,120
Fulton,6/30/20,0,0,0,0,0,0,0,0,0,12,0,752,0,9,0,0,0,3,0,764,0,0,0,0,0,0,0,0,0,0,4
Garland,6/30/20,0,0,0,0,0,0,0,0,0,248,0,7085,0,174,0,1,0,73,0,7333,0,0,0,0,0,0,0,8,2,0,767
Grant,6/30/20,0,0,0,0,0,0,0,0,0,40,0,1126,0,28,0,0,0,12,0,1166,0,0,0,0,0,0,0,0,1,0,35
Greene,6/30/20,0,0,0,0,0,0,0,0,0,114,0,3901,0,89,0,0,0,25,0,4015,0,0,0,0,0,0,0,0,0,0,25
Hempstead,6/30/20,0,0,0,0,0,0,0,0,0,50,0,1599,0,44,0,1,0,5,0,1649,0,0,0,0,0,0,0,0,2,0,21
HotSpring,6/30/20,0,0,0,0,0,0,0,0,0,426,0,3437,0,52,0,0,0,374,0,3863,0,0,0,0,0,0,0,-2,1,0,132
Howard,6/30/20,0,0,0,0,0,0,0,0,0,89,0,1206,0,61,0,1,0,27,0,1295,0,0,0,0,0,0,0,3,7,0,76
Independence,6/30/20,0,0,0,0,0,0,0,0,0,55,0,2712,0,45,0,0,0,10,0,2767,0,0,0,0,0,0,0,0,1,0,17
Izard,6/30/20,0,0,0,0,0,0,0,0,0,20,0,643,0,19,0,1,0,0,0,663,0,0,0,0,0,0,0,0,0,0,3
Jackson,6/30/20,0,0,0,0,0,0,0,0,0,27,0,1026,0,19,0,0,0,8,0,1053,0,0,0,0,0,0,0,0,1,0,19
Jefferson,6/30/20,0,0,0,0,0,0,0,0,0,700,0,5898,0,601,0,28,0,71,0,6598,0,0,0,0,0,0,0,7,1,0,368
Johnson,6/30/20,0,0,0,0,0,0,0,0,0,227,0,1351,0,143,0,0,0,84,0,1578,0,0,0,0,0,0,0,16,5,0,79
Lafayette,6/30/20,0,0,0,0,0,0,0,0,0,18,0,332,0,14,0,1,0,3,0,350,0,0,0,0,0,0,0,2,0,0,6
Lawrence,6/30/20,0,0,0,0,0,0,0,0,0,99,0,1498,0,79,0,9,0,11,0,1597,0,0,0,0,0,0,0,0,0,0,13
Lee,6/30/20,0,0,0,0,0,0,0,0,0,651,0,1924,0,562,0,2,0,87,0,2575,0,0,0,0,0,0,0,10,27,0,29
Lincoln,6/30/20,0,0,0,0,0,0,0,0,0,1038,0,1735,0,973,0,11,0,54,0,2773,0,0,0,0,0,0,0,0,0,0,12
LittleRiver,6/30/20,0,0,0,0,0,0,0,0,0,38,0,841,0,37,0,0,0,1,0,879,0,0,0,0,0,0,0,0,0,0,17
Logan,6/30/20,0,0,0,0,0,0,0,0,0,46,0,1787,0,28,0,0,0,18,0,1833,0,0,0,0,0,0,0,1,3,0,51
Lonoke,6/30/20,0,0,0,0,0,0,0,0,0,138,0,3844,0,86,0,1,0,51,0,3982,0,0,0,0,0,0,0,4,3,0,253
Madison,6/30/20,0,0,0,0,0,0,0,0,0,192,0,1744,0,146,0,0,0,46,0,1936,0,0,0,0,0,0,0,2,8,0,15
Marion,6/30/20,0,0,0,0,0,0,0,0,0,6,0,657,0,4,0,0,0,2,0,663,0,0,0,0,0,0,0,2,2,0,23
Miller,6/30/20,0,0,0,0,0,0,0,0,0,114,0,1964,0,95,0,2,0,17,0,2078,0,0,0,0,0,0,0,0,1,0,32
MissingCountyInfo,6/30/20,0,0,0,0,0,0,0,0,0,721,0,50976,0,312,0,0,0,409,0,51697,0,0,0,0,0,0,0,-10,7,0,682
Mississippi,6/30/20,0,0,0,0,0,0,0,0,0,168,0,3587,0,112,0,3,0,53,0,3755,0,0,0,0,0,0,0,7,5,0,55
Monroe,6/30/20,0,0,0,0,0,0,0,0,0,12,0,668,0,7,0,0,0,5,0,680,0,0,0,0,0,0,0,0,0,0,8
Montgomery,6/30/20,0,0,0,0,0,0,0,0,0,4,0,556,0,3,0,0,0,1,0,560,0,0,0,0,0,0,0,0,1,0,182
Nevada,6/30/20,0,0,0,0,0,0,0,0,0,101,0,1163,0,73,0,3,0,25,0,1264,0,0,0,0,0,0,0,0,0,1,2
Newton,6/30/20,0,0,0,0,0,0,0,0,0,5,0,454,0,4,0,0,0,1,0,459,0,0,0,0,0,0,0,0,0,0,44
Ouachita,6/30/20,0,0,0,0,0,0,0,0,0,20,0,1607,0,17,0,0,0,3,0,1627,0,0,0,0,0,0,0,0,0,0,13
Perry,6/30/20,0,0,0,0,0,0,0,0,0,29,0,757,0,21,0,0,0,8,0,786,0,0,0,0,0,0,0,0,1,0,21
Phillips,6/30/20,0,0,0,0,0,0,0,0,0,142,0,2119,0,73,0,3,0,66,0,2261,0,0,0,0,0,0,0,2,0,0,70
Pike,6/30/20,0,0,0,0,0,0,0,0,0,8,0,1678,0,7,0,0,0,1,0,1686,0,0,0,0,0,0,0,0,0,0,39
Poinsett,6/30/20,0,0,0,0,0,0,0,0,0,58,0,1605,0,50,0,3,0,5,0,1663,0,0,0,0,0,0,0,1,1,0,19
Polk,6/30/20,0,0,0,0,0,0,0,0,0,74,0,1433,0,63,0,0,0,11,0,1507,0,0,0,0,0,0,0,0,3,0,31
Pope,6/30/20,0,0,0,0,0,0,0,0,0,433,0,5265,0,323,0,3,0,107,0,5698,0,0,0,0,0,0,0,17,11,0,532
Prairie,6/30/20,0,0,0,0,0,0,0,0,0,20,0,474,0,11,0,0,0,9,0,494,0,0,0,0,0,0,0,0,2,0,28
Pulaski,6/30/20,0,0,0,0,0,0,0,0,0,2036,0,31684,0,1374,0,58,0,604,0,33720,0,0,0,0,0,0,0,120,58,1,1122
Randolph,6/30/20,0,0,0,0,0,0,0,0,0,48,0,1894,0,36,0,1,0,11,0,1942,0,0,0,0,0,0,0,1,3,0,14
Saline,6/30/20,0,0,0,0,0,0,0,0,0,275,0,8627,0,206,0,2,0,67,0,8902,0,0,0,0,0,0,0,14,10,0,205
Scott,6/30/20,0,0,0,0,0,0,0,0,0,11,0,482,0,6,0,0,0,5,0,493,0,0,0,0,0,0,0,0,0,0,9
Searcy,6/30/20,0,0,0,0,0,0,0,0,0,7,0,781,0,7,0,0,0,0,0,788,0,0,0,0,0,0,0,0,0,0,44
Sebastian,6/30/20,0,0,0,0,0,0,0,0,0,468,0,8528,0,231,0,5,0,232,0,8996,0,0,0,0,0,0,0,11,16,0,381
Sevier,6/30/20,0,0,0,0,0,0,0,0,0,700,0,3328,0,541,0,7,0,152,0,4028,0,0,0,0,0,0,0,7,17,0,39
Sharp,6/30/20,0,0,0,0,0,0,0,0,0,53,0,887,0,43,0,4,0,6,0,940,0,0,0,0,0,0,0,0,0,0,5
St.Francis,6/30/20,0,0,0,0,0,0,0,0,0,812,0,4280,0,787,0,3,0,22,0,5092,0,0,0,0,0,0,0,1,2,0,75
Stone,6/30/20,0,0,0,0,0,0,0,0,0,14,0,772,0,12,0,0,0,2,0,786,0,0,0,0,0,0,0,0,0,0,6
Union,6/30/20,0,0,0,0,0,0,0,0,0,248,0,3008,0,201,0,13,0,34,0,3256,0,0,0,0,0,0,0,1,1,0,17
VanBuren,6/30/20,0,0,0,0,0,0,0,0,0,35,0,976,0,28,0,2,0,5,0,1011,0,0,0,0,0,0,0,1,0,0,59
Washington,6/30/20,0,0,0,0,0,0,0,0,0,3578,0,12567,0,2294,0,30,0,1254,0,16145,0,0,0,0,0,0,0,161,80,0,569
White,6/30/20,0,0,0,0,0,0,0,0,0,86,0,3629,0,68,0,1,0,17,0,3715,0,0,0,0,0,0,0,1,1,0,140
Woodruff,6/30/20,0,0,0,0,0,0,0,0,0,6,0,483,0,5,0,0,0,1,0,489,0,0,0,0,0,0,0,0,0,0,3
Yell,6/30/20,0,0,0,0,0,0,0,0,0,616,0,1945,0,390,0,3,0,223,0,2561,0,0,0,0,0,0,0,25,23,0,100
Arkansas_all_counties,6/29/20,0,0,0,0,0,0,0,0,2990671,20257,0,282279,0,14066,0,265,0,5926,0,302536,0,0,0,0,0,0,0,439,430,1,5432
Arkansas_county,6/29/20,0,0,0,0,0,0,0,0,0,28,0,1352,0,18,0,0,0,10,0,1380,0,0,0,0,0,0,0,2,0,0,32
Ashley,6/29/20,0,0,0,0,0,0,0,0,0,70,0,1384,0,51,0,1,0,18,0,1454,0,0,0,0,0,0,0,2,1,0,24
Baxter,6/29/20,0,0,0,0,0,0,0,0,0,20,0,1620,0,14,0,0,0,6,0,1640,0,0,0,0,0,0,0,0,0,0,2
Benton,6/29/20,0,0,0,0,0,0,0,0,0,2679,0,31924,0,1835,0,18,0,826,0,34603,0,0,0,0,0,0,0,56,76,0,597
Boone,6/29/20,0,0,0,0,0,0,0,0,0,22,0,1809,0,11,0,1,0,10,0,1831,0,0,0,0,0,0,0,0,0,0,26
Bradley,6/29/20,0,0,0,0,0,0,0,0,0,51,0,1040,0,32,0,2,0,17,0,1091,0,0,0,0,0,0,0,9,1,0,123
Calhoun,6/29/20,0,0,0,0,0,0,0,0,0,0,0,234,0,0,0,0,0,0,0,234,0,0,0,0,0,0,0,0,0,0,3
Carroll,6/29/20,0,0,0,0,0,0,0,0,0,169,0,2696,0,99,0,5,0,65,0,2865,0,0,0,0,0,0,0,3,5,0,73
Chicot,6/29/20,0,0,0,0,0,0,0,0,0,129,0,1200,0,76,0,3,0,50,0,1329,0,0,0,0,0,0,0,9,4,0,48
Clark,6/29/20,0,0,0,0,0,0,0,0,0,56,0,1831,0,50,0,0,0,6,0,1887,0,0,0,0,0,0,0,0,0,0,17
Clay,6/29/20,0,0,0,0,0,0,0,0,0,54,0,1494,0,27,0,3,0,24,0,1548,0,0,0,0,0,0,0,0,1,0,18
Cleburne,6/29/20,0,0,0,0,0,0,0,0,0,85,0,1650,0,70,0,4,0,11,0,1735,0,0,0,0,0,0,0,1,0,0,26
Cleveland,6/29/20,0,0,0,0,0,0,0,0,0,25,0,662,0,23,0,0,0,2,0,687,0,0,0,0,0,0,0,0,1,0,30
Columbia,6/29/20,0,0,0,0,0,0,0,0,0,84,0,1199,0,29,0,3,0,52,0,1283,0,0,0,0,0,0,0,0,1,0,22
Conway,6/29/20,0,0,0,0,0,0,0,0,0,48,0,1229,0,29,0,3,0,16,0,1277,0,0,0,0,0,0,0,1,3,0,10
Craighead,6/29/20,0,0,0,0,0,0,0,0,0,447,0,10448,0,378,0,6,0,63,0,10895,0,0,0,0,0,0,0,5,7,0,152
Crawford,6/29/20,0,0,0,0,0,0,0,0,0,155,0,3770,0,81,0,0,0,74,0,3925,0,0,0,0,0,0,0,7,6,0,96
Crittenden,6/29/20,0,0,0,0,0,0,0,0,0,737,0,5506,0,556,0,11,0,170,0,6243,0,0,0,0,0,0,0,6,9,0,53
Cross,6/29/20,0,0,0,0,0,0,0,0,0,85,0,1393,0,77,0,1,0,7,0,1478,0,0,0,0,0,0,0,0,1,0,13
Dallas,6/29/20,0,0,0,0,0,0,0,0,0,10,0,397,0,5,0,0,0,5,0,407,0,0,0,0,0,0,0,1,0,0,13
Desha,6/29/20,0,0,0,0,0,0,0,0,0,45,0,926,0,29,0,0,0,16,0,971,0,0,0,0,0,0,0,1,1,0,18
Drew,6/29/20,0,0,0,0,0,0,0,0,0,64,0,1445,0,30,0,1,0,33,0,1509,0,0,0,0,0,0,0,1,2,0,28
Faulkner,6/29/20,0,0,0,0,0,0,0,0,0,453,0,8852,0,228,0,3,0,222,0,9305,0,0,0,0,0,0,0,16,13,0,237
Franklin,6/29/20,0,0,0,0,0,0,0,0,0,18,0,1041,0,12,0,0,0,6,0,1059,0,0,0,0,0,0,0,1,2,0,68
Fulton,6/29/20,0,0,0,0,0,0,0,0,0,12,0,748,0,9,0,0,0,3,0,760,0,0,0,0,0,0,0,0,0,0,6
Garland,6/29/20,0,0,0,0,0,0,0,0,0,240,0,6326,0,172,0,1,0,67,0,6566,0,0,0,0,0,0,0,3,5,0,178
Grant,6/29/20,0,0,0,0,0,0,0,0,0,40,0,1091,0,27,0,0,0,13,0,1131,0,0,0,0,0,0,0,6,1,0,38
Greene,6/29/20,0,0,0,0,0,0,0,0,0,114,0,3876,0,89,0,0,0,25,0,3990,0,0,0,0,0,0,0,0,5,0,45
Hempstead,6/29/20,0,0,0,0,0,0,0,0,0,50,0,1578,0,42,0,1,0,7,0,1628,0,0,0,0,0,0,0,2,1,0,25
HotSpring,6/29/20,0,0,0,0,0,0,0,0,0,428,0,3303,0,51,0,0,0,377,0,3731,0,0,0,0,0,0,0,5,2,0,57
Howard,6/29/20,0,0,0,0,0,0,0,0,0,86,0,1133,0,54,0,1,0,31,0,1219,0,0,0,0,0,0,0,4,4,0,71
Independence,6/29/20,0,0,0,0,0,0,0,0,0,55,0,2695,0,44,0,0,0,11,0,2750,0,0,0,0,0,0,0,1,0,0,80
Izard,6/29/20,0,0,0,0,0,0,0,0,0,20,0,640,0,19,0,1,0,0,0,660,0,0,0,0,0,0,0,0,0,0,5
Jackson,6/29/20,0,0,0,0,0,0,0,0,0,27,0,1007,0,18,0,0,0,9,0,1034,0,0,0,0,0,0,0,0,1,0,58
Jefferson,6/29/20,0,0,0,0,0,0,0,0,0,693,0,5537,0,600,0,28,0,65,0,6230,0,0,0,0,0,0,0,10,5,0,105
Johnson,6/29/20,0,0,0,0,0,0,0,0,0,211,0,1288,0,138,0,0,0,73,0,1499,0,0,0,0,0,0,0,1,15,0,8
Lafayette,6/29/20,0,0,0,0,0,0,0,0,0,16,0,328,0,14,0,1,0,1,0,344,0,0,0,0,0,0,0,0,0,0,3
Lawrence,6/29/20,0,0,0,0,0,0,0,0,0,99,0,1485,0,79,0,9,0,11,0,1584,0,0,0,0,0,0,0,0,1,0,18
Lee,6/29/20,0,0,0,0,0,0,0,0,0,641,0,1905,0,535,0,2,0,104,0,2546,0,0,0,0,0,0,0,13,2,0,7
Lincoln,6/29/20,0,0,0,0,0,0,0,0,0,1038,0,1723,0,973,0,11,0,54,0,2761,0,0,0,0,0,0,0,1,0,0,95
LittleRiver,6/29/20,0,0,0,0,0,0,0,0,0,38,0,824,0,37,0,0,0,1,0,862,0,0,0,0,0,0,0,0,0,0,5
Logan,6/29/20,0,0,0,0,0,0,0,0,0,45,0,1737,0,25,0,0,0,20,0,1782,0,0,0,0,0,0,0,-1,2,0,26
Lonoke,6/29/20,0,0,0,0,0,0,0,0,0,134,0,3595,0,83,0,1,0,50,0,3729,0,0,0,0,0,0,0,2,4,0,72
Madison,6/29/20,0,0,0,0,0,0,0,0,0,190,0,1731,0,138,0,0,0,52,0,1921,0,0,0,0,0,0,0,2,6,0,14
Marion,6/29/20,0,0,0,0,0,0,0,0,0,4,0,636,0,2,0,0,0,2,0,640,0,0,0,0,0,0,0,0,0,0,3
Miller,6/29/20,0,0,0,0,0,0,0,0,0,114,0,1932,0,94,0,2,0,18,0,2046,0,0,0,0,0,0,0,3,2,0,67
MissingCountyInfo,6/29/20,0,0,0,0,0,0,0,0,0,731,0,50284,0,305,0,0,0,426,0,51015,0,0,0,0,0,0,0,19,15,0,701
Mississippi,6/29/20,0,0,0,0,0,0,0,0,0,161,0,3539,0,107,0,3,0,51,0,3700,0,0,0,0,0,0,0,4,4,0,44
Monroe,6/29/20,0,0,0,0,0,0,0,0,0,12,0,660,0,7,0,0,0,5,0,672,0,0,0,0,0,0,0,0,0,0,19
Montgomery,6/29/20,0,0,0,0,0,0,0,0,0,4,0,374,0,2,0,0,0,2,0,378,0,0,0,0,0,0,0,0,0,0,17
Nevada,6/29/20,0,0,0,0,0,0,0,0,0,101,0,1161,0,73,0,2,0,26,0,1262,0,0,0,0,0,0,0,0,0,0,5
Newton,6/29/20,0,0,0,0,0,0,0,0,0,5,0,410,0,4,0,0,0,1,0,415,0,0,0,0,0,0,0,0,0,0,4
Ouachita,6/29/20,0,0,0,0,0,0,0,0,0,20,0,1594,0,17,0,0,0,3,0,1614,0,0,0,0,0,0,0,-1,0,0,9
Perry,6/29/20,0,0,0,0,0,0,0,0,0,29,0,736,0,20,0,0,0,9,0,765,0,0,0,0,0,0,0,0,2,0,8
Phillips,6/29/20,0,0,0,0,0,0,0,0,0,140,0,2051,0,73,0,3,0,64,0,2191,0,0,0,0,0,0,0,8,4,0,38
Pike,6/29/20,0,0,0,0,0,0,0,0,0,8,0,1639,0,7,0,0,0,1,0,1647,0,0,0,0,0,0,0,0,0,0,19
Poinsett,6/29/20,0,0,0,0,0,0,0,0,0,57,0,1587,0,49,0,3,0,5,0,1644,0,0,0,0,0,0,0,0,0,0,11
Polk,6/29/20,0,0,0,0,0,0,0,0,0,74,0,1402,0,60,0,0,0,14,0,1476,0,0,0,0,0,0,0,2,0,0,34
Pope,6/29/20,0,0,0,0,0,0,0,0,0,416,0,4750,0,312,0,3,0,101,0,5166,0,0,0,0,0,0,0,2,4,0,46
Prairie,6/29/20,0,0,0,0,0,0,0,0,0,20,0,446,0,9,0,0,0,11,0,466,0,0,0,0,0,0,0,0,0,0,12
Pulaski,6/29/20,0,0,0,0,0,0,0,0,0,1916,0,30682,0,1316,0,57,0,543,0,32598,0,0,0,0,0,0,0,54,25,1,720
Randolph,6/29/20,0,0,0,0,0,0,0,0,0,47,0,1881,0,33,0,1,0,13,0,1928,0,0,0,0,0,0,0,1,1,0,22
Saline,6/29/20,0,0,0,0,0,0,0,0,0,261,0,8436,0,196,0,2,0,63,0,8697,0,0,0,0,0,0,0,11,4,0,112
Scott,6/29/20,0,0,0,0,0,0,0,0,0,11,0,473,0,6,0,0,0,5,0,484,0,0,0,0,0,0,0,1,0,0,9
Searcy,6/29/20,0,0,0,0,0,0,0,0,0,7,0,737,0,7,0,0,0,0,0,744,0,0,0,0,0,0,0,0,0,0,5
Sebastian,6/29/20,0,0,0,0,0,0,0,0,0,457,0,8158,0,215,0,5,0,237,0,8615,0,0,0,0,0,0,0,22,17,0,201
Sevier,6/29/20,0,0,0,0,0,0,0,0,0,693,0,3296,0,524,0,7,0,162,0,3989,0,0,0,0,0,0,0,32,30,0,71
Sharp,6/29/20,0,0,0,0,0,0,0,0,0,53,0,882,0,43,0,4,0,6,0,935,0,0,0,0,0,0,0,0,0,0,10
St.Francis,6/29/20,0,0,0,0,0,0,0,0,0,811,0,4206,0,785,0,3,0,23,0,5017,0,0,0,0,0,0,0,1,3,0,73
Stone,6/29/20,0,0,0,0,0,0,0,0,0,14,0,766,0,12,0,0,0,2,0,780,0,0,0,0,0,0,0,1,1,0,4
Union,6/29/20,0,0,0,0,0,0,0,0,0,247,0,2992,0,200,0,13,0,34,0,3239,0,0,0,0,0,0,0,2,4,0,29
VanBuren,6/29/20,0,0,0,0,0,0,0,0,0,34,0,918,0,28,0,2,0,4,0,952,0,0,0,0,0,0,0,0,0,0,13
Washington,6/29/20,0,0,0,0,0,0,0,0,0,3417,0,12159,0,2214,0,30,0,1173,0,15576,0,0,0,0,0,0,0,97,104,0,325
White,6/29/20,0,0,0,0,0,0,0,0,0,85,0,3490,0,67,0,1,0,17,0,3575,0,0,0,0,0,0,0,1,3,0,89
Woodruff,6/29/20,0,0,0,0,0,0,0,0,0,6,0,480,0,5,0,0,0,1,0,486,0,0,0,0,0,0,0,0,0,0,17
Yell,6/29/20,0,0,0,0,0,0,0,0,0,591,0,1870,0,367,0,3,0,221,0,2461,0,0,0,0,0,0,0,9,19,0,50
Arkansas_all_counties,6/28/20,0,0,0,0,0,0,0,0,2990671,19818,0,277286,0,13636,0,264,0,5918,0,297104,0,0,0,0,0,0,0,508,366,5,5882
Arkansas_county,6/28/20,0,0,0,0,0,0,0,0,0,26,0,1322,0,18,0,0,0,8,0,1348,0,0,0,0,0,0,0,0,0,0,28
Ashley,6/28/20,0,0,0,0,0,0,0,0,0,68,0,1362,0,50,0,1,0,17,0,1430,0,0,0,0,0,0,0,0,3,0,79
Baxter,6/28/20,0,0,0,0,0,0,0,0,0,20,0,1618,0,14,0,0,0,6,0,1638,0,0,0,0,0,0,0,2,0,0,22
Benton,6/28/20,0,0,0,0,0,0,0,0,0,2623,0,31383,0,1759,0,18,0,846,0,34006,0,0,0,0,0,0,0,50,71,0,471
Boone,6/28/20,0,0,0,0,0,0,0,0,0,22,0,1783,0,11,0,1,0,10,0,1805,0,0,0,0,0,0,0,0,2,0,35
Bradley,6/28/20,0,0,0,0,0,0,0,0,0,42,0,926,0,31,0,2,0,9,0,968,0,0,0,0,0,0,0,0,0,0,65
Calhoun,6/28/20,0,0,0,0,0,0,0,0,0,0,0,231,0,0,0,0,0,0,0,231,0,0,0,0,0,0,0,0,0,0,5
Carroll,6/28/20,0,0,0,0,0,0,0,0,0,166,0,2626,0,94,0,5,0,67,0,2792,0,0,0,0,0,0,0,5,3,0,76
Chicot,6/28/20,0,0,0,0,0,0,0,0,0,120,0,1161,0,72,0,3,0,45,0,1281,0,0,0,0,0,0,0,0,4,0,19
Clark,6/28/20,0,0,0,0,0,0,0,0,0,56,0,1814,0,50,0,0,0,6,0,1870,0,0,0,0,0,0,0,1,1,0,12
Clay,6/28/20,0,0,0,0,0,0,0,0,0,54,0,1476,0,26,0,3,0,25,0,1530,0,0,0,0,0,0,0,2,1,0,42
Cleburne,6/28/20,0,0,0,0,0,0,0,0,0,84,0,1625,0,70,0,4,0,10,0,1709,0,0,0,0,0,0,0,1,0,0,13
Cleveland,6/28/20,0,0,0,0,0,0,0,0,0,25,0,632,0,22,0,0,0,3,0,657,0,0,0,0,0,0,0,0,0,0,12
Columbia,6/28/20,0,0,0,0,0,0,0,0,0,84,0,1177,0,28,0,3,0,53,0,1261,0,0,0,0,0,0,0,10,0,0,50
Conway,6/28/20,0,0,0,0,0,0,0,0,0,47,0,1220,0,26,0,3,0,18,0,1267,0,0,0,0,0,0,0,3,1,0,23
Craighead,6/28/20,0,0,0,0,0,0,0,0,0,442,0,10301,0,371,0,6,0,65,0,10743,0,0,0,0,0,0,0,6,2,0,226
Crawford,6/28/20,0,0,0,0,0,0,0,0,0,148,0,3681,0,75,0,0,0,73,0,3829,0,0,0,0,0,0,0,13,6,0,278
Crittenden,6/28/20,0,0,0,0,0,0,0,0,0,731,0,5459,0,547,0,11,0,173,0,6190,0,0,0,0,0,0,0,35,8,0,67
Cross,6/28/20,0,0,0,0,0,0,0,0,0,85,0,1380,0,76,0,1,0,8,0,1465,0,0,0,0,0,0,0,0,0,0,13
Dallas,6/28/20,0,0,0,0,0,0,0,0,0,9,0,385,0,5,0,0,0,4,0,394,0,0,0,0,0,0,0,2,0,0,8
Desha,6/28/20,0,0,0,0,0,0,0,0,0,44,0,909,0,28,0,0,0,16,0,953,0,0,0,0,0,0,0,2,2,0,52
Drew,6/28/20,0,0,0,0,0,0,0,0,0,63,0,1418,0,28,0,1,0,34,0,1481,0,0,0,0,0,0,0,10,2,0,59
Faulkner,6/28/20,0,0,0,0,0,0,0,0,0,437,0,8631,0,215,0,3,0,219,0,9068,0,0,0,0,0,0,0,28,12,0,227
Franklin,6/28/20,0,0,0,0,0,0,0,0,0,17,0,974,0,10,0,0,0,7,0,991,0,0,0,0,0,0,0,1,0,0,84
Fulton,6/28/20,0,0,0,0,0,0,0,0,0,12,0,742,0,9,0,0,0,3,0,754,0,0,0,0,0,0,0,0,0,0,8
Garland,6/28/20,0,0,0,0,0,0,0,0,0,237,0,6151,0,167,0,1,0,69,0,6388,0,0,0,0,0,0,0,23,2,0,153
Grant,6/28/20,0,0,0,0,0,0,0,0,0,34,0,1059,0,26,0,0,0,8,0,1093,0,0,0,0,0,0,0,0,1,0,13
Greene,6/28/20,0,0,0,0,0,0,0,0,0,114,0,3831,0,84,0,0,0,30,0,3945,0,0,0,0,0,0,0,2,2,0,71
Hempstead,6/28/20,0,0,0,0,0,0,0,0,0,48,0,1555,0,41,0,1,0,6,0,1603,0,0,0,0,0,0,0,1,0,0,5
HotSpring,6/28/20,0,0,0,0,0,0,0,0,0,423,0,3251,0,49,0,0,0,374,0,3674,0,0,0,0,0,0,0,3,1,0,109
Howard,6/28/20,0,0,0,0,0,0,0,0,0,82,0,1066,0,50,0,1,0,31,0,1148,0,0,0,0,0,0,0,6,1,0,35
Independence,6/28/20,0,0,0,0,0,0,0,0,0,54,0,2616,0,44,0,0,0,10,0,2670,0,0,0,0,0,0,0,3,0,0,75
Izard,6/28/20,0,0,0,0,0,0,0,0,0,20,0,635,0,19,0,1,0,0,0,655,0,0,0,0,0,0,0,0,0,0,15
Jackson,6/28/20,0,0,0,0,0,0,0,0,0,27,0,949,0,17,0,0,0,10,0,976,0,0,0,0,0,0,0,1,0,0,26
Jefferson,6/28/20,0,0,0,0,0,0,0,0,0,683,0,5442,0,595,0,28,0,60,0,6125,0,0,0,0,0,0,0,3,6,0,53
Johnson,6/28/20,0,0,0,0,0,0,0,0,0,210,0,1281,0,123,0,0,0,87,0,1491,0,0,0,0,0,0,0,3,11,0,23
Lafayette,6/28/20,0,0,0,0,0,0,0,0,0,16,0,325,0,14,0,1,0,1,0,341,0,0,0,0,0,0,0,1,1,0,3
Lawrence,6/28/20,0,0,0,0,0,0,0,0,0,99,0,1467,0,78,0,9,0,12,0,1566,0,0,0,0,0,0,0,0,0,0,14
Lee,6/28/20,0,0,0,0,0,0,0,0,0,628,0,1911,0,533,0,2,0,93,0,2539,0,0,0,0,0,0,0,2,2,1,9
Lincoln,6/28/20,0,0,0,0,0,0,0,0,0,1037,0,1629,0,973,0,11,0,53,0,2666,0,0,0,0,0,0,0,1,1,0,23
LittleRiver,6/28/20,0,0,0,0,0,0,0,0,0,38,0,819,0,37,0,0,0,1,0,857,0,0,0,0,0,0,0,0,0,0,2
Logan,6/28/20,0,0,0,0,0,0,0,0,0,46,0,1710,0,23,0,0,0,23,0,1756,0,0,0,0,0,0,0,0,0,0,37
Lonoke,6/28/20,0,0,0,0,0,0,0,0,0,132,0,3525,0,79,0,1,0,52,0,3657,0,0,0,0,0,0,0,5,3,0,54
Madison,6/28/20,0,0,0,0,0,0,0,0,0,188,0,1719,0,132,0,0,0,56,0,1907,0,0,0,0,0,0,0,13,4,0,22
Marion,6/28/20,0,0,0,0,0,0,0,0,0,4,0,633,0,2,0,0,0,2,0,637,0,0,0,0,0,0,0,0,0,0,3
Miller,6/28/20,0,0,0,0,0,0,0,0,0,111,0,1868,0,92,0,2,0,17,0,1979,0,0,0,0,0,0,0,4,5,0,24
MissingCountyInfo,6/28/20,0,0,0,0,0,0,0,0,0,712,0,49602,0,290,0,0,0,422,0,50314,0,0,0,0,0,0,0,-21,15,0,429
Mississippi,6/28/20,0,0,0,0,0,0,0,0,0,157,0,3499,0,103,0,3,0,51,0,3656,0,0,0,0,0,0,0,8,4,0,54
Monroe,6/28/20,0,0,0,0,0,0,0,0,0,12,0,641,0,7,0,0,0,5,0,653,0,0,0,0,0,0,0,0,0,0,3
Montgomery,6/28/20,0,0,0,0,0,0,0,0,0,4,0,357,0,2,0,0,0,2,0,361,0,0,0,0,0,0,0,0,0,0,4
Nevada,6/28/20,0,0,0,0,0,0,0,0,0,101,0,1156,0,73,0,2,0,26,0,1257,0,0,0,0,0,0,0,0,0,0,5
Newton,6/28/20,0,0,0,0,0,0,0,0,0,5,0,406,0,4,0,0,0,1,0,411,0,0,0,0,0,0,0,0,1,0,9
Ouachita,6/28/20,0,0,0,0,0,0,0,0,0,21,0,1584,0,17,0,0,0,4,0,1605,0,0,0,0,0,0,0,2,0,0,12
Perry,6/28/20,0,0,0,0,0,0,0,0,0,29,0,728,0,18,0,0,0,11,0,757,0,0,0,0,0,0,0,2,2,0,10
Phillips,6/28/20,0,0,0,0,0,0,0,0,0,132,0,2021,0,69,0,3,0,60,0,2153,0,0,0,0,0,0,0,5,8,0,64
Pike,6/28/20,0,0,0,0,0,0,0,0,0,8,0,1620,0,7,0,0,0,1,0,1628,0,0,0,0,0,0,0,0,1,0,59
Poinsett,6/28/20,0,0,0,0,0,0,0,0,0,57,0,1576,0,49,0,3,0,5,0,1633,0,0,0,0,0,0,0,1,1,0,20
Polk,6/28/20,0,0,0,0,0,0,0,0,0,72,0,1370,0,60,0,0,0,12,0,1442,0,0,0,0,0,0,0,2,1,0,25
Pope,6/28/20,0,0,0,0,0,0,0,0,0,414,0,4706,0,308,0,3,0,103,0,5120,0,0,0,0,0,0,0,12,8,0,130
Prairie,6/28/20,0,0,0,0,0,0,0,0,0,20,0,434,0,9,0,0,0,11,0,454,0,0,0,0,0,0,0,0,0,0,10
Pulaski,6/28/20,0,0,0,0,0,0,0,0,0,1862,0,30016,0,1291,0,56,0,515,0,31878,0,0,0,0,0,0,0,52,18,0,563
Randolph,6/28/20,0,0,0,0,0,0,0,0,0,46,0,1860,0,32,0,1,0,13,0,1906,0,0,0,0,0,0,0,0,2,0,21
Saline,6/28/20,0,0,0,0,0,0,0,0,0,250,0,8335,0,192,0,2,0,56,0,8585,0,0,0,0,0,0,0,4,2,0,143
Scott,6/28/20,0,0,0,0,0,0,0,0,0,10,0,465,0,6,0,0,0,4,0,475,0,0,0,0,0,0,0,0,1,0,14
Searcy,6/28/20,0,0,0,0,0,0,0,0,0,7,0,732,0,7,0,0,0,0,0,739,0,0,0,0,0,0,0,0,0,0,6
Sebastian,6/28/20,0,0,0,0,0,0,0,0,0,435,0,7979,0,198,0,5,0,232,0,8414,0,0,0,0,0,0,0,57,9,1,817
Sevier,6/28/20,0,0,0,0,0,0,0,0,0,661,0,3257,0,494,0,7,0,160,0,3918,0,0,0,0,0,0,0,9,10,0,52
Sharp,6/28/20,0,0,0,0,0,0,0,0,0,53,0,872,0,43,0,4,0,6,0,925,0,0,0,0,0,0,0,0,0,0,5
St.Francis,6/28/20,0,0,0,0,0,0,0,0,0,810,0,4134,0,782,0,3,0,25,0,4944,0,0,0,0,0,0,0,1,2,0,15
Stone,6/28/20,0,0,0,0,0,0,0,0,0,13,0,763,0,11,0,0,0,2,0,776,0,0,0,0,0,0,0,0,0,0,18
Union,6/28/20,0,0,0,0,0,0,0,0,0,245,0,2965,0,196,0,13,0,36,0,3210,0,0,0,0,0,0,0,0,5,0,21
VanBuren,6/28/20,0,0,0,0,0,0,0,0,0,34,0,905,0,28,0,2,0,4,0,939,0,0,0,0,0,0,0,0,0,0,15
Washington,6/28/20,0,0,0,0,0,0,0,0,0,3320,0,11931,0,2110,0,30,0,1180,0,15251,0,0,0,0,0,0,0,82,108,3,260
White,6/28/20,0,0,0,0,0,0,0,0,0,84,0,3402,0,64,0,1,0,19,0,3486,0,0,0,0,0,0,0,2,2,0,36
Woodruff,6/28/20,0,0,0,0,0,0,0,0,0,6,0,463,0,5,0,0,0,1,0,469,0,0,0,0,0,0,0,0,0,0,4
Yell,6/28/20,0,0,0,0,0,0,0,0,0,582,0,1829,0,348,0,3,0,231,0,2411,0,0,0,0,0,0,0,48,8,0,215
Arkansas_all_counties,6/27/20,0,0,0,0,0,0,0,0,2990671,19310,0,271912,0,13270,0,259,0,5781,0,291222,0,0,0,0,0,0,0,570,486,10,8257
Arkansas_county,6/27/20,0,0,0,0,0,0,0,0,0,26,0,1294,0,18,0,0,0,8,0,1320,0,0,0,0,0,0,0,2,2,0,134
Ashley,6/27/20,0,0,0,0,0,0,0,0,0,68,0,1283,0,47,0,1,0,20,0,1351,0,0,0,0,0,0,0,0,1,0,27
Baxter,6/27/20,0,0,0,0,0,0,0,0,0,18,0,1598,0,14,0,0,0,4,0,1616,0,0,0,0,0,0,0,0,0,0,18
Benton,6/27/20,0,0,0,0,0,0,0,0,0,2573,0,30962,0,1688,0,18,0,867,0,33535,0,0,0,0,0,0,0,119,87,3,857
Boone,6/27/20,0,0,0,0,0,0,0,0,0,22,0,1748,0,9,0,1,0,12,0,1770,0,0,0,0,0,0,0,0,2,0,33
Bradley,6/27/20,0,0,0,0,0,0,0,0,0,42,0,861,0,31,0,2,0,9,0,903,0,0,0,0,0,0,0,2,0,0,37
Calhoun,6/27/20,0,0,0,0,0,0,0,0,0,0,0,226,0,0,0,0,0,0,0,226,0,0,0,0,0,0,0,0,0,0,3
Carroll,6/27/20,0,0,0,0,0,0,0,0,0,161,0,2555,0,91,0,5,0,65,0,2716,0,0,0,0,0,0,0,3,2,1,35
Chicot,6/27/20,0,0,0,0,0,0,0,0,0,120,0,1142,0,68,0,3,0,49,0,1262,0,0,0,0,0,0,0,3,6,0,66
Clark,6/27/20,0,0,0,0,0,0,0,0,0,55,0,1803,0,49,0,0,0,6,0,1858,0,0,0,0,0,0,0,2,2,0,20
Clay,6/27/20,0,0,0,0,0,0,0,0,0,52,0,1436,0,25,0,3,0,24,0,1488,0,0,0,0,0,0,0,0,5,0,79
Cleburne,6/27/20,0,0,0,0,0,0,0,0,0,83,0,1613,0,70,0,4,0,9,0,1696,0,0,0,0,0,0,0,1,0,0,22
Cleveland,6/27/20,0,0,0,0,0,0,0,0,0,25,0,620,0,22,0,0,0,3,0,645,0,0,0,0,0,0,0,0,0,0,18
Columbia,6/27/20,0,0,0,0,0,0,0,0,0,74,0,1137,0,28,0,3,0,43,0,1211,0,0,0,0,0,0,0,1,1,0,16
Conway,6/27/20,0,0,0,0,0,0,0,0,0,44,0,1200,0,25,0,3,0,16,0,1244,0,0,0,0,0,0,0,2,0,0,45
Craighead,6/27/20,0,0,0,0,0,0,0,0,0,436,0,9981,0,369,0,6,0,61,0,10417,0,0,0,0,0,0,0,6,5,0,521
Crawford,6/27/20,0,0,0,0,0,0,0,0,0,135,0,3416,0,69,0,0,0,66,0,3551,0,0,0,0,0,0,0,4,2,0,111
Crittenden,6/27/20,0,0,0,0,0,0,0,0,0,696,0,5427,0,539,0,11,0,146,0,6123,0,0,0,0,0,0,0,9,9,0,86
Cross,6/27/20,0,0,0,0,0,0,0,0,0,85,0,1367,0,76,0,1,0,8,0,1452,0,0,0,0,0,0,0,1,0,0,24
Dallas,6/27/20,0,0,0,0,0,0,0,0,0,7,0,379,0,5,0,0,0,2,0,386,0,0,0,0,0,0,0,1,1,0,17
Desha,6/27/20,0,0,0,0,0,0,0,0,0,42,0,859,0,26,0,0,0,16,0,901,0,0,0,0,0,0,0,2,3,0,31
Drew,6/27/20,0,0,0,0,0,0,0,0,0,53,0,1369,0,26,0,1,0,26,0,1422,0,0,0,0,0,0,0,4,1,0,76
Faulkner,6/27/20,0,0,0,0,0,0,0,0,0,409,0,8432,0,203,0,3,0,203,0,8841,0,0,0,0,0,0,0,27,21,0,232
Franklin,6/27/20,0,0,0,0,0,0,0,0,0,16,0,891,0,10,0,0,0,6,0,907,0,0,0,0,0,0,0,0,3,0,21
Fulton,6/27/20,0,0,0,0,0,0,0,0,0,12,0,734,0,9,0,0,0,3,0,746,0,0,0,0,0,0,0,2,-1,0,19
Garland,6/27/20,0,0,0,0,0,0,0,0,0,214,0,6021,0,165,0,1,0,48,0,6235,0,0,0,0,0,0,0,4,1,0,155
Grant,6/27/20,0,0,0,0,0,0,0,0,0,34,0,1046,0,25,0,0,0,9,0,1080,0,0,0,0,0,0,0,1,0,0,24
Greene,6/27/20,0,0,0,0,0,0,0,0,0,112,0,3762,0,82,0,0,0,30,0,3874,0,0,0,0,0,0,0,5,7,0,132
Hempstead,6/27/20,0,0,0,0,0,0,0,0,0,47,0,1551,0,41,0,1,0,5,0,1598,0,0,0,0,0,0,0,0,0,0,14
HotSpring,6/27/20,0,0,0,0,0,0,0,0,0,420,0,3145,0,48,0,0,0,372,0,3565,0,0,0,0,0,0,0,5,5,0,38
Howard,6/27/20,0,0,0,0,0,0,0,0,0,76,0,1037,0,49,0,1,0,26,0,1113,0,0,0,0,0,0,0,1,0,0,14
Independence,6/27/20,0,0,0,0,0,0,0,0,0,51,0,2544,0,44,0,0,0,7,0,2595,0,0,0,0,0,0,0,2,0,0,57
Izard,6/27/20,0,0,0,0,0,0,0,0,0,20,0,620,0,19,0,1,0,0,0,640,0,0,0,0,0,0,0,0,0,0,9
Jackson,6/27/20,0,0,0,0,0,0,0,0,0,26,0,924,0,17,0,0,0,9,0,950,0,0,0,0,0,0,0,0,1,0,29
Jefferson,6/27/20,0,0,0,0,0,0,0,0,0,680,0,5392,0,589,0,28,0,63,0,6072,0,0,0,0,0,0,0,4,1,0,91
Johnson,6/27/20,0,0,0,0,0,0,0,0,0,207,0,1261,0,112,0,0,0,95,0,1468,0,0,0,0,0,0,0,19,11,0,48
Lafayette,6/27/20,0,0,0,0,0,0,0,0,0,15,0,323,0,13,0,1,0,1,0,338,0,0,0,0,0,0,0,0,0,0,4
Lawrence,6/27/20,0,0,0,0,0,0,0,0,0,99,0,1453,0,78,0,9,0,12,0,1552,0,0,0,0,0,0,0,0,0,0,50
Lee,6/27/20,0,0,0,0,0,0,0,0,0,626,0,1904,0,531,0,1,0,94,0,2530,0,0,0,0,0,0,0,0,60,0,5
Lincoln,6/27/20,0,0,0,0,0,0,0,0,0,1036,0,1607,0,972,0,11,0,53,0,2643,0,0,0,0,0,0,0,0,7,0,23
LittleRiver,6/27/20,0,0,0,0,0,0,0,0,0,38,0,817,0,37,0,0,0,1,0,855,0,0,0,0,0,0,0,0,0,0,4
Logan,6/27/20,0,0,0,0,0,0,0,0,0,46,0,1673,0,23,0,0,0,23,0,1719,0,0,0,0,0,0,0,2,2,0,66
Lonoke,6/27/20,0,0,0,0,0,0,0,0,0,127,0,3476,0,76,0,1,0,50,0,3603,0,0,0,0,0,0,0,8,3,0,155
Madison,6/27/20,0,0,0,0,0,0,0,0,0,175,0,1710,0,128,0,0,0,47,0,1885,0,0,0,0,0,0,0,1,4,0,46
Marion,6/27/20,0,0,0,0,0,0,0,0,0,4,0,630,0,2,0,0,0,2,0,634,0,0,0,0,0,0,0,0,0,0,14
Miller,6/27/20,0,0,0,0,0,0,0,0,0,107,0,1848,0,87,0,2,0,18,0,1955,0,0,0,0,0,0,0,6,4,0,41
MissingCountyInfo,6/27/20,0,0,0,0,0,0,0,0,0,733,0,49152,0,275,0,0,0,458,0,49885,0,0,0,0,0,0,0,34,14,0,617
Mississippi,6/27/20,0,0,0,0,0,0,0,0,0,149,0,3453,0,99,0,3,0,47,0,3602,0,0,0,0,0,0,0,13,0,0,91
Monroe,6/27/20,0,0,0,0,0,0,0,0,0,12,0,638,0,7,0,0,0,5,0,650,0,0,0,0,0,0,0,2,0,0,16
Montgomery,6/27/20,0,0,0,0,0,0,0,0,0,4,0,353,0,2,0,0,0,2,0,357,0,0,0,0,0,0,0,0,0,0,8
Nevada,6/27/20,0,0,0,0,0,0,0,0,0,101,0,1151,0,73,0,2,0,26,0,1252,0,0,0,0,0,0,0,0,1,0,6
Newton,6/27/20,0,0,0,0,0,0,0,0,0,5,0,397,0,3,0,0,0,2,0,402,0,0,0,0,0,0,0,0,0,0,4
Ouachita,6/27/20,0,0,0,0,0,0,0,0,0,19,0,1574,0,17,0,0,0,2,0,1593,0,0,0,0,0,0,0,0,0,0,20
Perry,6/27/20,0,0,0,0,0,0,0,0,0,27,0,720,0,16,0,0,0,11,0,747,0,0,0,0,0,0,0,1,1,0,10
Phillips,6/27/20,0,0,0,0,0,0,0,0,0,127,0,1962,0,61,0,3,0,63,0,2089,0,0,0,0,0,0,0,18,9,0,266
Pike,6/27/20,0,0,0,0,0,0,0,0,0,8,0,1561,0,6,0,0,0,2,0,1569,0,0,0,0,0,0,0,0,0,0,5
Poinsett,6/27/20,0,0,0,0,0,0,0,0,0,56,0,1557,0,48,0,3,0,5,0,1613,0,0,0,0,0,0,0,0,0,0,34
Polk,6/27/20,0,0,0,0,0,0,0,0,0,70,0,1347,0,59,0,0,0,11,0,1417,0,0,0,0,0,0,0,0,3,0,22
Pope,6/27/20,0,0,0,0,0,0,0,0,0,402,0,4588,0,300,0,3,0,99,0,4990,0,0,0,0,0,0,0,10,12,0,91
Prairie,6/27/20,0,0,0,0,0,0,0,0,0,20,0,424,0,9,0,0,0,11,0,444,0,0,0,0,0,0,0,1,2,0,14
Pulaski,6/27/20,0,0,0,0,0,0,0,0,0,1810,0,29505,0,1273,0,56,0,481,0,31315,0,0,0,0,0,0,0,70,31,1,939
Randolph,6/27/20,0,0,0,0,0,0,0,0,0,46,0,1839,0,30,0,1,0,15,0,1885,0,0,0,0,0,0,0,2,1,0,43
Saline,6/27/20,0,0,0,0,0,0,0,0,0,246,0,8196,0,190,0,2,0,54,0,8442,0,0,0,0,0,0,0,13,10,0,201
Scott,6/27/20,0,0,0,0,0,0,0,0,0,10,0,451,0,5,0,0,0,5,0,461,0,0,0,0,0,0,0,1,0,0,10
Searcy,6/27/20,0,0,0,0,0,0,0,0,0,7,0,726,0,7,0,0,0,0,0,733,0,0,0,0,0,0,0,0,0,0,7
Sebastian,6/27/20,0,0,0,0,0,0,0,0,0,378,0,7219,0,189,0,4,0,185,0,7597,0,0,0,0,0,0,0,21,22,2,481
Sevier,6/27/20,0,0,0,0,0,0,0,0,0,652,0,3214,0,484,0,7,0,161,0,3866,0,0,0,0,0,0,0,4,19,0,33
Sharp,6/27/20,0,0,0,0,0,0,0,0,0,53,0,867,0,43,0,4,0,6,0,920,0,0,0,0,0,0,0,0,0,0,19
St.Francis,6/27/20,0,0,0,0,0,0,0,0,0,809,0,4120,0,780,0,3,0,26,0,4929,0,0,0,0,0,0,0,5,1,0,35
Stone,6/27/20,0,0,0,0,0,0,0,0,0,13,0,745,0,11,0,0,0,2,0,758,0,0,0,0,0,0,0,0,0,0,34
Union,6/27/20,0,0,0,0,0,0,0,0,0,245,0,2944,0,191,0,13,0,41,0,3189,0,0,0,0,0,0,0,2,2,0,38
VanBuren,6/27/20,0,0,0,0,0,0,0,0,0,34,0,890,0,28,0,2,0,4,0,924,0,0,0,0,0,0,0,1,0,0,16
Washington,6/27/20,0,0,0,0,0,0,0,0,0,3238,0,11753,0,2002,0,27,0,1209,0,14991,0,0,0,0,0,0,0,98,88,3,315
White,6/27/20,0,0,0,0,0,0,0,0,0,82,0,3368,0,62,0,1,0,19,0,3450,0,0,0,0,0,0,0,2,1,0,186
Woodruff,6/27/20,0,0,0,0,0,0,0,0,0,6,0,459,0,5,0,0,0,1,0,465,0,0,0,0,0,0,0,0,1,0,27
Yell,6/27/20,0,0,0,0,0,0,0,0,0,534,0,1662,0,340,0,3,0,191,0,2196,0,0,0,0,0,0,0,23,12,0,102
Arkansas_all_counties,6/26/20,0,0,0,0,0,0,0,0,2990671,18740,0,264225,0,12784,0,249,0,5707,0,282965,0,0,0,0,0,0,0,678,657,7,5585
Arkansas_county,6/26/20,0,0,0,0,0,0,0,0,0,24,0,1162,0,16,0,0,0,8,0,1186,0,0,0,0,0,0,0,0,4,0,57
Ashley,6/26/20,0,0,0,0,0,0,0,0,0,68,0,1256,0,46,0,1,0,21,0,1324,0,0,0,0,0,0,0,9,0,0,38
Baxter,6/26/20,0,0,0,0,0,0,0,0,0,18,0,1580,0,14,0,0,0,4,0,1598,0,0,0,0,0,0,0,2,0,0,17
Benton,6/26/20,0,0,0,0,0,0,0,0,0,2454,0,30224,0,1601,0,15,0,838,0,32678,0,0,0,0,0,0,0,192,97,1,636
Boone,6/26/20,0,0,0,0,0,0,0,0,0,22,0,1715,0,7,0,1,0,14,0,1737,0,0,0,0,0,0,0,3,0,0,29
Bradley,6/26/20,0,0,0,0,0,0,0,0,0,40,0,826,0,31,0,2,0,7,0,866,0,0,0,0,0,0,0,1,0,0,30
Calhoun,6/26/20,0,0,0,0,0,0,0,0,0,0,0,223,0,0,0,0,0,0,0,223,0,0,0,0,0,0,0,0,0,0,7
Carroll,6/26/20,0,0,0,0,0,0,0,0,0,158,0,2523,0,89,0,4,0,65,0,2681,0,0,0,0,0,0,0,9,3,0,58
Chicot,6/26/20,0,0,0,0,0,0,0,0,0,117,0,1079,0,62,0,3,0,52,0,1196,0,0,0,0,0,0,0,9,5,1,25
Clark,6/26/20,0,0,0,0,0,0,0,0,0,53,0,1785,0,47,0,0,0,6,0,1838,0,0,0,0,0,0,0,0,0,0,19
Clay,6/26/20,0,0,0,0,0,0,0,0,0,52,0,1357,0,20,0,3,0,29,0,1409,0,0,0,0,0,0,0,3,1,0,38
Cleburne,6/26/20,0,0,0,0,0,0,0,0,0,82,0,1592,0,70,0,4,0,8,0,1674,0,0,0,0,0,0,0,3,0,0,19
Cleveland,6/26/20,0,0,0,0,0,0,0,0,0,25,0,602,0,22,0,0,0,3,0,627,0,0,0,0,0,0,0,0,1,0,50
Columbia,6/26/20,0,0,0,0,0,0,0,0,0,73,0,1122,0,27,0,3,0,43,0,1195,0,0,0,0,0,0,0,1,1,0,24
Conway,6/26/20,0,0,0,0,0,0,0,0,0,42,0,1157,0,25,0,3,0,14,0,1199,0,0,0,0,0,0,0,3,1,0,16
Craighead,6/26/20,0,0,0,0,0,0,0,0,0,430,0,9466,0,364,0,6,0,60,0,9896,0,0,0,0,0,0,0,8,6,0,112
Crawford,6/26/20,0,0,0,0,0,0,0,0,0,131,0,3309,0,67,0,0,0,64,0,3440,0,0,0,0,0,0,0,10,7,0,127
Crittenden,6/26/20,0,0,0,0,0,0,0,0,0,687,0,5350,0,530,0,11,0,146,0,6037,0,0,0,0,0,0,0,27,16,1,69
Cross,6/26/20,0,0,0,0,0,0,0,0,0,84,0,1344,0,76,0,1,0,7,0,1428,0,0,0,0,0,0,0,0,0,0,16
Dallas,6/26/20,0,0,0,0,0,0,0,0,0,6,0,363,0,4,0,0,0,2,0,369,0,0,0,0,0,0,0,0,0,0,17
Desha,6/26/20,0,0,0,0,0,0,0,0,0,40,0,830,0,23,0,0,0,17,0,870,0,0,0,0,0,0,0,0,1,0,68
Drew,6/26/20,0,0,0,0,0,0,0,0,0,49,0,1297,0,25,0,1,0,23,0,1346,0,0,0,0,0,0,0,5,0,0,70
Faulkner,6/26/20,0,0,0,0,0,0,0,0,0,382,0,8227,0,182,0,3,0,197,0,8609,0,0,0,0,0,0,0,32,10,0,281
Franklin,6/26/20,0,0,0,0,0,0,0,0,0,16,0,870,0,7,0,0,0,9,0,886,0,0,0,0,0,0,0,1,-1,0,26
Fulton,6/26/20,0,0,0,0,0,0,0,0,0,10,0,717,0,10,0,0,0,0,0,727,0,0,0,0,0,0,0,1,1,0,10
Garland,6/26/20,0,0,0,0,0,0,0,0,0,210,0,5870,0,164,0,1,0,45,0,6080,0,0,0,0,0,0,0,5,1,0,97
Grant,6/26/20,0,0,0,0,0,0,0,0,0,33,0,1023,0,25,0,0,0,8,0,1056,0,0,0,0,0,0,0,3,1,0,93
Greene,6/26/20,0,0,0,0,0,0,0,0,0,107,0,3635,0,75,0,0,0,32,0,3742,0,0,0,0,0,0,0,5,2,0,108
Hempstead,6/26/20,0,0,0,0,0,0,0,0,0,47,0,1537,0,41,0,1,0,5,0,1584,0,0,0,0,0,0,0,1,2,0,14
HotSpring,6/26/20,0,0,0,0,0,0,0,0,0,415,0,3112,0,43,0,0,0,372,0,3527,0,0,0,0,0,0,0,19,2,0,163
Howard,6/26/20,0,0,0,0,0,0,0,0,0,75,0,1024,0,49,0,1,0,25,0,1099,0,0,0,0,0,0,0,2,2,1,15
Independence,6/26/20,0,0,0,0,0,0,0,0,0,49,0,2489,0,44,0,0,0,5,0,2538,0,0,0,0,0,0,0,0,0,0,45
Izard,6/26/20,0,0,0,0,0,0,0,0,0,20,0,611,0,19,0,1,0,0,0,631,0,0,0,0,0,0,0,0,0,0,7
Jackson,6/26/20,0,0,0,0,0,0,0,0,0,26,0,895,0,16,0,0,0,10,0,921,0,0,0,0,0,0,0,0,0,0,30
Jefferson,6/26/20,0,0,0,0,0,0,0,0,0,676,0,5305,0,588,0,28,0,60,0,5981,0,0,0,0,0,0,0,13,42,0,135
Johnson,6/26/20,0,0,0,0,0,0,0,0,0,188,0,1232,0,101,0,0,0,87,0,1420,0,0,0,0,0,0,0,13,8,0,55
Lafayette,6/26/20,0,0,0,0,0,0,0,0,0,15,0,319,0,13,0,1,0,1,0,334,0,0,0,0,0,0,0,1,0,0,10
Lawrence,6/26/20,0,0,0,0,0,0,0,0,0,99,0,1403,0,78,0,9,0,12,0,1502,0,0,0,0,0,0,0,1,0,0,98
Lee,6/26/20,0,0,0,0,0,0,0,0,0,626,0,1899,0,471,0,1,0,154,0,2525,0,0,0,0,0,0,0,0,188,0,6
Lincoln,6/26/20,0,0,0,0,0,0,0,0,0,1036,0,1584,0,965,0,11,0,60,0,2620,0,0,0,0,0,0,0,0,1,0,145
LittleRiver,6/26/20,0,0,0,0,0,0,0,0,0,38,0,813,0,37,0,0,0,1,0,851,0,0,0,0,0,0,0,1,1,0,4
Logan,6/26/20,0,0,0,0,0,0,0,0,0,44,0,1609,0,21,0,0,0,23,0,1653,0,0,0,0,0,0,0,8,1,0,105
Lonoke,6/26/20,0,0,0,0,0,0,0,0,0,119,0,3329,0,73,0,1,0,45,0,3448,0,0,0,0,0,0,0,-4,1,1,90
Madison,6/26/20,0,0,0,0,0,0,0,0,0,174,0,1665,0,124,0,0,0,50,0,1839,0,0,0,0,0,0,0,6,8,0,29
Marion,6/26/20,0,0,0,0,0,0,0,0,0,4,0,616,0,2,0,0,0,2,0,620,0,0,0,0,0,0,0,1,0,0,7
Miller,6/26/20,0,0,0,0,0,0,0,0,0,101,0,1813,0,83,0,2,0,16,0,1914,0,0,0,0,0,0,0,3,3,0,41
MissingCountyInfo,6/26/20,0,0,0,0,0,0,0,0,0,699,0,48569,0,261,0,0,0,438,0,49268,0,0,0,0,0,0,0,-236,-3,0,580
Mississippi,6/26/20,0,0,0,0,0,0,0,0,0,136,0,3375,0,99,0,3,0,34,0,3511,0,0,0,0,0,0,0,8,4,0,96
Monroe,6/26/20,0,0,0,0,0,0,0,0,0,10,0,624,0,7,0,0,0,3,0,634,0,0,0,0,0,0,0,2,0,0,5
Montgomery,6/26/20,0,0,0,0,0,0,0,0,0,4,0,345,0,2,0,0,0,2,0,349,0,0,0,0,0,0,0,0,0,0,13
Nevada,6/26/20,0,0,0,0,0,0,0,0,0,101,0,1145,0,72,0,2,0,27,0,1246,0,0,0,0,0,0,0,6,-2,0,16
Newton,6/26/20,0,0,0,0,0,0,0,0,0,5,0,393,0,3,0,0,0,2,0,398,0,0,0,0,0,0,0,1,0,0,4
Ouachita,6/26/20,0,0,0,0,0,0,0,0,0,19,0,1554,0,17,0,0,0,2,0,1573,0,0,0,0,0,0,0,1,1,0,20
Perry,6/26/20,0,0,0,0,0,0,0,0,0,26,0,711,0,15,0,0,0,11,0,737,0,0,0,0,0,0,0,3,0,0,20
Phillips,6/26/20,0,0,0,0,0,0,0,0,0,109,0,1714,0,52,0,3,0,54,0,1823,0,0,0,0,0,0,0,5,5,0,25
Pike,6/26/20,0,0,0,0,0,0,0,0,0,8,0,1556,0,6,0,0,0,2,0,1564,0,0,0,0,0,0,0,0,0,0,69
Poinsett,6/26/20,0,0,0,0,0,0,0,0,0,56,0,1523,0,48,0,3,0,5,0,1579,0,0,0,0,0,0,0,1,0,0,18
Polk,6/26/20,0,0,0,0,0,0,0,0,0,70,0,1325,0,56,0,0,0,14,0,1395,0,0,0,0,0,0,0,1,1,0,57
Pope,6/26/20,0,0,0,0,0,0,0,0,0,392,0,4507,0,288,0,3,0,101,0,4899,0,0,0,0,0,0,0,22,16,0,65
Prairie,6/26/20,0,0,0,0,0,0,0,0,0,19,0,411,0,7,0,0,0,12,0,430,0,0,0,0,0,0,0,0,0,0,3
Pulaski,6/26/20,0,0,0,0,0,0,0,0,0,1740,0,28636,0,1242,0,55,0,443,0,30376,0,0,0,0,0,0,0,85,28,2,1152
Randolph,6/26/20,0,0,0,0,0,0,0,0,0,44,0,1798,0,29,0,1,0,14,0,1842,0,0,0,0,0,0,0,4,0,0,25
Saline,6/26/20,0,0,0,0,0,0,0,0,0,233,0,8008,0,180,0,2,0,51,0,8241,0,0,0,0,0,0,0,8,3,0,114
Scott,6/26/20,0,0,0,0,0,0,0,0,0,9,0,442,0,5,0,0,0,4,0,451,0,0,0,0,0,0,0,1,0,0,7
Searcy,6/26/20,0,0,0,0,0,0,0,0,0,7,0,719,0,7,0,0,0,0,0,726,0,0,0,0,0,0,0,0,0,0,6
Sebastian,6/26/20,0,0,0,0,0,0,0,0,0,357,0,6759,0,167,0,2,0,188,0,7116,0,0,0,0,0,0,0,33,14,0,376
Sevier,6/26/20,0,0,0,0,0,0,0,0,0,648,0,3185,0,465,0,7,0,176,0,3833,0,0,0,0,0,0,0,31,31,1,119
Sharp,6/26/20,0,0,0,0,0,0,0,0,0,53,0,848,0,43,0,4,0,6,0,901,0,0,0,0,0,0,0,0,0,0,6
St.Francis,6/26/20,0,0,0,0,0,0,0,0,0,804,0,4090,0,779,0,3,0,22,0,4894,0,0,0,0,0,0,0,3,0,0,7
Stone,6/26/20,0,0,0,0,0,0,0,0,0,13,0,711,0,11,0,0,0,2,0,724,0,0,0,0,0,0,0,0,1,0,10
Union,6/26/20,0,0,0,0,0,0,0,0,0,243,0,2908,0,189,0,13,0,41,0,3151,0,0,0,0,0,0,0,6,4,0,21
VanBuren,6/26/20,0,0,0,0,0,0,0,0,0,33,0,875,0,28,0,2,0,3,0,908,0,0,0,0,0,0,0,3,0,0,14
Washington,6/26/20,0,0,0,0,0,0,0,0,0,3140,0,11536,0,1914,0,24,0,1202,0,14676,0,0,0,0,0,0,0,260,114,1,444
White,6/26/20,0,0,0,0,0,0,0,0,0,80,0,3184,0,61,0,1,0,18,0,3264,0,0,0,0,0,0,0,1,2,0,52
Woodruff,6/26/20,0,0,0,0,0,0,0,0,0,6,0,432,0,4,0,0,0,2,0,438,0,0,0,0,0,0,0,0,1,0,3
Yell,6/26/20,0,0,0,0,0,0,0,0,0,511,0,1583,0,328,0,3,0,180,0,2094,0,0,0,0,0,0,0,32,19,0,82
Arkansas_all_counties,6/25/20,0,0,0,0,0,0,0,0,2990671,18062,0,259318,0,12127,0,242,0,5693,0,277380,0,0,0,0,0,0,0,687,559,2,7399
Arkansas_county,6/25/20,0,0,0,0,0,0,0,0,0,24,0,1105,0,12,0,0,0,12,0,1129,0,0,0,0,0,0,0,2,2,0,249
Ashley,6/25/20,0,0,0,0,0,0,0,0,0,59,0,1227,0,46,0,1,0,12,0,1286,0,0,0,0,0,0,0,1,3,0,148
Baxter,6/25/20,0,0,0,0,0,0,0,0,0,16,0,1565,0,14,0,0,0,2,0,1581,0,0,0,0,0,0,0,1,0,0,36
Benton,6/25/20,0,0,0,0,0,0,0,0,0,2262,0,29780,0,1504,0,14,0,744,0,32042,0,0,0,0,0,0,0,66,73,0,792
Boone,6/25/20,0,0,0,0,0,0,0,0,0,19,0,1689,0,7,0,1,0,11,0,1708,0,0,0,0,0,0,0,3,0,0,27
Bradley,6/25/20,0,0,0,0,0,0,0,0,0,39,0,797,0,31,0,2,0,6,0,836,0,0,0,0,0,0,0,1,0,0,54
Calhoun,6/25/20,0,0,0,0,0,0,0,0,0,0,0,216,0,0,0,0,0,0,0,216,0,0,0,0,0,0,0,0,0,0,3
Carroll,6/25/20,0,0,0,0,0,0,0,0,0,149,0,2474,0,86,0,4,0,59,0,2623,0,0,0,0,0,0,0,8,8,0,105
Chicot,6/25/20,0,0,0,0,0,0,0,0,0,108,0,1063,0,57,0,2,0,49,0,1171,0,0,0,0,0,0,0,12,5,0,91
Clark,6/25/20,0,0,0,0,0,0,0,0,0,53,0,1766,0,47,0,0,0,6,0,1819,0,0,0,0,0,0,0,-1,1,0,24
Clay,6/25/20,0,0,0,0,0,0,0,0,0,49,0,1322,0,19,0,3,0,27,0,1371,0,0,0,0,0,0,0,0,2,0,55
Cleburne,6/25/20,0,0,0,0,0,0,0,0,0,79,0,1576,0,70,0,4,0,5,0,1655,0,0,0,0,0,0,0,1,0,0,40
Cleveland,6/25/20,0,0,0,0,0,0,0,0,0,25,0,552,0,21,0,0,0,4,0,577,0,0,0,0,0,0,0,0,0,0,29
Columbia,6/25/20,0,0,0,0,0,0,0,0,0,72,0,1099,0,26,0,3,0,43,0,1171,0,0,0,0,0,0,0,0,1,0,29
Conway,6/25/20,0,0,0,0,0,0,0,0,0,39,0,1144,0,24,0,3,0,12,0,1183,0,0,0,0,0,0,0,0,2,0,37
Craighead,6/25/20,0,0,0,0,0,0,0,0,0,422,0,9362,0,358,0,6,0,58,0,9784,0,0,0,0,0,0,0,7,8,0,431
Crawford,6/25/20,0,0,0,0,0,0,0,0,0,121,0,3192,0,60,0,0,0,61,0,3313,0,0,0,0,0,0,0,9,1,0,123
Crittenden,6/25/20,0,0,0,0,0,0,0,0,0,660,0,5308,0,514,0,10,0,136,0,5968,0,0,0,0,0,0,0,39,6,0,78
Cross,6/25/20,0,0,0,0,0,0,0,0,0,84,0,1328,0,76,0,1,0,7,0,1412,0,0,0,0,0,0,0,1,1,0,17
Dallas,6/25/20,0,0,0,0,0,0,0,0,0,6,0,346,0,4,0,0,0,2,0,352,0,0,0,0,0,0,0,0,0,0,5
Desha,6/25/20,0,0,0,0,0,0,0,0,0,40,0,762,0,22,0,0,0,18,0,802,0,0,0,0,0,0,0,3,0,0,38
Drew,6/25/20,0,0,0,0,0,0,0,0,0,44,0,1232,0,25,0,1,0,18,0,1276,0,0,0,0,0,0,0,3,0,0,38
Faulkner,6/25/20,0,0,0,0,0,0,0,0,0,350,0,7978,0,172,0,3,0,175,0,8328,0,0,0,0,0,0,0,11,11,0,159
Franklin,6/25/20,0,0,0,0,0,0,0,0,0,15,0,845,0,8,0,0,0,7,0,860,0,0,0,0,0,0,0,2,0,0,21
Fulton,6/25/20,0,0,0,0,0,0,0,0,0,9,0,708,0,9,0,0,0,0,0,717,0,0,0,0,0,0,0,-1,-1,0,11
Garland,6/25/20,0,0,0,0,0,0,0,0,0,205,0,5778,0,163,0,1,0,41,0,5983,0,0,0,0,0,0,0,14,3,0,80
Grant,6/25/20,0,0,0,0,0,0,0,0,0,30,0,933,0,24,0,0,0,6,0,963,0,0,0,0,0,0,0,2,0,0,16
Greene,6/25/20,0,0,0,0,0,0,0,0,0,102,0,3532,0,73,0,0,0,29,0,3634,0,0,0,0,0,0,0,3,3,0,153
Hempstead,6/25/20,0,0,0,0,0,0,0,0,0,46,0,1524,0,39,0,1,0,6,0,1570,0,0,0,0,0,0,0,0,1,0,12
HotSpring,6/25/20,0,0,0,0,0,0,0,0,0,396,0,2968,0,41,0,0,0,355,0,3364,0,0,0,0,0,0,0,0,0,0,46
Howard,6/25/20,0,0,0,0,0,0,0,0,0,73,0,1011,0,47,0,0,0,26,0,1084,0,0,0,0,0,0,0,3,2,0,16
Independence,6/25/20,0,0,0,0,0,0,0,0,0,49,0,2444,0,44,0,0,0,5,0,2493,0,0,0,0,0,0,0,1,2,0,220
Izard,6/25/20,0,0,0,0,0,0,0,0,0,20,0,604,0,19,0,1,0,0,0,624,0,0,0,0,0,0,0,0,0,0,12
Jackson,6/25/20,0,0,0,0,0,0,0,0,0,26,0,865,0,16,0,0,0,10,0,891,0,0,0,0,0,0,0,1,1,0,171
Jefferson,6/25/20,0,0,0,0,0,0,0,0,0,663,0,5183,0,546,0,28,0,89,0,5846,0,0,0,0,0,0,0,2,7,0,94
Johnson,6/25/20,0,0,0,0,0,0,0,0,0,175,0,1190,0,93,0,0,0,82,0,1365,0,0,0,0,0,0,0,9,2,0,31
Lafayette,6/25/20,0,0,0,0,0,0,0,0,0,14,0,310,0,13,0,1,0,0,0,324,0,0,0,0,0,0,0,0,1,0,6
Lawrence,6/25/20,0,0,0,0,0,0,0,0,0,98,0,1306,0,78,0,9,0,11,0,1404,0,0,0,0,0,0,0,0,1,0,51
Lee,6/25/20,0,0,0,0,0,0,0,0,0,626,0,1893,0,283,0,1,0,342,0,2519,0,0,0,0,0,0,0,5,161,0,20
Lincoln,6/25/20,0,0,0,0,0,0,0,0,0,1036,0,1439,0,964,0,11,0,61,0,2475,0,0,0,0,0,0,0,0,0,0,6
LittleRiver,6/25/20,0,0,0,0,0,0,0,0,0,37,0,810,0,36,0,0,0,1,0,847,0,0,0,0,0,0,0,0,0,0,7
Logan,6/25/20,0,0,0,0,0,0,0,0,0,36,0,1512,0,20,0,0,0,16,0,1548,0,0,0,0,0,0,0,0,2,0,61
Lonoke,6/25/20,0,0,0,0,0,0,0,0,0,123,0,3235,0,72,0,0,0,51,0,3358,0,0,0,0,0,0,0,27,1,0,141
Madison,6/25/20,0,0,0,0,0,0,0,0,0,168,0,1642,0,116,0,0,0,52,0,1810,0,0,0,0,0,0,0,5,21,0,75
Marion,6/25/20,0,0,0,0,0,0,0,0,0,3,0,610,0,2,0,0,0,1,0,613,0,0,0,0,0,0,0,1,0,0,5
Miller,6/25/20,0,0,0,0,0,0,0,0,0,98,0,1775,0,80,0,2,0,16,0,1873,0,0,0,0,0,0,0,1,1,0,24
MissingCountyInfo,6/25/20,0,0,0,0,0,0,0,0,0,935,0,47753,0,264,0,0,0,671,0,48688,0,0,0,0,0,0,0,144,11,0,766
Mississippi,6/25/20,0,0,0,0,0,0,0,0,0,128,0,3287,0,95,0,3,0,30,0,3415,0,0,0,0,0,0,0,0,2,0,56
Monroe,6/25/20,0,0,0,0,0,0,0,0,0,8,0,621,0,7,0,0,0,1,0,629,0,0,0,0,0,0,0,0,1,0,35
Montgomery,6/25/20,0,0,0,0,0,0,0,0,0,4,0,332,0,2,0,0,0,2,0,336,0,0,0,0,0,0,0,2,0,0,12
Nevada,6/25/20,0,0,0,0,0,0,0,0,0,95,0,1135,0,74,0,2,0,19,0,1230,0,0,0,0,0,0,0,0,4,0,20
Newton,6/25/20,0,0,0,0,0,0,0,0,0,4,0,390,0,3,0,0,0,1,0,394,0,0,0,0,0,0,0,0,0,0,8
Ouachita,6/25/20,0,0,0,0,0,0,0,0,0,18,0,1535,0,16,0,0,0,2,0,1553,0,0,0,0,0,0,0,0,3,0,16
Perry,6/25/20,0,0,0,0,0,0,0,0,0,23,0,694,0,15,0,0,0,8,0,717,0,0,0,0,0,0,0,2,0,0,19
Phillips,6/25/20,0,0,0,0,0,0,0,0,0,104,0,1694,0,47,0,3,0,54,0,1798,0,0,0,0,0,0,0,13,9,0,124
Pike,6/25/20,0,0,0,0,0,0,0,0,0,8,0,1487,0,6,0,0,0,2,0,1495,0,0,0,0,0,0,0,1,0,0,30
Poinsett,6/25/20,0,0,0,0,0,0,0,0,0,55,0,1506,0,48,0,3,0,4,0,1561,0,0,0,0,0,0,0,2,0,0,44
Polk,6/25/20,0,0,0,0,0,0,0,0,0,69,0,1269,0,55,0,0,0,14,0,1338,0,0,0,0,0,0,0,0,0,0,22
Pope,6/25/20,0,0,0,0,0,0,0,0,0,370,0,4464,0,272,0,3,0,95,0,4834,0,0,0,0,0,0,0,7,14,0,77
Prairie,6/25/20,0,0,0,0,0,0,0,0,0,19,0,408,0,7,0,0,0,12,0,427,0,0,0,0,0,0,0,1,0,0,24
Pulaski,6/25/20,0,0,0,0,0,0,0,0,0,1655,0,27569,0,1214,0,53,0,388,0,29224,0,0,0,0,0,0,0,48,30,0,725
Randolph,6/25/20,0,0,0,0,0,0,0,0,0,40,0,1777,0,29,0,1,0,10,0,1817,0,0,0,0,0,0,0,1,0,0,198
Saline,6/25/20,0,0,0,0,0,0,0,0,0,225,0,7902,0,177,0,2,0,46,0,8127,0,0,0,0,0,0,0,8,3,0,115
Scott,6/25/20,0,0,0,0,0,0,0,0,0,8,0,436,0,5,0,0,0,3,0,444,0,0,0,0,0,0,0,0,0,0,7
Searcy,6/25/20,0,0,0,0,0,0,0,0,0,7,0,713,0,7,0,0,0,0,0,720,0,0,0,0,0,0,0,0,0,0,5
Sebastian,6/25/20,0,0,0,0,0,0,0,0,0,324,0,6416,0,153,0,2,0,169,0,6740,0,0,0,0,0,0,0,26,17,0,293
Sevier,6/25/20,0,0,0,0,0,0,0,0,0,617,0,3097,0,434,0,6,0,177,0,3714,0,0,0,0,0,0,0,3,11,0,25
Sharp,6/25/20,0,0,0,0,0,0,0,0,0,53,0,842,0,43,0,4,0,6,0,895,0,0,0,0,0,0,0,1,0,0,14
St.Francis,6/25/20,0,0,0,0,0,0,0,0,0,801,0,4086,0,779,0,3,0,19,0,4887,0,0,0,0,0,0,0,6,6,0,28
Stone,6/25/20,0,0,0,0,0,0,0,0,0,13,0,701,0,10,0,0,0,3,0,714,0,0,0,0,0,0,0,0,0,0,4
Union,6/25/20,0,0,0,0,0,0,0,0,0,237,0,2893,0,185,0,13,0,39,0,3130,0,0,0,0,0,0,0,5,2,0,316
VanBuren,6/25/20,0,0,0,0,0,0,0,0,0,30,0,864,0,28,0,2,0,0,0,894,0,0,0,0,0,0,0,0,0,0,13
Washington,6/25/20,0,0,0,0,0,0,0,0,0,2880,0,11352,0,1800,0,23,0,1057,0,14232,0,0,0,0,0,0,0,113,100,0,384
White,6/25/20,0,0,0,0,0,0,0,0,0,79,0,3133,0,59,0,1,0,19,0,3212,0,0,0,0,0,0,0,-1,1,0,275
Woodruff,6/25/20,0,0,0,0,0,0,0,0,0,6,0,429,0,3,0,0,0,3,0,435,0,0,0,0,0,0,0,0,1,0,13
Yell,6/25/20,0,0,0,0,0,0,0,0,0,479,0,1533,0,309,0,3,0,167,0,2012,0,0,0,0,0,0,0,4,12,0,55
Arkansas_all_counties,6/24/20,0,0,0,0,0,0,0,0,2990671,17375,0,252606,0,11568,0,240,0,5567,0,269981,0,0,0,0,0,0,0,697,348,3,5489
Arkansas_county,6/24/20,0,0,0,0,0,0,0,0,0,22,0,858,0,10,0,0,0,12,0,880,0,0,0,0,0,0,0,1,3,0,59
Ashley,6/24/20,0,0,0,0,0,0,0,0,0,58,0,1080,0,43,0,1,0,14,0,1138,0,0,0,0,0,0,0,1,2,0,18
Baxter,6/24/20,0,0,0,0,0,0,0,0,0,15,0,1530,0,14,0,0,0,1,0,1545,0,0,0,0,0,0,0,0,-1,0,10
Benton,6/24/20,0,0,0,0,0,0,0,0,0,2196,0,29054,0,1431,0,14,0,751,0,31250,0,0,0,0,0,0,0,68,58,0,609
Boone,6/24/20,0,0,0,0,0,0,0,0,0,16,0,1665,0,7,0,1,0,8,0,1681,0,0,0,0,0,0,0,2,0,0,40
Bradley,6/24/20,0,0,0,0,0,0,0,0,0,38,0,744,0,31,0,2,0,5,0,782,0,0,0,0,0,0,0,0,0,0,4
Calhoun,6/24/20,0,0,0,0,0,0,0,0,0,0,0,213,0,0,0,0,0,0,0,213,0,0,0,0,0,0,0,0,0,0,2
Carroll,6/24/20,0,0,0,0,0,0,0,0,0,141,0,2377,0,78,0,4,0,59,0,2518,0,0,0,0,0,0,0,5,6,0,41
Chicot,6/24/20,0,0,0,0,0,0,0,0,0,96,0,984,0,52,0,2,0,42,0,1080,0,0,0,0,0,0,0,3,5,0,16
Clark,6/24/20,0,0,0,0,0,0,0,0,0,54,0,1741,0,46,0,0,0,8,0,1795,0,0,0,0,0,0,0,1,0,0,12
Clay,6/24/20,0,0,0,0,0,0,0,0,0,49,0,1267,0,17,0,3,0,29,0,1316,0,0,0,0,0,0,0,1,7,0,18
Cleburne,6/24/20,0,0,0,0,0,0,0,0,0,78,0,1537,0,70,0,4,0,4,0,1615,0,0,0,0,0,0,0,1,0,0,25
Cleveland,6/24/20,0,0,0,0,0,0,0,0,0,25,0,523,0,21,0,0,0,4,0,548,0,0,0,0,0,0,0,0,1,0,4
Columbia,6/24/20,0,0,0,0,0,0,0,0,0,72,0,1070,0,25,0,3,0,44,0,1142,0,0,0,0,0,0,0,28,1,0,36
Conway,6/24/20,0,0,0,0,0,0,0,0,0,39,0,1107,0,22,0,3,0,14,0,1146,0,0,0,0,0,0,0,3,2,0,27
Craighead,6/24/20,0,0,0,0,0,0,0,0,0,415,0,8938,0,350,0,6,0,59,0,9353,0,0,0,0,0,0,0,11,6,0,132
Crawford,6/24/20,0,0,0,0,0,0,0,0,0,112,0,3078,0,59,0,0,0,53,0,3190,0,0,0,0,0,0,0,7,7,0,99
Crittenden,6/24/20,0,0,0,0,0,0,0,0,0,621,0,5269,0,508,0,10,0,103,0,5890,0,0,0,0,0,0,0,17,10,0,82
Cross,6/24/20,0,0,0,0,0,0,0,0,0,83,0,1312,0,75,0,1,0,7,0,1395,0,0,0,0,0,0,0,0,3,0,14
Dallas,6/24/20,0,0,0,0,0,0,0,0,0,6,0,341,0,4,0,0,0,2,0,347,0,0,0,0,0,0,0,0,1,0,4
Desha,6/24/20,0,0,0,0,0,0,0,0,0,37,0,727,0,22,0,0,0,15,0,764,0,0,0,0,0,0,0,8,1,0,18
Drew,6/24/20,0,0,0,0,0,0,0,0,0,41,0,1197,0,25,0,1,0,15,0,1238,0,0,0,0,0,0,0,2,1,0,52
Faulkner,6/24/20,0,0,0,0,0,0,0,0,0,339,0,7830,0,161,0,3,0,175,0,8169,0,0,0,0,0,0,0,34,11,0,245
Franklin,6/24/20,0,0,0,0,0,0,0,0,0,13,0,826,0,8,0,0,0,5,0,839,0,0,0,0,0,0,0,0,1,0,28
Fulton,6/24/20,0,0,0,0,0,0,0,0,0,10,0,696,0,10,0,0,0,0,0,706,0,0,0,0,0,0,0,0,2,0,13
Garland,6/24/20,0,0,0,0,0,0,0,0,0,191,0,5712,0,160,0,1,0,30,0,5903,0,0,0,0,0,0,0,8,2,0,97
Grant,6/24/20,0,0,0,0,0,0,0,0,0,28,0,919,0,24,0,0,0,4,0,947,0,0,0,0,0,0,0,0,0,0,12
Greene,6/24/20,0,0,0,0,0,0,0,0,0,99,0,3382,0,70,0,0,0,29,0,3481,0,0,0,0,0,0,0,2,2,0,82
Hempstead,6/24/20,0,0,0,0,0,0,0,0,0,46,0,1512,0,38,0,1,0,7,0,1558,0,0,0,0,0,0,0,0,1,0,20
HotSpring,6/24/20,0,0,0,0,0,0,0,0,0,396,0,2922,0,41,0,0,0,355,0,3318,0,0,0,0,0,0,0,170,2,0,791
Howard,6/24/20,0,0,0,0,0,0,0,0,0,70,0,998,0,45,0,0,0,25,0,1068,0,0,0,0,0,0,0,0,4,0,8
Independence,6/24/20,0,0,0,0,0,0,0,0,0,48,0,2225,0,42,0,0,0,6,0,2273,0,0,0,0,0,0,0,2,0,0,34
Izard,6/24/20,0,0,0,0,0,0,0,0,0,20,0,592,0,19,0,1,0,0,0,612,0,0,0,0,0,0,0,0,1,0,9
Jackson,6/24/20,0,0,0,0,0,0,0,0,0,25,0,695,0,15,0,0,0,10,0,720,0,0,0,0,0,0,0,1,0,0,5
Jefferson,6/24/20,0,0,0,0,0,0,0,0,0,661,0,5091,0,539,0,28,0,94,0,5752,0,0,0,0,0,0,0,4,1,0,95
Johnson,6/24/20,0,0,0,0,0,0,0,0,0,166,0,1168,0,91,0,0,0,75,0,1334,0,0,0,0,0,0,0,0,6,0,45
Lafayette,6/24/20,0,0,0,0,0,0,0,0,0,14,0,304,0,12,0,1,0,1,0,318,0,0,0,0,0,0,0,1,1,0,4
Lawrence,6/24/20,0,0,0,0,0,0,0,0,0,98,0,1255,0,77,0,9,0,12,0,1353,0,0,0,0,0,0,0,2,0,0,43
Lee,6/24/20,0,0,0,0,0,0,0,0,0,621,0,1878,0,122,0,1,0,498,0,2499,0,0,0,0,0,0,0,0,0,0,13
Lincoln,6/24/20,0,0,0,0,0,0,0,0,0,1036,0,1433,0,964,0,11,0,61,0,2469,0,0,0,0,0,0,0,0,0,0,10
LittleRiver,6/24/20,0,0,0,0,0,0,0,0,0,37,0,803,0,36,0,0,0,1,0,840,0,0,0,0,0,0,0,1,2,0,1
Logan,6/24/20,0,0,0,0,0,0,0,0,0,36,0,1451,0,18,0,0,0,18,0,1487,0,0,0,0,0,0,0,2,2,0,23
Lonoke,6/24/20,0,0,0,0,0,0,0,0,0,96,0,3121,0,71,0,0,0,25,0,3217,0,0,0,0,0,0,0,5,1,0,67
Madison,6/24/20,0,0,0,0,0,0,0,0,0,163,0,1572,0,95,0,0,0,68,0,1735,0,0,0,0,0,0,0,1,10,0,10
Marion,6/24/20,0,0,0,0,0,0,0,0,0,2,0,606,0,2,0,0,0,0,0,608,0,0,0,0,0,0,0,0,0,0,11
Miller,6/24/20,0,0,0,0,0,0,0,0,0,97,0,1752,0,79,0,2,0,16,0,1849,0,0,0,0,0,0,0,3,1,0,8
MissingCountyInfo,6/24/20,0,0,0,0,0,0,0,0,0,791,0,47131,0,253,0,0,0,538,0,47922,0,0,0,0,0,0,0,108,10,0,710
Mississippi,6/24/20,0,0,0,0,0,0,0,0,0,128,0,3231,0,93,0,3,0,32,0,3359,0,0,0,0,0,0,0,7,3,0,172
Monroe,6/24/20,0,0,0,0,0,0,0,0,0,8,0,586,0,6,0,0,0,2,0,594,0,0,0,0,0,0,0,0,0,0,12
Montgomery,6/24/20,0,0,0,0,0,0,0,0,0,2,0,322,0,2,0,0,0,0,0,324,0,0,0,0,0,0,0,0,0,0,7
Nevada,6/24/20,0,0,0,0,0,0,0,0,0,95,0,1115,0,70,0,2,0,23,0,1210,0,0,0,0,0,0,0,0,0,0,7
Newton,6/24/20,0,0,0,0,0,0,0,0,0,4,0,382,0,3,0,0,0,1,0,386,0,0,0,0,0,0,0,0,0,0,9
Ouachita,6/24/20,0,0,0,0,0,0,0,0,0,18,0,1519,0,13,0,0,0,5,0,1537,0,0,0,0,0,0,0,1,0,0,11
Perry,6/24/20,0,0,0,0,0,0,0,0,0,21,0,677,0,15,0,0,0,6,0,698,0,0,0,0,0,0,0,0,0,0,16
Phillips,6/24/20,0,0,0,0,0,0,0,0,0,91,0,1583,0,38,0,3,0,50,0,1674,0,0,0,0,0,0,0,1,3,0,16
Pike,6/24/20,0,0,0,0,0,0,0,0,0,7,0,1458,0,6,0,0,0,1,0,1465,0,0,0,0,0,0,0,0,0,0,19
Poinsett,6/24/20,0,0,0,0,0,0,0,0,0,53,0,1464,0,48,0,3,0,2,0,1517,0,0,0,0,0,0,0,0,4,0,16
Polk,6/24/20,0,0,0,0,0,0,0,0,0,69,0,1247,0,55,0,0,0,14,0,1316,0,0,0,0,0,0,0,2,1,0,20
Pope,6/24/20,0,0,0,0,0,0,0,0,0,363,0,4394,0,258,0,3,0,102,0,4757,0,0,0,0,0,0,0,14,9,1,70
Prairie,6/24/20,0,0,0,0,0,0,0,0,0,18,0,385,0,7,0,0,0,11,0,403,0,0,0,0,0,0,0,2,2,0,17
Pulaski,6/24/20,0,0,0,0,0,0,0,0,0,1607,0,26892,0,1184,0,53,0,370,0,28499,0,0,0,0,0,0,0,51,25,0,599
Randolph,6/24/20,0,0,0,0,0,0,0,0,0,39,0,1580,0,29,0,1,0,9,0,1619,0,0,0,0,0,0,0,0,0,0,22
Saline,6/24/20,0,0,0,0,0,0,0,0,0,217,0,7795,0,174,0,2,0,41,0,8012,0,0,0,0,0,0,0,6,1,0,123
Scott,6/24/20,0,0,0,0,0,0,0,0,0,8,0,429,0,5,0,0,0,3,0,437,0,0,0,0,0,0,0,0,0,0,6
Searcy,6/24/20,0,0,0,0,0,0,0,0,0,7,0,708,0,7,0,0,0,0,0,715,0,0,0,0,0,0,0,0,0,0,15
Sebastian,6/24/20,0,0,0,0,0,0,0,0,0,298,0,6149,0,136,0,2,0,160,0,6447,0,0,0,0,0,0,0,40,9,0,257
Sevier,6/24/20,0,0,0,0,0,0,0,0,0,614,0,3075,0,423,0,6,0,185,0,3689,0,0,0,0,0,0,0,8,15,0,29
Sharp,6/24/20,0,0,0,0,0,0,0,0,0,52,0,829,0,43,0,4,0,5,0,881,0,0,0,0,0,0,0,1,0,0,13
St.Francis,6/24/20,0,0,0,0,0,0,0,0,0,795,0,4064,0,773,0,3,0,19,0,4859,0,0,0,0,0,0,0,2,4,0,25
Stone,6/24/20,0,0,0,0,0,0,0,0,0,13,0,697,0,10,0,0,0,3,0,710,0,0,0,0,0,0,0,0,0,0,5
Union,6/24/20,0,0,0,0,0,0,0,0,0,232,0,2582,0,183,0,13,0,36,0,2814,0,0,0,0,0,0,0,0,3,0,-262
VanBuren,6/24/20,0,0,0,0,0,0,0,0,0,30,0,851,0,28,0,2,0,0,0,881,0,0,0,0,0,0,0,0,0,0,13
Washington,6/24/20,0,0,0,0,0,0,0,0,0,2767,0,11081,0,1700,0,23,0,1044,0,13848,0,0,0,0,0,0,0,87,83,2,233
White,6/24/20,0,0,0,0,0,0,0,0,0,80,0,2857,0,58,0,1,0,21,0,2937,0,0,0,0,0,0,0,4,5,0,41
Woodruff,6/24/20,0,0,0,0,0,0,0,0,0,6,0,416,0,2,0,0,0,4,0,422,0,0,0,0,0,0,0,0,0,0,7
Yell,6/24/20,0,0,0,0,0,0,0,0,0,475,0,1482,0,297,0,3,0,175,0,1957,0,0,0,0,0,0,0,27,9,0,54
Arkansas_all_counties,6/23/20,0,0,0,0,0,0,0,0,2990671,16678,0,247814,0,11220,0,237,0,5221,0,264492,0,0,0,0,0,0,0,595,427,10,8153
Arkansas_county,6/23/20,0,0,0,0,0,0,0,0,0,21,0,800,0,7,0,0,0,14,0,821,0,0,0,0,0,0,0,2,0,0,48
Ashley,6/23/20,0,0,0,0,0,0,0,0,0,57,0,1063,0,41,0,1,0,15,0,1120,0,0,0,0,0,0,0,1,2,0,19
Baxter,6/23/20,0,0,0,0,0,0,0,0,0,15,0,1520,0,15,0,0,0,0,0,1535,0,0,0,0,0,0,0,0,1,0,19
Benton,6/23/20,0,0,0,0,0,0,0,0,0,2128,0,28513,0,1373,0,14,0,741,0,30641,0,0,0,0,0,0,0,41,62,1,757
Boone,6/23/20,0,0,0,0,0,0,0,0,0,14,0,1627,0,7,0,1,0,6,0,1641,0,0,0,0,0,0,0,1,0,1,64
Bradley,6/23/20,0,0,0,0,0,0,0,0,0,38,0,740,0,31,0,2,0,5,0,778,0,0,0,0,0,0,0,0,0,0,14
Calhoun,6/23/20,0,0,0,0,0,0,0,0,0,0,0,211,0,0,0,0,0,0,0,211,0,0,0,0,0,0,0,0,0,0,4
Carroll,6/23/20,0,0,0,0,0,0,0,0,0,136,0,2341,0,72,0,4,0,60,0,2477,0,0,0,0,0,0,0,0,7,0,176
Chicot,6/23/20,0,0,0,0,0,0,0,0,0,93,0,971,0,47,0,2,0,44,0,1064,0,0,0,0,0,0,0,5,5,0,47
Clark,6/23/20,0,0,0,0,0,0,0,0,0,53,0,1730,0,46,0,0,0,7,0,1783,0,0,0,0,0,0,0,0,3,0,48
Clay,6/23/20,0,0,0,0,0,0,0,0,0,48,0,1250,0,10,0,3,0,35,0,1298,0,0,0,0,0,0,0,2,3,1,69
Cleburne,6/23/20,0,0,0,0,0,0,0,0,0,77,0,1513,0,70,0,4,0,3,0,1590,0,0,0,0,0,0,0,0,0,0,22
Cleveland,6/23/20,0,0,0,0,0,0,0,0,0,25,0,519,0,20,0,0,0,5,0,544,0,0,0,0,0,0,0,0,0,0,1
Columbia,6/23/20,0,0,0,0,0,0,0,0,0,44,0,1062,0,24,0,3,0,17,0,1106,0,0,0,0,0,0,0,1,1,1,72
Conway,6/23/20,0,0,0,0,0,0,0,0,0,36,0,1083,0,20,0,3,0,13,0,1119,0,0,0,0,0,0,0,2,-1,0,42
Craighead,6/23/20,0,0,0,0,0,0,0,0,0,404,0,8817,0,344,0,6,0,54,0,9221,0,0,0,0,0,0,0,3,8,1,132
Crawford,6/23/20,0,0,0,0,0,0,0,0,0,105,0,2986,0,52,0,0,0,53,0,3091,0,0,0,0,0,0,0,7,4,0,122
Crittenden,6/23/20,0,0,0,0,0,0,0,0,0,604,0,5204,0,498,0,10,0,96,0,5808,0,0,0,0,0,0,0,4,11,0,64
Cross,6/23/20,0,0,0,0,0,0,0,0,0,83,0,1298,0,72,0,1,0,10,0,1381,0,0,0,0,0,0,0,1,2,0,16
Dallas,6/23/20,0,0,0,0,0,0,0,0,0,6,0,337,0,3,0,0,0,3,0,343,0,0,0,0,0,0,0,0,1,0,14
Desha,6/23/20,0,0,0,0,0,0,0,0,0,29,0,717,0,21,0,0,0,8,0,746,0,0,0,0,0,0,0,0,0,0,11
Drew,6/23/20,0,0,0,0,0,0,0,0,0,39,0,1147,0,24,0,1,0,14,0,1186,0,0,0,0,0,0,0,0,0,0,14
Faulkner,6/23/20,0,0,0,0,0,0,0,0,0,305,0,7619,0,150,0,3,0,152,0,7924,0,0,0,0,0,0,0,15,6,0,179
Franklin,6/23/20,0,0,0,0,0,0,0,0,0,13,0,798,0,7,0,0,0,6,0,811,0,0,0,0,0,0,0,0,0,0,29
Fulton,6/23/20,0,0,0,0,0,0,0,0,0,10,0,683,0,8,0,0,0,2,0,693,0,0,0,0,0,0,0,0,0,0,9
Garland,6/23/20,0,0,0,0,0,0,0,0,0,183,0,5623,0,158,0,1,0,24,0,5806,0,0,0,0,0,0,0,3,3,0,84
Grant,6/23/20,0,0,0,0,0,0,0,0,0,28,0,907,0,24,0,0,0,4,0,935,0,0,0,0,0,0,0,1,0,0,11
Greene,6/23/20,0,0,0,0,0,0,0,0,0,97,0,3302,0,68,0,0,0,29,0,3399,0,0,0,0,0,0,0,3,1,0,144
Hempstead,6/23/20,0,0,0,0,0,0,0,0,0,46,0,1492,0,37,0,1,0,8,0,1538,0,0,0,0,0,0,0,1,4,0,126
HotSpring,6/23/20,0,0,0,0,0,0,0,0,0,226,0,2301,0,39,0,0,0,187,0,2527,0,0,0,0,0,0,0,88,3,0,695
Howard,6/23/20,0,0,0,0,0,0,0,0,0,70,0,990,0,41,0,0,0,29,0,1060,0,0,0,0,0,0,0,2,2,0,15
Independence,6/23/20,0,0,0,0,0,0,0,0,0,46,0,2193,0,42,0,0,0,4,0,2239,0,0,0,0,0,0,0,0,1,0,230
Izard,6/23/20,0,0,0,0,0,0,0,0,0,20,0,583,0,18,0,1,0,1,0,603,0,0,0,0,0,0,0,0,0,0,16
Jackson,6/23/20,0,0,0,0,0,0,0,0,0,24,0,691,0,15,0,0,0,9,0,715,0,0,0,0,0,0,0,0,4,0,11
Jefferson,6/23/20,0,0,0,0,0,0,0,0,0,657,0,5000,0,538,0,28,0,91,0,5657,0,0,0,0,0,0,0,0,15,0,45
Johnson,6/23/20,0,0,0,0,0,0,0,0,0,166,0,1123,0,85,0,0,0,81,0,1289,0,0,0,0,0,0,0,8,4,0,49
Lafayette,6/23/20,0,0,0,0,0,0,0,0,0,13,0,301,0,11,0,1,0,1,0,314,0,0,0,0,0,0,0,0,1,0,10
Lawrence,6/23/20,0,0,0,0,0,0,0,0,0,96,0,1214,0,77,0,9,0,10,0,1310,0,0,0,0,0,0,0,2,2,0,22
Lee,6/23/20,0,0,0,0,0,0,0,0,0,621,0,1865,0,122,0,1,0,498,0,2486,0,0,0,0,0,0,0,45,58,0,83
Lincoln,6/23/20,0,0,0,0,0,0,0,0,0,1036,0,1423,0,964,0,11,0,61,0,2459,0,0,0,0,0,0,0,0,0,0,5
LittleRiver,6/23/20,0,0,0,0,0,0,0,0,0,36,0,803,0,34,0,0,0,2,0,839,0,0,0,0,0,0,0,1,2,0,10
Logan,6/23/20,0,0,0,0,0,0,0,0,0,34,0,1430,0,16,0,0,0,18,0,1464,0,0,0,0,0,0,0,2,0,0,158
Lonoke,6/23/20,0,0,0,0,0,0,0,0,0,91,0,3059,0,70,0,0,0,21,0,3150,0,0,0,0,0,0,0,2,3,0,82
Madison,6/23/20,0,0,0,0,0,0,0,0,0,162,0,1563,0,85,0,0,0,77,0,1725,0,0,0,0,0,0,0,8,6,0,60
Marion,6/23/20,0,0,0,0,0,0,0,0,0,2,0,595,0,2,0,0,0,0,0,597,0,0,0,0,0,0,0,0,0,0,3
Miller,6/23/20,0,0,0,0,0,0,0,0,0,94,0,1747,0,78,0,2,0,14,0,1841,0,0,0,0,0,0,0,2,4,0,28
MissingCountyInfo,6/23/20,0,0,0,0,0,0,0,0,0,683,0,46529,0,243,0,0,0,440,0,47212,0,0,0,0,0,0,0,99,13,0,1912
Mississippi,6/23/20,0,0,0,0,0,0,0,0,0,121,0,3066,0,90,0,3,0,28,0,3187,0,0,0,0,0,0,0,6,0,0,67
Monroe,6/23/20,0,0,0,0,0,0,0,0,0,8,0,574,0,6,0,0,0,2,0,582,0,0,0,0,0,0,0,1,1,0,38
Montgomery,6/23/20,0,0,0,0,0,0,0,0,0,2,0,315,0,2,0,0,0,0,0,317,0,0,0,0,0,0,0,0,0,0,10
Nevada,6/23/20,0,0,0,0,0,0,0,0,0,95,0,1108,0,70,0,2,0,23,0,1203,0,0,0,0,0,0,0,1,2,0,30
Newton,6/23/20,0,0,0,0,0,0,0,0,0,4,0,373,0,3,0,0,0,1,0,377,0,0,0,0,0,0,0,0,0,0,10
Ouachita,6/23/20,0,0,0,0,0,0,0,0,0,17,0,1509,0,13,0,0,0,4,0,1526,0,0,0,0,0,0,0,0,1,0,98
Perry,6/23/20,0,0,0,0,0,0,0,0,0,21,0,661,0,15,0,0,0,6,0,682,0,0,0,0,0,0,0,0,0,0,14
Phillips,6/23/20,0,0,0,0,0,0,0,0,0,90,0,1568,0,35,0,3,0,52,0,1658,0,0,0,0,0,0,0,3,0,1,30
Pike,6/23/20,0,0,0,0,0,0,0,0,0,7,0,1439,0,6,0,0,0,1,0,1446,0,0,0,0,0,0,0,0,0,0,12
Poinsett,6/23/20,0,0,0,0,0,0,0,0,0,53,0,1448,0,44,0,3,0,6,0,1501,0,0,0,0,0,0,0,0,1,0,8
Polk,6/23/20,0,0,0,0,0,0,0,0,0,67,0,1229,0,54,0,0,0,13,0,1296,0,0,0,0,0,0,0,0,0,0,35
Pope,6/23/20,0,0,0,0,0,0,0,0,0,349,0,4338,0,249,0,2,0,98,0,4687,0,0,0,0,0,0,0,16,12,0,229
Prairie,6/23/20,0,0,0,0,0,0,0,0,0,16,0,370,0,5,0,0,0,11,0,386,0,0,0,0,0,0,0,0,0,0,7
Pulaski,6/23/20,0,0,0,0,0,0,0,0,0,1556,0,26344,0,1159,0,53,0,344,0,27900,0,0,0,0,0,0,0,25,25,1,646
Randolph,6/23/20,0,0,0,0,0,0,0,0,0,39,0,1558,0,29,0,1,0,9,0,1597,0,0,0,0,0,0,0,0,1,0,42
Saline,6/23/20,0,0,0,0,0,0,0,0,0,211,0,7678,0,173,0,2,0,36,0,7889,0,0,0,0,0,0,0,1,2,0,87
Scott,6/23/20,0,0,0,0,0,0,0,0,0,8,0,423,0,5,0,0,0,3,0,431,0,0,0,0,0,0,0,0,1,0,31
Searcy,6/23/20,0,0,0,0,0,0,0,0,0,7,0,693,0,7,0,0,0,0,0,700,0,0,0,0,0,0,0,0,0,0,8
Sebastian,6/23/20,0,0,0,0,0,0,0,0,0,258,0,5932,0,127,0,2,0,129,0,6190,0,0,0,0,0,0,0,8,8,0,121
Sevier,6/23/20,0,0,0,0,0,0,0,0,0,606,0,3054,0,408,0,6,0,192,0,3660,0,0,0,0,0,0,0,14,15,0,53
Sharp,6/23/20,0,0,0,0,0,0,0,0,0,51,0,817,0,43,0,4,0,4,0,868,0,0,0,0,0,0,0,0,0,0,24
St.Francis,6/23/20,0,0,0,0,0,0,0,0,0,793,0,4041,0,769,0,3,0,21,0,4834,0,0,0,0,0,0,0,1,3,0,15
Stone,6/23/20,0,0,0,0,0,0,0,0,0,13,0,692,0,10,0,0,0,3,0,705,0,0,0,0,0,0,0,0,0,0,16
Union,6/23/20,0,0,0,0,0,0,0,0,0,232,0,2844,0,180,0,13,0,39,0,3076,0,0,0,0,0,0,0,5,0,0,239
VanBuren,6/23/20,0,0,0,0,0,0,0,0,0,30,0,838,0,28,0,2,0,0,0,868,0,0,0,0,0,0,0,0,0,0,7
Washington,6/23/20,0,0,0,0,0,0,0,0,0,2680,0,10935,0,1617,0,21,0,1042,0,13615,0,0,0,0,0,0,0,149,95,3,342
White,6/23/20,0,0,0,0,0,0,0,0,0,76,0,2820,0,53,0,1,0,22,0,2896,0,0,0,0,0,0,0,0,2,0,51
Woodruff,6/23/20,0,0,0,0,0,0,0,0,0,6,0,409,0,2,0,0,0,4,0,415,0,0,0,0,0,0,0,0,1,0,1
Yell,6/23/20,0,0,0,0,0,0,0,0,0,448,0,1455,0,288,0,3,0,157,0,1903,0,0,0,0,0,0,0,13,15,0,92
Arkansas_all_counties,6/22/20,0,0,0,0,0,0,0,0,2990671,16083,0,240256,0,10793,0,227,0,5063,0,256339,0,0,0,0,0,0,0,522,337,2,8159
Arkansas_county,6/22/20,0,0,0,0,0,0,0,0,0,19,0,754,0,7,0,0,0,12,0,773,0,0,0,0,0,0,0,0,0,0,29
Ashley,6/22/20,0,0,0,0,0,0,0,0,0,56,0,1045,0,39,0,1,0,16,0,1101,0,0,0,0,0,0,0,3,1,0,11
Baxter,6/22/20,0,0,0,0,0,0,0,0,0,15,0,1501,0,14,0,0,0,1,0,1516,0,0,0,0,0,0,0,1,1,0,24
Benton,6/22/20,0,0,0,0,0,0,0,0,0,2087,0,27797,0,1311,0,13,0,763,0,29884,0,0,0,0,0,0,0,84,63,0,1088
Boone,6/22/20,0,0,0,0,0,0,0,0,0,13,0,1564,0,7,0,0,0,6,0,1577,0,0,0,0,0,0,0,2,0,0,52
Bradley,6/22/20,0,0,0,0,0,0,0,0,0,38,0,726,0,31,0,2,0,5,0,764,0,0,0,0,0,0,0,0,1,0,6
Calhoun,6/22/20,0,0,0,0,0,0,0,0,0,0,0,207,0,0,0,0,0,0,0,207,0,0,0,0,0,0,0,0,0,0,4
Carroll,6/22/20,0,0,0,0,0,0,0,0,0,136,0,2165,0,65,0,4,0,67,0,2301,0,0,0,0,0,0,0,7,5,0,276
Chicot,6/22/20,0,0,0,0,0,0,0,0,0,88,0,929,0,42,0,2,0,44,0,1017,0,0,0,0,0,0,0,7,7,0,74
Clark,6/22/20,0,0,0,0,0,0,0,0,0,53,0,1682,0,43,0,0,0,10,0,1735,0,0,0,0,0,0,0,2,0,0,137
Clay,6/22/20,0,0,0,0,0,0,0,0,0,46,0,1183,0,7,0,2,0,37,0,1229,0,0,0,0,0,0,0,6,0,0,114
Cleburne,6/22/20,0,0,0,0,0,0,0,0,0,77,0,1491,0,70,0,4,0,3,0,1568,0,0,0,0,0,0,0,0,0,0,38
Cleveland,6/22/20,0,0,0,0,0,0,0,0,0,25,0,518,0,20,0,0,0,5,0,543,0,0,0,0,0,0,0,0,1,0,10
Columbia,6/22/20,0,0,0,0,0,0,0,0,0,43,0,991,0,23,0,2,0,18,0,1034,0,0,0,0,0,0,0,5,1,0,34
Conway,6/22/20,0,0,0,0,0,0,0,0,0,34,0,1043,0,21,0,3,0,10,0,1077,0,0,0,0,0,0,0,0,1,0,24
Craighead,6/22/20,0,0,0,0,0,0,0,0,0,401,0,8688,0,336,0,5,0,60,0,9089,0,0,0,0,0,0,0,5,8,0,138
Crawford,6/22/20,0,0,0,0,0,0,0,0,0,98,0,2871,0,48,0,0,0,50,0,2969,0,0,0,0,0,0,0,1,2,0,259
Crittenden,6/22/20,0,0,0,0,0,0,0,0,0,600,0,5144,0,487,0,10,0,103,0,5744,0,0,0,0,0,0,0,12,6,0,62
Cross,6/22/20,0,0,0,0,0,0,0,0,0,82,0,1283,0,70,0,1,0,11,0,1365,0,0,0,0,0,0,0,0,0,0,25
Dallas,6/22/20,0,0,0,0,0,0,0,0,0,6,0,323,0,2,0,0,0,4,0,329,0,0,0,0,0,0,0,0,0,0,13
Desha,6/22/20,0,0,0,0,0,0,0,0,0,29,0,706,0,21,0,0,0,8,0,735,0,0,0,0,0,0,0,0,1,0,16
Drew,6/22/20,0,0,0,0,0,0,0,0,0,39,0,1133,0,24,0,1,0,14,0,1172,0,0,0,0,0,0,0,2,1,0,24
Faulkner,6/22/20,0,0,0,0,0,0,0,0,0,290,0,7455,0,144,0,3,0,143,0,7745,0,0,0,0,0,0,0,21,7,0,247
Franklin,6/22/20,0,0,0,0,0,0,0,0,0,13,0,769,0,7,0,0,0,6,0,782,0,0,0,0,0,0,0,1,0,0,38
Fulton,6/22/20,0,0,0,0,0,0,0,0,0,10,0,674,0,8,0,0,0,2,0,684,0,0,0,0,0,0,0,1,0,0,28
Garland,6/22/20,0,0,0,0,0,0,0,0,0,180,0,5542,0,155,0,1,0,24,0,5722,0,0,0,0,0,0,0,3,4,0,200
Grant,6/22/20,0,0,0,0,0,0,0,0,0,27,0,897,0,24,0,0,0,3,0,924,0,0,0,0,0,0,0,1,2,0,19
Greene,6/22/20,0,0,0,0,0,0,0,0,0,94,0,3161,0,67,0,0,0,27,0,3255,0,0,0,0,0,0,0,1,0,0,123
Hempstead,6/22/20,0,0,0,0,0,0,0,0,0,45,0,1367,0,33,0,1,0,11,0,1412,0,0,0,0,0,0,0,1,1,0,66
HotSpring,6/22/20,0,0,0,0,0,0,0,0,0,138,0,1694,0,36,0,0,0,102,0,1832,0,0,0,0,0,0,0,85,0,0,406
Howard,6/22/20,0,0,0,0,0,0,0,0,0,68,0,977,0,39,0,0,0,29,0,1045,0,0,0,0,0,0,0,0,0,0,27
Independence,6/22/20,0,0,0,0,0,0,0,0,0,46,0,1963,0,41,0,0,0,5,0,2009,0,0,0,0,0,0,0,0,5,0,163
Izard,6/22/20,0,0,0,0,0,0,0,0,0,20,0,567,0,18,0,1,0,1,0,587,0,0,0,0,0,0,0,0,0,0,19
Jackson,6/22/20,0,0,0,0,0,0,0,0,0,24,0,680,0,11,0,0,0,13,0,704,0,0,0,0,0,0,0,3,1,0,17
Jefferson,6/22/20,0,0,0,0,0,0,0,0,0,657,0,4955,0,523,0,28,0,106,0,5612,0,0,0,0,0,0,0,7,2,0,84
Johnson,6/22/20,0,0,0,0,0,0,0,0,0,158,0,1082,0,81,0,0,0,77,0,1240,0,0,0,0,0,0,0,12,5,0,46
Lafayette,6/22/20,0,0,0,0,0,0,0,0,0,13,0,291,0,10,0,1,0,2,0,304,0,0,0,0,0,0,0,0,0,0,5
Lawrence,6/22/20,0,0,0,0,0,0,0,0,0,94,0,1194,0,75,0,9,0,10,0,1288,0,0,0,0,0,0,0,1,1,0,36
Lee,6/22/20,0,0,0,0,0,0,0,0,0,576,0,1827,0,64,0,1,0,511,0,2403,0,0,0,0,0,0,0,2,17,0,79
Lincoln,6/22/20,0,0,0,0,0,0,0,0,0,1036,0,1418,0,964,0,11,0,61,0,2454,0,0,0,0,0,0,0,0,0,0,14
LittleRiver,6/22/20,0,0,0,0,0,0,0,0,0,35,0,794,0,32,0,0,0,3,0,829,0,0,0,0,0,0,0,0,0,0,1
Logan,6/22/20,0,0,0,0,0,0,0,0,0,32,0,1274,0,16,0,0,0,16,0,1306,0,0,0,0,0,0,0,4,0,0,137
Lonoke,6/22/20,0,0,0,0,0,0,0,0,0,89,0,2979,0,67,0,0,0,22,0,3068,0,0,0,0,0,0,0,1,1,0,49
Madison,6/22/20,0,0,0,0,0,0,0,0,0,154,0,1511,0,79,0,0,0,75,0,1665,0,0,0,0,0,0,0,8,4,0,141
Marion,6/22/20,0,0,0,0,0,0,0,0,0,2,0,592,0,2,0,0,0,0,0,594,0,0,0,0,0,0,0,0,0,0,1
Miller,6/22/20,0,0,0,0,0,0,0,0,0,92,0,1721,0,74,0,2,0,16,0,1813,0,0,0,0,0,0,0,1,4,0,40
MissingCountyInfo,6/22/20,0,0,0,0,0,0,0,0,0,584,0,44716,0,230,0,0,0,354,0,45300,0,0,0,0,0,0,0,13,15,0,703
Mississippi,6/22/20,0,0,0,0,0,0,0,0,0,115,0,3005,0,90,0,3,0,22,0,3120,0,0,0,0,0,0,0,1,2,0,41
Monroe,6/22/20,0,0,0,0,0,0,0,0,0,7,0,537,0,5,0,0,0,2,0,544,0,0,0,0,0,0,0,0,0,0,6
Montgomery,6/22/20,0,0,0,0,0,0,0,0,0,2,0,305,0,2,0,0,0,0,0,307,0,0,0,0,0,0,0,0,0,0,45
Nevada,6/22/20,0,0,0,0,0,0,0,0,0,94,0,1079,0,68,0,2,0,24,0,1173,0,0,0,0,0,0,0,7,2,0,426
Newton,6/22/20,0,0,0,0,0,0,0,0,0,4,0,363,0,3,0,0,0,1,0,367,0,0,0,0,0,0,0,0,0,0,6
Ouachita,6/22/20,0,0,0,0,0,0,0,0,0,17,0,1411,0,12,0,0,0,5,0,1428,0,0,0,0,0,0,0,0,0,0,53
Perry,6/22/20,0,0,0,0,0,0,0,0,0,21,0,647,0,15,0,0,0,6,0,668,0,0,0,0,0,0,0,1,0,0,14
Phillips,6/22/20,0,0,0,0,0,0,0,0,0,87,0,1541,0,35,0,2,0,50,0,1628,0,0,0,0,0,0,0,8,2,0,113
Pike,6/22/20,0,0,0,0,0,0,0,0,0,7,0,1427,0,6,0,0,0,1,0,1434,0,0,0,0,0,0,0,0,0,0,52
Poinsett,6/22/20,0,0,0,0,0,0,0,0,0,53,0,1440,0,43,0,3,0,7,0,1493,0,0,0,0,0,0,0,0,3,0,21
Polk,6/22/20,0,0,0,0,0,0,0,0,0,67,0,1194,0,54,0,0,0,13,0,1261,0,0,0,0,0,0,0,3,1,0,140
Pope,6/22/20,0,0,0,0,0,0,0,0,0,333,0,4125,0,237,0,2,0,94,0,4458,0,0,0,0,0,0,0,7,6,0,215
Prairie,6/22/20,0,0,0,0,0,0,0,0,0,16,0,363,0,5,0,0,0,11,0,379,0,0,0,0,0,0,0,3,1,0,14
Pulaski,6/22/20,0,0,0,0,0,0,0,0,0,1531,0,25723,0,1134,0,52,0,345,0,27254,0,0,0,0,0,0,0,17,28,0,493
Randolph,6/22/20,0,0,0,0,0,0,0,0,0,39,0,1516,0,28,0,1,0,10,0,1555,0,0,0,0,0,0,0,5,1,0,56
Saline,6/22/20,0,0,0,0,0,0,0,0,0,210,0,7592,0,171,0,2,0,37,0,7802,0,0,0,0,0,0,0,1,5,0,125
Scott,6/22/20,0,0,0,0,0,0,0,0,0,8,0,392,0,4,0,0,0,4,0,400,0,0,0,0,0,0,0,0,2,0,86
Searcy,6/22/20,0,0,0,0,0,0,0,0,0,7,0,685,0,7,0,0,0,0,0,692,0,0,0,0,0,0,0,0,0,0,8
Sebastian,6/22/20,0,0,0,0,0,0,0,0,0,250,0,5819,0,119,0,2,0,129,0,6069,0,0,0,0,0,0,0,6,6,0,135
Sevier,6/22/20,0,0,0,0,0,0,0,0,0,592,0,3015,0,393,0,6,0,193,0,3607,0,0,0,0,0,0,0,4,11,1,46
Sharp,6/22/20,0,0,0,0,0,0,0,0,0,51,0,793,0,43,0,4,0,4,0,844,0,0,0,0,0,0,0,1,0,0,34
St.Francis,6/22/20,0,0,0,0,0,0,0,0,0,792,0,4027,0,766,0,3,0,23,0,4819,0,0,0,0,0,0,0,1,3,0,116
Stone,6/22/20,0,0,0,0,0,0,0,0,0,13,0,676,0,10,0,0,0,3,0,689,0,0,0,0,0,0,0,2,0,0,22
Union,6/22/20,0,0,0,0,0,0,0,0,0,227,0,2610,0,180,0,13,0,34,0,2837,0,0,0,0,0,0,0,3,4,0,164
VanBuren,6/22/20,0,0,0,0,0,0,0,0,0,30,0,831,0,28,0,2,0,0,0,861,0,0,0,0,0,0,0,0,0,0,8
Washington,6/22/20,0,0,0,0,0,0,0,0,0,2531,0,10742,0,1522,0,18,0,991,0,13273,0,0,0,0,0,0,0,127,0,0,433
White,6/22/20,0,0,0,0,0,0,0,0,0,76,0,2769,0,51,0,1,0,24,0,2845,0,0,0,0,0,0,0,3,3,0,47
Woodruff,6/22/20,0,0,0,0,0,0,0,0,0,6,0,408,0,1,0,0,0,5,0,414,0,0,0,0,0,0,0,0,0,0,40
Yell,6/22/20,0,0,0,0,0,0,0,0,0,435,0,1376,0,273,0,3,0,159,0,1811,0,0,0,0,0,0,0,19,8,1,-39
Arkansas_all_counties,6/21/20,0,0,0,0,0,0,0,0,2990671,15561,0,232619,0,10456,0,225,0,4880,0,248180,0,0,0,0,0,0,0,419,374,1,5946
Arkansas_county,6/21/20,0,0,0,0,0,0,0,0,0,19,0,725,0,7,0,0,0,12,0,744,0,0,0,0,0,0,0,0,1,0,30
Ashley,6/21/20,0,0,0,0,0,0,0,0,0,53,0,1037,0,38,0,1,0,14,0,1090,0,0,0,0,0,0,0,1,2,0,26
Baxter,6/21/20,0,0,0,0,0,0,0,0,0,14,0,1478,0,13,0,0,0,1,0,1492,0,0,0,0,0,0,0,0,0,0,41
Benton,6/21/20,0,0,0,0,0,0,0,0,0,2003,0,26793,0,1248,0,13,0,742,0,28796,0,0,0,0,0,0,0,99,81,0,1044
Boone,6/21/20,0,0,0,0,0,0,0,0,0,11,0,1514,0,7,0,0,0,4,0,1525,0,0,0,0,0,0,0,0,0,0,18
Bradley,6/21/20,0,0,0,0,0,0,0,0,0,38,0,720,0,30,0,2,0,6,0,758,0,0,0,0,0,0,0,1,1,0,15
Calhoun,6/21/20,0,0,0,0,0,0,0,0,0,0,0,203,0,0,0,0,0,0,0,203,0,0,0,0,0,0,0,0,0,0,10
Carroll,6/21/20,0,0,0,0,0,0,0,0,0,129,0,1896,0,60,0,4,0,65,0,2025,0,0,0,0,0,0,0,3,5,0,33
Chicot,6/21/20,0,0,0,0,0,0,0,0,0,81,0,862,0,35,0,2,0,44,0,943,0,0,0,0,0,0,0,11,2,0,103
Clark,6/21/20,0,0,0,0,0,0,0,0,0,51,0,1547,0,43,0,0,0,8,0,1598,0,0,0,0,0,0,0,1,0,0,205
Clay,6/21/20,0,0,0,0,0,0,0,0,0,40,0,1075,0,7,0,2,0,31,0,1115,0,0,0,0,0,0,0,7,0,1,103
Cleburne,6/21/20,0,0,0,0,0,0,0,0,0,77,0,1453,0,70,0,4,0,3,0,1530,0,0,0,0,0,0,0,0,0,0,61
Cleveland,6/21/20,0,0,0,0,0,0,0,0,0,25,0,508,0,19,0,0,0,6,0,533,0,0,0,0,0,0,0,3,0,0,9
Columbia,6/21/20,0,0,0,0,0,0,0,0,0,38,0,962,0,22,0,2,0,14,0,1000,0,0,0,0,0,0,0,6,1,0,28
Conway,6/21/20,0,0,0,0,0,0,0,0,0,34,0,1019,0,20,0,3,0,11,0,1053,0,0,0,0,0,0,0,5,1,0,43
Craighead,6/21/20,0,0,0,0,0,0,0,0,0,396,0,8555,0,328,0,5,0,63,0,8951,0,0,0,0,0,0,0,8,2,0,103
Crawford,6/21/20,0,0,0,0,0,0,0,0,0,97,0,2613,0,46,0,0,0,51,0,2710,0,0,0,0,0,0,0,6,2,0,154
Crittenden,6/21/20,0,0,0,0,0,0,0,0,0,588,0,5094,0,481,0,10,0,97,0,5682,0,0,0,0,0,0,0,11,6,0,65
Cross,6/21/20,0,0,0,0,0,0,0,0,0,82,0,1258,0,70,0,1,0,11,0,1340,0,0,0,0,0,0,0,0,3,0,7
Dallas,6/21/20,0,0,0,0,0,0,0,0,0,6,0,310,0,2,0,0,0,4,0,316,0,0,0,0,0,0,0,0,0,0,12
Desha,6/21/20,0,0,0,0,0,0,0,0,0,29,0,690,0,20,0,0,0,9,0,719,0,0,0,0,0,0,0,1,1,0,17
Drew,6/21/20,0,0,0,0,0,0,0,0,0,37,0,1111,0,23,0,1,0,13,0,1148,0,0,0,0,0,0,0,3,0,0,57
Faulkner,6/21/20,0,0,0,0,0,0,0,0,0,269,0,7229,0,137,0,3,0,129,0,7498,0,0,0,0,0,0,0,23,4,0,643
Franklin,6/21/20,0,0,0,0,0,0,0,0,0,12,0,732,0,7,0,0,0,5,0,744,0,0,0,0,0,0,0,2,1,0,28
Fulton,6/21/20,0,0,0,0,0,0,0,0,0,9,0,647,0,8,0,0,0,1,0,656,0,0,0,0,0,0,0,0,0,0,5
Garland,6/21/20,0,0,0,0,0,0,0,0,0,177,0,5345,0,151,0,1,0,25,0,5522,0,0,0,0,0,0,0,0,4,0,47
Grant,6/21/20,0,0,0,0,0,0,0,0,0,26,0,879,0,22,0,0,0,4,0,905,0,0,0,0,0,0,0,1,0,0,10
Greene,6/21/20,0,0,0,0,0,0,0,0,0,93,0,3039,0,67,0,0,0,26,0,3132,0,0,0,0,0,0,0,4,0,0,53
Hempstead,6/21/20,0,0,0,0,0,0,0,0,0,44,0,1302,0,32,0,1,0,11,0,1346,0,0,0,0,0,0,0,0,1,0,37
HotSpring,6/21/20,0,0,0,0,0,0,0,0,0,53,0,1373,0,36,0,0,0,17,0,1426,0,0,0,0,0,0,0,0,1,0,16
Howard,6/21/20,0,0,0,0,0,0,0,0,0,68,0,950,0,39,0,0,0,29,0,1018,0,0,0,0,0,0,0,6,1,0,29
Independence,6/21/20,0,0,0,0,0,0,0,0,0,46,0,1800,0,36,0,0,0,10,0,1846,0,0,0,0,0,0,0,2,0,0,33
Izard,6/21/20,0,0,0,0,0,0,0,0,0,20,0,548,0,18,0,1,0,1,0,568,0,0,0,0,0,0,0,0,0,0,3
Jackson,6/21/20,0,0,0,0,0,0,0,0,0,21,0,666,0,10,0,0,0,11,0,687,0,0,0,0,0,0,0,0,1,0,13
Jefferson,6/21/20,0,0,0,0,0,0,0,0,0,650,0,4878,0,521,0,28,0,101,0,5528,0,0,0,0,0,0,0,6,3,0,74
Johnson,6/21/20,0,0,0,0,0,0,0,0,0,146,0,1048,0,76,0,0,0,70,0,1194,0,0,0,0,0,0,0,11,2,0,27
Lafayette,6/21/20,0,0,0,0,0,0,0,0,0,13,0,286,0,10,0,1,0,2,0,299,0,0,0,0,0,0,0,0,0,0,3
Lawrence,6/21/20,0,0,0,0,0,0,0,0,0,93,0,1159,0,74,0,9,0,10,0,1252,0,0,0,0,0,0,0,0,0,0,8
Lee,6/21/20,0,0,0,0,0,0,0,0,0,574,0,1750,0,47,0,1,0,526,0,2324,0,0,0,0,0,0,0,2,7,0,19
Lincoln,6/21/20,0,0,0,0,0,0,0,0,0,1036,0,1404,0,964,0,11,0,61,0,2440,0,0,0,0,0,0,0,0,0,0,8
LittleRiver,6/21/20,0,0,0,0,0,0,0,0,0,35,0,793,0,32,0,0,0,3,0,828,0,0,0,0,0,0,0,0,1,0,23
Logan,6/21/20,0,0,0,0,0,0,0,0,0,28,0,1141,0,16,0,0,0,12,0,1169,0,0,0,0,0,0,0,4,0,0,80
Lonoke,6/21/20,0,0,0,0,0,0,0,0,0,88,0,2931,0,66,0,0,0,22,0,3019,0,0,0,0,0,0,0,2,1,0,50
Madison,6/21/20,0,0,0,0,0,0,0,0,0,146,0,1378,0,75,0,0,0,71,0,1524,0,0,0,0,0,0,0,4,1,0,30
Marion,6/21/20,0,0,0,0,0,0,0,0,0,2,0,591,0,2,0,0,0,0,0,593,0,0,0,0,0,0,0,0,0,0,25
Miller,6/21/20,0,0,0,0,0,0,0,0,0,91,0,1682,0,70,0,2,0,19,0,1773,0,0,0,0,0,0,0,4,3,0,50
MissingCountyInfo,6/21/20,0,0,0,0,0,0,0,0,0,571,0,44026,0,215,0,0,0,356,0,44597,0,0,0,0,0,0,0,11,8,0,470
Mississippi,6/21/20,0,0,0,0,0,0,0,0,0,114,0,2965,0,88,0,3,0,23,0,3079,0,0,0,0,0,0,0,4,1,0,62
Monroe,6/21/20,0,0,0,0,0,0,0,0,0,7,0,531,0,5,0,0,0,2,0,538,0,0,0,0,0,0,0,0,0,0,12
Montgomery,6/21/20,0,0,0,0,0,0,0,0,0,2,0,260,0,2,0,0,0,0,0,262,0,0,0,0,0,0,0,0,0,0,0
Nevada,6/21/20,0,0,0,0,0,0,0,0,0,87,0,660,0,66,0,2,0,19,0,747,0,0,0,0,0,0,0,0,41,0,27
Newton,6/21/20,0,0,0,0,0,0,0,0,0,4,0,357,0,3,0,0,0,1,0,361,0,0,0,0,0,0,0,1,0,0,2
Ouachita,6/21/20,0,0,0,0,0,0,0,0,0,17,0,1358,0,12,0,0,0,5,0,1375,0,0,0,0,0,0,0,0,0,0,17
Perry,6/21/20,0,0,0,0,0,0,0,0,0,20,0,634,0,15,0,0,0,5,0,654,0,0,0,0,0,0,0,-5,-1,0,6
Phillips,6/21/20,0,0,0,0,0,0,0,0,0,79,0,1436,0,33,0,2,0,44,0,1515,0,0,0,0,0,0,0,0,0,0,9
Pike,6/21/20,0,0,0,0,0,0,0,0,0,7,0,1375,0,6,0,0,0,1,0,1382,0,0,0,0,0,0,0,0,0,0,31
Poinsett,6/21/20,0,0,0,0,0,0,0,0,0,53,0,1419,0,40,0,3,0,10,0,1472,0,0,0,0,0,0,0,0,0,0,22
Polk,6/21/20,0,0,0,0,0,0,0,0,0,64,0,1057,0,53,0,0,0,11,0,1121,0,0,0,0,0,0,0,1,3,0,7
Pope,6/21/20,0,0,0,0,0,0,0,0,0,326,0,3917,0,231,0,2,0,93,0,4243,0,0,0,0,0,0,0,4,4,0,40
Prairie,6/21/20,0,0,0,0,0,0,0,0,0,13,0,352,0,4,0,0,0,9,0,365,0,0,0,0,0,0,0,1,0,0,16
Pulaski,6/21/20,0,0,0,0,0,0,0,0,0,1514,0,25247,0,1106,0,52,0,356,0,26761,0,0,0,0,0,0,0,15,14,0,463
Randolph,6/21/20,0,0,0,0,0,0,0,0,0,34,0,1465,0,27,0,1,0,6,0,1499,0,0,0,0,0,0,0,0,1,0,21
Saline,6/21/20,0,0,0,0,0,0,0,0,0,209,0,7468,0,166,0,2,0,41,0,7677,0,0,0,0,0,0,0,9,8,0,110
Scott,6/21/20,0,0,0,0,0,0,0,0,0,8,0,306,0,2,0,0,0,6,0,314,0,0,0,0,0,0,0,0,0,0,7
Searcy,6/21/20,0,0,0,0,0,0,0,0,0,7,0,677,0,7,0,0,0,0,0,684,0,0,0,0,0,0,0,0,0,0,7
Sebastian,6/21/20,0,0,0,0,0,0,0,0,0,244,0,5690,0,113,0,2,0,129,0,5934,0,0,0,0,0,0,0,18,8,0,274
Sevier,6/21/20,0,0,0,0,0,0,0,0,0,588,0,2973,0,382,0,5,0,201,0,3561,0,0,0,0,0,0,0,25,6,0,85
Sharp,6/21/20,0,0,0,0,0,0,0,0,0,50,0,760,0,43,0,4,0,3,0,810,0,0,0,0,0,0,0,0,1,0,6
St.Francis,6/21/20,0,0,0,0,0,0,0,0,0,791,0,3912,0,763,0,3,0,25,0,4703,0,0,0,0,0,0,0,0,5,0,14
Stone,6/21/20,0,0,0,0,0,0,0,0,0,11,0,656,0,10,0,0,0,1,0,667,0,0,0,0,0,0,0,0,1,0,11
Union,6/21/20,0,0,0,0,0,0,0,0,0,224,0,2449,0,176,0,13,0,35,0,2673,0,0,0,0,0,0,0,1,2,0,146
VanBuren,6/21/20,0,0,0,0,0,0,0,0,0,30,0,823,0,28,0,2,0,0,0,853,0,0,0,0,0,0,0,0,0,0,18
Washington,6/21/20,0,0,0,0,0,0,0,0,0,2404,0,10436,0,1441,0,18,0,945,0,12840,0,0,0,0,0,0,0,83,163,0,463
White,6/21/20,0,0,0,0,0,0,0,0,0,73,0,2725,0,48,0,1,0,24,0,2798,0,0,0,0,0,0,0,0,0,0,38
Woodruff,6/21/20,0,0,0,0,0,0,0,0,0,6,0,368,0,1,0,0,0,5,0,374,0,0,0,0,0,0,0,1,0,0,19
Yell,6/21/20,0,0,0,0,0,0,0,0,0,416,0,1434,0,265,0,2,0,149,0,1850,0,0,0,0,0,0,0,13,5,0,136
Arkansas_all_counties,6/20/20,0,0,0,0,0,0,0,0,2990671,15142,0,227092,0,10082,0,224,0,4836,0,242234,0,0,0,0,0,0,0,511,370,10,7462
Arkansas_county,6/20/20,0,0,0,0,0,0,0,0,0,19,0,695,0,6,0,0,0,13,0,714,0,0,0,0,0,0,0,1,0,0,32
Ashley,6/20/20,0,0,0,0,0,0,0,0,0,52,0,1012,0,36,0,1,0,15,0,1064,0,0,0,0,0,0,0,1,1,0,10
Baxter,6/20/20,0,0,0,0,0,0,0,0,0,14,0,1437,0,13,0,0,0,1,0,1451,0,0,0,0,0,0,0,0,0,0,6
Benton,6/20/20,0,0,0,0,0,0,0,0,0,1904,0,25848,0,1167,0,13,0,724,0,27752,0,0,0,0,0,0,0,63,62,2,768
Boone,6/20/20,0,0,0,0,0,0,0,0,0,11,0,1496,0,7,0,0,0,4,0,1507,0,0,0,0,0,0,0,1,0,0,20
Bradley,6/20/20,0,0,0,0,0,0,0,0,0,37,0,706,0,29,0,2,0,6,0,743,0,0,0,0,0,0,0,2,0,0,16
Calhoun,6/20/20,0,0,0,0,0,0,0,0,0,0,0,193,0,0,0,0,0,0,0,193,0,0,0,0,0,0,0,0,0,0,4
Carroll,6/20/20,0,0,0,0,0,0,0,0,0,126,0,1866,0,55,0,4,0,67,0,1992,0,0,0,0,0,0,0,24,7,1,58
Chicot,6/20/20,0,0,0,0,0,0,0,0,0,70,0,770,0,33,0,2,0,35,0,840,0,0,0,0,0,0,0,3,3,0,41
Clark,6/20/20,0,0,0,0,0,0,0,0,0,50,0,1343,0,43,0,0,0,7,0,1393,0,0,0,0,0,0,0,0,0,0,181
Clay,6/20/20,0,0,0,0,0,0,0,0,0,33,0,979,0,7,0,1,0,25,0,1012,0,0,0,0,0,0,0,2,0,1,28
Cleburne,6/20/20,0,0,0,0,0,0,0,0,0,77,0,1392,0,70,0,4,0,3,0,1469,0,0,0,0,0,0,0,1,0,0,23
Cleveland,6/20/20,0,0,0,0,0,0,0,0,0,22,0,502,0,19,0,0,0,3,0,524,0,0,0,0,0,0,0,0,0,0,15
Columbia,6/20/20,0,0,0,0,0,0,0,0,0,32,0,940,0,21,0,2,0,9,0,972,0,0,0,0,0,0,0,1,0,0,87
Conway,6/20/20,0,0,0,0,0,0,0,0,0,29,0,981,0,19,0,3,0,7,0,1010,0,0,0,0,0,0,0,3,3,0,49
Craighead,6/20/20,0,0,0,0,0,0,0,0,0,388,0,8460,0,326,0,5,0,57,0,8848,0,0,0,0,0,0,0,3,9,0,71
Crawford,6/20/20,0,0,0,0,0,0,0,0,0,91,0,2465,0,44,0,0,0,47,0,2556,0,0,0,0,0,0,0,8,1,0,67
Crittenden,6/20/20,0,0,0,0,0,0,0,0,0,577,0,5040,0,475,0,10,0,92,0,5617,0,0,0,0,0,0,0,4,5,0,143
Cross,6/20/20,0,0,0,0,0,0,0,0,0,82,0,1251,0,67,0,1,0,14,0,1333,0,0,0,0,0,0,0,0,1,0,19
Dallas,6/20/20,0,0,0,0,0,0,0,0,0,6,0,298,0,2,0,0,0,4,0,304,0,0,0,0,0,0,0,2,0,0,42
Desha,6/20/20,0,0,0,0,0,0,0,0,0,28,0,674,0,19,0,0,0,9,0,702,0,0,0,0,0,0,0,2,0,0,27
Drew,6/20/20,0,0,0,0,0,0,0,0,0,34,0,1057,0,23,0,1,0,10,0,1091,0,0,0,0,0,0,0,2,1,0,21
Faulkner,6/20/20,0,0,0,0,0,0,0,0,0,246,0,6609,0,133,0,3,0,110,0,6855,0,0,0,0,0,0,0,19,3,0,749
Franklin,6/20/20,0,0,0,0,0,0,0,0,0,10,0,706,0,6,0,0,0,4,0,716,0,0,0,0,0,0,0,0,0,0,13
Fulton,6/20/20,0,0,0,0,0,0,0,0,0,9,0,642,0,8,0,0,0,1,0,651,0,0,0,0,0,0,0,0,0,0,8
Garland,6/20/20,0,0,0,0,0,0,0,0,0,177,0,5298,0,147,0,1,0,29,0,5475,0,0,0,0,0,0,0,5,3,0,58
Grant,6/20/20,0,0,0,0,0,0,0,0,0,25,0,870,0,22,0,0,0,3,0,895,0,0,0,0,0,0,0,1,0,0,25
Greene,6/20/20,0,0,0,0,0,0,0,0,0,89,0,2990,0,67,0,0,0,22,0,3079,0,0,0,0,0,0,0,2,0,0,47
Hempstead,6/20/20,0,0,0,0,0,0,0,0,0,44,0,1265,0,31,0,1,0,12,0,1309,0,0,0,0,0,0,0,1,3,0,29
HotSpring,6/20/20,0,0,0,0,0,0,0,0,0,53,0,1357,0,35,0,0,0,18,0,1410,0,0,0,0,0,0,0,7,1,0,31
Howard,6/20/20,0,0,0,0,0,0,0,0,0,62,0,927,0,38,0,0,0,24,0,989,0,0,0,0,0,0,0,8,4,0,33
Independence,6/20/20,0,0,0,0,0,0,0,0,0,44,0,1769,0,36,0,0,0,8,0,1813,0,0,0,0,0,0,0,0,1,0,17
Izard,6/20/20,0,0,0,0,0,0,0,0,0,20,0,545,0,18,0,1,0,1,0,565,0,0,0,0,0,0,0,0,0,0,9
Jackson,6/20/20,0,0,0,0,0,0,0,0,0,21,0,653,0,9,0,0,0,12,0,674,0,0,0,0,0,0,0,1,0,0,8
Jefferson,6/20/20,0,0,0,0,0,0,0,0,0,644,0,4810,0,518,0,28,0,98,0,5454,0,0,0,0,0,0,0,4,0,0,88
Johnson,6/20/20,0,0,0,0,0,0,0,0,0,135,0,1032,0,74,0,0,0,61,0,1167,0,0,0,0,0,0,0,14,4,0,43
Lafayette,6/20/20,0,0,0,0,0,0,0,0,0,13,0,283,0,10,0,1,0,2,0,296,0,0,0,0,0,0,0,0,0,0,15
Lawrence,6/20/20,0,0,0,0,0,0,0,0,0,93,0,1151,0,74,0,9,0,10,0,1244,0,0,0,0,0,0,0,0,0,0,24
Lee,6/20/20,0,0,0,0,0,0,0,0,0,572,0,1733,0,40,0,1,0,531,0,2305,0,0,0,0,0,0,0,2,1,0,35
Lincoln,6/20/20,0,0,0,0,0,0,0,0,0,1036,0,1396,0,964,0,11,0,61,0,2432,0,0,0,0,0,0,0,13,2,0,87
LittleRiver,6/20/20,0,0,0,0,0,0,0,0,0,35,0,770,0,31,0,0,0,4,0,805,0,0,0,0,0,0,0,0,3,0,9
Logan,6/20/20,0,0,0,0,0,0,0,0,0,24,0,1065,0,16,0,0,0,8,0,1089,0,0,0,0,0,0,0,3,1,0,232
Lonoke,6/20/20,0,0,0,0,0,0,0,0,0,86,0,2883,0,65,0,0,0,21,0,2969,0,0,0,0,0,0,0,2,3,0,52
Madison,6/20/20,0,0,0,0,0,0,0,0,0,142,0,1352,0,74,0,0,0,68,0,1494,0,0,0,0,0,0,0,5,7,0,88
Marion,6/20/20,0,0,0,0,0,0,0,0,0,2,0,566,0,2,0,0,0,0,0,568,0,0,0,0,0,0,0,0,0,0,4
Miller,6/20/20,0,0,0,0,0,0,0,0,0,87,0,1636,0,67,0,2,0,18,0,1723,0,0,0,0,0,0,0,9,8,0,51
MissingCountyInfo,6/20/20,0,0,0,0,0,0,0,0,0,560,0,43567,0,207,0,0,0,353,0,44127,0,0,0,0,0,0,0,27,1,0,1183
Mississippi,6/20/20,0,0,0,0,0,0,0,0,0,110,0,2907,0,87,0,3,0,20,0,3017,0,0,0,0,0,0,0,3,1,0,105
Monroe,6/20/20,0,0,0,0,0,0,0,0,0,7,0,519,0,5,0,0,0,2,0,526,0,0,0,0,0,0,0,0,0,0,25
Montgomery,6/20/20,0,0,0,0,0,0,0,0,0,2,0,260,0,2,0,0,0,0,0,262,0,0,0,0,0,0,0,0,0,0,7
Nevada,6/20/20,0,0,0,0,0,0,0,0,0,87,0,633,0,25,0,2,0,60,0,720,0,0,0,0,0,0,0,0,1,0,12
Newton,6/20/20,0,0,0,0,0,0,0,0,0,3,0,356,0,3,0,0,0,0,0,359,0,0,0,0,0,0,0,0,0,0,6
Ouachita,6/20/20,0,0,0,0,0,0,0,0,0,17,0,1341,0,12,0,0,0,5,0,1358,0,0,0,0,0,0,0,0,0,0,67
Perry,6/20/20,0,0,0,0,0,0,0,0,0,25,0,623,0,16,0,0,0,9,0,648,0,0,0,0,0,0,0,1,1,0,23
Phillips,6/20/20,0,0,0,0,0,0,0,0,0,79,0,1427,0,33,0,2,0,44,0,1506,0,0,0,0,0,0,0,4,3,1,94
Pike,6/20/20,0,0,0,0,0,0,0,0,0,7,0,1344,0,6,0,0,0,1,0,1351,0,0,0,0,0,0,0,0,0,0,44
Poinsett,6/20/20,0,0,0,0,0,0,0,0,0,53,0,1397,0,40,0,3,0,10,0,1450,0,0,0,0,0,0,0,1,0,0,24
Polk,6/20/20,0,0,0,0,0,0,0,0,0,63,0,1051,0,50,0,0,0,13,0,1114,0,0,0,0,0,0,0,1,2,0,12
Pope,6/20/20,0,0,0,0,0,0,0,0,0,322,0,3881,0,227,0,2,0,93,0,4203,0,0,0,0,0,0,0,18,7,0,93
Prairie,6/20/20,0,0,0,0,0,0,0,0,0,12,0,337,0,4,0,0,0,8,0,349,0,0,0,0,0,0,0,0,0,0,11
Pulaski,6/20/20,0,0,0,0,0,0,0,0,0,1499,0,24799,0,1092,0,52,0,355,0,26298,0,0,0,0,0,0,0,54,26,4,901
Randolph,6/20/20,0,0,0,0,0,0,0,0,0,34,0,1444,0,26,0,1,0,7,0,1478,0,0,0,0,0,0,0,3,1,0,29
Saline,6/20/20,0,0,0,0,0,0,0,0,0,200,0,7367,0,158,0,2,0,40,0,7567,0,0,0,0,0,0,0,5,5,0,132
Scott,6/20/20,0,0,0,0,0,0,0,0,0,8,0,299,0,2,0,0,0,6,0,307,0,0,0,0,0,0,0,1,0,0,18
Searcy,6/20/20,0,0,0,0,0,0,0,0,0,7,0,670,0,7,0,0,0,0,0,677,0,0,0,0,0,0,0,0,0,0,3
Sebastian,6/20/20,0,0,0,0,0,0,0,0,0,226,0,5434,0,105,0,2,0,119,0,5660,0,0,0,0,0,0,0,7,6,0,151
Sevier,6/20/20,0,0,0,0,0,0,0,0,0,563,0,2913,0,376,0,5,0,182,0,3476,0,0,0,0,0,0,0,13,17,0,65
Sharp,6/20/20,0,0,0,0,0,0,0,0,0,50,0,754,0,42,0,4,0,4,0,804,0,0,0,0,0,0,0,0,0,0,5
St.Francis,6/20/20,0,0,0,0,0,0,0,0,0,791,0,3898,0,758,0,3,0,30,0,4689,0,0,0,0,0,0,0,8,4,0,47
Stone,6/20/20,0,0,0,0,0,0,0,0,0,11,0,645,0,9,0,0,0,2,0,656,0,0,0,0,0,0,0,0,0,0,13
Union,6/20/20,0,0,0,0,0,0,0,0,0,223,0,2304,0,174,0,13,0,36,0,2527,0,0,0,0,0,0,0,3,0,0,128
VanBuren,6/20/20,0,0,0,0,0,0,0,0,0,30,0,805,0,28,0,2,0,0,0,835,0,0,0,0,0,0,0,0,1,0,9
Washington,6/20/20,0,0,0,0,0,0,0,0,0,2321,0,10056,0,1278,0,18,0,1025,0,12377,0,0,0,0,0,0,0,99,241,1,596
White,6/20/20,0,0,0,0,0,0,0,0,0,73,0,2687,0,48,0,1,0,24,0,2760,0,0,0,0,0,0,0,3,1,0,56
Woodruff,6/20/20,0,0,0,0,0,0,0,0,0,5,0,350,0,1,0,0,0,4,0,355,0,0,0,0,0,0,0,-1,0,0,20
Yell,6/20/20,0,0,0,0,0,0,0,0,0,403,0,1311,0,260,0,2,0,141,0,1714,0,0,0,0,0,0,0,42,11,0,100
Arkansas_all_counties,6/19/20,0,0,0,0,0,0,0,0,2990671,14631,0,220141,0,9712,0,214,0,4705,0,234772,0,0,0,0,0,0,0,703,336,6,6338
Arkansas_county,6/19/20,0,0,0,0,0,0,0,0,0,18,0,664,0,6,0,0,0,12,0,682,0,0,0,0,0,0,0,2,0,0,21
Ashley,6/19/20,0,0,0,0,0,0,0,0,0,51,0,1003,0,35,0,1,0,15,0,1054,0,0,0,0,0,0,0,0,1,0,5
Baxter,6/19/20,0,0,0,0,0,0,0,0,0,14,0,1431,0,13,0,0,0,1,0,1445,0,0,0,0,0,0,0,0,1,0,19
Benton,6/19/20,0,0,0,0,0,0,0,0,0,1841,0,25143,0,1105,0,11,0,725,0,26984,0,0,0,0,0,0,0,184,64,0,810
Boone,6/19/20,0,0,0,0,0,0,0,0,0,10,0,1477,0,7,0,0,0,3,0,1487,0,0,0,0,0,0,0,0,0,0,31
Bradley,6/19/20,0,0,0,0,0,0,0,0,0,35,0,692,0,29,0,2,0,4,0,727,0,0,0,0,0,0,0,0,2,0,8
Calhoun,6/19/20,0,0,0,0,0,0,0,0,0,0,0,189,0,0,0,0,0,0,0,189,0,0,0,0,0,0,0,0,0,0,2
Carroll,6/19/20,0,0,0,0,0,0,0,0,0,102,0,1832,0,48,0,3,0,51,0,1934,0,0,0,0,0,0,0,2,5,2,36
Chicot,6/19/20,0,0,0,0,0,0,0,0,0,67,0,732,0,30,0,2,0,35,0,799,0,0,0,0,0,0,0,1,4,0,12
Clark,6/19/20,0,0,0,0,0,0,0,0,0,50,0,1162,0,43,0,0,0,7,0,1212,0,0,0,0,0,0,0,0,1,0,8
Clay,6/19/20,0,0,0,0,0,0,0,0,0,31,0,953,0,7,0,0,0,24,0,984,0,0,0,0,0,0,0,7,1,0,22
Cleburne,6/19/20,0,0,0,0,0,0,0,0,0,76,0,1370,0,70,0,4,0,2,0,1446,0,0,0,0,0,0,0,0,0,0,37
Cleveland,6/19/20,0,0,0,0,0,0,0,0,0,22,0,487,0,19,0,0,0,3,0,509,0,0,0,0,0,0,0,2,0,0,9
Columbia,6/19/20,0,0,0,0,0,0,0,0,0,31,0,854,0,21,0,2,0,8,0,885,0,0,0,0,0,0,0,2,1,0,11
Conway,6/19/20,0,0,0,0,0,0,0,0,0,26,0,935,0,16,0,3,0,7,0,961,0,0,0,0,0,0,0,1,1,0,17
Craighead,6/19/20,0,0,0,0,0,0,0,0,0,385,0,8392,0,317,0,5,0,63,0,8777,0,0,0,0,0,0,0,13,6,0,187
Crawford,6/19/20,0,0,0,0,0,0,0,0,0,83,0,2406,0,43,0,0,0,40,0,2489,0,0,0,0,0,0,0,8,2,0,49
Crittenden,6/19/20,0,0,0,0,0,0,0,0,0,573,0,4901,0,470,0,10,0,93,0,5474,0,0,0,0,0,0,0,11,15,0,127
Cross,6/19/20,0,0,0,0,0,0,0,0,0,82,0,1232,0,66,0,1,0,15,0,1314,0,0,0,0,0,0,0,1,1,0,28
Dallas,6/19/20,0,0,0,0,0,0,0,0,0,4,0,258,0,2,0,0,0,2,0,262,0,0,0,0,0,0,0,0,0,0,1
Desha,6/19/20,0,0,0,0,0,0,0,0,0,26,0,649,0,19,0,0,0,7,0,675,0,0,0,0,0,0,0,1,0,0,7
Drew,6/19/20,0,0,0,0,0,0,0,0,0,32,0,1038,0,22,0,1,0,9,0,1070,0,0,0,0,0,0,0,3,1,0,22
Faulkner,6/19/20,0,0,0,0,0,0,0,0,0,227,0,5879,0,130,0,3,0,94,0,6106,0,0,0,0,0,0,0,22,9,0,287
Franklin,6/19/20,0,0,0,0,0,0,0,0,0,10,0,693,0,6,0,0,0,4,0,703,0,0,0,0,0,0,0,1,0,0,18
Fulton,6/19/20,0,0,0,0,0,0,0,0,0,9,0,634,0,8,0,0,0,1,0,643,0,0,0,0,0,0,0,0,0,0,8
Garland,6/19/20,0,0,0,0,0,0,0,0,0,172,0,5245,0,144,0,1,0,27,0,5417,0,0,0,0,0,0,0,2,0,0,55
Grant,6/19/20,0,0,0,0,0,0,0,0,0,24,0,846,0,22,0,0,0,2,0,870,0,0,0,0,0,0,0,0,0,0,16
Greene,6/19/20,0,0,0,0,0,0,0,0,0,87,0,2945,0,67,0,0,0,20,0,3032,0,0,0,0,0,0,0,9,0,0,49
Hempstead,6/19/20,0,0,0,0,0,0,0,0,0,43,0,1237,0,28,0,1,0,14,0,1280,0,0,0,0,0,0,0,2,3,0,21
HotSpring,6/19/20,0,0,0,0,0,0,0,0,0,46,0,1333,0,34,0,0,0,12,0,1379,0,0,0,0,0,0,0,0,0,0,25
Howard,6/19/20,0,0,0,0,0,0,0,0,0,54,0,902,0,34,0,0,0,20,0,956,0,0,0,0,0,0,0,7,0,0,15
Independence,6/19/20,0,0,0,0,0,0,0,0,0,44,0,1752,0,35,0,0,0,9,0,1796,0,0,0,0,0,0,0,1,0,0,16
Izard,6/19/20,0,0,0,0,0,0,0,0,0,20,0,536,0,18,0,1,0,1,0,556,0,0,0,0,0,0,0,0,0,0,12
Jackson,6/19/20,0,0,0,0,0,0,0,0,0,20,0,646,0,9,0,0,0,11,0,666,0,0,0,0,0,0,0,0,1,0,3
Jefferson,6/19/20,0,0,0,0,0,0,0,0,0,640,0,4726,0,518,0,28,0,94,0,5366,0,0,0,0,0,0,0,3,3,0,125
Johnson,6/19/20,0,0,0,0,0,0,0,0,0,121,0,1003,0,70,0,0,0,51,0,1124,0,0,0,0,0,0,0,14,2,0,58
Lafayette,6/19/20,0,0,0,0,0,0,0,0,0,13,0,268,0,10,0,1,0,2,0,281,0,0,0,0,0,0,0,1,0,0,4
Lawrence,6/19/20,0,0,0,0,0,0,0,0,0,93,0,1127,0,74,0,9,0,10,0,1220,0,0,0,0,0,0,0,1,0,0,11
Lee,6/19/20,0,0,0,0,0,0,0,0,0,570,0,1700,0,39,0,1,0,530,0,2270,0,0,0,0,0,0,0,-1,3,0,11
Lincoln,6/19/20,0,0,0,0,0,0,0,0,0,1023,0,1322,0,962,0,11,0,50,0,2345,0,0,0,0,0,0,0,28,1,0,199
LittleRiver,6/19/20,0,0,0,0,0,0,0,0,0,35,0,761,0,28,0,0,0,7,0,796,0,0,0,0,0,0,0,1,0,0,2
Logan,6/19/20,0,0,0,0,0,0,0,0,0,21,0,836,0,15,0,0,0,6,0,857,0,0,0,0,0,0,0,0,0,0,24
Lonoke,6/19/20,0,0,0,0,0,0,0,0,0,84,0,2833,0,62,0,0,0,22,0,2917,0,0,0,0,0,0,0,4,1,0,57
Madison,6/19/20,0,0,0,0,0,0,0,0,0,137,0,1269,0,67,0,0,0,70,0,1406,0,0,0,0,0,0,0,9,7,0,25
Marion,6/19/20,0,0,0,0,0,0,0,0,0,2,0,562,0,2,0,0,0,0,0,564,0,0,0,0,0,0,0,0,0,0,10
Miller,6/19/20,0,0,0,0,0,0,0,0,0,78,0,1594,0,59,0,2,0,17,0,1672,0,0,0,0,0,0,0,1,0,0,24
MissingCountyInfo,6/19/20,0,0,0,0,0,0,0,0,0,533,0,42411,0,206,0,0,0,327,0,42944,0,0,0,0,0,0,0,98,10,0,1279
Mississippi,6/19/20,0,0,0,0,0,0,0,0,0,107,0,2805,0,86,0,3,0,18,0,2912,0,0,0,0,0,0,0,2,-1,1,167
Monroe,6/19/20,0,0,0,0,0,0,0,0,0,7,0,494,0,5,0,0,0,2,0,501,0,0,0,0,0,0,0,0,0,0,45
Montgomery,6/19/20,0,0,0,0,0,0,0,0,0,2,0,253,0,2,0,0,0,0,0,255,0,0,0,0,0,0,0,0,0,0,6
Nevada,6/19/20,0,0,0,0,0,0,0,0,0,87,0,621,0,24,0,2,0,61,0,708,0,0,0,0,0,0,0,0,7,1,6
Newton,6/19/20,0,0,0,0,0,0,0,0,0,3,0,350,0,3,0,0,0,0,0,353,0,0,0,0,0,0,0,0,0,0,5
Ouachita,6/19/20,0,0,0,0,0,0,0,0,0,17,0,1274,0,12,0,0,0,5,0,1291,0,0,0,0,0,0,0,0,0,0,15
Perry,6/19/20,0,0,0,0,0,0,0,0,0,24,0,601,0,15,0,0,0,9,0,625,0,0,0,0,0,0,0,7,0,0,19
Phillips,6/19/20,0,0,0,0,0,0,0,0,0,75,0,1337,0,30,0,1,0,44,0,1412,0,0,0,0,0,0,0,11,1,0,134
Pike,6/19/20,0,0,0,0,0,0,0,0,0,7,0,1300,0,6,0,0,0,1,0,1307,0,0,0,0,0,0,0,0,0,0,27
Poinsett,6/19/20,0,0,0,0,0,0,0,0,0,52,0,1374,0,40,0,3,0,9,0,1426,0,0,0,0,0,0,0,0,0,0,53
Polk,6/19/20,0,0,0,0,0,0,0,0,0,62,0,1040,0,48,0,0,0,14,0,1102,0,0,0,0,0,0,0,2,5,0,15
Pope,6/19/20,0,0,0,0,0,0,0,0,0,304,0,3806,0,220,0,2,0,82,0,4110,0,0,0,0,0,0,0,3,9,0,123
Prairie,6/19/20,0,0,0,0,0,0,0,0,0,12,0,326,0,4,0,0,0,8,0,338,0,0,0,0,0,0,0,0,0,0,7
Pulaski,6/19/20,0,0,0,0,0,0,0,0,0,1445,0,23952,0,1066,0,48,0,331,0,25397,0,0,0,0,0,0,0,51,19,0,937
Randolph,6/19/20,0,0,0,0,0,0,0,0,0,31,0,1418,0,25,0,1,0,5,0,1449,0,0,0,0,0,0,0,2,1,0,10
Saline,6/19/20,0,0,0,0,0,0,0,0,0,195,0,7240,0,153,0,2,0,40,0,7435,0,0,0,0,0,0,0,5,7,0,180
Scott,6/19/20,0,0,0,0,0,0,0,0,0,7,0,282,0,2,0,0,0,5,0,289,0,0,0,0,0,0,0,1,0,0,11
Searcy,6/19/20,0,0,0,0,0,0,0,0,0,7,0,667,0,7,0,0,0,0,0,674,0,0,0,0,0,0,0,0,0,0,8
Sebastian,6/19/20,0,0,0,0,0,0,0,0,0,219,0,5290,0,99,0,2,0,118,0,5509,0,0,0,0,0,0,0,26,4,0,224
Sevier,6/19/20,0,0,0,0,0,0,0,0,0,550,0,2861,0,359,0,5,0,186,0,3411,0,0,0,0,0,0,0,44,15,0,139
Sharp,6/19/20,0,0,0,0,0,0,0,0,0,50,0,749,0,42,0,4,0,4,0,799,0,0,0,0,0,0,0,0,0,0,3
St.Francis,6/19/20,0,0,0,0,0,0,0,0,0,783,0,3859,0,754,0,3,0,26,0,4642,0,0,0,0,0,0,0,2,8,0,25
Stone,6/19/20,0,0,0,0,0,0,0,0,0,11,0,632,0,9,0,0,0,2,0,643,0,0,0,0,0,0,0,0,0,0,5
Union,6/19/20,0,0,0,0,0,0,0,0,0,220,0,2179,0,174,0,13,0,33,0,2399,0,0,0,0,0,0,0,2,0,0,32
VanBuren,6/19/20,0,0,0,0,0,0,0,0,0,30,0,796,0,27,0,2,0,1,0,826,0,0,0,0,0,0,0,0,0,0,14
Washington,6/19/20,0,0,0,0,0,0,0,0,0,2222,0,9559,0,1037,0,17,0,1168,0,11781,0,0,0,0,0,0,0,81,-21,2,169
White,6/19/20,0,0,0,0,0,0,0,0,0,70,0,2634,0,47,0,1,0,22,0,2704,0,0,0,0,0,0,0,1,0,0,36
Woodruff,6/19/20,0,0,0,0,0,0,0,0,0,6,0,329,0,1,0,0,0,5,0,335,0,0,0,0,0,0,0,1,0,0,14
Yell,6/19/20,0,0,0,0,0,0,0,0,0,361,0,1253,0,249,0,2,0,110,0,1614,0,0,0,0,0,0,0,21,5,0,77
Arkansas_all_counties,6/18/20,0,0,0,0,0,0,0,0,2990671,13928,0,214506,0,9376,0,208,0,4344,0,228434,0,0,0,0,0,0,0,322,380,11,7735
Arkansas_county,6/18/20,0,0,0,0,0,0,0,0,0,16,0,645,0,6,0,0,0,10,0,661,0,0,0,0,0,0,0,2,0,0,17
Ashley,6/18/20,0,0,0,0,0,0,0,0,0,51,0,998,0,34,0,1,0,16,0,1049,0,0,0,0,0,0,0,3,3,0,21
Baxter,6/18/20,0,0,0,0,0,0,0,0,0,14,0,1412,0,12,0,0,0,2,0,1426,0,0,0,0,0,0,0,0,0,0,8
Benton,6/18/20,0,0,0,0,0,0,0,0,0,1657,0,24517,0,1041,0,11,0,605,0,26174,0,0,0,0,0,0,0,45,56,2,823
Boone,6/18/20,0,0,0,0,0,0,0,0,0,10,0,1446,0,7,0,0,0,3,0,1456,0,0,0,0,0,0,0,0,0,0,27
Bradley,6/18/20,0,0,0,0,0,0,0,0,0,35,0,684,0,27,0,2,0,6,0,719,0,0,0,0,0,0,0,0,2,0,23
Calhoun,6/18/20,0,0,0,0,0,0,0,0,0,0,0,187,0,0,0,0,0,0,0,187,0,0,0,0,0,0,0,0,0,0,4
Carroll,6/18/20,0,0,0,0,0,0,0,0,0,100,0,1798,0,43,0,1,0,56,0,1898,0,0,0,0,0,0,0,5,0,0,30
Chicot,6/18/20,0,0,0,0,0,0,0,0,0,66,0,721,0,26,0,2,0,38,0,787,0,0,0,0,0,0,0,4,4,0,16
Clark,6/18/20,0,0,0,0,0,0,0,0,0,50,0,1154,0,42,0,0,0,8,0,1204,0,0,0,0,0,0,0,0,1,0,16
Clay,6/18/20,0,0,0,0,0,0,0,0,0,24,0,938,0,6,0,0,0,18,0,962,0,0,0,0,0,0,0,1,0,0,30
Cleburne,6/18/20,0,0,0,0,0,0,0,0,0,76,0,1333,0,70,0,4,0,2,0,1409,0,0,0,0,0,0,0,1,0,0,40
Cleveland,6/18/20,0,0,0,0,0,0,0,0,0,20,0,480,0,19,0,0,0,1,0,500,0,0,0,0,0,0,0,0,0,0,6
Columbia,6/18/20,0,0,0,0,0,0,0,0,0,29,0,845,0,20,0,2,0,7,0,874,0,0,0,0,0,0,0,1,0,0,10
Conway,6/18/20,0,0,0,0,0,0,0,0,0,25,0,919,0,15,0,3,0,7,0,944,0,0,0,0,0,0,0,1,0,0,18
Craighead,6/18/20,0,0,0,0,0,0,0,0,0,372,0,8218,0,311,0,5,0,56,0,8590,0,0,0,0,0,0,0,3,12,3,150
Crawford,6/18/20,0,0,0,0,0,0,0,0,0,75,0,2365,0,41,0,0,0,34,0,2440,0,0,0,0,0,0,0,6,1,0,72
Crittenden,6/18/20,0,0,0,0,0,0,0,0,0,562,0,4785,0,455,0,10,0,97,0,5347,0,0,0,0,0,0,0,8,11,0,277
Cross,6/18/20,0,0,0,0,0,0,0,0,0,81,0,1205,0,65,0,1,0,15,0,1286,0,0,0,0,0,0,0,2,4,0,165
Dallas,6/18/20,0,0,0,0,0,0,0,0,0,4,0,257,0,2,0,0,0,2,0,261,0,0,0,0,0,0,0,0,0,0,9
Desha,6/18/20,0,0,0,0,0,0,0,0,0,25,0,643,0,19,0,0,0,6,0,668,0,0,0,0,0,0,0,0,0,0,9
Drew,6/18/20,0,0,0,0,0,0,0,0,0,29,0,1019,0,21,0,1,0,7,0,1048,0,0,0,0,0,0,0,2,1,0,21
Faulkner,6/18/20,0,0,0,0,0,0,0,0,0,205,0,5614,0,121,0,3,0,81,0,5819,0,0,0,0,0,0,0,10,3,0,132
Franklin,6/18/20,0,0,0,0,0,0,0,0,0,9,0,676,0,6,0,0,0,3,0,685,0,0,0,0,0,0,0,0,0,0,41
Fulton,6/18/20,0,0,0,0,0,0,0,0,0,9,0,626,0,8,0,0,0,1,0,635,0,0,0,0,0,0,0,0,0,0,3
Garland,6/18/20,0,0,0,0,0,0,0,0,0,170,0,5192,0,144,0,1,0,25,0,5362,0,0,0,0,0,0,0,2,7,0,55
Grant,6/18/20,0,0,0,0,0,0,0,0,0,24,0,830,0,22,0,0,0,2,0,854,0,0,0,0,0,0,0,0,2,0,27
Greene,6/18/20,0,0,0,0,0,0,0,0,0,78,0,2905,0,67,0,0,0,11,0,2983,0,0,0,0,0,0,0,2,0,0,83
Hempstead,6/18/20,0,0,0,0,0,0,0,0,0,41,0,1218,0,25,0,1,0,15,0,1259,0,0,0,0,0,0,0,1,1,0,53
HotSpring,6/18/20,0,0,0,0,0,0,0,0,0,46,0,1308,0,34,0,0,0,12,0,1354,0,0,0,0,0,0,0,2,0,0,14
Howard,6/18/20,0,0,0,0,0,0,0,0,0,47,0,894,0,34,0,0,0,13,0,941,0,0,0,0,0,0,0,2,1,0,19
Independence,6/18/20,0,0,0,0,0,0,0,0,0,43,0,1737,0,35,0,0,0,8,0,1780,0,0,0,0,0,0,0,0,0,0,21
Izard,6/18/20,0,0,0,0,0,0,0,0,0,20,0,524,0,18,0,1,0,1,0,544,0,0,0,0,0,0,0,0,0,0,8
Jackson,6/18/20,0,0,0,0,0,0,0,0,0,20,0,643,0,8,0,0,0,12,0,663,0,0,0,0,0,0,0,0,1,0,8
Jefferson,6/18/20,0,0,0,0,0,0,0,0,0,637,0,4604,0,515,0,28,0,94,0,5241,0,0,0,0,0,0,0,3,5,0,94
Johnson,6/18/20,0,0,0,0,0,0,0,0,0,107,0,959,0,68,0,0,0,39,0,1066,0,0,0,0,0,0,0,8,3,0,24
Lafayette,6/18/20,0,0,0,0,0,0,0,0,0,12,0,265,0,10,0,1,0,1,0,277,0,0,0,0,0,0,0,0,1,0,5
Lawrence,6/18/20,0,0,0,0,0,0,0,0,0,92,0,1117,0,74,0,9,0,9,0,1209,0,0,0,0,0,0,0,0,1,0,13
Lee,6/18/20,0,0,0,0,0,0,0,0,0,571,0,1688,0,36,0,1,0,534,0,2259,0,0,0,0,0,0,0,2,3,0,23
Lincoln,6/18/20,0,0,0,0,0,0,0,0,0,995,0,1151,0,961,0,11,0,23,0,2146,0,0,0,0,0,0,0,0,0,0,5
LittleRiver,6/18/20,0,0,0,0,0,0,0,0,0,34,0,760,0,28,0,0,0,6,0,794,0,0,0,0,0,0,0,0,0,0,13
Logan,6/18/20,0,0,0,0,0,0,0,0,0,21,0,812,0,15,0,0,0,6,0,833,0,0,0,0,0,0,0,1,2,0,18
Lonoke,6/18/20,0,0,0,0,0,0,0,0,0,80,0,2780,0,61,0,0,0,19,0,2860,0,0,0,0,0,0,0,2,2,0,49
Madison,6/18/20,0,0,0,0,0,0,0,0,0,128,0,1253,0,60,0,0,0,68,0,1381,0,0,0,0,0,0,0,0,7,0,10
Marion,6/18/20,0,0,0,0,0,0,0,0,0,2,0,552,0,2,0,0,0,0,0,554,0,0,0,0,0,0,0,0,0,0,6
Miller,6/18/20,0,0,0,0,0,0,0,0,0,77,0,1571,0,59,0,2,0,16,0,1648,0,0,0,0,0,0,0,0,2,0,21
MissingCountyInfo,6/18/20,0,0,0,0,0,0,0,0,0,435,0,41230,0,196,0,0,0,239,0,41665,0,0,0,0,0,0,0,44,5,0,2646
Mississippi,6/18/20,0,0,0,0,0,0,0,0,0,105,0,2640,0,87,0,2,0,16,0,2745,0,0,0,0,0,0,0,3,4,0,146
Monroe,6/18/20,0,0,0,0,0,0,0,0,0,7,0,449,0,5,0,0,0,2,0,456,0,0,0,0,0,0,0,0,0,0,48
Montgomery,6/18/20,0,0,0,0,0,0,0,0,0,2,0,247,0,2,0,0,0,0,0,249,0,0,0,0,0,0,0,0,0,0,3
Nevada,6/18/20,0,0,0,0,0,0,0,0,0,87,0,615,0,17,0,1,0,69,0,702,0,0,0,0,0,0,0,1,1,0,16
Newton,6/18/20,0,0,0,0,0,0,0,0,0,3,0,345,0,3,0,0,0,0,0,348,0,0,0,0,0,0,0,0,0,0,5
Ouachita,6/18/20,0,0,0,0,0,0,0,0,0,17,0,1259,0,12,0,0,0,5,0,1276,0,0,0,0,0,0,0,0,0,0,106
Perry,6/18/20,0,0,0,0,0,0,0,0,0,17,0,589,0,15,0,0,0,2,0,606,0,0,0,0,0,0,0,1,1,0,17
Phillips,6/18/20,0,0,0,0,0,0,0,0,0,64,0,1214,0,29,0,1,0,34,0,1278,0,0,0,0,0,0,0,11,4,0,137
Pike,6/18/20,0,0,0,0,0,0,0,0,0,7,0,1273,0,6,0,0,0,1,0,1280,0,0,0,0,0,0,0,0,1,0,18
Poinsett,6/18/20,0,0,0,0,0,0,0,0,0,52,0,1321,0,40,0,3,0,9,0,1373,0,0,0,0,0,0,0,0,0,0,202
Polk,6/18/20,0,0,0,0,0,0,0,0,0,60,0,1027,0,43,0,0,0,17,0,1087,0,0,0,0,0,0,0,0,4,0,21
Pope,6/18/20,0,0,0,0,0,0,0,0,0,301,0,3686,0,211,0,2,0,88,0,3987,0,0,0,0,0,0,0,10,12,0,51
Prairie,6/18/20,0,0,0,0,0,0,0,0,0,12,0,319,0,4,0,0,0,8,0,331,0,0,0,0,0,0,0,0,1,0,7
Pulaski,6/18/20,0,0,0,0,0,0,0,0,0,1394,0,23066,0,1047,0,48,0,299,0,24460,0,0,0,0,0,0,0,29,33,2,742
Randolph,6/18/20,0,0,0,0,0,0,0,0,0,29,0,1410,0,24,0,1,0,4,0,1439,0,0,0,0,0,0,0,0,0,1,14
Saline,6/18/20,0,0,0,0,0,0,0,0,0,190,0,7065,0,146,0,2,0,42,0,7255,0,0,0,0,0,0,0,1,6,0,118
Scott,6/18/20,0,0,0,0,0,0,0,0,0,6,0,272,0,2,0,0,0,4,0,278,0,0,0,0,0,0,0,1,0,0,10
Searcy,6/18/20,0,0,0,0,0,0,0,0,0,7,0,659,0,7,0,0,0,0,0,666,0,0,0,0,0,0,0,0,0,0,4
Sebastian,6/18/20,0,0,0,0,0,0,0,0,0,193,0,5092,0,95,0,2,0,96,0,5285,0,0,0,0,0,0,0,6,6,0,217
Sevier,6/18/20,0,0,0,0,0,0,0,0,0,506,0,2766,0,344,0,5,0,157,0,3272,0,0,0,0,0,0,0,8,11,0,133
Sharp,6/18/20,0,0,0,0,0,0,0,0,0,50,0,746,0,42,0,4,0,4,0,796,0,0,0,0,0,0,0,0,-1,1,11
St.Francis,6/18/20,0,0,0,0,0,0,0,0,0,781,0,3836,0,746,0,3,0,32,0,4617,0,0,0,0,0,0,0,2,53,0,44
Stone,6/18/20,0,0,0,0,0,0,0,0,0,11,0,627,0,9,0,0,0,2,0,638,0,0,0,0,0,0,0,0,0,0,7
Union,6/18/20,0,0,0,0,0,0,0,0,0,218,0,2149,0,174,0,13,0,31,0,2367,0,0,0,0,0,0,0,5,1,2,136
VanBuren,6/18/20,0,0,0,0,0,0,0,0,0,30,0,782,0,27,0,2,0,1,0,812,0,0,0,0,0,0,0,0,0,0,4
Washington,6/18/20,0,0,0,0,0,0,0,0,0,2141,0,9471,0,1058,0,15,0,1068,0,11612,0,0,0,0,0,0,0,61,93,0,225
White,6/18/20,0,0,0,0,0,0,0,0,0,69,0,2599,0,47,0,1,0,21,0,2668,0,0,0,0,0,0,0,4,0,0,48
Woodruff,6/18/20,0,0,0,0,0,0,0,0,0,5,0,316,0,1,0,0,0,4,0,321,0,0,0,0,0,0,0,0,0,0,12
Yell,6/18/20,0,0,0,0,0,0,0,0,0,340,0,1197,0,244,0,2,0,94,0,1537,0,0,0,0,0,0,0,16,9,0,59
Arkansas_all_counties,6/17/20,0,0,0,0,0,0,0,0,2990671,13606,0,207093,0,8996,0,197,0,4413,0,220699,0,0,0,0,0,0,0,415,331,9,6296
Arkansas_county,6/17/20,0,0,0,0,0,0,0,0,0,14,0,630,0,6,0,0,0,8,0,644,0,0,0,0,0,0,0,6,0,0,53
Ashley,6/17/20,0,0,0,0,0,0,0,0,0,48,0,980,0,31,0,1,0,16,0,1028,0,0,0,0,0,0,0,1,0,0,15
Baxter,6/17/20,0,0,0,0,0,0,0,0,0,14,0,1404,0,12,0,0,0,2,0,1418,0,0,0,0,0,0,0,0,0,0,30
Benton,6/17/20,0,0,0,0,0,0,0,0,0,1612,0,23739,0,985,0,9,0,618,0,25351,0,0,0,0,0,0,0,98,64,1,775
Boone,6/17/20,0,0,0,0,0,0,0,0,0,10,0,1419,0,7,0,0,0,3,0,1429,0,0,0,0,0,0,0,0,0,0,28
Bradley,6/17/20,0,0,0,0,0,0,0,0,0,35,0,661,0,25,0,2,0,8,0,696,0,0,0,0,0,0,0,0,0,1,8
Calhoun,6/17/20,0,0,0,0,0,0,0,0,0,0,0,183,0,0,0,0,0,0,0,183,0,0,0,0,0,0,0,0,0,0,7
Carroll,6/17/20,0,0,0,0,0,0,0,0,0,95,0,1773,0,43,0,1,0,51,0,1868,0,0,0,0,0,0,0,3,4,0,27
Chicot,6/17/20,0,0,0,0,0,0,0,0,0,62,0,709,0,22,0,2,0,38,0,771,0,0,0,0,0,0,0,4,4,0,15
Clark,6/17/20,0,0,0,0,0,0,0,0,0,50,0,1138,0,41,0,0,0,9,0,1188,0,0,0,0,0,0,0,2,1,0,29
Clay,6/17/20,0,0,0,0,0,0,0,0,0,23,0,909,0,6,0,0,0,17,0,932,0,0,0,0,0,0,0,1,1,0,23
Cleburne,6/17/20,0,0,0,0,0,0,0,0,0,75,0,1294,0,70,0,4,0,1,0,1369,0,0,0,0,0,0,0,0,0,0,140
Cleveland,6/17/20,0,0,0,0,0,0,0,0,0,20,0,474,0,19,0,0,0,1,0,494,0,0,0,0,0,0,0,0,0,0,5
Columbia,6/17/20,0,0,0,0,0,0,0,0,0,28,0,836,0,20,0,2,0,6,0,864,0,0,0,0,0,0,0,-1,0,0,23
Conway,6/17/20,0,0,0,0,0,0,0,0,0,24,0,902,0,15,0,3,0,6,0,926,0,0,0,0,0,0,0,0,1,1,9
Craighead,6/17/20,0,0,0,0,0,0,0,0,0,369,0,8071,0,299,0,2,0,68,0,8440,0,0,0,0,0,0,0,4,10,0,137
Crawford,6/17/20,0,0,0,0,0,0,0,0,0,69,0,2299,0,40,0,0,0,29,0,2368,0,0,0,0,0,0,0,4,3,0,60
Crittenden,6/17/20,0,0,0,0,0,0,0,0,0,554,0,4516,0,444,0,10,0,100,0,5070,0,0,0,0,0,0,0,9,11,0,74
Cross,6/17/20,0,0,0,0,0,0,0,0,0,79,0,1042,0,61,0,1,0,17,0,1121,0,0,0,0,0,0,0,0,3,1,16
Dallas,6/17/20,0,0,0,0,0,0,0,0,0,4,0,248,0,2,0,0,0,2,0,252,0,0,0,0,0,0,0,0,0,0,6
Desha,6/17/20,0,0,0,0,0,0,0,0,0,25,0,634,0,19,0,0,0,6,0,659,0,0,0,0,0,0,0,2,0,0,14
Drew,6/17/20,0,0,0,0,0,0,0,0,0,27,0,1000,0,20,0,1,0,6,0,1027,0,0,0,0,0,0,0,1,0,0,25
Faulkner,6/17/20,0,0,0,0,0,0,0,0,0,195,0,5492,0,118,0,3,0,74,0,5687,0,0,0,0,0,0,0,15,5,0,135
Franklin,6/17/20,0,0,0,0,0,0,0,0,0,9,0,635,0,6,0,0,0,3,0,644,0,0,0,0,0,0,0,0,2,0,33
Fulton,6/17/20,0,0,0,0,0,0,0,0,0,9,0,623,0,8,0,0,0,1,0,632,0,0,0,0,0,0,0,0,1,0,7
Garland,6/17/20,0,0,0,0,0,0,0,0,0,168,0,5139,0,137,0,1,0,30,0,5307,0,0,0,0,0,0,0,3,0,0,95
Grant,6/17/20,0,0,0,0,0,0,0,0,0,24,0,803,0,20,0,0,0,4,0,827,0,0,0,0,0,0,0,0,1,0,13
Greene,6/17/20,0,0,0,0,0,0,0,0,0,76,0,2824,0,67,0,0,0,9,0,2900,0,0,0,0,0,0,0,2,0,0,82
Hempstead,6/17/20,0,0,0,0,0,0,0,0,0,40,0,1166,0,24,0,1,0,15,0,1206,0,0,0,0,0,0,0,0,2,0,4
HotSpring,6/17/20,0,0,0,0,0,0,0,0,0,44,0,1296,0,34,0,0,0,10,0,1340,0,0,0,0,0,0,0,1,0,0,18
Howard,6/17/20,0,0,0,0,0,0,0,0,0,45,0,877,0,33,0,0,0,12,0,922,0,0,0,0,0,0,0,3,1,0,25
Independence,6/17/20,0,0,0,0,0,0,0,0,0,43,0,1716,0,35,0,0,0,8,0,1759,0,0,0,0,0,0,0,0,0,0,40
Izard,6/17/20,0,0,0,0,0,0,0,0,0,20,0,516,0,18,0,1,0,1,0,536,0,0,0,0,0,0,0,0,0,0,8
Jackson,6/17/20,0,0,0,0,0,0,0,0,0,20,0,635,0,7,0,0,0,13,0,655,0,0,0,0,0,0,0,4,0,0,31
Jefferson,6/17/20,0,0,0,0,0,0,0,0,0,634,0,4513,0,510,0,28,0,96,0,5147,0,0,0,0,0,0,0,1,2,0,45
Johnson,6/17/20,0,0,0,0,0,0,0,0,0,99,0,943,0,65,0,0,0,34,0,1042,0,0,0,0,0,0,0,6,4,0,21
Lafayette,6/17/20,0,0,0,0,0,0,0,0,0,12,0,260,0,9,0,1,0,2,0,272,0,0,0,0,0,0,0,1,0,0,3
Lawrence,6/17/20,0,0,0,0,0,0,0,0,0,92,0,1104,0,73,0,9,0,10,0,1196,0,0,0,0,0,0,0,1,0,0,24
Lee,6/17/20,0,0,0,0,0,0,0,0,0,569,0,1667,0,33,0,1,0,535,0,2236,0,0,0,0,0,0,0,24,2,0,45
Lincoln,6/17/20,0,0,0,0,0,0,0,0,0,995,0,1146,0,961,0,11,0,23,0,2141,0,0,0,0,0,0,0,0,2,0,10
LittleRiver,6/17/20,0,0,0,0,0,0,0,0,0,34,0,747,0,28,0,0,0,6,0,781,0,0,0,0,0,0,0,0,2,0,3
Logan,6/17/20,0,0,0,0,0,0,0,0,0,20,0,795,0,13,0,0,0,7,0,815,0,0,0,0,0,0,0,0,0,0,19
Lonoke,6/17/20,0,0,0,0,0,0,0,0,0,78,0,2733,0,59,0,0,0,19,0,2811,0,0,0,0,0,0,0,3,0,0,38
Madison,6/17/20,0,0,0,0,0,0,0,0,0,128,0,1243,0,53,0,0,0,75,0,1371,0,0,0,0,0,0,0,6,6,0,42
Marion,6/17/20,0,0,0,0,0,0,0,0,0,2,0,546,0,2,0,0,0,0,0,548,0,0,0,0,0,0,0,0,0,0,17
Miller,6/17/20,0,0,0,0,0,0,0,0,0,77,0,1550,0,57,0,2,0,18,0,1627,0,0,0,0,0,0,0,4,2,0,21
MissingCountyInfo,6/17/20,0,0,0,0,0,0,0,0,0,391,0,38628,0,191,0,0,0,200,0,39019,0,0,0,0,0,0,0,-5,7,0,2512
Mississippi,6/17/20,0,0,0,0,0,0,0,0,0,102,0,2497,0,83,0,2,0,17,0,2599,0,0,0,0,0,0,0,4,1,0,40
Monroe,6/17/20,0,0,0,0,0,0,0,0,0,7,0,401,0,5,0,0,0,2,0,408,0,0,0,0,0,0,0,0,0,0,28
Montgomery,6/17/20,0,0,0,0,0,0,0,0,0,2,0,244,0,2,0,0,0,0,0,246,0,0,0,0,0,0,0,0,0,0,3
Nevada,6/17/20,0,0,0,0,0,0,0,0,0,86,0,600,0,16,0,1,0,69,0,686,0,0,0,0,0,0,0,3,1,0,13
Newton,6/17/20,0,0,0,0,0,0,0,0,0,3,0,340,0,3,0,0,0,0,0,343,0,0,0,0,0,0,0,0,0,0,9
Ouachita,6/17/20,0,0,0,0,0,0,0,0,0,17,0,1153,0,12,0,0,0,5,0,1170,0,0,0,0,0,0,0,1,1,0,12
Perry,6/17/20,0,0,0,0,0,0,0,0,0,16,0,573,0,14,0,0,0,2,0,589,0,0,0,0,0,0,0,0,0,0,6
Phillips,6/17/20,0,0,0,0,0,0,0,0,0,53,0,1088,0,25,0,1,0,27,0,1141,0,0,0,0,0,0,0,1,1,0,2
Pike,6/17/20,0,0,0,0,0,0,0,0,0,7,0,1255,0,5,0,0,0,2,0,1262,0,0,0,0,0,0,0,0,0,0,16
Poinsett,6/17/20,0,0,0,0,0,0,0,0,0,52,0,1119,0,40,0,3,0,9,0,1171,0,0,0,0,0,0,0,1,2,0,23
Polk,6/17/20,0,0,0,0,0,0,0,0,0,60,0,1006,0,39,0,0,0,21,0,1066,0,0,0,0,0,0,0,2,1,0,20
Pope,6/17/20,0,0,0,0,0,0,0,0,0,291,0,3645,0,199,0,2,0,90,0,3936,0,0,0,0,0,0,0,6,11,0,83
Prairie,6/17/20,0,0,0,0,0,0,0,0,0,12,0,312,0,3,0,0,0,9,0,324,0,0,0,0,0,0,0,3,0,0,13
Pulaski,6/17/20,0,0,0,0,0,0,0,0,0,1365,0,22353,0,1014,0,46,0,305,0,23718,0,0,0,0,0,0,0,22,22,3,318
Randolph,6/17/20,0,0,0,0,0,0,0,0,0,29,0,1396,0,24,0,0,0,5,0,1425,0,0,0,0,0,0,0,0,0,0,27
Saline,6/17/20,0,0,0,0,0,0,0,0,0,189,0,6948,0,140,0,2,0,47,0,7137,0,0,0,0,0,0,0,5,4,0,72
Scott,6/17/20,0,0,0,0,0,0,0,0,0,5,0,263,0,2,0,0,0,3,0,268,0,0,0,0,0,0,0,0,0,0,16
Searcy,6/17/20,0,0,0,0,0,0,0,0,0,7,0,655,0,7,0,0,0,0,0,662,0,0,0,0,0,0,0,0,0,0,11
Sebastian,6/17/20,0,0,0,0,0,0,0,0,0,187,0,4881,0,89,0,2,0,96,0,5068,0,0,0,0,0,0,0,18,9,0,267
Sevier,6/17/20,0,0,0,0,0,0,0,0,0,498,0,2641,0,333,0,5,0,160,0,3139,0,0,0,0,0,0,0,20,14,0,35
Sharp,6/17/20,0,0,0,0,0,0,0,0,0,50,0,735,0,43,0,3,0,4,0,785,0,0,0,0,0,0,0,0,0,0,9
St.Francis,6/17/20,0,0,0,0,0,0,0,0,0,779,0,3794,0,693,0,3,0,83,0,4573,0,0,0,0,0,0,0,0,5,1,25
Stone,6/17/20,0,0,0,0,0,0,0,0,0,11,0,620,0,9,0,0,0,2,0,631,0,0,0,0,0,0,0,0,0,0,4
Union,6/17/20,0,0,0,0,0,0,0,0,0,213,0,2018,0,173,0,11,0,29,0,2231,0,0,0,0,0,0,0,4,4,0,23
VanBuren,6/17/20,0,0,0,0,0,0,0,0,0,30,0,778,0,27,0,2,0,1,0,808,0,0,0,0,0,0,0,0,0,0,14
Washington,6/17/20,0,0,0,0,0,0,0,0,0,2080,0,9307,0,965,0,15,0,1100,0,11387,0,0,0,0,0,0,0,103,98,2,316
White,6/17/20,0,0,0,0,0,0,0,0,0,65,0,2555,0,47,0,1,0,17,0,2620,0,0,0,0,0,0,0,4,0,0,24
Woodruff,6/17/20,0,0,0,0,0,0,0,0,0,5,0,304,0,1,0,0,0,4,0,309,0,0,0,0,0,0,0,0,0,0,7
Yell,6/17/20,0,0,0,0,0,0,0,0,0,324,0,1154,0,235,0,2,0,87,0,1478,0,0,0,0,0,0,0,15,16,0,50
Arkansas_all_counties,6/16/20,0,0,0,0,0,0,0,0,2990671,13191,0,201212,0,8665,0,188,0,4338,0,214403,0,0,0,0,0,0,0,274,313,6,9111
Arkansas_county,6/16/20,0,0,0,0,0,0,0,0,0,8,0,583,0,6,0,0,0,2,0,591,0,0,0,0,0,0,0,0,0,0,8
Ashley,6/16/20,0,0,0,0,0,0,0,0,0,47,0,966,0,31,0,1,0,15,0,1013,0,0,0,0,0,0,0,2,1,0,26
Baxter,6/16/20,0,0,0,0,0,0,0,0,0,14,0,1374,0,12,0,0,0,2,0,1388,0,0,0,0,0,0,0,0,0,0,9
Benton,6/16/20,0,0,0,0,0,0,0,0,0,1514,0,23062,0,921,0,8,0,585,0,24576,0,0,0,0,0,0,0,34,57,0,930
Boone,6/16/20,0,0,0,0,0,0,0,0,0,10,0,1391,0,7,0,0,0,3,0,1401,0,0,0,0,0,0,0,0,1,0,23
Bradley,6/16/20,0,0,0,0,0,0,0,0,0,35,0,653,0,25,0,1,0,9,0,688,0,0,0,0,0,0,0,0,0,0,12
Calhoun,6/16/20,0,0,0,0,0,0,0,0,0,0,0,176,0,0,0,0,0,0,0,176,0,0,0,0,0,0,0,0,0,0,1
Carroll,6/16/20,0,0,0,0,0,0,0,0,0,92,0,1749,0,39,0,1,0,52,0,1841,0,0,0,0,0,0,0,4,7,0,68
Chicot,6/16/20,0,0,0,0,0,0,0,0,0,58,0,698,0,18,0,2,0,38,0,756,0,0,0,0,0,0,0,4,0,0,98
Clark,6/16/20,0,0,0,0,0,0,0,0,0,48,0,111,0,40,0,0,0,8,0,1159,0,0,0,0,0,0,0,0,1,0,26
Clay,6/16/20,0,0,0,0,0,0,0,0,0,22,0,887,0,5,0,0,0,17,0,909,0,0,0,0,0,0,0,2,0,0,22
Cleburne,6/16/20,0,0,0,0,0,0,0,0,0,75,0,1154,0,70,0,4,0,1,0,1229,0,0,0,0,0,0,0,0,0,0,12
Cleveland,6/16/20,0,0,0,0,0,0,0,0,0,20,0,469,0,19,0,0,0,1,0,489,0,0,0,0,0,0,0,0,0,0,6
Columbia,6/16/20,0,0,0,0,0,0,0,0,0,29,0,812,0,20,0,2,0,7,0,841,0,0,0,0,0,0,0,1,0,0,14
Conway,6/16/20,0,0,0,0,0,0,0,0,0,24,0,893,0,14,0,2,0,8,0,917,0,0,0,0,0,0,0,0,0,0,31
Craighead,6/16/20,0,0,0,0,0,0,0,0,0,365,0,7938,0,289,0,2,0,74,0,8303,0,0,0,0,0,0,0,2,14,0,194
Crawford,6/16/20,0,0,0,0,0,0,0,0,0,65,0,2243,0,37,0,0,0,28,0,2308,0,0,0,0,0,0,0,4,5,0,64
Crittenden,6/16/20,0,0,0,0,0,0,0,0,0,545,0,4451,0,433,0,10,0,102,0,4996,0,0,0,0,0,0,0,8,12,1,143
Cross,6/16/20,0,0,0,0,0,0,0,0,0,79,0,1026,0,58,0,0,0,21,0,1105,0,0,0,0,0,0,0,0,2,0,70
Dallas,6/16/20,0,0,0,0,0,0,0,0,0,4,0,242,0,2,0,0,0,2,0,246,0,0,0,0,0,0,0,1,0,0,3
Desha,6/16/20,0,0,0,0,0,0,0,0,0,23,0,622,0,19,0,0,0,4,0,645,0,0,0,0,0,0,0,1,0,0,20
Drew,6/16/20,0,0,0,0,0,0,0,0,0,26,0,976,0,20,0,1,0,5,0,1002,0,0,0,0,0,0,0,0,2,0,11
Faulkner,6/16/20,0,0,0,0,0,0,0,0,0,180,0,5372,0,113,0,3,0,64,0,5552,0,0,0,0,0,0,0,8,7,0,643
Franklin,6/16/20,0,0,0,0,0,0,0,0,0,9,0,602,0,4,0,0,0,5,0,611,0,0,0,0,0,0,0,3,0,0,28
Fulton,6/16/20,0,0,0,0,0,0,0,0,0,9,0,616,0,7,0,0,0,2,0,625,0,0,0,0,0,0,0,0,0,0,7
Garland,6/16/20,0,0,0,0,0,0,0,0,0,165,0,5047,0,137,0,1,0,27,0,5212,0,0,0,0,0,0,0,0,0,0,119
Grant,6/16/20,0,0,0,0,0,0,0,0,0,24,0,790,0,19,0,0,0,5,0,814,0,0,0,0,0,0,0,0,0,0,20
Greene,6/16/20,0,0,0,0,0,0,0,0,0,74,0,2744,0,67,0,0,0,7,0,2818,0,0,0,0,0,0,0,1,0,0,57
Hempstead,6/16/20,0,0,0,0,0,0,0,0,0,40,0,1162,0,22,0,1,0,17,0,1202,0,0,0,0,0,0,0,1,1,0,84
HotSpring,6/16/20,0,0,0,0,0,0,0,0,0,43,0,1279,0,34,0,0,0,9,0,1322,0,0,0,0,0,0,0,1,1,0,26
Howard,6/16/20,0,0,0,0,0,0,0,0,0,42,0,855,0,32,0,0,0,10,0,897,0,0,0,0,0,0,0,1,0,0,132
Independence,6/16/20,0,0,0,0,0,0,0,0,0,43,0,1676,0,35,0,0,0,8,0,1719,0,0,0,0,0,0,0,1,0,0,30
Izard,6/16/20,0,0,0,0,0,0,0,0,0,20,0,508,0,18,0,1,0,1,0,528,0,0,0,0,0,0,0,0,0,0,9
Jackson,6/16/20,0,0,0,0,0,0,0,0,0,16,0,608,0,7,0,0,0,9,0,624,0,0,0,0,0,0,0,0,1,0,14
Jefferson,6/16/20,0,0,0,0,0,0,0,0,0,633,0,4469,0,508,0,28,0,97,0,5102,0,0,0,0,0,0,0,0,6,0,72
Johnson,6/16/20,0,0,0,0,0,0,0,0,0,93,0,928,0,61,0,0,0,32,0,1021,0,0,0,0,0,0,0,1,5,0,55
Lafayette,6/16/20,0,0,0,0,0,0,0,0,0,11,0,258,0,9,0,1,0,1,0,269,0,0,0,0,0,0,0,0,0,0,9
Lawrence,6/16/20,0,0,0,0,0,0,0,0,0,91,0,1081,0,73,0,9,0,9,0,1172,0,0,0,0,0,0,0,0,0,0,7
Lee,6/16/20,0,0,0,0,0,0,0,0,0,545,0,1646,0,31,0,1,0,513,0,2191,0,0,0,0,0,0,0,2,2,0,10
Lincoln,6/16/20,0,0,0,0,0,0,0,0,0,995,0,1136,0,959,0,11,0,25,0,2131,0,0,0,0,0,0,0,0,0,0,4
LittleRiver,6/16/20,0,0,0,0,0,0,0,0,0,34,0,744,0,26,0,0,0,8,0,778,0,0,0,0,0,0,0,0,4,0,16
Logan,6/16/20,0,0,0,0,0,0,0,0,0,20,0,776,0,13,0,0,0,7,0,796,0,0,0,0,0,0,0,0,1,0,39
Lonoke,6/16/20,0,0,0,0,0,0,0,0,0,75,0,2698,0,59,0,0,0,16,0,2773,0,0,0,0,0,0,0,2,1,0,67
Madison,6/16/20,0,0,0,0,0,0,0,0,0,122,0,1207,0,47,0,0,0,75,0,1329,0,0,0,0,0,0,0,3,3,0,58
Marion,6/16/20,0,0,0,0,0,0,0,0,0,2,0,529,0,2,0,0,0,0,0,531,0,0,0,0,0,0,0,0,0,0,3
Miller,6/16/20,0,0,0,0,0,0,0,0,0,73,0,1533,0,55,0,2,0,16,0,1606,0,0,0,0,0,0,0,2,2,1,153
MissingCountyInfo,6/16/20,0,0,0,0,0,0,0,0,0,396,0,36111,0,184,0,0,0,212,0,36507,0,0,0,0,0,0,0,52,10,0,1943
Mississippi,6/16/20,0,0,0,0,0,0,0,0,0,98,0,2461,0,82,0,2,0,14,0,2559,0,0,0,0,0,0,0,2,4,0,97
Monroe,6/16/20,0,0,0,0,0,0,0,0,0,7,0,373,0,5,0,0,0,2,0,380,0,0,0,0,0,0,0,0,0,0,7
Montgomery,6/16/20,0,0,0,0,0,0,0,0,0,2,0,241,0,2,0,0,0,0,0,243,0,0,0,0,0,0,0,0,0,0,10
Nevada,6/16/20,0,0,0,0,0,0,0,0,0,83,0,590,0,15,0,1,0,67,0,673,0,0,0,0,0,0,0,0,4,1,13
Newton,6/16/20,0,0,0,0,0,0,0,0,0,3,0,331,0,3,0,0,0,0,0,334,0,0,0,0,0,0,0,0,0,0,15
Ouachita,6/16/20,0,0,0,0,0,0,0,0,0,16,0,1142,0,11,0,0,0,5,0,1158,0,0,0,0,0,0,0,1,1,0,14
Perry,6/16/20,0,0,0,0,0,0,0,0,0,16,0,567,0,14,0,0,0,2,0,583,0,0,0,0,0,0,0,0,0,0,26
Phillips,6/16/20,0,0,0,0,0,0,0,0,0,52,0,1087,0,24,0,1,0,27,0,1139,0,0,0,0,0,0,0,3,1,0,25
Pike,6/16/20,0,0,0,0,0,0,0,0,0,7,0,1239,0,5,0,0,0,2,0,1246,0,0,0,0,0,0,0,0,0,0,162
Poinsett,6/16/20,0,0,0,0,0,0,0,0,0,51,0,1097,0,38,0,3,0,10,0,1148,0,0,0,0,0,0,0,0,2,0,30
Polk,6/16/20,0,0,0,0,0,0,0,0,0,58,0,988,0,38,0,0,0,20,0,1046,0,0,0,0,0,0,0,2,1,0,50
Pope,6/16/20,0,0,0,0,0,0,0,0,0,285,0,3568,0,188,0,2,0,95,0,3853,0,0,0,0,0,0,0,4,6,0,174
Prairie,6/16/20,0,0,0,0,0,0,0,0,0,9,0,302,0,3,0,0,0,6,0,311,0,0,0,0,0,0,0,2,0,0,22
Pulaski,6/16/20,0,0,0,0,0,0,0,0,0,1343,0,22057,0,992,0,43,0,308,0,23400,0,0,0,0,0,0,0,41,30,1,1695
Randolph,6/16/20,0,0,0,0,0,0,0,0,0,29,0,1369,0,24,0,0,0,5,0,1398,0,0,0,0,0,0,0,1,0,0,24
Saline,6/16/20,0,0,0,0,0,0,0,0,0,184,0,6881,0,136,0,2,0,46,0,7065,0,0,0,0,0,0,0,3,7,0,388
Scott,6/16/20,0,0,0,0,0,0,0,0,0,5,0,247,0,2,0,0,0,3,0,252,0,0,0,0,0,0,0,0,0,0,9
Searcy,6/16/20,0,0,0,0,0,0,0,0,0,7,0,644,0,7,0,0,0,0,0,651,0,0,0,0,0,0,0,0,0,0,3
Sebastian,6/16/20,0,0,0,0,0,0,0,0,0,169,0,4632,0,80,0,2,0,87,0,4801,0,0,0,0,0,0,0,4,6,0,204
Sevier,6/16/20,0,0,0,0,0,0,0,0,0,478,0,2626,0,319,0,5,0,154,0,3104,0,0,0,0,0,0,0,13,26,0,144
Sharp,6/16/20,0,0,0,0,0,0,0,0,0,50,0,726,0,43,0,3,0,4,0,776,0,0,0,0,0,0,0,0,0,0,6
St.Francis,6/16/20,0,0,0,0,0,0,0,0,0,779,0,3769,0,688,0,2,0,89,0,4548,0,0,0,0,0,0,0,1,3,0,68
Stone,6/16/20,0,0,0,0,0,0,0,0,0,11,0,616,0,9,0,0,0,2,0,627,0,0,0,0,0,0,0,0,0,0,41
Union,6/16/20,0,0,0,0,0,0,0,0,0,209,0,1999,0,169,0,11,0,29,0,2208,0,0,0,0,0,0,0,1,3,0,53
VanBuren,6/16/20,0,0,0,0,0,0,0,0,0,30,0,764,0,27,0,2,0,1,0,794,0,0,0,0,0,0,0,0,0,0,14
Washington,6/16/20,0,0,0,0,0,0,0,0,0,1977,0,9094,0,867,0,13,0,1097,0,11071,0,0,0,0,0,0,0,52,61,1,294
White,6/16/20,0,0,0,0,0,0,0,0,0,61,0,2535,0,47,0,1,0,13,0,2596,0,0,0,0,0,0,0,2,1,0,77
Woodruff,6/16/20,0,0,0,0,0,0,0,0,0,5,0,297,0,1,0,0,0,4,0,302,0,0,0,0,0,0,0,0,0,0,9
Yell,6/16/20,0,0,0,0,0,0,0,0,0,309,0,1119,0,219,0,2,0,88,0,1428,0,0,0,0,0,0,0,1,11,0,41
Arkansas_all_counties,6/15/20,0,0,0,0,0,0,0,0,2990671,12917,0,192375,0,8352,0,182,0,4383,0,205292,0,0,0,0,0,0,0,416,242,3,8303
Arkansas_county,6/15/20,0,0,0,0,0,0,0,0,0,8,0,575,0,6,0,0,0,2,0,583,0,0,0,0,0,0,0,0,0,0,14
Ashley,6/15/20,0,0,0,0,0,0,0,0,0,45,0,942,0,30,0,1,0,14,0,987,0,0,0,0,0,0,0,4,0,0,24
Baxter,6/15/20,0,0,0,0,0,0,0,0,0,14,0,1365,0,12,0,0,0,2,0,1379,0,0,0,0,0,0,0,0,0,0,13
Benton,6/15/20,0,0,0,0,0,0,0,0,0,1480,0,22166,0,864,0,8,0,608,0,23646,0,0,0,0,0,0,0,74,50,1,1136
Boone,6/15/20,0,0,0,0,0,0,0,0,0,10,0,1368,0,6,0,0,0,4,0,1378,0,0,0,0,0,0,0,1,0,0,74
Bradley,6/15/20,0,0,0,0,0,0,0,0,0,35,0,641,0,25,0,1,0,9,0,676,0,0,0,0,0,0,0,1,1,0,26
Calhoun,6/15/20,0,0,0,0,0,0,0,0,0,0,0,175,0,0,0,0,0,0,0,175,0,0,0,0,0,0,0,0,0,0,19
Carroll,6/15/20,0,0,0,0,0,0,0,0,0,88,0,1685,0,32,0,1,0,55,0,1773,0,0,0,0,0,0,0,8,1,0,80
Chicot,6/15/20,0,0,0,0,0,0,0,0,0,54,0,604,0,18,0,2,0,34,0,658,0,0,0,0,0,0,0,5,0,0,39
Clark,6/15/20,0,0,0,0,0,0,0,0,0,48,0,1085,0,39,0,0,0,9,0,1133,0,0,0,0,0,0,0,3,0,0,18
Clay,6/15/20,0,0,0,0,0,0,0,0,0,20,0,867,0,5,0,0,0,15,0,887,0,0,0,0,0,0,0,0,0,0,7
Cleburne,6/15/20,0,0,0,0,0,0,0,0,0,75,0,1142,0,70,0,4,0,1,0,1217,0,0,0,0,0,0,0,0,0,0,36
Cleveland,6/15/20,0,0,0,0,0,0,0,0,0,20,0,463,0,19,0,0,0,1,0,483,0,0,0,0,0,0,0,0,0,0,5
Columbia,6/15/20,0,0,0,0,0,0,0,0,0,28,0,799,0,20,0,2,0,6,0,827,0,0,0,0,0,0,0,0,1,0,12
Conway,6/15/20,0,0,0,0,0,0,0,0,0,24,0,862,0,14,0,2,0,8,0,886,0,0,0,0,0,0,0,3,1,0,99
Craighead,6/15/20,0,0,0,0,0,0,0,0,0,363,0,7746,0,275,0,2,0,86,0,8109,0,0,0,0,0,0,0,5,13,1,115
Crawford,6/15/20,0,0,0,0,0,0,0,0,0,61,0,2183,0,32,0,0,0,29,0,2244,0,0,0,0,0,0,0,5,0,0,94
Crittenden,6/15/20,0,0,0,0,0,0,0,0,0,537,0,4316,0,421,0,9,0,107,0,4853,0,0,0,0,0,0,0,15,9,0,72
Cross,6/15/20,0,0,0,0,0,0,0,0,0,79,0,956,0,56,0,0,0,23,0,1035,0,0,0,0,0,0,0,3,2,0,25
Dallas,6/15/20,0,0,0,0,0,0,0,0,0,3,0,240,0,2,0,0,0,1,0,243,0,0,0,0,0,0,0,0,0,0,10
Desha,6/15/20,0,0,0,0,0,0,0,0,0,22,0,603,0,19,0,0,0,3,0,625,0,0,0,0,0,0,0,0,0,0,13
Drew,6/15/20,0,0,0,0,0,0,0,0,0,26,0,965,0,18,0,1,0,7,0,991,0,0,0,0,0,0,0,0,0,0,8
Faulkner,6/15/20,0,0,0,0,0,0,0,0,0,172,0,4737,0,106,0,3,0,63,0,4909,0,0,0,0,0,0,0,18,2,0,639
Franklin,6/15/20,0,0,0,0,0,0,0,0,0,6,0,577,0,4,0,0,0,2,0,583,0,0,0,0,0,0,0,0,0,0,12
Fulton,6/15/20,0,0,0,0,0,0,0,0,0,9,0,609,0,7,0,0,0,2,0,618,0,0,0,0,0,0,0,0,0,0,21
Garland,6/15/20,0,0,0,0,0,0,0,0,0,165,0,4928,0,137,0,1,0,27,0,5093,0,0,0,0,0,0,0,3,2,0,138
Grant,6/15/20,0,0,0,0,0,0,0,0,0,24,0,770,0,19,0,0,0,5,0,794,0,0,0,0,0,0,0,0,0,0,25
Greene,6/15/20,0,0,0,0,0,0,0,0,0,73,0,2688,0,67,0,0,0,6,0,2761,0,0,0,0,0,0,0,1,0,0,46
Hempstead,6/15/20,0,0,0,0,0,0,0,0,0,39,0,1079,0,21,0,1,0,17,0,1118,0,0,0,0,0,0,0,3,0,0,51
HotSpring,6/15/20,0,0,0,0,0,0,0,0,0,42,0,1254,0,33,0,0,0,9,0,1296,0,0,0,0,0,0,0,0,0,0,42
Howard,6/15/20,0,0,0,0,0,0,0,0,0,41,0,724,0,32,0,0,0,9,0,765,0,0,0,0,0,0,0,3,1,0,41
Independence,6/15/20,0,0,0,0,0,0,0,0,0,42,0,1647,0,35,0,0,0,7,0,1689,0,0,0,0,0,0,0,0,2,0,32
Izard,6/15/20,0,0,0,0,0,0,0,0,0,20,0,499,0,18,0,1,0,1,0,519,0,0,0,0,0,0,0,0,0,0,4
Jackson,6/15/20,0,0,0,0,0,0,0,0,0,16,0,594,0,6,0,0,0,10,0,610,0,0,0,0,0,0,0,1,1,0,22
Jefferson,6/15/20,0,0,0,0,0,0,0,0,0,633,0,4397,0,502,0,28,0,103,0,5030,0,0,0,0,0,0,0,3,3,0,158
Johnson,6/15/20,0,0,0,0,0,0,0,0,0,92,0,874,0,56,0,0,0,36,0,966,0,0,0,0,0,0,0,4,3,0,34
Lafayette,6/15/20,0,0,0,0,0,0,0,0,0,11,0,249,0,9,0,1,0,1,0,260,0,0,0,0,0,0,0,0,0,0,19
Lawrence,6/15/20,0,0,0,0,0,0,0,0,0,91,0,1074,0,73,0,9,0,9,0,1165,0,0,0,0,0,0,0,0,0,0,22
Lee,6/15/20,0,0,0,0,0,0,0,0,0,543,0,1638,0,29,0,1,0,513,0,2181,0,0,0,0,0,0,0,-2,0,0,37
Lincoln,6/15/20,0,0,0,0,0,0,0,0,0,995,0,1132,0,959,0,11,0,25,0,2127,0,0,0,0,0,0,0,0,0,0,15
LittleRiver,6/15/20,0,0,0,0,0,0,0,0,0,34,0,728,0,22,0,0,0,12,0,762,0,0,0,0,0,0,0,0,1,0,112
Logan,6/15/20,0,0,0,0,0,0,0,0,0,20,0,737,0,12,0,0,0,8,0,757,0,0,0,0,0,0,0,1,0,0,47
Lonoke,6/15/20,0,0,0,0,0,0,0,0,0,73,0,2633,0,58,0,0,0,15,0,2706,0,0,0,0,0,0,0,2,1,0,75
Madison,6/15/20,0,0,0,0,0,0,0,0,0,119,0,1152,0,44,0,0,0,75,0,1271,0,0,0,0,0,0,0,8,2,0,32
Marion,6/15/20,0,0,0,0,0,0,0,0,0,2,0,526,0,2,0,0,0,0,0,528,0,0,0,0,0,0,0,0,0,0,10
Miller,6/15/20,0,0,0,0,0,0,0,0,0,71,0,1382,0,53,0,1,0,17,0,1453,0,0,0,0,0,0,0,2,0,0,220
MissingCountyInfo,6/15/20,0,0,0,0,0,0,0,0,0,344,0,34220,0,174,0,0,0,170,0,34564,0,0,0,0,0,0,0,4,3,0,934
Mississippi,6/15/20,0,0,0,0,0,0,0,0,0,96,0,2366,0,78,0,2,0,16,0,2462,0,0,0,0,0,0,0,1,1,0,50
Monroe,6/15/20,0,0,0,0,0,0,0,0,0,7,0,366,0,5,0,0,0,2,0,373,0,0,0,0,0,0,0,0,0,0,8
Montgomery,6/15/20,0,0,0,0,0,0,0,0,0,2,0,231,0,2,0,0,0,0,0,233,0,0,0,0,0,0,0,0,0,0,12
Nevada,6/15/20,0,0,0,0,0,0,0,0,0,83,0,577,0,11,0,0,0,72,0,660,0,0,0,0,0,0,0,3,1,0,42
Newton,6/15/20,0,0,0,0,0,0,0,0,0,3,0,316,0,3,0,0,0,0,0,319,0,0,0,0,0,0,0,0,0,0,15
Ouachita,6/15/20,0,0,0,0,0,0,0,0,0,15,0,1129,0,10,0,0,0,5,0,1144,0,0,0,0,0,0,0,1,0,0,43
Perry,6/15/20,0,0,0,0,0,0,0,0,0,16,0,541,0,14,0,0,0,2,0,557,0,0,0,0,0,0,0,0,0,0,134
Phillips,6/15/20,0,0,0,0,0,0,0,0,0,49,0,1065,0,23,0,1,0,25,0,1114,0,0,0,0,0,0,0,10,1,0,102
Pike,6/15/20,0,0,0,0,0,0,0,0,0,7,0,1077,0,5,0,0,0,2,0,1084,0,0,0,0,0,0,0,0,0,0,47
Poinsett,6/15/20,0,0,0,0,0,0,0,0,0,51,0,1067,0,36,0,3,0,12,0,1118,0,0,0,0,0,0,0,1,1,0,21
Polk,6/15/20,0,0,0,0,0,0,0,0,0,56,0,940,0,37,0,0,0,19,0,996,0,0,0,0,0,0,0,3,3,0,87
Pope,6/15/20,0,0,0,0,0,0,0,0,0,281,0,3398,0,182,0,2,0,97,0,3679,0,0,0,0,0,0,0,25,6,0,95
Prairie,6/15/20,0,0,0,0,0,0,0,0,0,7,0,282,0,3,0,0,0,4,0,289,0,0,0,0,0,0,0,0,0,0,11
Pulaski,6/15/20,0,0,0,0,0,0,0,0,0,1302,0,20403,0,962,0,42,0,298,0,21705,0,0,0,0,0,0,0,13,39,0,762
Randolph,6/15/20,0,0,0,0,0,0,0,0,0,28,0,1346,0,24,0,0,0,4,0,1374,0,0,0,0,0,0,0,0,0,0,31
Saline,6/15/20,0,0,0,0,0,0,0,0,0,181,0,6496,0,129,0,2,0,50,0,6677,0,0,0,0,0,0,0,7,5,0,677
Scott,6/15/20,0,0,0,0,0,0,0,0,0,5,0,238,0,2,0,0,0,3,0,243,0,0,0,0,0,0,0,2,0,0,9
Searcy,6/15/20,0,0,0,0,0,0,0,0,0,7,0,641,0,7,0,0,0,0,0,648,0,0,0,0,0,0,0,0,0,0,8
Sebastian,6/15/20,0,0,0,0,0,0,0,0,0,165,0,4432,0,74,0,2,0,89,0,4597,0,0,0,0,0,0,0,17,7,0,342
Sevier,6/15/20,0,0,0,0,0,0,0,0,0,465,0,2495,0,293,0,5,0,167,0,2960,0,0,0,0,0,0,0,19,10,1,160
Sharp,6/15/20,0,0,0,0,0,0,0,0,0,50,0,720,0,43,0,3,0,4,0,770,0,0,0,0,0,0,0,0,0,0,25
St.Francis,6/15/20,0,0,0,0,0,0,0,0,0,778,0,3702,0,685,0,2,0,91,0,4480,0,0,0,0,0,0,0,3,3,0,46
Stone,6/15/20,0,0,0,0,0,0,0,0,0,11,0,575,0,9,0,0,0,2,0,586,0,0,0,0,0,0,0,0,0,0,4
Union,6/15/20,0,0,0,0,0,0,0,0,0,208,0,1947,0,166,0,11,0,31,0,2155,0,0,0,0,0,0,0,5,1,0,65
VanBuren,6/15/20,0,0,0,0,0,0,0,0,0,30,0,750,0,27,0,2,0,1,0,780,0,0,0,0,0,0,0,0,1,0,15
Washington,6/15/20,0,0,0,0,0,0,0,0,0,1925,0,8852,0,806,0,12,0,1107,0,10777,0,0,0,0,0,0,0,121,45,0,524
White,6/15/20,0,0,0,0,0,0,0,0,0,59,0,2460,0,46,0,1,0,12,0,2519,0,0,0,0,0,0,0,1,1,0,56
Woodruff,6/15/20,0,0,0,0,0,0,0,0,0,5,0,288,0,1,0,0,0,4,0,293,0,0,0,0,0,0,0,1,0,0,48
Yell,6/15/20,0,0,0,0,0,0,0,0,0,308,0,1079,0,208,0,2,0,98,0,1387,0,0,0,0,0,0,0,5,18,0,137
Arkansas_all_counties,6/14/20,0,0,0,0,0,0,0,0,2990671,12501,0,184488,0,8110,0,179,0,4212,0,196989,0,0,0,0,0,0,0,406,247,2,3195
Arkansas_county,6/14/20,0,0,0,0,0,0,0,0,0,8,0,561,0,6,0,0,0,2,0,569,0,0,0,0,0,0,0,1,2,0,12
Ashley,6/14/20,0,0,0,0,0,0,0,0,0,41,0,922,0,30,0,1,0,10,0,963,0,0,0,0,0,0,0,1,1,0,12
Baxter,6/14/20,0,0,0,0,0,0,0,0,0,14,0,1352,0,12,0,0,0,2,0,1366,0,0,0,0,0,0,0,0,0,0,127
Benton,6/14/20,0,0,0,0,0,0,0,0,0,1406,0,21104,0,814,0,7,0,585,0,22510,0,0,0,0,0,0,0,44,64,0,454
Boone,6/14/20,0,0,0,0,0,0,0,0,0,9,0,1295,0,6,0,0,0,3,0,1304,0,0,0,0,0,0,0,0,0,0,15
Bradley,6/14/20,0,0,0,0,0,0,0,0,0,34,0,616,0,24,0,1,0,9,0,650,0,0,0,0,0,0,0,0,3,0,8
Calhoun,6/14/20,0,0,0,0,0,0,0,0,0,0,0,156,0,0,0,0,0,0,0,156,0,0,0,0,0,0,0,0,0,0,0
Carroll,6/14/20,0,0,0,0,0,0,0,0,0,80,0,1613,0,31,0,1,0,48,0,1693,0,0,0,0,0,0,0,10,2,0,78
Chicot,6/14/20,0,0,0,0,0,0,0,0,0,49,0,570,0,18,0,2,0,29,0,619,0,0,0,0,0,0,0,6,0,1,52
Clark,6/14/20,0,0,0,0,0,0,0,0,0,45,0,1070,0,39,0,0,0,6,0,1115,0,0,0,0,0,0,0,0,0,0,3
Clay,6/14/20,0,0,0,0,0,0,0,0,0,20,0,860,0,5,0,0,0,15,0,880,0,0,0,0,0,0,0,2,0,0,41
Cleburne,6/14/20,0,0,0,0,0,0,0,0,0,75,0,1106,0,70,0,4,0,1,0,1181,0,0,0,0,0,0,0,0,1,0,8
Cleveland,6/14/20,0,0,0,0,0,0,0,0,0,20,0,458,0,19,0,0,0,1,0,478,0,0,0,0,0,0,0,1,0,0,3
Columbia,6/14/20,0,0,0,0,0,0,0,0,0,28,0,787,0,19,0,2,0,7,0,815,0,0,0,0,0,0,0,1,0,0,15
Conway,6/14/20,0,0,0,0,0,0,0,0,0,21,0,766,0,13,0,2,0,6,0,787,0,0,0,0,0,0,0,2,0,0,7
Craighead,6/14/20,0,0,0,0,0,0,0,0,0,358,0,7636,0,262,0,1,0,95,0,7994,0,0,0,0,0,0,0,6,9,0,51
Crawford,6/14/20,0,0,0,0,0,0,0,0,0,56,0,2094,0,32,0,0,0,24,0,2150,0,0,0,0,0,0,0,5,1,0,70
Crittenden,6/14/20,0,0,0,0,0,0,0,0,0,522,0,4259,0,412,0,9,0,101,0,4781,0,0,0,0,0,0,0,5,6,0,45
Cross,6/14/20,0,0,0,0,0,0,0,0,0,76,0,934,0,54,0,0,0,22,0,1010,0,0,0,0,0,0,0,1,1,0,2
Dallas,6/14/20,0,0,0,0,0,0,0,0,0,3,0,230,0,2,0,0,0,1,0,233,0,0,0,0,0,0,0,0,0,0,1
Desha,6/14/20,0,0,0,0,0,0,0,0,0,22,0,590,0,19,0,0,0,3,0,612,0,0,0,0,0,0,0,2,0,0,10
Drew,6/14/20,0,0,0,0,0,0,0,0,0,26,0,957,0,18,0,1,0,7,0,983,0,0,0,0,0,0,0,1,0,0,10
Faulkner,6/14/20,0,0,0,0,0,0,0,0,0,154,0,4116,0,104,0,3,0,47,0,4270,0,0,0,0,0,0,0,7,1,0,46
Franklin,6/14/20,0,0,0,0,0,0,0,0,0,6,0,565,0,4,0,0,0,2,0,571,0,0,0,0,0,0,0,0,0,0,15
Fulton,6/14/20,0,0,0,0,0,0,0,0,0,9,0,588,0,7,0,0,0,2,0,597,0,0,0,0,0,0,0,0,0,0,19
Garland,6/14/20,0,0,0,0,0,0,0,0,0,162,0,4793,0,135,0,1,0,26,0,4955,0,0,0,0,0,0,0,1,0,0,18
Grant,6/14/20,0,0,0,0,0,0,0,0,0,24,0,745,0,19,0,0,0,5,0,769,0,0,0,0,0,0,0,0,0,0,4
Greene,6/14/20,0,0,0,0,0,0,0,0,0,72,0,2643,0,67,0,0,0,5,0,2715,0,0,0,0,0,0,0,1,1,0,30
Hempstead,6/14/20,0,0,0,0,0,0,0,0,0,36,0,1031,0,21,0,1,0,14,0,1067,0,0,0,0,0,0,0,2,1,0,10
HotSpring,6/14/20,0,0,0,0,0,0,0,0,0,42,0,1212,0,33,0,0,0,9,0,1254,0,0,0,0,0,0,0,4,0,0,10
Howard,6/14/20,0,0,0,0,0,0,0,0,0,38,0,686,0,31,0,0,0,7,0,724,0,0,0,0,0,0,0,0,2,0,6
Independence,6/14/20,0,0,0,0,0,0,0,0,0,42,0,1615,0,33,0,0,0,9,0,1657,0,0,0,0,0,0,0,3,0,0,9
Izard,6/14/20,0,0,0,0,0,0,0,0,0,20,0,495,0,18,0,1,0,1,0,515,0,0,0,0,0,0,0,1,0,0,6
Jackson,6/14/20,0,0,0,0,0,0,0,0,0,15,0,573,0,5,0,0,0,10,0,588,0,0,0,0,0,0,0,-1,0,0,4
Jefferson,6/14/20,0,0,0,0,0,0,0,0,0,630,0,4242,0,499,0,28,0,103,0,4872,0,0,0,0,0,0,0,2,2,0,41
Johnson,6/14/20,0,0,0,0,0,0,0,0,0,88,0,844,0,53,0,0,0,35,0,932,0,0,0,0,0,0,0,4,1,0,42
Lafayette,6/14/20,0,0,0,0,0,0,0,0,0,11,0,230,0,9,0,1,0,1,0,241,0,0,0,0,0,0,0,0,0,0,-1
Lawrence,6/14/20,0,0,0,0,0,0,0,0,0,91,0,1052,0,73,0,9,0,9,0,1143,0,0,0,0,0,0,0,1,0,0,12
Lee,6/14/20,0,0,0,0,0,0,0,0,0,545,0,1599,0,29,0,1,0,515,0,2144,0,0,0,0,0,0,0,64,0,0,484
Lincoln,6/14/20,0,0,0,0,0,0,0,0,0,995,0,1117,0,959,0,11,0,25,0,2112,0,0,0,0,0,0,0,8,0,0,25
LittleRiver,6/14/20,0,0,0,0,0,0,0,0,0,34,0,616,0,21,0,0,0,13,0,650,0,0,0,0,0,0,0,0,2,0,0
Logan,6/14/20,0,0,0,0,0,0,0,0,0,19,0,691,0,12,0,0,0,7,0,710,0,0,0,0,0,0,0,1,0,0,13
Lonoke,6/14/20,0,0,0,0,0,0,0,0,0,71,0,2560,0,57,0,0,0,14,0,2631,0,0,0,0,0,0,0,1,1,0,14
Madison,6/14/20,0,0,0,0,0,0,0,0,0,111,0,1128,0,42,0,0,0,69,0,1239,0,0,0,0,0,0,0,4,3,0,11
Marion,6/14/20,0,0,0,0,0,0,0,0,0,2,0,516,0,2,0,0,0,0,0,518,0,0,0,0,0,0,0,0,0,0,11
Miller,6/14/20,0,0,0,0,0,0,0,0,0,69,0,1164,0,53,0,1,0,15,0,1233,0,0,0,0,0,0,0,0,0,0,11
MissingCountyInfo,6/14/20,0,0,0,0,0,0,0,0,0,340,0,33290,0,171,0,0,0,169,0,33630,0,0,0,0,0,0,0,19,6,0,317
Mississippi,6/14/20,0,0,0,0,0,0,0,0,0,95,0,2317,0,77,0,2,0,16,0,2412,0,0,0,0,0,0,0,4,1,0,29
Monroe,6/14/20,0,0,0,0,0,0,0,0,0,7,0,358,0,5,0,0,0,2,0,365,0,0,0,0,0,0,0,0,0,0,10
Montgomery,6/14/20,0,0,0,0,0,0,0,0,0,2,0,219,0,2,0,0,0,0,0,221,0,0,0,0,0,0,0,0,0,0,1
Nevada,6/14/20,0,0,0,0,0,0,0,0,0,80,0,538,0,10,0,0,0,70,0,618,0,0,0,0,0,0,0,6,1,0,14
Newton,6/14/20,0,0,0,0,0,0,0,0,0,3,0,301,0,3,0,0,0,0,0,304,0,0,0,0,0,0,0,0,0,0,3
Ouachita,6/14/20,0,0,0,0,0,0,0,0,0,14,0,1087,0,10,0,0,0,4,0,1101,0,0,0,0,0,0,0,1,0,0,6
Perry,6/14/20,0,0,0,0,0,0,0,0,0,16,0,407,0,14,0,0,0,2,0,423,0,0,0,0,0,0,0,0,0,0,2
Phillips,6/14/20,0,0,0,0,0,0,0,0,0,39,0,973,0,22,0,1,0,16,0,1012,0,0,0,0,0,0,0,3,0,0,22
Pike,6/14/20,0,0,0,0,0,0,0,0,0,7,0,1030,0,5,0,0,0,2,0,1037,0,0,0,0,0,0,0,0,0,0,7
Poinsett,6/14/20,0,0,0,0,0,0,0,0,0,50,0,1047,0,35,0,3,0,12,0,1097,0,0,0,0,0,0,0,0,1,0,8
Polk,6/14/20,0,0,0,0,0,0,0,0,0,53,0,856,0,34,0,0,0,19,0,909,0,0,0,0,0,0,0,2,4,0,6
Pope,6/14/20,0,0,0,0,0,0,0,0,0,256,0,3328,0,176,0,2,0,78,0,3584,0,0,0,0,0,0,0,11,6,0,38
Prairie,6/14/20,0,0,0,0,0,0,0,0,0,7,0,271,0,3,0,0,0,4,0,278,0,0,0,0,0,0,0,0,0,0,6
Pulaski,6/14/20,0,0,0,0,0,0,0,0,0,1289,0,19654,0,923,0,42,0,324,0,20943,0,0,0,0,0,0,0,23,11,1,266
Randolph,6/14/20,0,0,0,0,0,0,0,0,0,28,0,1315,0,24,0,0,0,4,0,1343,0,0,0,0,0,0,0,0,0,0,24
Saline,6/14/20,0,0,0,0,0,0,0,0,0,174,0,5826,0,124,0,2,0,48,0,6000,0,0,0,0,0,0,0,7,3,0,68
Scott,6/14/20,0,0,0,0,0,0,0,0,0,3,0,231,0,2,0,0,0,1,0,234,0,0,0,0,0,0,0,1,0,0,6
Searcy,6/14/20,0,0,0,0,0,0,0,0,0,7,0,633,0,7,0,0,0,0,0,640,0,0,0,0,0,0,0,0,0,0,24
Sebastian,6/14/20,0,0,0,0,0,0,0,0,0,148,0,4107,0,67,0,2,0,79,0,4255,0,0,0,0,0,0,0,4,6,0,146
Sevier,6/14/20,0,0,0,0,0,0,0,0,0,446,0,2354,0,283,0,4,0,159,0,2800,0,0,0,0,0,0,0,18,29,0,31
Sharp,6/14/20,0,0,0,0,0,0,0,0,0,50,0,695,0,43,0,3,0,4,0,745,0,0,0,0,0,0,0,0,0,0,7
St.Francis,6/14/20,0,0,0,0,0,0,0,0,0,775,0,3659,0,682,0,2,0,91,0,4434,0,0,0,0,0,0,0,4,1,0,7
Stone,6/14/20,0,0,0,0,0,0,0,0,0,11,0,571,0,9,0,0,0,2,0,582,0,0,0,0,0,0,0,0,0,0,12
Union,6/14/20,0,0,0,0,0,0,0,0,0,203,0,1887,0,165,0,11,0,27,0,2090,0,0,0,0,0,0,0,1,2,0,23
VanBuren,6/14/20,0,0,0,0,0,0,0,0,0,30,0,735,0,26,0,2,0,2,0,765,0,0,0,0,0,0,0,0,0,0,7
Washington,6/14/20,0,0,0,0,0,0,0,0,0,1804,0,8449,0,761,0,12,0,1031,0,10253,0,0,0,0,0,0,0,94,61,0,175
White,6/14/20,0,0,0,0,0,0,0,0,0,58,0,2405,0,45,0,1,0,12,0,2463,0,0,0,0,0,0,0,2,0,0,30
Woodruff,6/14/20,0,0,0,0,0,0,0,0,0,4,0,241,0,1,0,0,0,3,0,245,0,0,0,0,0,0,0,1,0,0,2
Yell,6/14/20,0,0,0,0,0,0,0,0,0,303,0,947,0,190,0,2,0,111,0,1250,0,0,0,0,0,0,0,14,11,0,34
Arkansas_all_counties,6/13/20,0,0,0,0,0,0,0,0,2990671,12095,0,181699,0,7863,0,177,0,4055,0,193794,0,0,0,0,0,0,0,548,256,1,6777
Arkansas_county,6/13/20,0,0,0,0,0,0,0,0,0,7,0,550,0,4,0,0,0,3,0,557,0,0,0,0,0,0,0,0,0,0,8
Ashley,6/13/20,0,0,0,0,0,0,0,0,0,40,0,911,0,29,0,1,0,10,0,951,0,0,0,0,0,0,0,2,2,0,16
Baxter,6/13/20,0,0,0,0,0,0,0,0,0,14,0,1225,0,12,0,0,0,2,0,1239,0,0,0,0,0,0,0,0,1,0,10
Benton,6/13/20,0,0,0,0,0,0,0,0,0,1362,0,20694,0,750,0,7,0,605,0,22056,0,0,0,0,0,0,0,56,65,1,912
Boone,6/13/20,0,0,0,0,0,0,0,0,0,9,0,1280,0,6,0,0,0,3,0,1289,0,0,0,0,0,0,0,0,1,0,10
Bradley,6/13/20,0,0,0,0,0,0,0,0,0,34,0,608,0,21,0,1,0,12,0,642,0,0,0,0,0,0,0,0,2,0,4
Calhoun,6/13/20,0,0,0,0,0,0,0,0,0,0,0,156,0,0,0,0,0,0,0,156,0,0,0,0,0,0,0,0,0,0,7
Carroll,6/13/20,0,0,0,0,0,0,0,0,0,70,0,1545,0,29,0,1,0,40,0,1615,0,0,0,0,0,0,0,4,1,0,24
Chicot,6/13/20,0,0,0,0,0,0,0,0,0,43,0,524,0,18,0,1,0,24,0,567,0,0,0,0,0,0,0,3,1,0,36
Clark,6/13/20,0,0,0,0,0,0,0,0,0,45,0,1067,0,39,0,0,0,6,0,1112,0,0,0,0,0,0,0,0,0,0,28
Clay,6/13/20,0,0,0,0,0,0,0,0,0,18,0,821,0,5,0,0,0,13,0,839,0,0,0,0,0,0,0,9,0,0,29
Cleburne,6/13/20,0,0,0,0,0,0,0,0,0,75,0,1098,0,69,0,4,0,2,0,1173,0,0,0,0,0,0,0,1,0,0,41
Cleveland,6/13/20,0,0,0,0,0,0,0,0,0,19,0,456,0,19,0,0,0,0,0,475,0,0,0,0,0,0,0,0,0,0,6
Columbia,6/13/20,0,0,0,0,0,0,0,0,0,27,0,773,0,19,0,2,0,6,0,800,0,0,0,0,0,0,0,0,0,0,26
Conway,6/13/20,0,0,0,0,0,0,0,0,0,19,0,761,0,13,0,2,0,4,0,780,0,0,0,0,0,0,0,0,0,0,15
Craighead,6/13/20,0,0,0,0,0,0,0,0,0,352,0,7591,0,253,0,1,0,98,0,7943,0,0,0,0,0,0,0,6,6,0,140
Crawford,6/13/20,0,0,0,0,0,0,0,0,0,51,0,2029,0,31,0,0,0,20,0,2080,0,0,0,0,0,0,0,0,1,0,60
Crittenden,6/13/20,0,0,0,0,0,0,0,0,0,517,0,4219,0,406,0,9,0,102,0,4736,0,0,0,0,0,0,0,9,11,0,72
Cross,6/13/20,0,0,0,0,0,0,0,0,0,75,0,933,0,53,0,0,0,22,0,1008,0,0,0,0,0,0,0,1,2,0,14
Dallas,6/13/20,0,0,0,0,0,0,0,0,0,3,0,229,0,2,0,0,0,1,0,232,0,0,0,0,0,0,0,0,0,0,5
Desha,6/13/20,0,0,0,0,0,0,0,0,0,20,0,582,0,19,0,0,0,1,0,602,0,0,0,0,0,0,0,0,0,0,5
Drew,6/13/20,0,0,0,0,0,0,0,0,0,25,0,948,0,18,0,1,0,6,0,973,0,0,0,0,0,0,0,0,0,0,10
Faulkner,6/13/20,0,0,0,0,0,0,0,0,0,147,0,4077,0,103,0,3,0,41,0,4224,0,0,0,0,0,0,0,5,2,0,86
Franklin,6/13/20,0,0,0,0,0,0,0,0,0,6,0,550,0,4,0,0,0,2,0,556,0,0,0,0,0,0,0,0,0,0,11
Fulton,6/13/20,0,0,0,0,0,0,0,0,0,9,0,569,0,7,0,0,0,2,0,578,0,0,0,0,0,0,0,0,0,0,7
Garland,6/13/20,0,0,0,0,0,0,0,0,0,161,0,4776,0,135,0,1,0,25,0,4937,0,0,0,0,0,0,0,7,0,0,118
Grant,6/13/20,0,0,0,0,0,0,0,0,0,24,0,741,0,19,0,0,0,5,0,765,0,0,0,0,0,0,0,1,0,0,40
Greene,6/13/20,0,0,0,0,0,0,0,0,0,71,0,2614,0,66,0,0,0,5,0,2685,0,0,0,0,0,0,0,2,0,0,49
Hempstead,6/13/20,0,0,0,0,0,0,0,0,0,34,0,1023,0,20,0,1,0,13,0,1057,0,0,0,0,0,0,0,1,0,0,176
HotSpring,6/13/20,0,0,0,0,0,0,0,0,0,38,0,1206,0,33,0,0,0,5,0,1244,0,0,0,0,0,0,0,1,0,0,77
Howard,6/13/20,0,0,0,0,0,0,0,0,0,38,0,680,0,29,0,0,0,9,0,718,0,0,0,0,0,0,0,0,0,0,244
Independence,6/13/20,0,0,0,0,0,0,0,0,0,39,0,1609,0,33,0,0,0,6,0,1648,0,0,0,0,0,0,0,0,0,0,31
Izard,6/13/20,0,0,0,0,0,0,0,0,0,19,0,490,0,18,0,1,0,0,0,509,0,0,0,0,0,0,0,2,2,0,10
Jackson,6/13/20,0,0,0,0,0,0,0,0,0,16,0,568,0,5,0,0,0,11,0,584,0,0,0,0,0,0,0,1,0,0,12
Jefferson,6/13/20,0,0,0,0,0,0,0,0,0,628,0,4203,0,497,0,28,0,103,0,4831,0,0,0,0,0,0,0,3,3,0,53
Johnson,6/13/20,0,0,0,0,0,0,0,0,0,84,0,806,0,52,0,0,0,32,0,890,0,0,0,0,0,0,0,6,0,0,13
Lafayette,6/13/20,0,0,0,0,0,0,0,0,0,11,0,231,0,9,0,1,0,1,0,242,0,0,0,0,0,0,0,1,1,0,82
Lawrence,6/13/20,0,0,0,0,0,0,0,0,0,90,0,1041,0,73,0,9,0,8,0,1131,0,0,0,0,0,0,0,0,1,0,6
Lee,6/13/20,0,0,0,0,0,0,0,0,0,481,0,1179,0,29,0,1,0,451,0,1660,0,0,0,0,0,0,0,164,4,0,397
Lincoln,6/13/20,0,0,0,0,0,0,0,0,0,987,0,1100,0,959,0,11,0,17,0,2087,0,0,0,0,0,0,0,1,0,0,5
LittleRiver,6/13/20,0,0,0,0,0,0,0,0,0,34,0,616,0,19,0,0,0,15,0,650,0,0,0,0,0,0,0,1,1,0,208
Logan,6/13/20,0,0,0,0,0,0,0,0,0,18,0,679,0,12,0,0,0,6,0,697,0,0,0,0,0,0,0,1,1,0,27
Lonoke,6/13/20,0,0,0,0,0,0,0,0,0,70,0,2547,0,56,0,0,0,14,0,2617,0,0,0,0,0,0,0,1,1,0,63
Madison,6/13/20,0,0,0,0,0,0,0,0,0,107,0,1121,0,39,0,0,0,68,0,1228,0,0,0,0,0,0,0,8,4,0,21
Marion,6/13/20,0,0,0,0,0,0,0,0,0,2,0,505,0,2,0,0,0,0,0,507,0,0,0,0,0,0,0,0,0,0,1
Miller,6/13/20,0,0,0,0,0,0,0,0,0,69,0,1153,0,53,0,1,0,15,0,1222,0,0,0,0,0,0,0,3,1,0,57
MissingCountyInfo,6/13/20,0,0,0,0,0,0,0,0,0,321,0,32992,0,165,0,0,0,156,0,33313,0,0,0,0,0,0,0,21,2,0,1097
Mississippi,6/13/20,0,0,0,0,0,0,0,0,0,91,0,2292,0,76,0,2,0,13,0,2383,0,0,0,0,0,0,0,2,1,0,37
Monroe,6/13/20,0,0,0,0,0,0,0,0,0,7,0,348,0,5,0,0,0,2,0,355,0,0,0,0,0,0,0,2,0,0,11
Montgomery,6/13/20,0,0,0,0,0,0,0,0,0,2,0,218,0,2,0,0,0,0,0,220,0,0,0,0,0,0,0,0,0,0,13
Nevada,6/13/20,0,0,0,0,0,0,0,0,0,74,0,530,0,9,0,0,0,65,0,604,0,0,0,0,0,0,0,1,2,0,155
Newton,6/13/20,0,0,0,0,0,0,0,0,0,3,0,298,0,3,0,0,0,0,0,301,0,0,0,0,0,0,0,0,0,0,2
Ouachita,6/13/20,0,0,0,0,0,0,0,0,0,13,0,1082,0,10,0,0,0,3,0,1095,0,0,0,0,0,0,0,0,0,0,16
Perry,6/13/20,0,0,0,0,0,0,0,0,0,16,0,405,0,14,0,0,0,2,0,421,0,0,0,0,0,0,0,1,0,0,6
Phillips,6/13/20,0,0,0,0,0,0,0,0,0,36,0,954,0,22,0,1,0,13,0,990,0,0,0,0,0,0,0,4,0,0,17
Pike,6/13/20,0,0,0,0,0,0,0,0,0,7,0,1023,0,5,0,0,0,2,0,1030,0,0,0,0,0,0,0,1,0,0,115
Poinsett,6/13/20,0,0,0,0,0,0,0,0,0,50,0,1039,0,34,0,3,0,13,0,1089,0,0,0,0,0,0,0,0,2,0,25
Polk,6/13/20,0,0,0,0,0,0,0,0,0,51,0,852,0,30,0,0,0,21,0,903,0,0,0,0,0,0,0,3,2,0,110
Pope,6/13/20,0,0,0,0,0,0,0,0,0,245,0,3301,0,170,0,2,0,73,0,3546,0,0,0,0,0,0,0,11,7,0,46
Prairie,6/13/20,0,0,0,0,0,0,0,0,0,7,0,265,0,3,0,0,0,4,0,272,0,0,0,0,0,0,0,1,1,0,23
Pulaski,6/13/20,0,0,0,0,0,0,0,0,0,1266,0,19411,0,912,0,41,0,313,0,20677,0,0,0,0,0,0,0,25,25,0,499
Randolph,6/13/20,0,0,0,0,0,0,0,0,0,28,0,1291,0,24,0,0,0,4,0,1319,0,0,0,0,0,0,0,0,0,0,18
Saline,6/13/20,0,0,0,0,0,0,0,0,0,167,0,5765,0,121,0,2,0,44,0,5932,0,0,0,0,0,0,0,1,3,0,497
Scott,6/13/20,0,0,0,0,0,0,0,0,0,2,0,226,0,2,0,0,0,0,0,228,0,0,0,0,0,0,0,0,0,0,5
Searcy,6/13/20,0,0,0,0,0,0,0,0,0,7,0,609,0,7,0,0,0,0,0,616,0,0,0,0,0,0,0,0,0,0,4
Sebastian,6/13/20,0,0,0,0,0,0,0,0,0,144,0,3965,0,61,0,2,0,81,0,4109,0,0,0,0,0,0,0,31,7,0,230
Sevier,6/13/20,0,0,0,0,0,0,0,0,0,428,0,2341,0,254,0,4,0,170,0,2769,0,0,0,0,0,0,0,35,12,0,148
Sharp,6/13/20,0,0,0,0,0,0,0,0,0,50,0,688,0,43,0,3,0,4,0,738,0,0,0,0,0,0,0,-1,0,0,17
St.Francis,6/13/20,0,0,0,0,0,0,0,0,0,771,0,3656,0,681,0,2,0,88,0,4427,0,0,0,0,0,0,0,4,2,0,29
Stone,6/13/20,0,0,0,0,0,0,0,0,0,11,0,559,0,9,0,0,0,2,0,570,0,0,0,0,0,0,0,0,1,0,5
Union,6/13/20,0,0,0,0,0,0,0,0,0,202,0,1865,0,163,0,11,0,28,0,2067,0,0,0,0,0,0,0,3,3,0,25
VanBuren,6/13/20,0,0,0,0,0,0,0,0,0,30,0,728,0,26,0,2,0,2,0,758,0,0,0,0,0,0,0,0,0,0,5
Washington,6/13/20,0,0,0,0,0,0,0,0,0,1710,0,8368,0,700,0,12,0,998,0,10078,0,0,0,0,0,0,0,105,65,0,280
White,6/13/20,0,0,0,0,0,0,0,0,0,56,0,2377,0,45,0,1,0,10,0,2433,0,0,0,0,0,0,0,2,1,0,34
Woodruff,6/13/20,0,0,0,0,0,0,0,0,0,3,0,240,0,1,0,0,0,2,0,243,0,0,0,0,0,0,0,2,0,0,12
Yell,6/13/20,0,0,0,0,0,0,0,0,0,289,0,927,0,179,0,2,0,108,0,1216,0,0,0,0,0,0,0,14,6,0,44
Arkansas_all_counties,6/12/20,0,0,0,0,0,0,0,0,2990671,11547,0,175470,0,7607,0,176,0,3764,0,187017,0,0,0,0,0,0,0,731,256,5,6626
Arkansas_county,6/12/20,0,0,0,0,0,0,0,0,0,7,0,542,0,4,0,0,0,3,0,549,0,0,0,0,0,0,0,0,0,0,12
Ashley,6/12/20,0,0,0,0,0,0,0,0,0,38,0,897,0,27,0,1,0,10,0,935,0,0,0,0,0,0,0,3,0,0,5
Baxter,6/12/20,0,0,0,0,0,0,0,0,0,14,0,1215,0,11,0,0,0,3,0,1229,0,0,0,0,0,0,0,0,0,0,88
Benton,6/12/20,0,0,0,0,0,0,0,0,0,1306,0,19838,0,685,0,6,0,615,0,21144,0,0,0,0,0,0,0,87,49,1,1863
Boone,6/12/20,0,0,0,0,0,0,0,0,0,9,0,1270,0,5,0,0,0,4,0,1279,0,0,0,0,0,0,0,2,0,0,34
Bradley,6/12/20,0,0,0,0,0,0,0,0,0,34,0,604,0,19,0,1,0,14,0,638,0,0,0,0,0,0,0,0,2,0,15
Calhoun,6/12/20,0,0,0,0,0,0,0,0,0,0,0,149,0,0,0,0,0,0,0,149,0,0,0,0,0,0,0,0,0,0,-4
Carroll,6/12/20,0,0,0,0,0,0,0,0,0,66,0,1525,0,28,0,1,0,37,0,1591,0,0,0,0,0,0,0,10,1,0,33
Chicot,6/12/20,0,0,0,0,0,0,0,0,0,40,0,491,0,17,0,1,0,22,0,531,0,0,0,0,0,0,0,8,0,0,83
Clark,6/12/20,0,0,0,0,0,0,0,0,0,45,0,1039,0,39,0,0,0,6,0,1084,0,0,0,0,0,0,0,2,1,0,23
Clay,6/12/20,0,0,0,0,0,0,0,0,0,9,0,801,0,5,0,0,0,4,0,810,0,0,0,0,0,0,0,0,0,0,-19
Cleburne,6/12/20,0,0,0,0,0,0,0,0,0,74,0,1058,0,69,0,4,0,1,0,1132,0,0,0,0,0,0,0,0,0,0,15
Cleveland,6/12/20,0,0,0,0,0,0,0,0,0,19,0,450,0,19,0,0,0,0,0,469,0,0,0,0,0,0,0,0,0,0,-11
Columbia,6/12/20,0,0,0,0,0,0,0,0,0,27,0,747,0,19,0,2,0,6,0,774,0,0,0,0,0,0,0,0,0,0,206
Conway,6/12/20,0,0,0,0,0,0,0,0,0,19,0,746,0,13,0,2,0,4,0,765,0,0,0,0,0,0,0,3,0,1,26
Craighead,6/12/20,0,0,0,0,0,0,0,0,0,346,0,7457,0,247,0,1,0,98,0,7803,0,0,0,0,0,0,0,9,7,0,268
Crawford,6/12/20,0,0,0,0,0,0,0,0,0,51,0,1969,0,30,0,0,0,21,0,2020,0,0,0,0,0,0,0,4,3,0,109
Crittenden,6/12/20,0,0,0,0,0,0,0,0,0,508,0,4156,0,395,0,9,0,104,0,4664,0,0,0,0,0,0,0,8,20,0,48
Cross,6/12/20,0,0,0,0,0,0,0,0,0,74,0,920,0,51,0,0,0,23,0,994,0,0,0,0,0,0,0,2,0,0,19
Dallas,6/12/20,0,0,0,0,0,0,0,0,0,3,0,224,0,2,0,0,0,1,0,227,0,0,0,0,0,0,0,0,0,0,-10
Desha,6/12/20,0,0,0,0,0,0,0,0,0,20,0,577,0,19,0,0,0,1,0,597,0,0,0,0,0,0,0,0,0,0,7
Drew,6/12/20,0,0,0,0,0,0,0,0,0,25,0,938,0,18,0,1,0,6,0,963,0,0,0,0,0,0,0,0,0,0,12
Faulkner,6/12/20,0,0,0,0,0,0,0,0,0,142,0,3996,0,101,0,3,0,38,0,4138,0,0,0,0,0,0,0,6,0,0,169
Franklin,6/12/20,0,0,0,0,0,0,0,0,0,6,0,539,0,4,0,0,0,2,0,545,0,0,0,0,0,0,0,0,0,0,1
Fulton,6/12/20,0,0,0,0,0,0,0,0,0,9,0,562,0,7,0,0,0,2,0,571,0,0,0,0,0,0,0,1,0,0,27
Garland,6/12/20,0,0,0,0,0,0,0,0,0,154,0,4665,0,135,0,1,0,18,0,4819,0,0,0,0,0,0,0,0,1,0,133
Grant,6/12/20,0,0,0,0,0,0,0,0,0,23,0,702,0,19,0,0,0,4,0,725,0,0,0,0,0,0,0,1,0,0,20
Greene,6/12/20,0,0,0,0,0,0,0,0,0,69,0,2567,0,66,0,0,0,3,0,2636,0,0,0,0,0,0,0,1,2,0,-15
Hempstead,6/12/20,0,0,0,0,0,0,0,0,0,33,0,848,0,20,0,1,0,12,0,881,0,0,0,0,0,0,0,0,1,0,99
HotSpring,6/12/20,0,0,0,0,0,0,0,0,0,37,0,1130,0,33,0,0,0,4,0,1167,0,0,0,0,0,0,0,0,0,0,63
Howard,6/12/20,0,0,0,0,0,0,0,0,0,38,0,436,0,29,0,0,0,9,0,474,0,0,0,0,0,0,0,0,1,0,4
Independence,6/12/20,0,0,0,0,0,0,0,0,0,39,0,1578,0,33,0,0,0,6,0,1617,0,0,0,0,0,0,0,2,0,0,1
Izard,6/12/20,0,0,0,0,0,0,0,0,0,17,0,482,0,16,0,1,0,0,0,499,0,0,0,0,0,0,0,0,0,0,10
Jackson,6/12/20,0,0,0,0,0,0,0,0,0,15,0,557,0,5,0,0,0,10,0,572,0,0,0,0,0,0,0,1,0,0,10
Jefferson,6/12/20,0,0,0,0,0,0,0,0,0,625,0,4153,0,494,0,28,0,103,0,4778,0,0,0,0,0,0,0,47,2,0,-43
Johnson,6/12/20,0,0,0,0,0,0,0,0,0,78,0,799,0,52,0,0,0,26,0,877,0,0,0,0,0,0,0,3,2,0,-35
Lafayette,6/12/20,0,0,0,0,0,0,0,0,0,10,0,150,0,8,0,1,0,1,0,160,0,0,0,0,0,0,0,0,0,0,17
Lawrence,6/12/20,0,0,0,0,0,0,0,0,0,90,0,1035,0,72,0,9,0,9,0,1125,0,0,0,0,0,0,0,1,0,0,-3
Lee,6/12/20,0,0,0,0,0,0,0,0,0,317,0,946,0,25,0,1,0,291,0,1263,0,0,0,0,0,0,0,197,3,0,438
Lincoln,6/12/20,0,0,0,0,0,0,0,0,0,986,0,1096,0,959,0,11,0,16,0,2082,0,0,0,0,0,0,0,0,3,0,-14
LittleRiver,6/12/20,0,0,0,0,0,0,0,0,0,33,0,409,0,18,0,0,0,15,0,442,0,0,0,0,0,0,0,0,2,0,44
Logan,6/12/20,0,0,0,0,0,0,0,0,0,17,0,653,0,11,0,0,0,6,0,670,0,0,0,0,0,0,0,2,3,0,28
Lonoke,6/12/20,0,0,0,0,0,0,0,0,0,69,0,2485,0,55,0,0,0,14,0,2554,0,0,0,0,0,0,0,2,0,0,42
Madison,6/12/20,0,0,0,0,0,0,0,0,0,99,0,1108,0,35,0,0,0,64,0,1207,0,0,0,0,0,0,0,32,3,0,129
Marion,6/12/20,0,0,0,0,0,0,0,0,0,2,0,504,0,2,0,0,0,0,0,506,0,0,0,0,0,0,0,0,0,0,-1
Miller,6/12/20,0,0,0,0,0,0,0,0,0,66,0,1099,0,52,0,1,0,13,0,1165,0,0,0,0,0,0,0,2,1,0,22
MissingCountyInfo,6/12/20,0,0,0,0,0,0,0,0,0,300,0,31916,0,163,0,0,0,137,0,32216,0,0,0,0,0,0,0,-2,7,0,101
Mississippi,6/12/20,0,0,0,0,0,0,0,0,0,89,0,2257,0,75,0,2,0,12,0,2346,0,0,0,0,0,0,0,3,1,0,13
Monroe,6/12/20,0,0,0,0,0,0,0,0,0,5,0,339,0,5,0,0,0,0,0,344,0,0,0,0,0,0,0,0,0,0,5
Montgomery,6/12/20,0,0,0,0,0,0,0,0,0,2,0,205,0,2,0,0,0,0,0,207,0,0,0,0,0,0,0,0,0,0,7
Nevada,6/12/20,0,0,0,0,0,0,0,0,0,73,0,376,0,7,0,0,0,66,0,449,0,0,0,0,0,0,0,2,0,0,42
Newton,6/12/20,0,0,0,0,0,0,0,0,0,3,0,296,0,3,0,0,0,0,0,299,0,0,0,0,0,0,0,0,0,0,5
Ouachita,6/12/20,0,0,0,0,0,0,0,0,0,13,0,1066,0,10,0,0,0,3,0,1079,0,0,0,0,0,0,0,1,0,0,17
Perry,6/12/20,0,0,0,0,0,0,0,0,0,15,0,400,0,14,0,0,0,1,0,415,0,0,0,0,0,0,0,0,0,0,9
Phillips,6/12/20,0,0,0,0,0,0,0,0,0,32,0,941,0,22,0,1,0,9,0,973,0,0,0,0,0,0,0,1,0,0,-5
Pike,6/12/20,0,0,0,0,0,0,0,0,0,6,0,909,0,5,0,0,0,1,0,915,0,0,0,0,0,0,0,0,0,0,74
Poinsett,6/12/20,0,0,0,0,0,0,0,0,0,50,0,1014,0,32,0,3,0,15,0,1064,0,0,0,0,0,0,0,4,1,0,-12
Polk,6/12/20,0,0,0,0,0,0,0,0,0,48,0,745,0,28,0,0,0,20,0,793,0,0,0,0,0,0,0,0,2,0,69
Pope,6/12/20,0,0,0,0,0,0,0,0,0,234,0,3266,0,163,0,2,0,69,0,3500,0,0,0,0,0,0,0,2,3,0,23
Prairie,6/12/20,0,0,0,0,0,0,0,0,0,6,0,243,0,2,0,0,0,4,0,249,0,0,0,0,0,0,0,1,0,0,13
Pulaski,6/12/20,0,0,0,0,0,0,0,0,0,1241,0,18937,0,887,0,41,0,313,0,20178,0,0,0,0,0,0,0,16,27,0,611
Randolph,6/12/20,0,0,0,0,0,0,0,0,0,28,0,1273,0,24,0,0,0,4,0,1301,0,0,0,0,0,0,0,0,0,0,-15
Saline,6/12/20,0,0,0,0,0,0,0,0,0,166,0,5269,0,118,0,2,0,46,0,5435,0,0,0,0,0,0,0,3,3,0,299
Scott,6/12/20,0,0,0,0,0,0,0,0,0,2,0,221,0,2,0,0,0,0,0,223,0,0,0,0,0,0,0,0,0,0,-5
Searcy,6/12/20,0,0,0,0,0,0,0,0,0,7,0,605,0,7,0,0,0,0,0,612,0,0,0,0,0,0,0,0,0,0,-1
Sebastian,6/12/20,0,0,0,0,0,0,0,0,0,113,0,3766,0,54,0,2,0,57,0,3879,0,0,0,0,0,0,0,4,4,0,419
Sevier,6/12/20,0,0,0,0,0,0,0,0,0,393,0,2228,0,242,0,4,0,147,0,2621,0,0,0,0,0,0,0,6,20,0,91
Sharp,6/12/20,0,0,0,0,0,0,0,0,0,51,0,670,0,43,0,3,0,5,0,721,0,0,0,0,0,0,0,1,2,0,11
St.Francis,6/12/20,0,0,0,0,0,0,0,0,0,767,0,3631,0,679,0,2,0,86,0,4398,0,0,0,0,0,0,0,-1,6,1,71
Stone,6/12/20,0,0,0,0,0,0,0,0,0,11,0,554,0,8,0,0,0,3,0,565,0,0,0,0,0,0,0,0,0,0,-3
Union,6/12/20,0,0,0,0,0,0,0,0,0,199,0,1843,0,160,0,11,0,28,0,2042,0,0,0,0,0,0,0,5,1,0,135
VanBuren,6/12/20,0,0,0,0,0,0,0,0,0,30,0,723,0,26,0,2,0,2,0,753,0,0,0,0,0,0,0,0,0,0,1
Washington,6/12/20,0,0,0,0,0,0,0,0,0,1605,0,8193,0,635,0,12,0,958,0,9798,0,0,0,0,0,0,0,216,64,2,604
White,6/12/20,0,0,0,0,0,0,0,0,0,54,0,2345,0,44,0,1,0,9,0,2399,0,0,0,0,0,0,0,-1,0,0,19
Woodruff,6/12/20,0,0,0,0,0,0,0,0,0,1,0,230,0,1,0,0,0,0,0,231,0,0,0,0,0,0,0,0,0,0,8
Yell,6/12/20,0,0,0,0,0,0,0,0,0,275,0,897,0,173,0,2,0,100,0,1172,0,0,0,0,0,0,0,14,7,0,32
Arkansas_all_counties,6/11/20,0,0,0,0,0,0,0,0,2990671,10816,0,169575,0,7351,0,171,0,3294,0,180391,0,0,0,0,0,0,0,448,235,6,4174
Arkansas_county,6/11/20,0,0,0,0,0,0,0,0,0,7,0,530,0,4,0,0,0,3,0,537,0,0,0,0,0,0,0,0,1,0,23
Ashley,6/11/20,0,0,0,0,0,0,0,0,0,35,0,895,0,27,0,1,0,7,0,930,0,0,0,0,0,0,0,1,0,1,58
Baxter,6/11/20,0,0,0,0,0,0,0,0,0,14,0,1127,0,11,0,0,0,3,0,1141,0,0,0,0,0,0,0,0,0,0,167
Benton,6/11/20,0,0,0,0,0,0,0,0,0,1219,0,18062,0,636,0,5,0,578,0,19281,0,0,0,0,0,0,0,82,45,0,732
Boone,6/11/20,0,0,0,0,0,0,0,0,0,7,0,1238,0,5,0,0,0,2,0,1245,0,0,0,0,0,0,0,0,0,0,53
Bradley,6/11/20,0,0,0,0,0,0,0,0,0,34,0,589,0,17,0,1,0,16,0,623,0,0,0,0,0,0,0,0,0,0,35
Calhoun,6/11/20,0,0,0,0,0,0,0,0,0,0,0,153,0,0,0,0,0,0,0,153,0,0,0,0,0,0,0,0,0,0,6
Carroll,6/11/20,0,0,0,0,0,0,0,0,0,56,0,1502,0,27,0,1,0,28,0,1558,0,0,0,0,0,0,0,14,2,0,61
Chicot,6/11/20,0,0,0,0,0,0,0,0,0,32,0,416,0,17,0,1,0,14,0,448,0,0,0,0,0,0,0,2,1,1,17
Clark,6/11/20,0,0,0,0,0,0,0,0,0,43,0,1018,0,38,0,0,0,5,0,1061,0,0,0,0,0,0,0,2,0,0,21
Clay,6/11/20,0,0,0,0,0,0,0,0,0,9,0,820,0,5,0,0,0,4,0,829,0,0,0,0,0,0,0,1,0,0,64
Cleburne,6/11/20,0,0,0,0,0,0,0,0,0,74,0,1043,0,69,0,4,0,1,0,1117,0,0,0,0,0,0,0,0,0,0,26
Cleveland,6/11/20,0,0,0,0,0,0,0,0,0,19,0,461,0,19,0,0,0,0,0,480,0,0,0,0,0,0,0,0,0,0,44
Columbia,6/11/20,0,0,0,0,0,0,0,0,0,27,0,541,0,19,0,2,0,6,0,568,0,0,0,0,0,0,0,1,0,0,25
Conway,6/11/20,0,0,0,0,0,0,0,0,0,16,0,723,0,13,0,1,0,2,0,739,0,0,0,0,0,0,0,0,0,0,11
Craighead,6/11/20,0,0,0,0,0,0,0,0,0,337,0,7198,0,240,0,1,0,96,0,7535,0,0,0,0,0,0,0,6,10,0,980
Crawford,6/11/20,0,0,0,0,0,0,0,0,0,47,0,1864,0,27,0,0,0,20,0,1911,0,0,0,0,0,0,0,4,2,0,65
Crittenden,6/11/20,0,0,0,0,0,0,0,0,0,500,0,4116,0,375,0,9,0,116,0,4616,0,0,0,0,0,0,0,11,13,0,268
Cross,6/11/20,0,0,0,0,0,0,0,0,0,72,0,903,0,51,0,0,0,21,0,975,0,0,0,0,0,0,0,5,3,0,99
Dallas,6/11/20,0,0,0,0,0,0,0,0,0,3,0,234,0,2,0,0,0,1,0,237,0,0,0,0,0,0,0,0,0,0,14
Desha,6/11/20,0,0,0,0,0,0,0,0,0,20,0,570,0,19,0,0,0,1,0,590,0,0,0,0,0,0,0,0,0,0,13
Drew,6/11/20,0,0,0,0,0,0,0,0,0,25,0,926,0,18,0,1,0,6,0,951,0,0,0,0,0,0,0,2,1,0,30
Faulkner,6/11/20,0,0,0,0,0,0,0,0,0,136,0,3833,0,101,0,3,0,32,0,3969,0,0,0,0,0,0,0,12,1,0,145
Franklin,6/11/20,0,0,0,0,0,0,0,0,0,6,0,538,0,4,0,0,0,2,0,544,0,0,0,0,0,0,0,1,0,0,34
Fulton,6/11/20,0,0,0,0,0,0,0,0,0,8,0,536,0,7,0,0,0,1,0,544,0,0,0,0,0,0,0,0,0,0,36
Garland,6/11/20,0,0,0,0,0,0,0,0,0,154,0,4532,0,134,0,1,0,19,0,4686,0,0,0,0,0,0,0,1,0,0,69
Grant,6/11/20,0,0,0,0,0,0,0,0,0,22,0,683,0,19,0,0,0,3,0,705,0,0,0,0,0,0,0,0,1,0,18
Greene,6/11/20,0,0,0,0,0,0,0,0,0,68,0,2583,0,64,0,0,0,4,0,2651,0,0,0,0,0,0,0,1,1,0,252
Hempstead,6/11/20,0,0,0,0,0,0,0,0,0,33,0,749,0,19,0,1,0,13,0,782,0,0,0,0,0,0,0,-1,1,0,16
HotSpring,6/11/20,0,0,0,0,0,0,0,0,0,37,0,1067,0,33,0,0,0,4,0,1104,0,0,0,0,0,0,0,3,0,0,23
Howard,6/11/20,0,0,0,0,0,0,0,0,0,38,0,432,0,28,0,0,0,10,0,470,0,0,0,0,0,0,0,3,2,0,30
Independence,6/11/20,0,0,0,0,0,0,0,0,0,37,0,1579,0,33,0,0,0,4,0,1616,0,0,0,0,0,0,0,1,1,0,259
Izard,6/11/20,0,0,0,0,0,0,0,0,0,17,0,472,0,16,0,1,0,0,0,489,0,0,0,0,0,0,0,0,0,0,47
Jackson,6/11/20,0,0,0,0,0,0,0,0,0,14,0,548,0,5,0,0,0,9,0,562,0,0,0,0,0,0,0,0,0,0,41
Jefferson,6/11/20,0,0,0,0,0,0,0,0,0,578,0,4243,0,492,0,28,0,58,0,4821,0,0,0,0,0,0,0,5,9,0,273
Johnson,6/11/20,0,0,0,0,0,0,0,0,0,75,0,837,0,50,0,0,0,25,0,912,0,0,0,0,0,0,0,4,5,0,153
Lafayette,6/11/20,0,0,0,0,0,0,0,0,0,10,0,133,0,8,0,1,0,1,0,143,0,0,0,0,0,0,0,0,0,0,-1
Lawrence,6/11/20,0,0,0,0,0,0,0,0,0,89,0,1039,0,72,0,9,0,8,0,1128,0,0,0,0,0,0,0,0,0,0,82
Lee,6/11/20,0,0,0,0,0,0,0,0,0,120,0,705,0,22,0,1,0,97,0,825,0,0,0,0,0,0,0,0,0,0,34
Lincoln,6/11/20,0,0,0,0,0,0,0,0,0,986,0,1110,0,956,0,11,0,19,0,2096,0,0,0,0,0,0,0,1,0,0,39
LittleRiver,6/11/20,0,0,0,0,0,0,0,0,0,33,0,365,0,16,0,0,0,17,0,398,0,0,0,0,0,0,0,2,3,0,41
Logan,6/11/20,0,0,0,0,0,0,0,0,0,15,0,627,0,8,0,0,0,7,0,642,0,0,0,0,0,0,0,1,1,0,44
Lonoke,6/11/20,0,0,0,0,0,0,0,0,0,67,0,2445,0,55,0,0,0,12,0,2512,0,0,0,0,0,0,0,3,1,0,71
Madison,6/11/20,0,0,0,0,0,0,0,0,0,67,0,1011,0,32,0,0,0,35,0,1078,0,0,0,0,0,0,0,9,2,0,165
Marion,6/11/20,0,0,0,0,0,0,0,0,0,2,0,505,0,2,0,0,0,0,0,507,0,0,0,0,0,0,0,0,0,0,58
Miller,6/11/20,0,0,0,0,0,0,0,0,0,64,0,1079,0,51,0,1,0,12,0,1143,0,0,0,0,0,0,0,4,3,0,84
MissingCountyInfo,6/11/20,0,0,0,0,0,0,0,0,0,302,0,31813,0,156,0,0,0,146,0,32115,0,0,0,0,0,0,0,24,6,0,-3529
Mississippi,6/11/20,0,0,0,0,0,0,0,0,0,86,0,2247,0,74,0,2,0,10,0,2333,0,0,0,0,0,0,0,0,1,0,160
Monroe,6/11/20,0,0,0,0,0,0,0,0,0,5,0,334,0,5,0,0,0,0,0,339,0,0,0,0,0,0,0,0,0,0,32
Montgomery,6/11/20,0,0,0,0,0,0,0,0,0,2,0,198,0,2,0,0,0,0,0,200,0,0,0,0,0,0,0,-1,-1,0,-3
Nevada,6/11/20,0,0,0,0,0,0,0,0,0,71,0,336,0,7,0,0,0,64,0,407,0,0,0,0,0,0,0,1,0,0,5
Newton,6/11/20,0,0,0,0,0,0,0,0,0,3,0,291,0,3,0,0,0,0,0,294,0,0,0,0,0,0,0,0,0,0,5
Ouachita,6/11/20,0,0,0,0,0,0,0,0,0,12,0,1050,0,10,0,0,0,2,0,1062,0,0,0,0,0,0,0,0,0,0,24
Perry,6/11/20,0,0,0,0,0,0,0,0,0,15,0,391,0,14,0,0,0,1,0,406,0,0,0,0,0,0,0,0,0,0,6
Phillips,6/11/20,0,0,0,0,0,0,0,0,0,31,0,947,0,22,0,1,0,8,0,978,0,0,0,0,0,0,0,1,1,0,63
Pike,6/11/20,0,0,0,0,0,0,0,0,0,6,0,835,0,5,0,0,0,1,0,841,0,0,0,0,0,0,0,0,1,0,13
Poinsett,6/11/20,0,0,0,0,0,0,0,0,0,46,0,1030,0,31,0,3,0,12,0,1076,0,0,0,0,0,0,0,2,1,1,184
Polk,6/11/20,0,0,0,0,0,0,0,0,0,48,0,676,0,26,0,0,0,22,0,724,0,0,0,0,0,0,0,1,1,0,11
Pope,6/11/20,0,0,0,0,0,0,0,0,0,232,0,3245,0,160,0,2,0,70,0,3477,0,0,0,0,0,0,0,10,5,0,71
Prairie,6/11/20,0,0,0,0,0,0,0,0,0,5,0,231,0,2,0,0,0,3,0,236,0,0,0,0,0,0,0,0,0,0,2
Pulaski,6/11/20,0,0,0,0,0,0,0,0,0,1225,0,18342,0,860,0,41,0,324,0,19567,0,0,0,0,0,0,0,37,21,1,847
Randolph,6/11/20,0,0,0,0,0,0,0,0,0,28,0,1288,0,24,0,0,0,4,0,1316,0,0,0,0,0,0,0,1,0,0,69
Saline,6/11/20,0,0,0,0,0,0,0,0,0,163,0,4973,0,115,0,2,0,46,0,5136,0,0,0,0,0,0,0,4,3,1,119
Scott,6/11/20,0,0,0,0,0,0,0,0,0,2,0,226,0,2,0,0,0,0,0,228,0,0,0,0,0,0,0,0,0,0,12
Searcy,6/11/20,0,0,0,0,0,0,0,0,0,7,0,606,0,7,0,0,0,0,0,613,0,0,0,0,0,0,0,0,0,0,14
Sebastian,6/11/20,0,0,0,0,0,0,0,0,0,109,0,3351,0,50,0,2,0,57,0,3460,0,0,0,0,0,0,0,7,3,1,177
Sevier,6/11/20,0,0,0,0,0,0,0,0,0,387,0,2143,0,222,0,4,0,161,0,2530,0,0,0,0,0,0,0,5,16,2,48
Sharp,6/11/20,0,0,0,0,0,0,0,0,0,50,0,660,0,41,0,3,0,6,0,710,0,0,0,0,0,0,0,0,0,0,55
St.Francis,6/11/20,0,0,0,0,0,0,0,0,0,768,0,3559,0,673,0,1,0,94,0,4327,0,0,0,0,0,0,0,4,1,0,84
Stone,6/11/20,0,0,0,0,0,0,0,0,0,11,0,557,0,8,0,0,0,3,0,568,0,0,0,0,0,0,0,0,0,0,25
Union,6/11/20,0,0,0,0,0,0,0,0,0,194,0,1713,0,159,0,11,0,24,0,1907,0,0,0,0,0,0,0,4,0,0,274
VanBuren,6/11/20,0,0,0,0,0,0,0,0,0,30,0,722,0,26,0,2,0,2,0,752,0,0,0,0,0,0,0,0,0,0,27
Washington,6/11/20,0,0,0,0,0,0,0,0,0,1389,0,7805,0,571,0,10,0,808,0,9194,0,0,0,0,0,0,0,154,57,3,390
White,6/11/20,0,0,0,0,0,0,0,0,0,55,0,2325,0,44,0,1,0,10,0,2380,0,0,0,0,0,0,0,3,0,0,99
Woodruff,6/11/20,0,0,0,0,0,0,0,0,0,1,0,222,0,1,0,0,0,0,0,223,0,0,0,0,0,0,0,0,0,0,4
Yell,6/11/20,0,0,0,0,0,0,0,0,0,261,0,879,0,166,0,2,0,93,0,1140,0,0,0,0,0,0,0,10,11,0,61
Arkansas_all_counties,6/10/20,0,0,0,0,0,0,0,0,2990671,10368,0,165849,0,7116,0,165,0,3087,0,176217,0,0,0,0,0,0,0,288,241,4,5697
Arkansas_county,6/10/20,0,0,0,0,0,0,0,0,0,7,0,507,0,3,0,0,0,4,0,514,0,0,0,0,0,0,0,0,0,0,34
Ashley,6/10/20,0,0,0,0,0,0,0,0,0,34,0,838,0,27,0,0,0,7,0,872,0,0,0,0,0,0,0,0,2,0,22
Baxter,6/10/20,0,0,0,0,0,0,0,0,0,14,0,960,0,11,0,0,0,3,0,974,0,0,0,0,0,0,0,1,1,0,39
Benton,6/10/20,0,0,0,0,0,0,0,0,0,1137,0,17412,0,591,0,5,0,541,0,18549,0,0,0,0,0,0,0,47,45,0,999
Boone,6/10/20,0,0,0,0,0,0,0,0,0,7,0,1185,0,5,0,0,0,2,0,1192,0,0,0,0,0,0,0,0,0,0,94
Bradley,6/10/20,0,0,0,0,0,0,0,0,0,34,0,554,0,17,0,1,0,16,0,588,0,0,0,0,0,0,0,2,0,0,17
Calhoun,6/10/20,0,0,0,0,0,0,0,0,0,0,0,147,0,0,0,0,0,0,0,147,0,0,0,0,0,0,0,0,0,0,13
Carroll,6/10/20,0,0,0,0,0,0,0,0,0,42,0,1455,0,25,0,1,0,16,0,1497,0,0,0,0,0,0,0,2,2,0,58
Chicot,6/10/20,0,0,0,0,0,0,0,0,0,30,0,401,0,16,0,0,0,14,0,431,0,0,0,0,0,0,0,4,1,0,14
Clark,6/10/20,0,0,0,0,0,0,0,0,0,41,0,999,0,38,0,0,0,3,0,1040,0,0,0,0,0,0,0,0,1,0,120
Clay,6/10/20,0,0,0,0,0,0,0,0,0,8,0,757,0,5,0,0,0,3,0,765,0,0,0,0,0,0,0,1,1,0,52
Cleburne,6/10/20,0,0,0,0,0,0,0,0,0,74,0,1017,0,69,0,4,0,1,0,1091,0,0,0,0,0,0,0,-1,0,0,48
Cleveland,6/10/20,0,0,0,0,0,0,0,0,0,19,0,417,0,19,0,0,0,0,0,436,0,0,0,0,0,0,0,0,0,0,27
Columbia,6/10/20,0,0,0,0,0,0,0,0,0,26,0,517,0,19,0,2,0,5,0,543,0,0,0,0,0,0,0,0,0,0,18
Conway,6/10/20,0,0,0,0,0,0,0,0,0,16,0,712,0,13,0,1,0,2,0,728,0,0,0,0,0,0,0,0,0,0,18
Craighead,6/10/20,0,0,0,0,0,0,0,0,0,331,0,6224,0,230,0,1,0,100,0,6555,0,0,0,0,0,0,0,13,10,0,180
Crawford,6/10/20,0,0,0,0,0,0,0,0,0,43,0,1803,0,25,0,0,0,18,0,1846,0,0,0,0,0,0,0,0,1,0,150
Crittenden,6/10/20,0,0,0,0,0,0,0,0,0,489,0,3859,0,362,0,9,0,118,0,4348,0,0,0,0,0,0,0,16,16,0,111
Cross,6/10/20,0,0,0,0,0,0,0,0,0,67,0,809,0,48,0,0,0,19,0,876,0,0,0,0,0,0,0,2,1,0,26
Dallas,6/10/20,0,0,0,0,0,0,0,0,0,3,0,220,0,2,0,0,0,1,0,223,0,0,0,0,0,0,0,0,0,0,2
Desha,6/10/20,0,0,0,0,0,0,0,0,0,20,0,557,0,19,0,0,0,1,0,577,0,0,0,0,0,0,0,0,0,0,23
Drew,6/10/20,0,0,0,0,0,0,0,0,0,23,0,898,0,17,0,1,0,5,0,921,0,0,0,0,0,0,0,2,0,0,35
Faulkner,6/10/20,0,0,0,0,0,0,0,0,0,124,0,3700,0,100,0,3,0,21,0,3824,0,0,0,0,0,0,0,5,0,0,128
Franklin,6/10/20,0,0,0,0,0,0,0,0,0,5,0,505,0,4,0,0,0,1,0,510,0,0,0,0,0,0,0,0,0,0,48
Fulton,6/10/20,0,0,0,0,0,0,0,0,0,8,0,500,0,7,0,0,0,1,0,508,0,0,0,0,0,0,0,1,0,0,43
Garland,6/10/20,0,0,0,0,0,0,0,0,0,153,0,4464,0,134,0,1,0,18,0,4617,0,0,0,0,0,0,0,3,0,0,68
Grant,6/10/20,0,0,0,0,0,0,0,0,0,22,0,665,0,18,0,0,0,4,0,687,0,0,0,0,0,0,0,0,0,0,23
Greene,6/10/20,0,0,0,0,0,0,0,0,0,67,0,2332,0,63,0,0,0,4,0,2399,0,0,0,0,0,0,0,0,0,0,40
Hempstead,6/10/20,0,0,0,0,0,0,0,0,0,34,0,732,0,18,0,1,0,15,0,766,0,0,0,0,0,0,0,1,1,0,100
HotSpring,6/10/20,0,0,0,0,0,0,0,0,0,34,0,1047,0,33,0,0,0,1,0,1081,0,0,0,0,0,0,0,0,0,0,23
Howard,6/10/20,0,0,0,0,0,0,0,0,0,35,0,405,0,26,0,0,0,9,0,440,0,0,0,0,0,0,0,-1,1,0,8
Independence,6/10/20,0,0,0,0,0,0,0,0,0,36,0,1321,0,32,0,0,0,4,0,1357,0,0,0,0,0,0,0,0,2,0,51
Izard,6/10/20,0,0,0,0,0,0,0,0,0,17,0,425,0,16,0,1,0,0,0,442,0,0,0,0,0,0,0,0,1,0,23
Jackson,6/10/20,0,0,0,0,0,0,0,0,0,14,0,507,0,5,0,0,0,9,0,521,0,0,0,0,0,0,0,7,1,0,88
Jefferson,6/10/20,0,0,0,0,0,0,0,0,0,573,0,3975,0,483,0,28,0,62,0,4548,0,0,0,0,0,0,0,14,4,0,98
Johnson,6/10/20,0,0,0,0,0,0,0,0,0,71,0,688,0,45,0,0,0,26,0,759,0,0,0,0,0,0,0,2,0,0,16
Lafayette,6/10/20,0,0,0,0,0,0,0,0,0,10,0,134,0,8,0,1,0,1,0,144,0,0,0,0,0,0,0,0,0,0,-3
Lawrence,6/10/20,0,0,0,0,0,0,0,0,0,89,0,957,0,72,0,9,0,8,0,1046,0,0,0,0,0,0,0,0,0,0,37
Lee,6/10/20,0,0,0,0,0,0,0,0,0,120,0,671,0,22,0,1,0,97,0,791,0,0,0,0,0,0,0,23,1,0,37
Lincoln,6/10/20,0,0,0,0,0,0,0,0,0,985,0,1072,0,956,0,11,0,18,0,2057,0,0,0,0,0,0,0,0,0,0,11
LittleRiver,6/10/20,0,0,0,0,0,0,0,0,0,31,0,326,0,13,0,0,0,18,0,357,0,0,0,0,0,0,0,3,1,0,15
Logan,6/10/20,0,0,0,0,0,0,0,0,0,14,0,584,0,7,0,0,0,7,0,598,0,0,0,0,0,0,0,0,2,0,65
Lonoke,6/10/20,0,0,0,0,0,0,0,0,0,64,0,2377,0,54,0,0,0,10,0,2441,0,0,0,0,0,0,0,1,2,0,85
Madison,6/10/20,0,0,0,0,0,0,0,0,0,58,0,855,0,30,0,0,0,28,0,913,0,0,0,0,0,0,0,1,1,0,90
Marion,6/10/20,0,0,0,0,0,0,0,0,0,2,0,447,0,2,0,0,0,0,0,449,0,0,0,0,0,0,0,0,1,0,29
Miller,6/10/20,0,0,0,0,0,0,0,0,0,60,0,999,0,48,0,1,0,11,0,1059,0,0,0,0,0,0,0,1,2,0,30
MissingCountyInfo,6/10/20,0,0,0,0,0,0,0,0,0,278,0,35366,0,150,0,0,0,128,0,35644,0,0,0,0,0,0,0,-16,2,0,-189
Mississippi,6/10/20,0,0,0,0,0,0,0,0,0,86,0,2087,0,73,0,2,0,11,0,2173,0,0,0,0,0,0,0,1,0,0,92
Monroe,6/10/20,0,0,0,0,0,0,0,0,0,5,0,302,0,5,0,0,0,0,0,307,0,0,0,0,0,0,0,0,0,0,4
Montgomery,6/10/20,0,0,0,0,0,0,0,0,0,3,0,200,0,3,0,0,0,0,0,203,0,0,0,0,0,0,0,0,0,0,11
Nevada,6/10/20,0,0,0,0,0,0,0,0,0,70,0,332,0,7,0,0,0,63,0,402,0,0,0,0,0,0,0,2,1,0,77
Newton,6/10/20,0,0,0,0,0,0,0,0,0,3,0,286,0,3,0,0,0,0,0,289,0,0,0,0,0,0,0,0,0,0,85
Ouachita,6/10/20,0,0,0,0,0,0,0,0,0,12,0,1026,0,10,0,0,0,2,0,1038,0,0,0,0,0,0,0,-1,-1,0,19
Perry,6/10/20,0,0,0,0,0,0,0,0,0,15,0,385,0,14,0,0,0,1,0,400,0,0,0,0,0,0,0,0,0,0,24
Phillips,6/10/20,0,0,0,0,0,0,0,0,0,30,0,885,0,21,0,1,0,8,0,915,0,0,0,0,0,0,0,0,3,0,29
Pike,6/10/20,0,0,0,0,0,0,0,0,0,6,0,822,0,4,0,0,0,2,0,828,0,0,0,0,0,0,0,0,0,0,104
Poinsett,6/10/20,0,0,0,0,0,0,0,0,0,44,0,848,0,30,0,2,0,12,0,892,0,0,0,0,0,0,0,0,0,0,18
Polk,6/10/20,0,0,0,0,0,0,0,0,0,47,0,666,0,25,0,0,0,22,0,713,0,0,0,0,0,0,0,2,2,0,5
Pope,6/10/20,0,0,0,0,0,0,0,0,0,222,0,3184,0,155,0,2,0,65,0,3406,0,0,0,0,0,0,0,4,2,0,89
Prairie,6/10/20,0,0,0,0,0,0,0,0,0,5,0,229,0,2,0,0,0,3,0,234,0,0,0,0,0,0,0,0,0,0,29
Pulaski,6/10/20,0,0,0,0,0,0,0,0,0,1188,0,17532,0,839,0,40,0,309,0,18720,0,0,0,0,0,0,0,57,25,0,671
Randolph,6/10/20,0,0,0,0,0,0,0,0,0,27,0,1220,0,24,0,0,0,3,0,1247,0,0,0,0,0,0,0,1,0,0,25
Saline,6/10/20,0,0,0,0,0,0,0,0,0,159,0,4858,0,112,0,1,0,46,0,5017,0,0,0,0,0,0,0,9,3,0,122
Scott,6/10/20,0,0,0,0,0,0,0,0,0,2,0,214,0,2,0,0,0,0,0,216,0,0,0,0,0,0,0,0,1,0,14
Searcy,6/10/20,0,0,0,0,0,0,0,0,0,7,0,592,0,7,0,0,0,0,0,599,0,0,0,0,0,0,0,0,0,0,18
Sebastian,6/10/20,0,0,0,0,0,0,0,0,0,102,0,3181,0,47,0,1,0,54,0,3283,0,0,0,0,0,0,0,4,11,0,274
Sevier,6/10/20,0,0,0,0,0,0,0,0,0,382,0,2100,0,206,0,2,0,174,0,2482,0,0,0,0,0,0,0,16,24,0,69
Sharp,6/10/20,0,0,0,0,0,0,0,0,0,50,0,605,0,41,0,3,0,6,0,655,0,0,0,0,0,0,0,1,0,0,11
St.Francis,6/10/20,0,0,0,0,0,0,0,0,0,764,0,3479,0,672,0,1,0,91,0,4243,0,0,0,0,0,0,0,3,2,0,154
Stone,6/10/20,0,0,0,0,0,0,0,0,0,11,0,532,0,8,0,0,0,3,0,543,0,0,0,0,0,0,0,0,0,0,20
Union,6/10/20,0,0,0,0,0,0,0,0,0,190,0,1443,0,159,0,11,0,20,0,1633,0,0,0,0,0,0,0,0,4,0,144
VanBuren,6/10/20,0,0,0,0,0,0,0,0,0,30,0,695,0,26,0,2,0,2,0,725,0,0,0,0,0,0,0,0,0,0,42
Washington,6/10/20,0,0,0,0,0,0,0,0,0,1235,0,7569,0,514,0,7,0,714,0,8804,0,0,0,0,0,0,0,50,52,0,376
White,6/10/20,0,0,0,0,0,0,0,0,0,52,0,2229,0,44,0,1,0,7,0,2281,0,0,0,0,0,0,0,2,0,0,67
Woodruff,6/10/20,0,0,0,0,0,0,0,0,0,1,0,218,0,1,0,0,0,0,0,219,0,0,0,0,0,0,0,0,0,0,-3
Yell,6/10/20,0,0,0,0,0,0,0,0,0,251,0,828,0,155,0,2,0,94,0,1079,0,0,0,0,0,0,0,3,9,0,42
Arkansas_all_counties,6/9/20,0,0,0,0,0,0,0,0,2990671,10080,0,160440,0,6875,0,161,0,3044,0,170520,0,0,0,0,0,0,0,340,245,6,9933
Arkansas_county,6/9/20,0,0,0,0,0,0,0,0,0,7,0,473,0,3,0,0,0,4,0,480,0,0,0,0,0,0,0,0,0,0,48
Ashley,6/9/20,0,0,0,0,0,0,0,0,0,34,0,816,0,25,0,0,0,9,0,850,0,0,0,0,0,0,0,2,1,0,18
Baxter,6/9/20,0,0,0,0,0,0,0,0,0,13,0,922,0,10,0,0,0,3,0,935,0,0,0,0,0,0,0,0,0,0,64
Benton,6/9/20,0,0,0,0,0,0,0,0,0,1090,0,16460,0,546,0,5,0,539,0,17550,0,0,0,0,0,0,0,79,46,1,921
Boone,6/9/20,0,0,0,0,0,0,0,0,0,7,0,1091,0,5,0,0,0,2,0,1098,0,0,0,0,0,0,0,0,0,0,112
Bradley,6/9/20,0,0,0,0,0,0,0,0,0,32,0,539,0,17,0,1,0,14,0,571,0,0,0,0,0,0,0,0,1,0,44
Calhoun,6/9/20,0,0,0,0,0,0,0,0,0,0,0,134,0,0,0,0,0,0,0,134,0,0,0,0,0,0,0,0,0,0,12
Carroll,6/9/20,0,0,0,0,0,0,0,0,0,40,0,1399,0,23,0,1,0,16,0,1439,0,0,0,0,0,0,0,2,3,0,56
Chicot,6/9/20,0,0,0,0,0,0,0,0,0,26,0,391,0,15,0,0,0,11,0,417,0,0,0,0,0,0,0,0,0,0,139
Clark,6/9/20,0,0,0,0,0,0,0,0,0,41,0,879,0,37,0,0,0,4,0,920,0,0,0,0,0,0,0,0,0,0,42
Clay,6/9/20,0,0,0,0,0,0,0,0,0,7,0,706,0,4,0,0,0,3,0,713,0,0,0,0,0,0,0,1,0,0,16
Cleburne,6/9/20,0,0,0,0,0,0,0,0,0,75,0,968,0,69,0,4,0,2,0,1043,0,0,0,0,0,0,0,0,0,0,97
Cleveland,6/9/20,0,0,0,0,0,0,0,0,0,19,0,390,0,19,0,0,0,0,0,409,0,0,0,0,0,0,0,0,0,0,22
Columbia,6/9/20,0,0,0,0,0,0,0,0,0,26,0,499,0,19,0,2,0,5,0,525,0,0,0,0,0,0,0,1,0,0,15
Conway,6/9/20,0,0,0,0,0,0,0,0,0,16,0,694,0,13,0,1,0,2,0,710,0,0,0,0,0,0,0,1,0,0,34
Craighead,6/9/20,0,0,0,0,0,0,0,0,0,318,0,6057,0,220,0,1,0,97,0,6375,0,0,0,0,0,0,0,13,13,0,292
Crawford,6/9/20,0,0,0,0,0,0,0,0,0,43,0,1653,0,24,0,0,0,19,0,1696,0,0,0,0,0,0,0,1,1,0,178
Crittenden,6/9/20,0,0,0,0,0,0,0,0,0,473,0,3764,0,346,0,9,0,118,0,4237,0,0,0,0,0,0,0,8,13,0,209
Cross,6/9/20,0,0,0,0,0,0,0,0,0,65,0,785,0,47,0,0,0,18,0,850,0,0,0,0,0,0,0,2,0,0,15
Dallas,6/9/20,0,0,0,0,0,0,0,0,0,3,0,218,0,2,0,0,0,1,0,221,0,0,0,0,0,0,0,0,0,0,18
Desha,6/9/20,0,0,0,0,0,0,0,0,0,20,0,534,0,19,0,0,0,1,0,554,0,0,0,0,0,0,0,0,0,0,15
Drew,6/9/20,0,0,0,0,0,0,0,0,0,21,0,865,0,17,0,1,0,3,0,886,0,0,0,0,0,0,0,0,0,0,15
Faulkner,6/9/20,0,0,0,0,0,0,0,0,0,119,0,3577,0,100,0,3,0,16,0,3696,0,0,0,0,0,0,0,2,0,0,68
Franklin,6/9/20,0,0,0,0,0,0,0,0,0,5,0,457,0,4,0,0,0,1,0,462,0,0,0,0,0,0,0,0,0,0,18
Fulton,6/9/20,0,0,0,0,0,0,0,0,0,7,0,458,0,7,0,0,0,0,0,465,0,0,0,0,0,0,0,-1,1,0,16
Garland,6/9/20,0,0,0,0,0,0,0,0,0,150,0,4399,0,134,0,1,0,15,0,4549,0,0,0,0,0,0,0,8,1,0,63
Grant,6/9/20,0,0,0,0,0,0,0,0,0,22,0,642,0,18,0,0,0,4,0,664,0,0,0,0,0,0,0,3,0,0,68
Greene,6/9/20,0,0,0,0,0,0,0,0,0,67,0,2292,0,63,0,0,0,4,0,2359,0,0,0,0,0,0,0,0,5,0,57
Hempstead,6/9/20,0,0,0,0,0,0,0,0,0,33,0,633,0,17,0,1,0,15,0,666,0,0,0,0,0,0,0,3,0,0,24
HotSpring,6/9/20,0,0,0,0,0,0,0,0,0,34,0,1024,0,33,0,0,0,1,0,1058,0,0,0,0,0,0,0,0,0,0,6
Howard,6/9/20,0,0,0,0,0,0,0,0,0,36,0,396,0,25,0,0,0,11,0,432,0,0,0,0,0,0,0,3,2,0,47
Independence,6/9/20,0,0,0,0,0,0,0,0,0,36,0,1270,0,30,0,0,0,6,0,1306,0,0,0,0,0,0,0,0,0,0,83
Izard,6/9/20,0,0,0,0,0,0,0,0,0,17,0,402,0,15,0,1,0,1,0,419,0,0,0,0,0,0,0,0,0,0,87
Jackson,6/9/20,0,0,0,0,0,0,0,0,0,7,0,426,0,4,0,0,0,3,0,433,0,0,0,0,0,0,0,0,0,0,89
Jefferson,6/9/20,0,0,0,0,0,0,0,0,0,559,0,3891,0,479,0,28,0,52,0,4450,0,0,0,0,0,0,0,5,2,2,88
Johnson,6/9/20,0,0,0,0,0,0,0,0,0,69,0,674,0,45,0,0,0,24,0,743,0,0,0,0,0,0,0,3,3,0,35
Lafayette,6/9/20,0,0,0,0,0,0,0,0,0,10,0,137,0,8,0,1,0,1,0,147,0,0,0,0,0,0,0,0,0,0,50
Lawrence,6/9/20,0,0,0,0,0,0,0,0,0,89,0,920,0,72,0,9,0,8,0,1009,0,0,0,0,0,0,0,0,3,0,39
Lee,6/9/20,0,0,0,0,0,0,0,0,0,97,0,657,0,21,0,1,0,75,0,754,0,0,0,0,0,0,0,48,3,0,172
Lincoln,6/9/20,0,0,0,0,0,0,0,0,0,985,0,1061,0,956,0,11,0,18,0,2046,0,0,0,0,0,0,0,0,0,0,26
LittleRiver,6/9/20,0,0,0,0,0,0,0,0,0,28,0,314,0,12,0,0,0,16,0,342,0,0,0,0,0,0,0,2,3,0,18
Logan,6/9/20,0,0,0,0,0,0,0,0,0,14,0,519,0,5,0,0,0,9,0,533,0,0,0,0,0,0,0,1,0,0,71
Lonoke,6/9/20,0,0,0,0,0,0,0,0,0,63,0,2293,0,52,0,0,0,11,0,2356,0,0,0,0,0,0,0,3,2,0,58
Madison,6/9/20,0,0,0,0,0,0,0,0,0,57,0,766,0,29,0,0,0,28,0,823,0,0,0,0,0,0,0,3,7,0,65
Marion,6/9/20,0,0,0,0,0,0,0,0,0,2,0,418,0,1,0,0,0,1,0,420,0,0,0,0,0,0,0,0,0,0,29
Miller,6/9/20,0,0,0,0,0,0,0,0,0,59,0,970,0,46,0,1,0,12,0,1029,0,0,0,0,0,0,0,0,1,0,23
MissingCountyInfo,6/9/20,0,0,0,0,0,0,0,0,0,294,0,35539,0,148,0,0,0,146,0,35833,0,0,0,0,0,0,0,-6,0,0,-1789
Mississippi,6/9/20,0,0,0,0,0,0,0,0,0,85,0,1996,0,73,0,2,0,10,0,2081,0,0,0,0,0,0,0,2,0,0,243
Monroe,6/9/20,0,0,0,0,0,0,0,0,0,5,0,298,0,5,0,0,0,0,0,303,0,0,0,0,0,0,0,0,0,0,108
Montgomery,6/9/20,0,0,0,0,0,0,0,0,0,3,0,189,0,3,0,0,0,0,0,192,0,0,0,0,0,0,0,1,1,0,23
Nevada,6/9/20,0,0,0,0,0,0,0,0,0,68,0,257,0,6,0,0,0,62,0,325,0,0,0,0,0,0,0,9,1,0,24
Newton,6/9/20,0,0,0,0,0,0,0,0,0,3,0,201,0,3,0,0,0,0,0,204,0,0,0,0,0,0,0,0,0,0,20
Ouachita,6/9/20,0,0,0,0,0,0,0,0,0,13,0,1006,0,11,0,0,0,2,0,1019,0,0,0,0,0,0,0,-1,0,0,26
Perry,6/9/20,0,0,0,0,0,0,0,0,0,15,0,361,0,14,0,0,0,1,0,376,0,0,0,0,0,0,0,0,0,0,30
Phillips,6/9/20,0,0,0,0,0,0,0,0,0,30,0,856,0,18,0,1,0,11,0,886,0,0,0,0,0,0,0,3,2,0,39
Pike,6/9/20,0,0,0,0,0,0,0,0,0,6,0,718,0,4,0,0,0,2,0,724,0,0,0,0,0,0,0,0,0,0,42
Poinsett,6/9/20,0,0,0,0,0,0,0,0,0,44,0,830,0,30,0,2,0,12,0,874,0,0,0,0,0,0,0,0,1,0,41
Polk,6/9/20,0,0,0,0,0,0,0,0,0,45,0,663,0,23,0,0,0,22,0,708,0,0,0,0,0,0,0,0,2,0,106
Pope,6/9/20,0,0,0,0,0,0,0,0,0,218,0,3099,0,153,0,2,0,63,0,3317,0,0,0,0,0,0,0,5,5,0,32
Prairie,6/9/20,0,0,0,0,0,0,0,0,0,5,0,200,0,2,0,0,0,3,0,205,0,0,0,0,0,0,0,0,0,0,55
Pulaski,6/9/20,0,0,0,0,0,0,0,0,0,1131,0,16918,0,814,0,40,0,277,0,18049,0,0,0,0,0,0,0,13,22,3,433
Randolph,6/9/20,0,0,0,0,0,0,0,0,0,26,0,1196,0,24,0,0,0,2,0,1222,0,0,0,0,0,0,0,0,0,0,54
Saline,6/9/20,0,0,0,0,0,0,0,0,0,150,0,4745,0,109,0,1,0,40,0,4895,0,0,0,0,0,0,0,3,1,0,226
Scott,6/9/20,0,0,0,0,0,0,0,0,0,2,0,200,0,1,0,0,0,1,0,202,0,0,0,0,0,0,0,0,0,0,160
Searcy,6/9/20,0,0,0,0,0,0,0,0,0,7,0,574,0,7,0,0,0,0,0,581,0,0,0,0,0,0,0,0,0,0,30
Sebastian,6/9/20,0,0,0,0,0,0,0,0,0,98,0,2911,0,36,0,1,0,61,0,3009,0,0,0,0,0,0,0,2,0,0,417
Sevier,6/9/20,0,0,0,0,0,0,0,0,0,366,0,2047,0,182,0,2,0,182,0,2413,0,0,0,0,0,0,0,11,16,0,163
Sharp,6/9/20,0,0,0,0,0,0,0,0,0,49,0,595,0,41,0,3,0,5,0,644,0,0,0,0,0,0,0,1,4,0,124
St.Francis,6/9/20,0,0,0,0,0,0,0,0,0,761,0,3328,0,670,0,1,0,90,0,4089,0,0,0,0,0,0,0,6,5,0,96
Stone,6/9/20,0,0,0,0,0,0,0,0,0,11,0,512,0,8,0,0,0,3,0,523,0,0,0,0,0,0,0,0,0,0,63
Union,6/9/20,0,0,0,0,0,0,0,0,0,190,0,1299,0,155,0,11,0,24,0,1489,0,0,0,0,0,0,0,2,2,0,31
VanBuren,6/9/20,0,0,0,0,0,0,0,0,0,30,0,653,0,26,0,2,0,2,0,683,0,0,0,0,0,0,0,0,0,0,2
Washington,6/9/20,0,0,0,0,0,0,0,0,0,1185,0,7243,0,462,0,7,0,716,0,8428,0,0,0,0,0,0,0,88,60,-1,301
White,6/9/20,0,0,0,0,0,0,0,0,0,50,0,2164,0,44,0,1,0,5,0,2214,0,0,0,0,0,0,0,0,1,0,161
Woodruff,6/9/20,0,0,0,0,0,0,0,0,0,1,0,221,0,1,0,0,0,0,0,222,0,0,0,0,0,0,0,0,0,0,71
Yell,6/9/20,0,0,0,0,0,0,0,0,0,248,0,789,0,146,0,2,0,100,0,1037,0,0,0,0,0,0,0,8,11,0,86
Arkansas_all_counties,6/8/20,0,0,0,0,0,0,0,0,2990671,9740,0,150847,0,6630,0,155,0,2955,0,160587,0,0,0,0,0,0,0,314,206,1,4854
Arkansas_county,6/8/20,0,0,0,0,0,0,0,0,0,7,0,425,0,3,0,0,0,4,0,432,0,0,0,0,0,0,0,0,0,0,7
Ashley,6/8/20,0,0,0,0,0,0,0,0,0,32,0,800,0,24,0,0,0,8,0,832,0,0,0,0,0,0,0,0,3,0,5
Baxter,6/8/20,0,0,0,0,0,0,0,0,0,13,0,858,0,10,0,0,0,3,0,871,0,0,0,0,0,0,0,0,0,0,15
Benton,6/8/20,0,0,0,0,0,0,0,0,0,1011,0,15618,0,500,0,4,0,507,0,16629,0,0,0,0,0,0,0,55,52,1,679
Boone,6/8/20,0,0,0,0,0,0,0,0,0,7,0,979,0,5,0,0,0,2,0,986,0,0,0,0,0,0,0,0,0,0,11
Bradley,6/8/20,0,0,0,0,0,0,0,0,0,32,0,495,0,16,0,1,0,15,0,527,0,0,0,0,0,0,0,2,0,0,19
Calhoun,6/8/20,0,0,0,0,0,0,0,0,0,0,0,122,0,0,0,0,0,0,0,122,0,0,0,0,0,0,0,0,0,0,2
Carroll,6/8/20,0,0,0,0,0,0,0,0,0,38,0,1345,0,20,0,1,0,17,0,1383,0,0,0,0,0,0,0,0,2,0,74
Chicot,6/8/20,0,0,0,0,0,0,0,0,0,26,0,252,0,15,0,0,0,11,0,278,0,0,0,0,0,0,0,3,0,0,5
Clark,6/8/20,0,0,0,0,0,0,0,0,0,41,0,837,0,37,0,0,0,4,0,878,0,0,0,0,0,0,0,1,0,0,10
Clay,6/8/20,0,0,0,0,0,0,0,0,0,6,0,691,0,4,0,0,0,2,0,697,0,0,0,0,0,0,0,0,0,0,9
Cleburne,6/8/20,0,0,0,0,0,0,0,0,0,75,0,871,0,69,0,4,0,2,0,946,0,0,0,0,0,0,0,1,0,0,22
Cleveland,6/8/20,0,0,0,0,0,0,0,0,0,19,0,368,0,19,0,0,0,0,0,387,0,0,0,0,0,0,0,0,0,0,3
Columbia,6/8/20,0,0,0,0,0,0,0,0,0,25,0,485,0,19,0,2,0,4,0,510,0,0,0,0,0,0,0,2,1,0,18
Conway,6/8/20,0,0,0,0,0,0,0,0,0,15,0,661,0,13,0,1,0,1,0,676,0,0,0,0,0,0,0,0,0,0,9
Craighead,6/8/20,0,0,0,0,0,0,0,0,0,305,0,5778,0,207,0,1,0,97,0,6083,0,0,0,0,0,0,0,3,2,0,113
Crawford,6/8/20,0,0,0,0,0,0,0,0,0,42,0,1476,0,23,0,0,0,19,0,1518,0,0,0,0,0,0,0,1,3,0,332
Crittenden,6/8/20,0,0,0,0,0,0,0,0,0,465,0,3563,0,333,0,9,0,123,0,4028,0,0,0,0,0,0,0,2,9,0,38
Cross,6/8/20,0,0,0,0,0,0,0,0,0,63,0,772,0,47,0,0,0,16,0,835,0,0,0,0,0,0,0,2,0,0,13
Dallas,6/8/20,0,0,0,0,0,0,0,0,0,3,0,200,0,2,0,0,0,1,0,203,0,0,0,0,0,0,0,0,0,0,4
Desha,6/8/20,0,0,0,0,0,0,0,0,0,20,0,519,0,19,0,0,0,1,0,539,0,0,0,0,0,0,0,0,0,0,7
Drew,6/8/20,0,0,0,0,0,0,0,0,0,21,0,850,0,17,0,1,0,3,0,871,0,0,0,0,0,0,0,0,0,0,4
Faulkner,6/8/20,0,0,0,0,0,0,0,0,0,117,0,3511,0,100,0,3,0,14,0,3628,0,0,0,0,0,0,0,4,2,0,72
Franklin,6/8/20,0,0,0,0,0,0,0,0,0,5,0,439,0,4,0,0,0,1,0,444,0,0,0,0,0,0,0,0,0,0,15
Fulton,6/8/20,0,0,0,0,0,0,0,0,0,8,0,441,0,6,0,0,0,2,0,449,0,0,0,0,0,0,0,1,0,0,22
Garland,6/8/20,0,0,0,0,0,0,0,0,0,142,0,4344,0,133,0,1,0,8,0,4486,0,0,0,0,0,0,0,2,0,0,58
Grant,6/8/20,0,0,0,0,0,0,0,0,0,19,0,577,0,18,0,0,0,1,0,596,0,0,0,0,0,0,0,0,1,0,20
Greene,6/8/20,0,0,0,0,0,0,0,0,0,67,0,2235,0,58,0,0,0,9,0,2302,0,0,0,0,0,0,0,0,2,0,23
Hempstead,6/8/20,0,0,0,0,0,0,0,0,0,30,0,612,0,17,0,1,0,12,0,642,0,0,0,0,0,0,0,1,2,0,52
HotSpring,6/8/20,0,0,0,0,0,0,0,0,0,34,0,1018,0,33,0,0,0,1,0,1052,0,0,0,0,0,0,0,0,0,0,22
Howard,6/8/20,0,0,0,0,0,0,0,0,0,33,0,352,0,23,0,0,0,10,0,385,0,0,0,0,0,0,0,2,1,0,14
Independence,6/8/20,0,0,0,0,0,0,0,0,0,36,0,1187,0,30,0,0,0,6,0,1223,0,0,0,0,0,0,0,3,0,0,34
Izard,6/8/20,0,0,0,0,0,0,0,0,0,17,0,315,0,15,0,1,0,1,0,332,0,0,0,0,0,0,0,0,1,0,47
Jackson,6/8/20,0,0,0,0,0,0,0,0,0,7,0,337,0,4,0,0,0,3,0,344,0,0,0,0,0,0,0,1,0,0,6
Jefferson,6/8/20,0,0,0,0,0,0,0,0,0,554,0,3808,0,477,0,26,0,51,0,4362,0,0,0,0,0,0,0,6,0,0,58
Johnson,6/8/20,0,0,0,0,0,0,0,0,0,66,0,642,0,42,0,0,0,24,0,708,0,0,0,0,0,0,0,0,1,0,22
Lafayette,6/8/20,0,0,0,0,0,0,0,0,0,10,0,87,0,8,0,1,0,1,0,97,0,0,0,0,0,0,0,0,0,0,3
Lawrence,6/8/20,0,0,0,0,0,0,0,0,0,89,0,881,0,69,0,9,0,11,0,970,0,0,0,0,0,0,0,0,0,0,10
Lee,6/8/20,0,0,0,0,0,0,0,0,0,49,0,533,0,18,0,1,0,30,0,582,0,0,0,0,0,0,0,13,0,0,46
Lincoln,6/8/20,0,0,0,0,0,0,0,0,0,985,0,1035,0,956,0,11,0,18,0,2020,0,0,0,0,0,0,0,0,0,0,6
LittleRiver,6/8/20,0,0,0,0,0,0,0,0,0,26,0,298,0,9,0,0,0,17,0,324,0,0,0,0,0,0,0,1,1,0,23
Logan,6/8/20,0,0,0,0,0,0,0,0,0,13,0,449,0,5,0,0,0,8,0,462,0,0,0,0,0,0,0,1,1,0,45
Lonoke,6/8/20,0,0,0,0,0,0,0,0,0,60,0,2238,0,50,0,0,0,10,0,2298,0,0,0,0,0,0,0,1,0,0,54
Madison,6/8/20,0,0,0,0,0,0,0,0,0,54,0,704,0,22,0,0,0,32,0,758,0,0,0,0,0,0,0,0,4,0,14
Marion,6/8/20,0,0,0,0,0,0,0,0,0,2,0,389,0,1,0,0,0,1,0,391,0,0,0,0,0,0,0,0,0,0,19
Miller,6/8/20,0,0,0,0,0,0,0,0,0,59,0,947,0,45,0,1,0,13,0,1006,0,0,0,0,0,0,0,5,2,0,46
MissingCountyInfo,6/8/20,0,0,0,0,0,0,0,0,0,300,0,37322,0,148,0,0,0,152,0,37622,0,0,0,0,0,0,0,36,6,0,966
Mississippi,6/8/20,0,0,0,0,0,0,0,0,0,83,0,1755,0,73,0,2,0,8,0,1838,0,0,0,0,0,0,0,3,1,0,3
Monroe,6/8/20,0,0,0,0,0,0,0,0,0,5,0,190,0,5,0,0,0,0,0,195,0,0,0,0,0,0,0,0,0,0,0
Montgomery,6/8/20,0,0,0,0,0,0,0,0,0,2,0,167,0,2,0,0,0,0,0,169,0,0,0,0,0,0,0,0,0,0,2
Nevada,6/8/20,0,0,0,0,0,0,0,0,0,59,0,242,0,5,0,0,0,54,0,301,0,0,0,0,0,0,0,3,1,0,39
Newton,6/8/20,0,0,0,0,0,0,0,0,0,3,0,181,0,3,0,0,0,0,0,184,0,0,0,0,0,0,0,0,0,0,0
Ouachita,6/8/20,0,0,0,0,0,0,0,0,0,14,0,979,0,11,0,0,0,3,0,993,0,0,0,0,0,0,0,0,1,0,26
Perry,6/8/20,0,0,0,0,0,0,0,0,0,15,0,331,0,14,0,0,0,1,0,346,0,0,0,0,0,0,0,0,0,0,9
Phillips,6/8/20,0,0,0,0,0,0,0,0,0,27,0,820,0,16,0,1,0,10,0,847,0,0,0,0,0,0,0,1,1,0,27
Pike,6/8/20,0,0,0,0,0,0,0,0,0,6,0,676,0,4,0,0,0,2,0,682,0,0,0,0,0,0,0,0,0,0,11
Poinsett,6/8/20,0,0,0,0,0,0,0,0,0,44,0,789,0,29,0,2,0,13,0,833,0,0,0,0,0,0,0,0,0,0,35
Polk,6/8/20,0,0,0,0,0,0,0,0,0,45,0,557,0,21,0,0,0,24,0,602,0,0,0,0,0,0,0,4,6,0,14
Pope,6/8/20,0,0,0,0,0,0,0,0,0,213,0,3072,0,148,0,2,0,63,0,3285,0,0,0,0,0,0,0,9,12,0,57
Prairie,6/8/20,0,0,0,0,0,0,0,0,0,5,0,145,0,2,0,0,0,3,0,150,0,0,0,0,0,0,0,0,0,0,10
Pulaski,6/8/20,0,0,0,0,0,0,0,0,0,1118,0,16498,0,792,0,37,0,289,0,17616,0,0,0,0,0,0,0,15,20,0,492
Randolph,6/8/20,0,0,0,0,0,0,0,0,0,26,0,1142,0,24,0,0,0,2,0,1168,0,0,0,0,0,0,0,0,0,0,19
Saline,6/8/20,0,0,0,0,0,0,0,0,0,147,0,4522,0,108,0,1,0,38,0,4669,0,0,0,0,0,0,0,12,5,0,445
Scott,6/8/20,0,0,0,0,0,0,0,0,0,2,0,40,0,1,0,0,0,1,0,42,0,0,0,0,0,0,0,1,0,0,4
Searcy,6/8/20,0,0,0,0,0,0,0,0,0,7,0,544,0,7,0,0,0,0,0,551,0,0,0,0,0,0,0,0,1,0,3
Sebastian,6/8/20,0,0,0,0,0,0,0,0,0,96,0,2496,0,36,0,1,0,59,0,2592,0,0,0,0,0,0,0,11,1,0,254
Sevier,6/8/20,0,0,0,0,0,0,0,0,0,355,0,1895,0,166,0,2,0,187,0,2250,0,0,0,0,0,0,0,16,13,0,94
Sharp,6/8/20,0,0,0,0,0,0,0,0,0,48,0,472,0,37,0,3,0,8,0,520,0,0,0,0,0,0,0,0,0,0,13
St.Francis,6/8/20,0,0,0,0,0,0,0,0,0,755,0,3238,0,665,0,1,0,89,0,3993,0,0,0,0,0,0,0,2,9,0,85
Stone,6/8/20,0,0,0,0,0,0,0,0,0,11,0,449,0,8,0,0,0,3,0,460,0,0,0,0,0,0,0,1,0,0,25
Union,6/8/20,0,0,0,0,0,0,0,0,0,188,0,1270,0,153,0,11,0,24,0,1458,0,0,0,0,0,0,0,0,2,0,27
VanBuren,6/8/20,0,0,0,0,0,0,0,0,0,30,0,651,0,26,0,2,0,2,0,681,0,0,0,0,0,0,0,0,0,0,4
Washington,6/8/20,0,0,0,0,0,0,0,0,0,1097,0,7030,0,402,0,8,0,687,0,8127,0,0,0,0,0,0,0,81,30,0,314
White,6/8/20,0,0,0,0,0,0,0,0,0,50,0,2003,0,43,0,1,0,6,0,2053,0,0,0,0,0,0,0,1,1,0,22
Woodruff,6/8/20,0,0,0,0,0,0,0,0,0,1,0,150,0,1,0,0,0,0,0,151,0,0,0,0,0,0,0,0,0,0,2
Yell,6/8/20,0,0,0,0,0,0,0,0,0,240,0,711,0,135,0,2,0,103,0,951,0,0,0,0,0,0,0,5,6,0,16
Arkansas_all_counties,6/7/20,0,0,0,0,0,0,0,0,2990671,9426,0,150847,0,6424,0,154,0,2848,0,160273,0,0,0,0,0,0,0,325,158,0,3516
Arkansas_county,6/7/20,0,0,0,0,0,0,0,0,0,7,0,418,0,3,0,0,0,4,0,425,0,0,0,0,0,0,0,0,0,0,14
Ashley,6/7/20,0,0,0,0,0,0,0,0,0,32,0,795,0,21,0,0,0,11,0,827,0,0,0,0,0,0,0,3,1,0,9
Baxter,6/7/20,0,0,0,0,0,0,0,0,0,13,0,843,0,10,0,0,0,3,0,856,0,0,0,0,0,0,0,0,1,0,13
Benton,6/7/20,0,0,0,0,0,0,0,0,0,956,0,14994,0,448,0,3,0,505,0,15950,0,0,0,0,0,0,0,73,39,0,693
Boone,6/7/20,0,0,0,0,0,0,0,0,0,7,0,968,0,5,0,0,0,2,0,975,0,0,0,0,0,0,0,0,0,0,25
Bradley,6/7/20,0,0,0,0,0,0,0,0,0,30,0,478,0,16,0,1,0,13,0,508,0,0,0,0,0,0,0,2,1,0,10
Calhoun,6/7/20,0,0,0,0,0,0,0,0,0,0,0,120,0,0,0,0,0,0,0,120,0,0,0,0,0,0,0,0,0,0,0
Carroll,6/7/20,0,0,0,0,0,0,0,0,0,38,0,1271,0,18,0,1,0,19,0,1309,0,0,0,0,0,0,0,3,1,0,55
Chicot,6/7/20,0,0,0,0,0,0,0,0,0,23,0,250,0,15,0,0,0,8,0,273,0,0,0,0,0,0,0,2,1,0,6
Clark,6/7/20,0,0,0,0,0,0,0,0,0,40,0,828,0,37,0,0,0,3,0,868,0,0,0,0,0,0,0,0,0,0,7
Clay,6/7/20,0,0,0,0,0,0,0,0,0,6,0,682,0,4,0,0,0,2,0,688,0,0,0,0,0,0,0,0,0,0,15
Cleburne,6/7/20,0,0,0,0,0,0,0,0,0,74,0,850,0,69,0,4,0,1,0,924,0,0,0,0,0,0,0,0,0,0,14
Cleveland,6/7/20,0,0,0,0,0,0,0,0,0,19,0,365,0,19,0,0,0,0,0,384,0,0,0,0,0,0,0,0,0,0,5
Columbia,6/7/20,0,0,0,0,0,0,0,0,0,23,0,469,0,18,0,2,0,3,0,492,0,0,0,0,0,0,0,0,1,0,3
Conway,6/7/20,0,0,0,0,0,0,0,0,0,15,0,652,0,13,0,1,0,1,0,667,0,0,0,0,0,0,0,0,0,0,14
Craighead,6/7/20,0,0,0,0,0,0,0,0,0,302,0,5668,0,205,0,1,0,96,0,5970,0,0,0,0,0,0,0,2,2,0,61
Crawford,6/7/20,0,0,0,0,0,0,0,0,0,41,0,1145,0,20,0,0,0,21,0,1186,0,0,0,0,0,0,0,2,0,0,61
Crittenden,6/7/20,0,0,0,0,0,0,0,0,0,463,0,3527,0,324,0,9,0,130,0,3990,0,0,0,0,0,0,0,11,9,0,53
Cross,6/7/20,0,0,0,0,0,0,0,0,0,61,0,761,0,47,0,0,0,14,0,822,0,0,0,0,0,0,0,1,1,0,18
Dallas,6/7/20,0,0,0,0,0,0,0,0,0,3,0,196,0,2,0,0,0,1,0,199,0,0,0,0,0,0,0,0,-1,0,0
Desha,6/7/20,0,0,0,0,0,0,0,0,0,20,0,512,0,19,0,0,0,1,0,532,0,0,0,0,0,0,0,0,0,0,10
Drew,6/7/20,0,0,0,0,0,0,0,0,0,21,0,846,0,17,0,1,0,3,0,867,0,0,0,0,0,0,0,0,0,0,78
Faulkner,6/7/20,0,0,0,0,0,0,0,0,0,113,0,3443,0,98,0,3,0,12,0,3556,0,0,0,0,0,0,0,3,1,0,49
Franklin,6/7/20,0,0,0,0,0,0,0,0,0,5,0,424,0,4,0,0,0,1,0,429,0,0,0,0,0,0,0,0,0,0,18
Fulton,6/7/20,0,0,0,0,0,0,0,0,0,7,0,420,0,6,0,0,0,1,0,427,0,0,0,0,0,0,0,0,0,0,18
Garland,6/7/20,0,0,0,0,0,0,0,0,0,140,0,4288,0,133,0,1,0,6,0,4428,0,0,0,0,0,0,0,0,0,0,32
Grant,6/7/20,0,0,0,0,0,0,0,0,0,19,0,557,0,17,0,0,0,2,0,576,0,0,0,0,0,0,0,1,0,0,7
Greene,6/7/20,0,0,0,0,0,0,0,0,0,67,0,2212,0,56,0,0,0,11,0,2279,0,0,0,0,0,0,0,0,3,0,27
Hempstead,6/7/20,0,0,0,0,0,0,0,0,0,29,0,561,0,15,0,1,0,13,0,590,0,0,0,0,0,0,0,2,0,0,18
HotSpring,6/7/20,0,0,0,0,0,0,0,0,0,34,0,996,0,33,0,0,0,1,0,1030,0,0,0,0,0,0,0,0,0,0,7
Howard,6/7/20,0,0,0,0,0,0,0,0,0,31,0,340,0,22,0,0,0,9,0,371,0,0,0,0,0,0,0,3,2,0,11
Independence,6/7/20,0,0,0,0,0,0,0,0,0,33,0,1156,0,30,0,0,0,3,0,1189,0,0,0,0,0,0,0,0,0,0,35
Izard,6/7/20,0,0,0,0,0,0,0,0,0,17,0,268,0,14,0,1,0,2,0,285,0,0,0,0,0,0,0,0,0,0,1
Jackson,6/7/20,0,0,0,0,0,0,0,0,0,6,0,332,0,4,0,0,0,2,0,338,0,0,0,0,0,0,0,0,0,0,12
Jefferson,6/7/20,0,0,0,0,0,0,0,0,0,548,0,3756,0,477,0,26,0,45,0,4304,0,0,0,0,0,0,0,1,2,0,44
Johnson,6/7/20,0,0,0,0,0,0,0,0,0,66,0,620,0,41,0,0,0,25,0,686,0,0,0,0,0,0,0,9,0,0,17
Lafayette,6/7/20,0,0,0,0,0,0,0,0,0,10,0,84,0,8,0,1,0,1,0,94,0,0,0,0,0,0,0,1,0,0,2
Lawrence,6/7/20,0,0,0,0,0,0,0,0,0,89,0,871,0,69,0,9,0,11,0,960,0,0,0,0,0,0,0,0,0,0,21
Lee,6/7/20,0,0,0,0,0,0,0,0,0,36,0,500,0,18,0,1,0,17,0,536,0,0,0,0,0,0,0,4,0,0,13
Lincoln,6/7/20,0,0,0,0,0,0,0,0,0,985,0,1029,0,956,0,11,0,18,0,2014,0,0,0,0,0,0,0,0,0,0,16
LittleRiver,6/7/20,0,0,0,0,0,0,0,0,0,25,0,276,0,8,0,0,0,17,0,301,0,0,0,0,0,0,0,8,2,0,52
Logan,6/7/20,0,0,0,0,0,0,0,0,0,12,0,405,0,4,0,0,0,8,0,417,0,0,0,0,0,0,0,0,0,0,18
Lonoke,6/7/20,0,0,0,0,0,0,0,0,0,59,0,2185,0,50,0,0,0,9,0,2244,0,0,0,0,0,0,0,2,2,0,26
Madison,6/7/20,0,0,0,0,0,0,0,0,0,54,0,690,0,18,0,0,0,36,0,744,0,0,0,0,0,0,0,4,6,0,19
Marion,6/7/20,0,0,0,0,0,0,0,0,0,2,0,370,0,1,0,0,0,1,0,372,0,0,0,0,0,0,0,0,0,0,2
Miller,6/7/20,0,0,0,0,0,0,0,0,0,54,0,906,0,43,0,1,0,10,0,960,0,0,0,0,0,0,0,1,0,0,48
MissingCountyInfo,6/7/20,0,0,0,0,0,0,0,0,0,264,0,36392,0,142,0,0,0,122,0,36656,0,0,0,0,0,0,0,0,2,0,459
Mississippi,6/7/20,0,0,0,0,0,0,0,0,0,80,0,1755,0,72,0,2,0,6,0,1835,0,0,0,0,0,0,0,1,1,0,78
Monroe,6/7/20,0,0,0,0,0,0,0,0,0,5,0,190,0,5,0,0,0,0,0,195,0,0,0,0,0,0,0,0,0,0,6
Montgomery,6/7/20,0,0,0,0,0,0,0,0,0,2,0,165,0,2,0,0,0,0,0,167,0,0,0,0,0,0,0,0,0,0,0
Nevada,6/7/20,0,0,0,0,0,0,0,0,0,56,0,206,0,4,0,0,0,52,0,262,0,0,0,0,0,0,0,6,0,0,15
Newton,6/7/20,0,0,0,0,0,0,0,0,0,3,0,181,0,3,0,0,0,0,0,184,0,0,0,0,0,0,0,0,0,0,3
Ouachita,6/7/20,0,0,0,0,0,0,0,0,0,14,0,953,0,10,0,0,0,4,0,967,0,0,0,0,0,0,0,2,0,0,7
Perry,6/7/20,0,0,0,0,0,0,0,0,0,15,0,322,0,14,0,0,0,1,0,337,0,0,0,0,0,0,0,0,0,0,3
Phillips,6/7/20,0,0,0,0,0,0,0,0,0,26,0,794,0,15,0,1,0,10,0,820,0,0,0,0,0,0,0,0,2,0,42
Pike,6/7/20,0,0,0,0,0,0,0,0,0,6,0,665,0,4,0,0,0,2,0,671,0,0,0,0,0,0,0,0,0,0,12
Poinsett,6/7/20,0,0,0,0,0,0,0,0,0,44,0,754,0,29,0,2,0,13,0,798,0,0,0,0,0,0,0,2,0,0,114
Polk,6/7/20,0,0,0,0,0,0,0,0,0,41,0,547,0,15,0,0,0,26,0,588,0,0,0,0,0,0,0,8,2,0,21
Pope,6/7/20,0,0,0,0,0,0,0,0,0,204,0,3024,0,136,0,2,0,66,0,3228,0,0,0,0,0,0,0,7,8,0,79
Prairie,6/7/20,0,0,0,0,0,0,0,0,0,5,0,135,0,2,0,0,0,3,0,140,0,0,0,0,0,0,0,1,0,0,4
Pulaski,6/7/20,0,0,0,0,0,0,0,0,0,1103,0,16021,0,772,0,37,0,294,0,17124,0,0,0,0,0,0,0,12,14,0,225
Randolph,6/7/20,0,0,0,0,0,0,0,0,0,26,0,1123,0,24,0,0,0,2,0,1149,0,0,0,0,0,0,0,0,0,0,25
Saline,6/7/20,0,0,0,0,0,0,0,0,0,135,0,4089,0,103,0,1,0,31,0,4224,0,0,0,0,0,0,0,5,5,0,97
Scott,6/7/20,0,0,0,0,0,0,0,0,0,1,0,37,0,1,0,0,0,0,0,38,0,0,0,0,0,0,0,0,0,0,1
Searcy,6/7/20,0,0,0,0,0,0,0,0,0,7,0,541,0,6,0,0,0,1,0,548,0,0,0,0,0,0,0,0,0,0,36
Sebastian,6/7/20,0,0,0,0,0,0,0,0,0,85,0,2253,0,35,0,1,0,49,0,2338,0,0,0,0,0,0,0,4,5,0,119
Sevier,6/7/20,0,0,0,0,0,0,0,0,0,339,0,1817,0,153,0,2,0,184,0,2156,0,0,0,0,0,0,0,13,11,0,94
Sharp,6/7/20,0,0,0,0,0,0,0,0,0,48,0,459,0,37,0,3,0,8,0,507,0,0,0,0,0,0,0,0,0,0,4
St.Francis,6/7/20,0,0,0,0,0,0,0,0,0,753,0,3155,0,656,0,1,0,96,0,3908,0,0,0,0,0,0,0,9,2,0,17
Stone,6/7/20,0,0,0,0,0,0,0,0,0,10,0,425,0,8,0,0,0,2,0,435,0,0,0,0,0,0,0,0,0,0,22
Union,6/7/20,0,0,0,0,0,0,0,0,0,188,0,1243,0,151,0,11,0,26,0,1431,0,0,0,0,0,0,0,0,1,0,10
VanBuren,6/7/20,0,0,0,0,0,0,0,0,0,30,0,647,0,26,0,2,0,2,0,677,0,0,0,0,0,0,0,1,0,0,5
Washington,6/7/20,0,0,0,0,0,0,0,0,0,1016,0,6797,0,372,0,8,0,636,0,7813,0,0,0,0,0,0,0,103,23,0,265
White,6/7/20,0,0,0,0,0,0,0,0,0,49,0,1982,0,42,0,1,0,6,0,2031,0,0,0,0,0,0,0,0,1,0,26
Woodruff,6/7/20,0,0,0,0,0,0,0,0,0,1,0,148,0,1,0,0,0,0,0,149,0,0,0,0,0,0,0,0,0,0,2
Yell,6/7/20,0,0,0,0,0,0,0,0,0,235,0,700,0,129,0,2,0,104,0,935,0,0,0,0,0,0,0,13,6,0,48
Arkansas_all_counties,6/6/20,0,0,0,0,0,0,0,0,2990671,9101,0,147656,0,6266,0,154,0,2681,0,156757,0,0,0,0,0,0,0,450,189,2,5782
Arkansas_county,6/6/20,0,0,0,0,0,0,0,0,0,7,0,404,0,3,0,0,0,4,0,411,0,0,0,0,0,0,0,0,0,0,22
Ashley,6/6/20,0,0,0,0,0,0,0,0,0,29,0,789,0,20,0,0,0,9,0,818,0,0,0,0,0,0,0,0,1,0,21
Baxter,6/6/20,0,0,0,0,0,0,0,0,0,13,0,830,0,9,0,0,0,4,0,843,0,0,0,0,0,0,0,1,0,0,32
Benton,6/6/20,0,0,0,0,0,0,0,0,0,883,0,14374,0,409,0,3,0,471,0,15257,0,0,0,0,0,0,0,57,32,0,661
Boone,6/6/20,0,0,0,0,0,0,0,0,0,7,0,943,0,5,0,0,0,2,0,950,0,0,0,0,0,0,0,0,0,0,9
Bradley,6/6/20,0,0,0,0,0,0,0,0,0,28,0,470,0,15,0,1,0,12,0,498,0,0,0,0,0,0,0,2,0,0,16
Calhoun,6/6/20,0,0,0,0,0,0,0,0,0,0,0,120,0,0,0,0,0,0,0,120,0,0,0,0,0,0,0,0,0,0,1
Carroll,6/6/20,0,0,0,0,0,0,0,0,0,35,0,1219,0,17,0,1,0,17,0,1254,0,0,0,0,0,0,0,2,2,0,28
Chicot,6/6/20,0,0,0,0,0,0,0,0,0,21,0,246,0,14,0,0,0,7,0,267,0,0,0,0,0,0,0,2,1,0,8
Clark,6/6/20,0,0,0,0,0,0,0,0,0,40,0,821,0,37,0,0,0,3,0,861,0,0,0,0,0,0,0,0,0,0,11
Clay,6/6/20,0,0,0,0,0,0,0,0,0,6,0,667,0,4,0,0,0,2,0,673,0,0,0,0,0,0,0,1,0,0,15
Cleburne,6/6/20,0,0,0,0,0,0,0,0,0,74,0,836,0,69,0,4,0,1,0,910,0,0,0,0,0,0,0,0,0,0,17
Cleveland,6/6/20,0,0,0,0,0,0,0,0,0,19,0,360,0,19,0,0,0,0,0,379,0,0,0,0,0,0,0,0,0,0,8
Columbia,6/6/20,0,0,0,0,0,0,0,0,0,23,0,466,0,17,0,2,0,4,0,489,0,0,0,0,0,0,0,0,0,0,16
Conway,6/6/20,0,0,0,0,0,0,0,0,0,15,0,638,0,13,0,1,0,1,0,653,0,0,0,0,0,0,0,0,0,0,10
Craighead,6/6/20,0,0,0,0,0,0,0,0,0,300,0,5609,0,203,0,1,0,96,0,5909,0,0,0,0,0,0,0,21,5,1,195
Crawford,6/6/20,0,0,0,0,0,0,0,0,0,39,0,1086,0,20,0,0,0,19,0,1125,0,0,0,0,0,0,0,4,0,0,117
Crittenden,6/6/20,0,0,0,0,0,0,0,0,0,452,0,3485,0,315,0,9,0,128,0,3937,0,0,0,0,0,0,0,16,10,0,74
Cross,6/6/20,0,0,0,0,0,0,0,0,0,60,0,744,0,46,0,0,0,14,0,804,0,0,0,0,0,0,0,0,1,0,23
Dallas,6/6/20,0,0,0,0,0,0,0,0,0,3,0,196,0,3,0,0,0,0,0,199,0,0,0,0,0,0,0,0,0,0,7
Desha,6/6/20,0,0,0,0,0,0,0,0,0,20,0,502,0,19,0,0,0,1,0,522,0,0,0,0,0,0,0,1,0,0,7
Drew,6/6/20,0,0,0,0,0,0,0,0,0,21,0,768,0,17,0,1,0,3,0,789,0,0,0,0,0,0,0,0,0,0,82
Faulkner,6/6/20,0,0,0,0,0,0,0,0,0,110,0,3397,0,97,0,3,0,10,0,3507,0,0,0,0,0,0,0,2,1,0,79
Franklin,6/6/20,0,0,0,0,0,0,0,0,0,5,0,406,0,4,0,0,0,1,0,411,0,0,0,0,0,0,0,0,0,0,21
Fulton,6/6/20,0,0,0,0,0,0,0,0,0,7,0,402,0,6,0,0,0,1,0,409,0,0,0,0,0,0,0,0,0,0,10
Garland,6/6/20,0,0,0,0,0,0,0,0,0,140,0,4256,0,133,0,1,0,6,0,4396,0,0,0,0,0,0,0,2,0,0,56
Grant,6/6/20,0,0,0,0,0,0,0,0,0,18,0,551,0,17,0,0,0,1,0,569,0,0,0,0,0,0,0,0,0,0,15
Greene,6/6/20,0,0,0,0,0,0,0,0,0,67,0,2185,0,53,0,0,0,14,0,2252,0,0,0,0,0,0,0,0,1,0,40
Hempstead,6/6/20,0,0,0,0,0,0,0,0,0,27,0,545,0,15,0,1,0,11,0,572,0,0,0,0,0,0,0,4,1,0,46
HotSpring,6/6/20,0,0,0,0,0,0,0,0,0,34,0,989,0,33,0,0,0,1,0,1023,0,0,0,0,0,0,0,0,0,0,13
Howard,6/6/20,0,0,0,0,0,0,0,0,0,28,0,332,0,20,0,0,0,8,0,360,0,0,0,0,0,0,0,1,1,0,13
Independence,6/6/20,0,0,0,0,0,0,0,0,0,33,0,1121,0,30,0,0,0,3,0,1154,0,0,0,0,0,0,0,0,0,0,36
Izard,6/6/20,0,0,0,0,0,0,0,0,0,17,0,267,0,14,0,1,0,2,0,284,0,0,0,0,0,0,0,0,0,0,4
Jackson,6/6/20,0,0,0,0,0,0,0,0,0,6,0,320,0,4,0,0,0,2,0,326,0,0,0,0,0,0,0,1,2,0,19
Jefferson,6/6/20,0,0,0,0,0,0,0,0,0,547,0,3713,0,475,0,26,0,46,0,4260,0,0,0,0,0,0,0,2,5,1,269
Johnson,6/6/20,0,0,0,0,0,0,0,0,0,57,0,612,0,41,0,0,0,16,0,669,0,0,0,0,0,0,0,2,0,0,15
Lafayette,6/6/20,0,0,0,0,0,0,0,0,0,9,0,83,0,8,0,1,0,0,0,92,0,0,0,0,0,0,0,0,0,0,2
Lawrence,6/6/20,0,0,0,0,0,0,0,0,0,89,0,850,0,69,0,9,0,11,0,939,0,0,0,0,0,0,0,2,0,0,19
Lee,6/6/20,0,0,0,0,0,0,0,0,0,32,0,491,0,18,0,1,0,13,0,523,0,0,0,0,0,0,0,2,0,0,32
Lincoln,6/6/20,0,0,0,0,0,0,0,0,0,985,0,1013,0,956,0,11,0,18,0,1998,0,0,0,0,0,0,0,0,6,0,6
LittleRiver,6/6/20,0,0,0,0,0,0,0,0,0,17,0,232,0,6,0,0,0,11,0,249,0,0,0,0,0,0,0,3,2,0,12
Logan,6/6/20,0,0,0,0,0,0,0,0,0,12,0,387,0,4,0,0,0,8,0,399,0,0,0,0,0,0,0,0,0,0,30
Lonoke,6/6/20,0,0,0,0,0,0,0,0,0,57,0,2161,0,48,0,0,0,9,0,2218,0,0,0,0,0,0,0,0,0,0,65
Madison,6/6/20,0,0,0,0,0,0,0,0,0,50,0,675,0,12,0,0,0,38,0,725,0,0,0,0,0,0,0,7,4,0,97
Marion,6/6/20,0,0,0,0,0,0,0,0,0,2,0,368,0,1,0,0,0,1,0,370,0,0,0,0,0,0,0,0,0,0,37
Miller,6/6/20,0,0,0,0,0,0,0,0,0,53,0,859,0,43,0,1,0,9,0,912,0,0,0,0,0,0,0,1,1,0,44
MissingCountyInfo,6/6/20,0,0,0,0,0,0,0,0,0,264,0,35933,0,140,0,0,0,124,0,36197,0,0,0,0,0,0,0,20,4,0,1562
Mississippi,6/6/20,0,0,0,0,0,0,0,0,0,79,0,1678,0,71,0,2,0,6,0,1757,0,0,0,0,0,0,0,0,2,0,58
Monroe,6/6/20,0,0,0,0,0,0,0,0,0,5,0,184,0,5,0,0,0,0,0,189,0,0,0,0,0,0,0,0,0,0,3
Montgomery,6/6/20,0,0,0,0,0,0,0,0,0,2,0,165,0,2,0,0,0,0,0,167,0,0,0,0,0,0,0,0,0,0,2
Nevada,6/6/20,0,0,0,0,0,0,0,0,0,50,0,197,0,4,0,0,0,46,0,247,0,0,0,0,0,0,0,40,0,0,68
Newton,6/6/20,0,0,0,0,0,0,0,0,0,3,0,178,0,3,0,0,0,0,0,181,0,0,0,0,0,0,0,0,0,0,3
Ouachita,6/6/20,0,0,0,0,0,0,0,0,0,12,0,948,0,10,0,0,0,2,0,960,0,0,0,0,0,0,0,0,0,0,24
Perry,6/6/20,0,0,0,0,0,0,0,0,0,15,0,319,0,14,0,0,0,1,0,334,0,0,0,0,0,0,0,1,0,0,7
Phillips,6/6/20,0,0,0,0,0,0,0,0,0,26,0,752,0,13,0,1,0,12,0,778,0,0,0,0,0,0,0,1,2,0,32
Pike,6/6/20,0,0,0,0,0,0,0,0,0,6,0,653,0,4,0,0,0,2,0,659,0,0,0,0,0,0,0,0,0,0,10
Poinsett,6/6/20,0,0,0,0,0,0,0,0,0,42,0,642,0,29,0,2,0,11,0,684,0,0,0,0,0,0,0,1,2,0,30
Polk,6/6/20,0,0,0,0,0,0,0,0,0,33,0,534,0,13,0,0,0,20,0,567,0,0,0,0,0,0,0,4,3,0,14
Pope,6/6/20,0,0,0,0,0,0,0,0,0,197,0,2952,0,128,0,2,0,67,0,3149,0,0,0,0,0,0,0,13,7,0,91
Prairie,6/6/20,0,0,0,0,0,0,0,0,0,4,0,132,0,2,0,0,0,2,0,136,0,0,0,0,0,0,0,1,0,0,17
Pulaski,6/6/20,0,0,0,0,0,0,0,0,0,1091,0,15808,0,758,0,37,0,296,0,16899,0,0,0,0,0,0,0,26,15,0,442
Randolph,6/6/20,0,0,0,0,0,0,0,0,0,26,0,1098,0,24,0,0,0,2,0,1124,0,0,0,0,0,0,0,0,0,0,19
Saline,6/6/20,0,0,0,0,0,0,0,0,0,130,0,3997,0,98,0,1,0,31,0,4127,0,0,0,0,0,0,0,7,4,0,165
Scott,6/6/20,0,0,0,0,0,0,0,0,0,1,0,36,0,1,0,0,0,0,0,37,0,0,0,0,0,0,0,0,0,0,0
Searcy,6/6/20,0,0,0,0,0,0,0,0,0,7,0,505,0,6,0,0,0,1,0,512,0,0,0,0,0,0,0,0,-1,0,3
Sebastian,6/6/20,0,0,0,0,0,0,0,0,0,81,0,2138,0,30,0,1,0,50,0,2219,0,0,0,0,0,0,0,12,5,0,205
Sevier,6/6/20,0,0,0,0,0,0,0,0,0,326,0,1736,0,142,0,2,0,182,0,2062,0,0,0,0,0,0,0,25,12,0,118
Sharp,6/6/20,0,0,0,0,0,0,0,0,0,48,0,455,0,37,0,3,0,8,0,503,0,0,0,0,0,0,0,0,0,0,7
St.Francis,6/6/20,0,0,0,0,0,0,0,0,0,744,0,3147,0,654,0,1,0,89,0,3891,0,0,0,0,0,0,0,50,5,0,109
Stone,6/6/20,0,0,0,0,0,0,0,0,0,10,0,403,0,8,0,0,0,2,0,413,0,0,0,0,0,0,0,0,0,0,3
Union,6/6/20,0,0,0,0,0,0,0,0,0,188,0,1233,0,150,0,11,0,27,0,1421,0,0,0,0,0,0,0,3,3,0,129
VanBuren,6/6/20,0,0,0,0,0,0,0,0,0,29,0,643,0,26,0,2,0,1,0,672,0,0,0,0,0,0,0,0,0,0,7
Washington,6/6/20,0,0,0,0,0,0,0,0,0,913,0,6635,0,349,0,8,0,556,0,7548,0,0,0,0,0,0,0,89,35,0,219
White,6/6/20,0,0,0,0,0,0,0,0,0,49,0,1956,0,41,0,1,0,7,0,2005,0,0,0,0,0,0,0,1,0,0,36
Woodruff,6/6/20,0,0,0,0,0,0,0,0,0,1,0,146,0,1,0,0,0,0,0,147,0,0,0,0,0,0,0,0,0,0,6
Yell,6/6/20,0,0,0,0,0,0,0,0,0,222,0,665,0,123,0,2,0,97,0,887,0,0,0,0,0,0,0,20,16,0,35
Arkansas_all_counties,6/5/20,0,0,0,0,0,0,0,0,2990671,8651,0,142324,0,6077,0,152,0,2422,0,150975,0,0,0,0,0,0,0,226,158,1,3590
Arkansas_county,6/5/20,0,0,0,0,0,0,0,0,0,7,0,382,0,3,0,0,0,4,0,389,0,0,0,0,0,0,0,0,0,0,12
Ashley,6/5/20,0,0,0,0,0,0,0,0,0,29,0,768,0,19,0,0,0,10,0,797,0,0,0,0,0,0,0,3,0,0,16
Baxter,6/5/20,0,0,0,0,0,0,0,0,0,12,0,799,0,9,0,0,0,3,0,811,0,0,0,0,0,0,0,0,0,0,14
Benton,6/5/20,0,0,0,0,0,0,0,0,0,826,0,13770,0,377,0,3,0,446,0,14596,0,0,0,0,0,0,0,22,34,0,381
Boone,6/5/20,0,0,0,0,0,0,0,0,0,7,0,934,0,5,0,0,0,2,0,941,0,0,0,0,0,0,0,0,0,0,19
Bradley,6/5/20,0,0,0,0,0,0,0,0,0,26,0,456,0,15,0,1,0,10,0,482,0,0,0,0,0,0,0,3,0,0,14
Calhoun,6/5/20,0,0,0,0,0,0,0,0,0,0,0,119,0,0,0,0,0,0,0,119,0,0,0,0,0,0,0,0,0,0,2
Carroll,6/5/20,0,0,0,0,0,0,0,0,0,33,0,1193,0,15,0,1,0,17,0,1226,0,0,0,0,0,0,0,3,1,0,39
Chicot,6/5/20,0,0,0,0,0,0,0,0,0,19,0,240,0,13,0,0,0,6,0,259,0,0,0,0,0,0,0,3,1,0,8
Clark,6/5/20,0,0,0,0,0,0,0,0,0,40,0,810,0,37,0,0,0,3,0,850,0,0,0,0,0,0,0,0,0,0,15
Clay,6/5/20,0,0,0,0,0,0,0,0,0,5,0,653,0,4,0,0,0,1,0,658,0,0,0,0,0,0,0,0,0,0,7
Cleburne,6/5/20,0,0,0,0,0,0,0,0,0,74,0,819,0,69,0,4,0,1,0,893,0,0,0,0,0,0,0,-2,0,0,21
Cleveland,6/5/20,0,0,0,0,0,0,0,0,0,19,0,352,0,19,0,0,0,0,0,371,0,0,0,0,0,0,0,0,0,0,3
Columbia,6/5/20,0,0,0,0,0,0,0,0,0,23,0,450,0,17,0,2,0,4,0,473,0,0,0,0,0,0,0,0,0,0,16
Conway,6/5/20,0,0,0,0,0,0,0,0,0,15,0,628,0,13,0,1,0,1,0,643,0,0,0,0,0,0,0,0,0,0,7
Craighead,6/5/20,0,0,0,0,0,0,0,0,0,279,0,5435,0,198,0,0,0,81,0,5714,0,0,0,0,0,0,0,13,5,0,83
Crawford,6/5/20,0,0,0,0,0,0,0,0,0,35,0,973,0,20,0,0,0,15,0,1008,0,0,0,0,0,0,0,0,1,0,54
Crittenden,6/5/20,0,0,0,0,0,0,0,0,0,436,0,3427,0,305,0,9,0,122,0,3863,0,0,0,0,0,0,0,10,13,0,50
Cross,6/5/20,0,0,0,0,0,0,0,0,0,60,0,721,0,45,0,0,0,15,0,781,0,0,0,0,0,0,0,0,2,0,11
Dallas,6/5/20,0,0,0,0,0,0,0,0,0,3,0,189,0,3,0,0,0,0,0,192,0,0,0,0,0,0,0,0,0,0,4
Desha,6/5/20,0,0,0,0,0,0,0,0,0,19,0,496,0,19,0,0,0,0,0,515,0,0,0,0,0,0,0,0,0,0,8
Drew,6/5/20,0,0,0,0,0,0,0,0,0,21,0,686,0,17,0,1,0,3,0,707,0,0,0,0,0,0,0,1,0,0,17
Faulkner,6/5/20,0,0,0,0,0,0,0,0,0,108,0,3320,0,96,0,3,0,9,0,3428,0,0,0,0,0,0,0,0,1,0,33
Franklin,6/5/20,0,0,0,0,0,0,0,0,0,5,0,385,0,4,0,0,0,1,0,390,0,0,0,0,0,0,0,1,2,0,10
Fulton,6/5/20,0,0,0,0,0,0,0,0,0,7,0,392,0,6,0,0,0,1,0,399,0,0,0,0,0,0,0,0,1,0,8
Garland,6/5/20,0,0,0,0,0,0,0,0,0,138,0,4202,0,133,0,1,0,4,0,4340,0,0,0,0,0,0,0,0,1,0,34
Grant,6/5/20,0,0,0,0,0,0,0,0,0,18,0,536,0,17,0,0,0,1,0,554,0,0,0,0,0,0,0,0,0,0,10
Greene,6/5/20,0,0,0,0,0,0,0,0,0,67,0,2145,0,52,0,0,0,15,0,2212,0,0,0,0,0,0,0,1,1,0,44
Hempstead,6/5/20,0,0,0,0,0,0,0,0,0,23,0,503,0,14,0,1,0,8,0,526,0,0,0,0,0,0,0,2,1,0,32
HotSpring,6/5/20,0,0,0,0,0,0,0,0,0,34,0,976,0,33,0,0,0,1,0,1010,0,0,0,0,0,0,0,0,1,0,29
Howard,6/5/20,0,0,0,0,0,0,0,0,0,27,0,320,0,19,0,0,0,8,0,347,0,0,0,0,0,0,0,1,0,0,8
Independence,6/5/20,0,0,0,0,0,0,0,0,0,33,0,1085,0,30,0,0,0,3,0,1118,0,0,0,0,0,0,0,0,0,0,29
Izard,6/5/20,0,0,0,0,0,0,0,0,0,17,0,263,0,14,0,1,0,2,0,280,0,0,0,0,0,0,0,0,0,0,9
Jackson,6/5/20,0,0,0,0,0,0,0,0,0,5,0,302,0,2,0,0,0,3,0,307,0,0,0,0,0,0,0,0,0,0,7
Jefferson,6/5/20,0,0,0,0,0,0,0,0,0,545,0,3446,0,470,0,25,0,50,0,3991,0,0,0,0,0,0,0,9,3,0,71
Johnson,6/5/20,0,0,0,0,0,0,0,0,0,55,0,599,0,41,0,0,0,14,0,654,0,0,0,0,0,0,0,1,1,0,5
Lafayette,6/5/20,0,0,0,0,0,0,0,0,0,9,0,81,0,8,0,1,0,0,0,90,0,0,0,0,0,0,0,0,0,0,2
Lawrence,6/5/20,0,0,0,0,0,0,0,0,0,87,0,833,0,69,0,9,0,9,0,920,0,0,0,0,0,0,0,0,1,0,13
Lee,6/5/20,0,0,0,0,0,0,0,0,0,30,0,461,0,18,0,1,0,11,0,491,0,0,0,0,0,0,0,3,0,0,12
Lincoln,6/5/20,0,0,0,0,0,0,0,0,0,985,0,1007,0,950,0,11,0,24,0,1992,0,0,0,0,0,0,0,0,1,1,0
LittleRiver,6/5/20,0,0,0,0,0,0,0,0,0,14,0,223,0,4,0,0,0,10,0,237,0,0,0,0,0,0,0,4,0,0,10
Logan,6/5/20,0,0,0,0,0,0,0,0,0,12,0,357,0,4,0,0,0,8,0,369,0,0,0,0,0,0,0,1,0,0,12
Lonoke,6/5/20,0,0,0,0,0,0,0,0,0,57,0,2096,0,48,0,0,0,9,0,2153,0,0,0,0,0,0,0,1,1,0,54
Madison,6/5/20,0,0,0,0,0,0,0,0,0,43,0,585,0,8,0,0,0,35,0,628,0,0,0,0,0,0,0,9,2,0,46
Marion,6/5/20,0,0,0,0,0,0,0,0,0,2,0,331,0,1,0,0,0,1,0,333,0,0,0,0,0,0,0,0,0,0,17
Miller,6/5/20,0,0,0,0,0,0,0,0,0,52,0,816,0,42,0,1,0,9,0,868,0,0,0,0,0,0,0,2,0,0,45
MissingCountyInfo,6/5/20,0,0,0,0,0,0,0,0,0,244,0,34391,0,136,0,0,0,108,0,34635,0,0,0,0,0,0,0,12,8,0,758
Mississippi,6/5/20,0,0,0,0,0,0,0,0,0,79,0,1620,0,69,0,2,0,8,0,1699,0,0,0,0,0,0,0,0,1,0,20
Monroe,6/5/20,0,0,0,0,0,0,0,0,0,5,0,181,0,5,0,0,0,0,0,186,0,0,0,0,0,0,0,-1,0,0,4
Montgomery,6/5/20,0,0,0,0,0,0,0,0,0,2,0,163,0,2,0,0,0,0,0,165,0,0,0,0,0,0,0,0,1,0,4
Nevada,6/5/20,0,0,0,0,0,0,0,0,0,10,0,169,0,4,0,0,0,6,0,179,0,0,0,0,0,0,0,1,0,0,7
Newton,6/5/20,0,0,0,0,0,0,0,0,0,3,0,175,0,3,0,0,0,0,0,178,0,0,0,0,0,0,0,0,0,0,2
Ouachita,6/5/20,0,0,0,0,0,0,0,0,0,12,0,924,0,10,0,0,0,2,0,936,0,0,0,0,0,0,0,1,0,0,17
Perry,6/5/20,0,0,0,0,0,0,0,0,0,14,0,313,0,14,0,0,0,0,0,327,0,0,0,0,0,0,0,0,0,0,7
Phillips,6/5/20,0,0,0,0,0,0,0,0,0,25,0,721,0,11,0,1,0,13,0,746,0,0,0,0,0,0,0,0,2,0,26
Pike,6/5/20,0,0,0,0,0,0,0,0,0,6,0,643,0,4,0,0,0,2,0,649,0,0,0,0,0,0,0,1,0,0,9
Poinsett,6/5/20,0,0,0,0,0,0,0,0,0,41,0,613,0,27,0,2,0,12,0,654,0,0,0,0,0,0,0,1,0,0,14
Polk,6/5/20,0,0,0,0,0,0,0,0,0,29,0,524,0,10,0,0,0,19,0,553,0,0,0,0,0,0,0,1,0,0,13
Pope,6/5/20,0,0,0,0,0,0,0,0,0,184,0,2874,0,121,0,2,0,61,0,3058,0,0,0,0,0,0,0,6,8,0,68
Prairie,6/5/20,0,0,0,0,0,0,0,0,0,3,0,116,0,2,0,0,0,1,0,119,0,0,0,0,0,0,0,0,0,0,5
Pulaski,6/5/20,0,0,0,0,0,0,0,0,0,1065,0,15392,0,743,0,37,0,285,0,16457,0,0,0,0,0,0,0,26,5,0,425
Randolph,6/5/20,0,0,0,0,0,0,0,0,0,26,0,1079,0,24,0,0,0,2,0,1105,0,0,0,0,0,0,0,0,1,0,5
Saline,6/5/20,0,0,0,0,0,0,0,0,0,123,0,3839,0,94,0,1,0,28,0,3962,0,0,0,0,0,0,0,3,0,0,78
Scott,6/5/20,0,0,0,0,0,0,0,0,0,1,0,36,0,1,0,0,0,0,0,37,0,0,0,0,0,0,0,0,0,0,4
Searcy,6/5/20,0,0,0,0,0,0,0,0,0,7,0,502,0,7,0,0,0,0,0,509,0,0,0,0,0,0,0,0,0,0,8
Sebastian,6/5/20,0,0,0,0,0,0,0,0,0,69,0,1945,0,25,0,1,0,43,0,2014,0,0,0,0,0,0,0,7,1,0,146
Sevier,6/5/20,0,0,0,0,0,0,0,0,0,301,0,1643,0,130,0,2,0,169,0,1944,0,0,0,0,0,0,0,4,13,0,62
Sharp,6/5/20,0,0,0,0,0,0,0,0,0,48,0,448,0,37,0,3,0,8,0,496,0,0,0,0,0,0,0,1,0,0,15
St.Francis,6/5/20,0,0,0,0,0,0,0,0,0,694,0,3088,0,649,0,1,0,44,0,3782,0,0,0,0,0,0,0,3,4,0,152
Stone,6/5/20,0,0,0,0,0,0,0,0,0,10,0,400,0,8,0,0,0,2,0,410,0,0,0,0,0,0,0,0,0,0,7
Union,6/5/20,0,0,0,0,0,0,0,0,0,185,0,1107,0,147,0,11,0,27,0,1292,0,0,0,0,0,0,0,6,3,0,70
VanBuren,6/5/20,0,0,0,0,0,0,0,0,0,29,0,636,0,26,0,2,0,1,0,665,0,0,0,0,0,0,0,0,0,0,3
Washington,6/5/20,0,0,0,0,0,0,0,0,0,824,0,6505,0,314,0,8,0,502,0,7329,0,0,0,0,0,0,0,53,32,0,248
White,6/5/20,0,0,0,0,0,0,0,0,0,48,0,1921,0,41,0,1,0,6,0,1969,0,0,0,0,0,0,0,0,0,0,33
Woodruff,6/5/20,0,0,0,0,0,0,0,0,0,1,0,140,0,1,0,0,0,0,0,141,0,0,0,0,0,0,0,0,0,0,4
Yell,6/5/20,0,0,0,0,0,0,0,0,0,202,0,650,0,107,0,2,0,93,0,852,0,0,0,0,0,0,0,10,6,0,33
Arkansas_all_counties,6/4/20,0,0,0,0,0,0,0,0,2990671,8425,0,138960,0,5919,0,151,0,2355,0,147385,0,0,0,0,0,0,0,358,202,9,4905
Arkansas_county,6/4/20,0,0,0,0,0,0,0,0,0,7,0,370,0,3,0,0,0,4,0,377,0,0,0,0,0,0,0,0,0,0,28
Ashley,6/4/20,0,0,0,0,0,0,0,0,0,26,0,755,0,19,0,0,0,7,0,781,0,0,0,0,0,0,0,6,0,0,19
Baxter,6/4/20,0,0,0,0,0,0,0,0,0,12,0,785,0,9,0,0,0,3,0,797,0,0,0,0,0,0,0,0,1,0,21
Benton,6/4/20,0,0,0,0,0,0,0,0,0,804,0,13411,0,343,0,3,0,458,0,14215,0,0,0,0,0,0,0,104,41,0,1005
Boone,6/4/20,0,0,0,0,0,0,0,0,0,7,0,915,0,5,0,0,0,2,0,922,0,0,0,0,0,0,0,0,1,0,21
Bradley,6/4/20,0,0,0,0,0,0,0,0,0,23,0,445,0,15,0,1,0,7,0,468,0,0,0,0,0,0,0,0,1,0,4
Calhoun,6/4/20,0,0,0,0,0,0,0,0,0,0,0,117,0,0,0,0,0,0,0,117,0,0,0,0,0,0,0,0,0,0,1
Carroll,6/4/20,0,0,0,0,0,0,0,0,0,30,0,1157,0,14,0,1,0,15,0,1187,0,0,0,0,0,0,0,1,2,0,26
Chicot,6/4/20,0,0,0,0,0,0,0,0,0,16,0,235,0,12,0,0,0,4,0,251,0,0,0,0,0,0,0,0,0,0,2
Clark,6/4/20,0,0,0,0,0,0,0,0,0,40,0,795,0,37,0,0,0,3,0,835,0,0,0,0,0,0,0,-1,0,0,9
Clay,6/4/20,0,0,0,0,0,0,0,0,0,5,0,646,0,4,0,0,0,1,0,651,0,0,0,0,0,0,0,0,0,0,6
Cleburne,6/4/20,0,0,0,0,0,0,0,0,0,76,0,796,0,69,0,4,0,3,0,872,0,0,0,0,0,0,0,0,0,0,23
Cleveland,6/4/20,0,0,0,0,0,0,0,0,0,19,0,349,0,19,0,0,0,0,0,368,0,0,0,0,0,0,0,0,1,0,4
Columbia,6/4/20,0,0,0,0,0,0,0,0,0,23,0,434,0,17,0,2,0,4,0,457,0,0,0,0,0,0,0,1,0,0,4
Conway,6/4/20,0,0,0,0,0,0,0,0,0,15,0,621,0,13,0,1,0,1,0,636,0,0,0,0,0,0,0,1,0,0,27
Craighead,6/4/20,0,0,0,0,0,0,0,0,0,266,0,5365,0,193,0,0,0,73,0,5631,0,0,0,0,0,0,0,9,1,0,137
Crawford,6/4/20,0,0,0,0,0,0,0,0,0,35,0,919,0,19,0,0,0,16,0,954,0,0,0,0,0,0,0,1,4,0,65
Crittenden,6/4/20,0,0,0,0,0,0,0,0,0,426,0,3387,0,292,0,9,0,125,0,3813,0,0,0,0,0,0,0,13,14,0,68
Cross,6/4/20,0,0,0,0,0,0,0,0,0,60,0,710,0,43,0,0,0,17,0,770,0,0,0,0,0,0,0,4,1,0,16
Dallas,6/4/20,0,0,0,0,0,0,0,0,0,3,0,185,0,3,0,0,0,0,0,188,0,0,0,0,0,0,0,0,0,0,6
Desha,6/4/20,0,0,0,0,0,0,0,0,0,19,0,488,0,19,0,0,0,0,0,507,0,0,0,0,0,0,0,0,0,0,12
Drew,6/4/20,0,0,0,0,0,0,0,0,0,20,0,670,0,17,0,1,0,2,0,690,0,0,0,0,0,0,0,0,1,0,12
Faulkner,6/4/20,0,0,0,0,0,0,0,0,0,108,0,3287,0,95,0,3,0,10,0,3395,0,0,0,0,0,0,0,2,0,0,66
Franklin,6/4/20,0,0,0,0,0,0,0,0,0,4,0,376,0,2,0,0,0,2,0,380,0,0,0,0,0,0,0,0,0,0,19
Fulton,6/4/20,0,0,0,0,0,0,0,0,0,7,0,384,0,5,0,0,0,2,0,391,0,0,0,0,0,0,0,0,0,0,8
Garland,6/4/20,0,0,0,0,0,0,0,0,0,138,0,4168,0,132,0,1,0,5,0,4306,0,0,0,0,0,0,0,0,0,0,58
Grant,6/4/20,0,0,0,0,0,0,0,0,0,18,0,526,0,17,0,0,0,1,0,544,0,0,0,0,0,0,0,0,0,0,6
Greene,6/4/20,0,0,0,0,0,0,0,0,0,66,0,2102,0,51,0,0,0,15,0,2168,0,0,0,0,0,0,0,0,3,0,43
Hempstead,6/4/20,0,0,0,0,0,0,0,0,0,21,0,473,0,13,0,1,0,7,0,494,0,0,0,0,0,0,0,1,0,0,23
HotSpring,6/4/20,0,0,0,0,0,0,0,0,0,34,0,947,0,32,0,0,0,2,0,981,0,0,0,0,0,0,0,1,2,0,32
Howard,6/4/20,0,0,0,0,0,0,0,0,0,26,0,313,0,19,0,0,0,7,0,339,0,0,0,0,0,0,0,0,0,0,8
Independence,6/4/20,0,0,0,0,0,0,0,0,0,33,0,1056,0,30,0,0,0,3,0,1089,0,0,0,0,0,0,0,0,0,0,26
Izard,6/4/20,0,0,0,0,0,0,0,0,0,17,0,254,0,14,0,1,0,2,0,271,0,0,0,0,0,0,0,0,0,0,3
Jackson,6/4/20,0,0,0,0,0,0,0,0,0,5,0,295,0,2,0,0,0,3,0,300,0,0,0,0,0,0,0,1,1,0,15
Jefferson,6/4/20,0,0,0,0,0,0,0,0,0,536,0,3384,0,467,0,25,0,44,0,3920,0,0,0,0,0,0,0,4,3,0,79
Johnson,6/4/20,0,0,0,0,0,0,0,0,0,54,0,595,0,40,0,0,0,14,0,649,0,0,0,0,0,0,0,6,1,0,18
Lafayette,6/4/20,0,0,0,0,0,0,0,0,0,9,0,79,0,8,0,1,0,0,0,88,0,0,0,0,0,0,0,0,0,0,5
Lawrence,6/4/20,0,0,0,0,0,0,0,0,0,87,0,820,0,68,0,9,0,10,0,907,0,0,0,0,0,0,0,2,3,3,12
Lee,6/4/20,0,0,0,0,0,0,0,0,0,27,0,452,0,18,0,1,0,8,0,479,0,0,0,0,0,0,0,3,0,0,27
Lincoln,6/4/20,0,0,0,0,0,0,0,0,0,985,0,1007,0,949,0,10,0,26,0,1992,0,0,0,0,0,0,0,1,0,0,7
LittleRiver,6/4/20,0,0,0,0,0,0,0,0,0,10,0,217,0,4,0,0,0,6,0,227,0,0,0,0,0,0,0,1,0,0,3
Logan,6/4/20,0,0,0,0,0,0,0,0,0,11,0,346,0,4,0,0,0,7,0,357,0,0,0,0,0,0,0,1,0,0,17
Lonoke,6/4/20,0,0,0,0,0,0,0,0,0,56,0,2043,0,47,0,0,0,9,0,2099,0,0,0,0,0,0,0,1,0,0,54
Madison,6/4/20,0,0,0,0,0,0,0,0,0,34,0,548,0,6,0,0,0,28,0,582,0,0,0,0,0,0,0,4,1,0,22
Marion,6/4/20,0,0,0,0,0,0,0,0,0,2,0,314,0,1,0,0,0,1,0,316,0,0,0,0,0,0,0,0,0,0,5
Miller,6/4/20,0,0,0,0,0,0,0,0,0,50,0,773,0,42,0,1,0,7,0,823,0,0,0,0,0,0,0,1,1,0,17
MissingCountyInfo,6/4/20,0,0,0,0,0,0,0,0,0,232,0,33645,0,128,0,0,0,104,0,33877,0,0,0,0,0,0,0,-17,0,0,641
Mississippi,6/4/20,0,0,0,0,0,0,0,0,0,79,0,1600,0,68,0,2,0,9,0,1679,0,0,0,0,0,0,0,1,0,0,58
Monroe,6/4/20,0,0,0,0,0,0,0,0,0,6,0,176,0,5,0,0,0,1,0,182,0,0,0,0,0,0,0,0,0,0,4
Montgomery,6/4/20,0,0,0,0,0,0,0,0,0,2,0,159,0,1,0,0,0,1,0,161,0,0,0,0,0,0,0,0,0,0,7
Nevada,6/4/20,0,0,0,0,0,0,0,0,0,9,0,163,0,4,0,0,0,5,0,172,0,0,0,0,0,0,0,2,0,0,6
Newton,6/4/20,0,0,0,0,0,0,0,0,0,3,0,173,0,3,0,0,0,0,0,176,0,0,0,0,0,0,0,0,0,0,1
Ouachita,6/4/20,0,0,0,0,0,0,0,0,0,11,0,908,0,10,0,0,0,1,0,919,0,0,0,0,0,0,0,1,0,0,34
Perry,6/4/20,0,0,0,0,0,0,0,0,0,14,0,306,0,14,0,0,0,0,0,320,0,0,0,0,0,0,0,0,0,0,2
Phillips,6/4/20,0,0,0,0,0,0,0,0,0,25,0,695,0,9,0,1,0,15,0,720,0,0,0,0,0,0,0,1,0,0,26
Pike,6/4/20,0,0,0,0,0,0,0,0,0,5,0,635,0,4,0,0,0,1,0,640,0,0,0,0,0,0,0,0,0,0,10
Poinsett,6/4/20,0,0,0,0,0,0,0,0,0,40,0,600,0,27,0,2,0,11,0,640,0,0,0,0,0,0,0,2,0,0,9
Polk,6/4/20,0,0,0,0,0,0,0,0,0,28,0,512,0,10,0,0,0,18,0,540,0,0,0,0,0,0,0,0,0,-1,21
Pope,6/4/20,0,0,0,0,0,0,0,0,0,178,0,2812,0,113,0,2,0,63,0,2990,0,0,0,0,0,0,0,7,5,1,60
Prairie,6/4/20,0,0,0,0,0,0,0,0,0,3,0,111,0,2,0,0,0,1,0,114,0,0,0,0,0,0,0,0,0,0,1
Pulaski,6/4/20,0,0,0,0,0,0,0,0,0,1039,0,14993,0,738,0,37,0,264,0,16032,0,0,0,0,0,0,0,36,18,2,471
Randolph,6/4/20,0,0,0,0,0,0,0,0,0,26,0,1074,0,23,0,0,0,3,0,1100,0,0,0,0,0,0,0,0,0,0,13
Saline,6/4/20,0,0,0,0,0,0,0,0,0,120,0,3764,0,94,0,1,0,25,0,3884,0,0,0,0,0,0,0,-1,-1,0,89
Scott,6/4/20,0,0,0,0,0,0,0,0,0,1,0,32,0,1,0,0,0,0,0,33,0,0,0,0,0,0,0,0,0,0,0
Searcy,6/4/20,0,0,0,0,0,0,0,0,0,7,0,494,0,7,0,0,0,0,0,501,0,0,0,0,0,0,0,0,0,0,10
Sebastian,6/4/20,0,0,0,0,0,0,0,0,0,62,0,1806,0,24,0,1,0,37,0,1868,0,0,0,0,0,0,0,9,1,0,284
Sevier,6/4/20,0,0,0,0,0,0,0,0,0,297,0,1585,0,117,0,2,0,178,0,1882,0,0,0,0,0,0,0,14,14,0,24
Sharp,6/4/20,0,0,0,0,0,0,0,0,0,47,0,434,0,37,0,3,0,7,0,481,0,0,0,0,0,0,0,0,0,1,5
St.Francis,6/4/20,0,0,0,0,0,0,0,0,0,691,0,2939,0,645,0,1,0,45,0,3630,0,0,0,0,0,0,0,4,17,0,97
Stone,6/4/20,0,0,0,0,0,0,0,0,0,10,0,393,0,8,0,0,0,2,0,403,0,0,0,0,0,0,0,1,0,0,4
Union,6/4/20,0,0,0,0,0,0,0,0,0,179,0,1043,0,144,0,11,0,24,0,1222,0,0,0,0,0,0,0,2,5,1,43
VanBuren,6/4/20,0,0,0,0,0,0,0,0,0,29,0,633,0,26,0,2,0,1,0,662,0,0,0,0,0,0,0,0,0,0,37
Washington,6/4/20,0,0,0,0,0,0,0,0,0,771,0,6310,0,282,0,8,0,481,0,7081,0,0,0,0,0,0,0,119,53,1,799
White,6/4/20,0,0,0,0,0,0,0,0,0,48,0,1888,0,41,0,1,0,6,0,1936,0,0,0,0,0,0,0,0,1,0,42
Woodruff,6/4/20,0,0,0,0,0,0,0,0,0,1,0,136,0,1,0,0,0,0,0,137,0,0,0,0,0,0,0,0,0,0,3
Yell,6/4/20,0,0,0,0,0,0,0,0,0,192,0,627,0,101,0,2,0,89,0,819,0,0,0,0,0,0,0,9,5,1,16
Arkansas_all_counties,6/3/20,0,0,0,0,0,0,0,0,2990671,8067,0,134413,0,5717,0,142,0,2208,0,142480,0,0,0,0,0,0,0,249,150,6,3580
Arkansas_county,6/3/20,0,0,0,0,0,0,0,0,0,7,0,342,0,3,0,0,0,4,0,349,0,0,0,0,0,0,0,0,0,0,7
Ashley,6/3/20,0,0,0,0,0,0,0,0,0,20,0,742,0,19,0,0,0,1,0,762,0,0,0,0,0,0,0,0,0,0,8
Baxter,6/3/20,0,0,0,0,0,0,0,0,0,12,0,764,0,8,0,0,0,4,0,776,0,0,0,0,0,0,0,0,1,0,1
Benton,6/3/20,0,0,0,0,0,0,0,0,0,700,0,12510,0,302,0,3,0,395,0,13210,0,0,0,0,0,0,0,24,30,1,472
Boone,6/3/20,0,0,0,0,0,0,0,0,0,7,0,894,0,4,0,0,0,3,0,901,0,0,0,0,0,0,0,1,0,0,25
Bradley,6/3/20,0,0,0,0,0,0,0,0,0,23,0,441,0,14,0,1,0,8,0,464,0,0,0,0,0,0,0,1,0,0,4
Calhoun,6/3/20,0,0,0,0,0,0,0,0,0,0,0,116,0,0,0,0,0,0,0,116,0,0,0,0,0,0,0,0,0,0,0
Carroll,6/3/20,0,0,0,0,0,0,0,0,0,29,0,1132,0,12,0,1,0,16,0,1161,0,0,0,0,0,0,0,0,5,0,73
Chicot,6/3/20,0,0,0,0,0,0,0,0,0,16,0,233,0,12,0,0,0,4,0,249,0,0,0,0,0,0,0,0,0,0,8
Clark,6/3/20,0,0,0,0,0,0,0,0,0,41,0,785,0,37,0,0,0,4,0,826,0,0,0,0,0,0,0,2,0,0,12
Clay,6/3/20,0,0,0,0,0,0,0,0,0,5,0,640,0,4,0,0,0,1,0,645,0,0,0,0,0,0,0,0,0,0,5
Cleburne,6/3/20,0,0,0,0,0,0,0,0,0,76,0,773,0,69,0,4,0,3,0,849,0,0,0,0,0,0,0,2,0,0,32
Cleveland,6/3/20,0,0,0,0,0,0,0,0,0,19,0,345,0,18,0,0,0,1,0,364,0,0,0,0,0,0,0,0,0,0,4
Columbia,6/3/20,0,0,0,0,0,0,0,0,0,22,0,431,0,17,0,2,0,3,0,453,0,0,0,0,0,0,0,0,0,0,2
Conway,6/3/20,0,0,0,0,0,0,0,0,0,14,0,595,0,13,0,1,0,0,0,609,0,0,0,0,0,0,0,0,0,0,11
Craighead,6/3/20,0,0,0,0,0,0,0,0,0,257,0,5237,0,192,0,0,0,65,0,5494,0,0,0,0,0,0,0,8,6,0,69
Crawford,6/3/20,0,0,0,0,0,0,0,0,0,34,0,855,0,15,0,0,0,19,0,889,0,0,0,0,0,0,0,3,0,0,28
Crittenden,6/3/20,0,0,0,0,0,0,0,0,0,413,0,3332,0,278,0,9,0,126,0,3745,0,0,0,0,0,0,0,18,11,0,66
Cross,6/3/20,0,0,0,0,0,0,0,0,0,56,0,698,0,42,0,0,0,14,0,754,0,0,0,0,0,0,0,0,2,0,6
Dallas,6/3/20,0,0,0,0,0,0,0,0,0,3,0,179,0,3,0,0,0,0,0,182,0,0,0,0,0,0,0,0,2,0,5
Desha,6/3/20,0,0,0,0,0,0,0,0,0,19,0,476,0,19,0,0,0,0,0,495,0,0,0,0,0,0,0,0,1,0,9
Drew,6/3/20,0,0,0,0,0,0,0,0,0,20,0,658,0,16,0,1,0,3,0,678,0,0,0,0,0,0,0,0,0,0,27
Faulkner,6/3/20,0,0,0,0,0,0,0,0,0,106,0,3223,0,95,0,3,0,8,0,3329,0,0,0,0,0,0,0,3,2,0,46
Franklin,6/3/20,0,0,0,0,0,0,0,0,0,4,0,357,0,2,0,0,0,2,0,361,0,0,0,0,0,0,0,0,0,0,7
Fulton,6/3/20,0,0,0,0,0,0,0,0,0,7,0,376,0,5,0,0,0,2,0,383,0,0,0,0,0,0,0,0,0,0,7
Garland,6/3/20,0,0,0,0,0,0,0,0,0,138,0,4110,0,132,0,1,0,5,0,4248,0,0,0,0,0,0,0,2,0,0,25
Grant,6/3/20,0,0,0,0,0,0,0,0,0,18,0,520,0,17,0,0,0,1,0,538,0,0,0,0,0,0,0,0,0,0,7
Greene,6/3/20,0,0,0,0,0,0,0,0,0,66,0,2059,0,48,0,0,0,18,0,2125,0,0,0,0,0,0,0,1,2,0,24
Hempstead,6/3/20,0,0,0,0,0,0,0,0,0,20,0,451,0,13,0,1,0,6,0,471,0,0,0,0,0,0,0,-1,0,0,0
HotSpring,6/3/20,0,0,0,0,0,0,0,0,0,33,0,916,0,30,0,0,0,3,0,949,0,0,0,0,0,0,0,1,0,0,10
Howard,6/3/20,0,0,0,0,0,0,0,0,0,26,0,305,0,19,0,0,0,7,0,331,0,0,0,0,0,0,0,1,0,0,3
Independence,6/3/20,0,0,0,0,0,0,0,0,0,33,0,1030,0,30,0,0,0,3,0,1063,0,0,0,0,0,0,0,-1,1,0,22
Izard,6/3/20,0,0,0,0,0,0,0,0,0,17,0,251,0,14,0,1,0,2,0,268,0,0,0,0,0,0,0,0,0,0,4
Jackson,6/3/20,0,0,0,0,0,0,0,0,0,4,0,281,0,1,0,0,0,3,0,285,0,0,0,0,0,0,0,0,0,0,7
Jefferson,6/3/20,0,0,0,0,0,0,0,0,0,532,0,3309,0,464,0,25,0,43,0,3841,0,0,0,0,0,0,0,3,0,0,156
Johnson,6/3/20,0,0,0,0,0,0,0,0,0,48,0,583,0,39,0,0,0,9,0,631,0,0,0,0,0,0,0,-1,2,0,7
Lafayette,6/3/20,0,0,0,0,0,0,0,0,0,9,0,74,0,8,0,1,0,0,0,83,0,0,0,0,0,0,0,0,0,0,2
Lawrence,6/3/20,0,0,0,0,0,0,0,0,0,85,0,810,0,65,0,6,0,14,0,895,0,0,0,0,0,0,0,0,0,1,8
Lee,6/3/20,0,0,0,0,0,0,0,0,0,24,0,428,0,18,0,1,0,5,0,452,0,0,0,0,0,0,0,1,3,0,2
Lincoln,6/3/20,0,0,0,0,0,0,0,0,0,984,0,1001,0,949,0,10,0,25,0,1985,0,0,0,0,0,0,0,1,0,1,6
LittleRiver,6/3/20,0,0,0,0,0,0,0,0,0,9,0,215,0,4,0,0,0,5,0,224,0,0,0,0,0,0,0,1,0,0,4
Logan,6/3/20,0,0,0,0,0,0,0,0,0,10,0,330,0,4,0,0,0,6,0,340,0,0,0,0,0,0,0,2,0,0,5
Lonoke,6/3/20,0,0,0,0,0,0,0,0,0,55,0,1990,0,47,0,0,0,8,0,2045,0,0,0,0,0,0,0,1,0,0,39
Madison,6/3/20,0,0,0,0,0,0,0,0,0,30,0,530,0,5,0,0,0,25,0,560,0,0,0,0,0,0,0,1,0,0,19
Marion,6/3/20,0,0,0,0,0,0,0,0,0,2,0,309,0,1,0,0,0,1,0,311,0,0,0,0,0,0,0,0,0,0,0
Miller,6/3/20,0,0,0,0,0,0,0,0,0,49,0,757,0,41,0,1,0,7,0,806,0,0,0,0,0,0,0,2,0,0,18
MissingCountyInfo,6/3/20,0,0,0,0,0,0,0,0,0,249,0,32987,0,128,0,0,0,121,0,33236,0,0,0,0,0,0,0,46,1,0,1180
Mississippi,6/3/20,0,0,0,0,0,0,0,0,0,78,0,1543,0,68,0,2,0,8,0,1621,0,0,0,0,0,0,0,0,2,0,15
Monroe,6/3/20,0,0,0,0,0,0,0,0,0,6,0,172,0,5,0,0,0,1,0,178,0,0,0,0,0,0,0,1,0,0,3
Montgomery,6/3/20,0,0,0,0,0,0,0,0,0,2,0,152,0,1,0,0,0,1,0,154,0,0,0,0,0,0,0,0,0,0,1
Nevada,6/3/20,0,0,0,0,0,0,0,0,0,7,0,159,0,4,0,0,0,3,0,166,0,0,0,0,0,0,0,0,0,0,1
Newton,6/3/20,0,0,0,0,0,0,0,0,0,3,0,172,0,3,0,0,0,0,0,175,0,0,0,0,0,0,0,0,0,0,5
Ouachita,6/3/20,0,0,0,0,0,0,0,0,0,10,0,875,0,10,0,0,0,0,0,885,0,0,0,0,0,0,0,0,0,0,13
Perry,6/3/20,0,0,0,0,0,0,0,0,0,14,0,304,0,14,0,0,0,0,0,318,0,0,0,0,0,0,0,0,0,0,5
Phillips,6/3/20,0,0,0,0,0,0,0,0,0,24,0,670,0,9,0,1,0,14,0,694,0,0,0,0,0,0,0,0,0,0,8
Pike,6/3/20,0,0,0,0,0,0,0,0,0,5,0,625,0,4,0,0,0,1,0,630,0,0,0,0,0,0,0,0,0,0,16
Poinsett,6/3/20,0,0,0,0,0,0,0,0,0,38,0,593,0,27,0,2,0,9,0,631,0,0,0,0,0,0,0,1,0,0,8
Polk,6/3/20,0,0,0,0,0,0,0,0,0,28,0,491,0,10,0,1,0,17,0,519,0,0,0,0,0,0,0,2,0,1,5
Pope,6/3/20,0,0,0,0,0,0,0,0,0,171,0,2759,0,108,0,1,0,62,0,2930,0,0,0,0,0,0,0,5,9,0,78
Prairie,6/3/20,0,0,0,0,0,0,0,0,0,3,0,110,0,2,0,0,0,1,0,113,0,0,0,0,0,0,0,0,0,0,2
Pulaski,6/3/20,0,0,0,0,0,0,0,0,0,1003,0,14558,0,720,0,35,0,248,0,15561,0,0,0,0,0,0,0,34,10,0,415
Randolph,6/3/20,0,0,0,0,0,0,0,0,0,26,0,1061,0,23,0,0,0,3,0,1087,0,0,0,0,0,0,0,0,0,0,2
Saline,6/3/20,0,0,0,0,0,0,0,0,0,121,0,3674,0,95,0,1,0,25,0,3795,0,0,0,0,0,0,0,5,1,0,43
Scott,6/3/20,0,0,0,0,0,0,0,0,0,1,0,32,0,1,0,0,0,0,0,33,0,0,0,0,0,0,0,0,0,0,0
Searcy,6/3/20,0,0,0,0,0,0,0,0,0,7,0,484,0,7,0,0,0,0,0,491,0,0,0,0,0,0,0,0,1,0,9
Sebastian,6/3/20,0,0,0,0,0,0,0,0,0,53,0,1531,0,23,0,1,0,29,0,1584,0,0,0,0,0,0,0,6,2,1,30
Sevier,6/3/20,0,0,0,0,0,0,0,0,0,283,0,1575,0,103,0,2,0,178,0,1858,0,0,0,0,0,0,0,25,12,0,92
Sharp,6/3/20,0,0,0,0,0,0,0,0,0,47,0,429,0,37,0,2,0,8,0,476,0,0,0,0,0,0,0,1,2,0,11
St.Francis,6/3/20,0,0,0,0,0,0,0,0,0,687,0,2846,0,628,0,1,0,58,0,3533,0,0,0,0,0,0,0,5,9,0,18
Stone,6/3/20,0,0,0,0,0,0,0,0,0,9,0,390,0,8,0,0,0,1,0,399,0,0,0,0,0,0,0,0,0,0,4
Union,6/3/20,0,0,0,0,0,0,0,0,0,177,0,1002,0,139,0,10,0,28,0,1179,0,0,0,0,0,0,0,4,0,1,15
VanBuren,6/3/20,0,0,0,0,0,0,0,0,0,29,0,596,0,26,0,2,0,1,0,625,0,0,0,0,0,0,0,0,0,0,49
Washington,6/3/20,0,0,0,0,0,0,0,0,0,652,0,5630,0,229,0,7,0,416,0,6282,0,0,0,0,0,0,0,32,20,0,224
White,6/3/20,0,0,0,0,0,0,0,0,0,48,0,1846,0,40,0,1,0,7,0,1894,0,0,0,0,0,0,0,2,0,0,9
Woodruff,6/3/20,0,0,0,0,0,0,0,0,0,1,0,133,0,1,0,0,0,0,0,134,0,0,0,0,0,0,0,0,0,0,0
Yell,6/3/20,0,0,0,0,0,0,0,0,0,183,0,620,0,96,0,1,0,86,0,803,0,0,0,0,0,0,0,4,13,0,16
Arkansas_all_counties,6/2/20,0,0,0,0,0,0,0,0,2990671,7818,0,131082,0,5567,0,136,0,2115,0,138900,0,0,0,0,0,0,0,375,166,3,5664
Arkansas_county,6/2/20,0,0,0,0,0,0,0,0,0,7,0,335,0,3,0,0,0,4,0,342,0,0,0,0,0,0,0,0,0,0,9
Ashley,6/2/20,0,0,0,0,0,0,0,0,0,20,0,734,0,19,0,0,0,1,0,754,0,0,0,0,0,0,0,1,0,0,21
Baxter,6/2/20,0,0,0,0,0,0,0,0,0,12,0,763,0,7,0,0,0,5,0,775,0,0,0,0,0,0,0,0,1,0,28
Benton,6/2/20,0,0,0,0,0,0,0,0,0,676,0,12062,0,272,0,2,0,402,0,12738,0,0,0,0,0,0,0,69,35,0,692
Boone,6/2/20,0,0,0,0,0,0,0,0,0,6,0,870,0,4,0,0,0,2,0,876,0,0,0,0,0,0,0,0,0,0,26
Bradley,6/2/20,0,0,0,0,0,0,0,0,0,22,0,438,0,14,0,1,0,7,0,460,0,0,0,0,0,0,0,0,1,0,6
Calhoun,6/2/20,0,0,0,0,0,0,0,0,0,0,0,116,0,0,0,0,0,0,0,116,0,0,0,0,0,0,0,0,0,0,1
Carroll,6/2/20,0,0,0,0,0,0,0,0,0,29,0,1059,0,7,0,1,0,21,0,1088,0,0,0,0,0,0,0,4,0,0,125
Chicot,6/2/20,0,0,0,0,0,0,0,0,0,16,0,225,0,12,0,0,0,4,0,241,0,0,0,0,0,0,0,1,0,0,2
Clark,6/2/20,0,0,0,0,0,0,0,0,0,39,0,775,0,37,0,0,0,2,0,814,0,0,0,0,0,0,0,0,0,0,13
Clay,6/2/20,0,0,0,0,0,0,0,0,0,5,0,635,0,4,0,0,0,1,0,640,0,0,0,0,0,0,0,1,0,0,7
Cleburne,6/2/20,0,0,0,0,0,0,0,0,0,74,0,743,0,69,0,4,0,1,0,817,0,0,0,0,0,0,0,0,0,0,13
Cleveland,6/2/20,0,0,0,0,0,0,0,0,0,19,0,341,0,18,0,0,0,1,0,360,0,0,0,0,0,0,0,0,0,0,8
Columbia,6/2/20,0,0,0,0,0,0,0,0,0,22,0,429,0,17,0,2,0,3,0,451,0,0,0,0,0,0,0,-1,1,0,4
Conway,6/2/20,0,0,0,0,0,0,0,0,0,14,0,584,0,13,0,1,0,0,0,598,0,0,0,0,0,0,0,0,0,0,6
Craighead,6/2/20,0,0,0,0,0,0,0,0,0,249,0,5176,0,186,0,0,0,63,0,5425,0,0,0,0,0,0,0,21,8,0,144
Crawford,6/2/20,0,0,0,0,0,0,0,0,0,31,0,830,0,15,0,0,0,16,0,861,0,0,0,0,0,0,0,1,3,0,49
Crittenden,6/2/20,0,0,0,0,0,0,0,0,0,395,0,3284,0,267,0,9,0,119,0,3679,0,0,0,0,0,0,0,9,14,0,179
Cross,6/2/20,0,0,0,0,0,0,0,0,0,56,0,692,0,40,0,0,0,16,0,748,0,0,0,0,0,0,0,4,0,0,14
Dallas,6/2/20,0,0,0,0,0,0,0,0,0,3,0,174,0,1,0,0,0,2,0,177,0,0,0,0,0,0,0,2,0,0,5
Desha,6/2/20,0,0,0,0,0,0,0,0,0,19,0,467,0,18,0,0,0,1,0,486,0,0,0,0,0,0,0,0,0,0,6
Drew,6/2/20,0,0,0,0,0,0,0,0,0,20,0,631,0,16,0,1,0,3,0,651,0,0,0,0,0,0,0,0,0,0,7
Faulkner,6/2/20,0,0,0,0,0,0,0,0,0,103,0,3180,0,93,0,3,0,7,0,3283,0,0,0,0,0,0,0,1,0,0,55
Franklin,6/2/20,0,0,0,0,0,0,0,0,0,4,0,350,0,2,0,0,0,2,0,354,0,0,0,0,0,0,0,0,0,0,18
Fulton,6/2/20,0,0,0,0,0,0,0,0,0,7,0,369,0,5,0,0,0,2,0,376,0,0,0,0,0,0,0,0,1,0,4
Garland,6/2/20,0,0,0,0,0,0,0,0,0,136,0,4087,0,132,0,1,0,3,0,4223,0,0,0,0,0,0,0,0,0,0,46
Grant,6/2/20,0,0,0,0,0,0,0,0,0,18,0,513,0,17,0,0,0,1,0,531,0,0,0,0,0,0,0,0,0,0,14
Greene,6/2/20,0,0,0,0,0,0,0,0,0,65,0,2036,0,46,0,0,0,19,0,2101,0,0,0,0,0,0,0,1,3,0,26
Hempstead,6/2/20,0,0,0,0,0,0,0,0,0,21,0,450,0,13,0,1,0,7,0,471,0,0,0,0,0,0,0,3,1,0,48
HotSpring,6/2/20,0,0,0,0,0,0,0,0,0,32,0,907,0,30,0,0,0,2,0,939,0,0,0,0,0,0,0,0,0,0,36
Howard,6/2/20,0,0,0,0,0,0,0,0,0,25,0,303,0,19,0,0,0,6,0,328,0,0,0,0,0,0,0,4,1,0,19
Independence,6/2/20,0,0,0,0,0,0,0,0,0,34,0,1007,0,29,0,0,0,5,0,1041,0,0,0,0,0,0,0,3,1,0,31
Izard,6/2/20,0,0,0,0,0,0,0,0,0,17,0,247,0,14,0,1,0,2,0,264,0,0,0,0,0,0,0,1,0,1,7
Jackson,6/2/20,0,0,0,0,0,0,0,0,0,4,0,274,0,1,0,0,0,3,0,278,0,0,0,0,0,0,0,1,0,0,6
Jefferson,6/2/20,0,0,0,0,0,0,0,0,0,529,0,3156,0,464,0,25,0,40,0,3685,0,0,0,0,0,0,0,6,2,0,330
Johnson,6/2/20,0,0,0,0,0,0,0,0,0,49,0,575,0,37,0,0,0,12,0,624,0,0,0,0,0,0,0,1,2,0,12
Lafayette,6/2/20,0,0,0,0,0,0,0,0,0,9,0,72,0,8,0,1,0,0,0,81,0,0,0,0,0,0,0,0,0,0,3
Lawrence,6/2/20,0,0,0,0,0,0,0,0,0,85,0,802,0,65,0,5,0,15,0,887,0,0,0,0,0,0,0,1,0,0,9
Lee,6/2/20,0,0,0,0,0,0,0,0,0,23,0,427,0,15,0,1,0,7,0,450,0,0,0,0,0,0,0,2,1,0,14
Lincoln,6/2/20,0,0,0,0,0,0,0,0,0,983,0,996,0,949,0,9,0,25,0,1979,0,0,0,0,0,0,0,0,0,0,5
LittleRiver,6/2/20,0,0,0,0,0,0,0,0,0,8,0,212,0,4,0,0,0,4,0,220,0,0,0,0,0,0,0,2,0,0,12
Logan,6/2/20,0,0,0,0,0,0,0,0,0,8,0,327,0,4,0,0,0,4,0,335,0,0,0,0,0,0,0,1,0,0,15
Lonoke,6/2/20,0,0,0,0,0,0,0,0,0,54,0,1952,0,47,0,0,0,7,0,2006,0,0,0,0,0,0,0,5,1,0,67
Madison,6/2/20,0,0,0,0,0,0,0,0,0,29,0,512,0,5,0,0,0,24,0,541,0,0,0,0,0,0,0,6,2,0,29
Marion,6/2/20,0,0,0,0,0,0,0,0,0,2,0,309,0,1,0,0,0,1,0,311,0,0,0,0,0,0,0,0,0,0,2
Miller,6/2/20,0,0,0,0,0,0,0,0,0,47,0,741,0,41,0,1,0,5,0,788,0,0,0,0,0,0,0,2,0,0,19
MissingCountyInfo,6/2/20,0,0,0,0,0,0,0,0,0,203,0,31853,0,127,0,0,0,76,0,32056,0,0,0,0,0,0,0,14,8,0,1386
Mississippi,6/2/20,0,0,0,0,0,0,0,0,0,78,0,1528,0,66,0,2,0,10,0,1606,0,0,0,0,0,0,0,2,2,0,15
Monroe,6/2/20,0,0,0,0,0,0,0,0,0,5,0,170,0,5,0,0,0,0,0,175,0,0,0,0,0,0,0,0,0,0,5
Montgomery,6/2/20,0,0,0,0,0,0,0,0,0,2,0,151,0,1,0,0,0,1,0,153,0,0,0,0,0,0,0,0,0,0,3
Nevada,6/2/20,0,0,0,0,0,0,0,0,0,7,0,158,0,4,0,0,0,3,0,165,0,0,0,0,0,0,0,0,0,0,6
Newton,6/2/20,0,0,0,0,0,0,0,0,0,3,0,167,0,3,0,0,0,0,0,170,0,0,0,0,0,0,0,0,0,0,5
Ouachita,6/2/20,0,0,0,0,0,0,0,0,0,10,0,862,0,10,0,0,0,0,0,872,0,0,0,0,0,0,0,0,0,0,6
Perry,6/2/20,0,0,0,0,0,0,0,0,0,14,0,299,0,14,0,0,0,0,0,313,0,0,0,0,0,0,0,0,0,0,5
Phillips,6/2/20,0,0,0,0,0,0,0,0,0,24,0,662,0,9,0,1,0,14,0,686,0,0,0,0,0,0,0,2,1,0,60
Pike,6/2/20,0,0,0,0,0,0,0,0,0,5,0,609,0,4,0,0,0,1,0,614,0,0,0,0,0,0,0,0,0,0,5
Poinsett,6/2/20,0,0,0,0,0,0,0,0,0,37,0,586,0,27,0,2,0,8,0,623,0,0,0,0,0,0,0,4,0,0,21
Polk,6/2/20,0,0,0,0,0,0,0,0,0,26,0,488,0,10,0,0,0,16,0,514,0,0,0,0,0,0,0,5,-1,0,15
Pope,6/2/20,0,0,0,0,0,0,0,0,0,166,0,2686,0,99,0,1,0,66,0,2852,0,0,0,0,0,0,0,5,4,0,70
Prairie,6/2/20,0,0,0,0,0,0,0,0,0,3,0,108,0,2,0,0,0,1,0,111,0,0,0,0,0,0,0,1,0,0,1
Pulaski,6/2/20,0,0,0,0,0,0,0,0,0,969,0,14177,0,710,0,35,0,224,0,15146,0,0,0,0,0,0,0,66,17,1,574
Randolph,6/2/20,0,0,0,0,0,0,0,0,0,26,0,1059,0,23,0,0,0,3,0,1085,0,0,0,0,0,0,0,0,1,0,4
Saline,6/2/20,0,0,0,0,0,0,0,0,0,116,0,3636,0,94,0,1,0,21,0,3752,0,0,0,0,0,0,0,3,5,0,83
Scott,6/2/20,0,0,0,0,0,0,0,0,0,1,0,32,0,1,0,0,0,0,0,33,0,0,0,0,0,0,0,0,0,0,0
Searcy,6/2/20,0,0,0,0,0,0,0,0,0,7,0,475,0,6,0,0,0,1,0,482,0,0,0,0,0,0,0,0,0,0,4
Sebastian,6/2/20,0,0,0,0,0,0,0,0,0,47,0,1507,0,21,0,0,0,26,0,1554,0,0,0,0,0,0,0,4,1,0,82
Sevier,6/2/20,0,0,0,0,0,0,0,0,0,258,0,1508,0,91,0,2,0,165,0,1766,0,0,0,0,0,0,0,33,9,0,521
Sharp,6/2/20,0,0,0,0,0,0,0,0,0,46,0,419,0,35,0,2,0,9,0,465,0,0,0,0,0,0,0,0,1,0,3
St.Francis,6/2/20,0,0,0,0,0,0,0,0,0,682,0,2833,0,619,0,1,0,62,0,3515,0,0,0,0,0,0,0,6,7,0,50
Stone,6/2/20,0,0,0,0,0,0,0,0,0,9,0,386,0,8,0,0,0,1,0,395,0,0,0,0,0,0,0,0,0,0,2
Union,6/2/20,0,0,0,0,0,0,0,0,0,173,0,991,0,139,0,9,0,25,0,1164,0,0,0,0,0,0,0,0,7,1,4
VanBuren,6/2/20,0,0,0,0,0,0,0,0,0,29,0,547,0,26,0,2,0,1,0,576,0,0,0,0,0,0,0,1,0,0,9
Washington,6/2/20,0,0,0,0,0,0,0,0,0,620,0,5438,0,209,0,7,0,404,0,6058,0,0,0,0,0,0,0,58,16,0,414
White,6/2/20,0,0,0,0,0,0,0,0,0,46,0,1839,0,40,0,1,0,5,0,1885,0,0,0,0,0,0,0,2,3,0,23
Woodruff,6/2/20,0,0,0,0,0,0,0,0,0,1,0,133,0,1,0,0,0,0,0,134,0,0,0,0,0,0,0,0,0,0,2
Yell,6/2/20,0,0,0,0,0,0,0,0,0,179,0,608,0,83,0,1,0,95,0,787,0,0,0,0,0,0,0,17,6,0,104
Arkansas_all_counties,6/1/20,0,0,0,0,0,0,0,0,2990671,7443,0,125793,0,5401,0,133,0,1909,0,133236,0,0,0,0,0,0,0,190,126,0,3721
Arkansas_county,6/1/20,0,0,0,0,0,0,0,0,0,7,0,326,0,3,0,0,0,4,0,333,0,0,0,0,0,0,0,1,1,0,4
Ashley,6/1/20,0,0,0,0,0,0,0,0,0,19,0,714,0,19,0,0,0,0,0,733,0,0,0,0,0,0,0,0,0,0,54
Baxter,6/1/20,0,0,0,0,0,0,0,0,0,12,0,735,0,6,0,0,0,6,0,747,0,0,0,0,0,0,0,0,0,0,28
Benton,6/1/20,0,0,0,0,0,0,0,0,0,607,0,11439,0,237,0,2,0,368,0,12046,0,0,0,0,0,0,0,29,20,0,713
Boone,6/1/20,0,0,0,0,0,0,0,0,0,6,0,844,0,4,0,0,0,2,0,850,0,0,0,0,0,0,0,0,0,0,25
Bradley,6/1/20,0,0,0,0,0,0,0,0,0,22,0,432,0,13,0,1,0,8,0,454,0,0,0,0,0,0,0,0,-1,0,4
Calhoun,6/1/20,0,0,0,0,0,0,0,0,0,0,0,115,0,0,0,0,0,0,0,115,0,0,0,0,0,0,0,0,0,0,42
Carroll,6/1/20,0,0,0,0,0,0,0,0,0,25,0,938,0,7,0,1,0,17,0,963,0,0,0,0,0,0,0,1,0,0,30
Chicot,6/1/20,0,0,0,0,0,0,0,0,0,15,0,224,0,12,0,0,0,3,0,239,0,0,0,0,0,0,0,0,0,0,3
Clark,6/1/20,0,0,0,0,0,0,0,0,0,39,0,762,0,37,0,0,0,2,0,801,0,0,0,0,0,0,0,0,0,0,15
Clay,6/1/20,0,0,0,0,0,0,0,0,0,4,0,629,0,4,0,0,0,0,0,633,0,0,0,0,0,0,0,0,0,0,16
Cleburne,6/1/20,0,0,0,0,0,0,0,0,0,74,0,730,0,69,0,4,0,1,0,804,0,0,0,0,0,0,0,1,0,0,19
Cleveland,6/1/20,0,0,0,0,0,0,0,0,0,19,0,333,0,18,0,0,0,1,0,352,0,0,0,0,0,0,0,0,0,0,6
Columbia,6/1/20,0,0,0,0,0,0,0,0,0,23,0,424,0,16,0,2,0,5,0,447,0,0,0,0,0,0,0,0,0,0,12
Conway,6/1/20,0,0,0,0,0,0,0,0,0,14,0,578,0,13,0,1,0,0,0,592,0,0,0,0,0,0,0,0,0,0,10
Craighead,6/1/20,0,0,0,0,0,0,0,0,0,228,0,5053,0,178,0,0,0,50,0,5281,0,0,0,0,0,0,0,8,5,0,196
Crawford,6/1/20,0,0,0,0,0,0,0,0,0,30,0,782,0,12,0,0,0,18,0,812,0,0,0,0,0,0,0,1,0,0,17
Crittenden,6/1/20,0,0,0,0,0,0,0,0,0,386,0,3114,0,253,0,9,0,124,0,3500,0,0,0,0,0,0,0,6,7,0,57
Cross,6/1/20,0,0,0,0,0,0,0,0,0,52,0,682,0,40,0,0,0,12,0,734,0,0,0,0,0,0,0,0,2,0,17
Dallas,6/1/20,0,0,0,0,0,0,0,0,0,1,0,171,0,1,0,0,0,0,0,172,0,0,0,0,0,0,0,0,0,0,5
Desha,6/1/20,0,0,0,0,0,0,0,0,0,19,0,461,0,18,0,0,0,1,0,480,0,0,0,0,0,0,0,0,0,0,5
Drew,6/1/20,0,0,0,0,0,0,0,0,0,20,0,624,0,16,0,1,0,3,0,644,0,0,0,0,0,0,0,0,0,0,12
Faulkner,6/1/20,0,0,0,0,0,0,0,0,0,102,0,3126,0,93,0,3,0,6,0,3228,0,0,0,0,0,0,0,0,0,0,35
Franklin,6/1/20,0,0,0,0,0,0,0,0,0,4,0,332,0,2,0,0,0,2,0,336,0,0,0,0,0,0,0,0,0,0,6
Fulton,6/1/20,0,0,0,0,0,0,0,0,0,7,0,365,0,4,0,0,0,3,0,372,0,0,0,0,0,0,0,0,0,0,11
Garland,6/1/20,0,0,0,0,0,0,0,0,0,136,0,4041,0,132,0,1,0,3,0,4177,0,0,0,0,0,0,0,0,0,0,60
Grant,6/1/20,0,0,0,0,0,0,0,0,0,18,0,499,0,17,0,0,0,1,0,517,0,0,0,0,0,0,0,0,0,0,8
Greene,6/1/20,0,0,0,0,0,0,0,0,0,64,0,2011,0,43,0,0,0,21,0,2075,0,0,0,0,0,0,0,0,3,0,32
Hempstead,6/1/20,0,0,0,0,0,0,0,0,0,18,0,405,0,12,0,1,0,5,0,423,0,0,0,0,0,0,0,0,0,0,52
HotSpring,6/1/20,0,0,0,0,0,0,0,0,0,32,0,871,0,30,0,0,0,2,0,903,0,0,0,0,0,0,0,0,0,0,31
Howard,6/1/20,0,0,0,0,0,0,0,0,0,21,0,288,0,18,0,0,0,3,0,309,0,0,0,0,0,0,0,0,2,0,12
Independence,6/1/20,0,0,0,0,0,0,0,0,0,31,0,979,0,28,0,0,0,3,0,1010,0,0,0,0,0,0,0,0,1,0,8
Izard,6/1/20,0,0,0,0,0,0,0,0,0,16,0,241,0,14,0,0,0,2,0,257,0,0,0,0,0,0,0,0,0,0,3
Jackson,6/1/20,0,0,0,0,0,0,0,0,0,3,0,269,0,1,0,0,0,2,0,272,0,0,0,0,0,0,0,0,0,0,6
Jefferson,6/1/20,0,0,0,0,0,0,0,0,0,523,0,2832,0,462,0,25,0,36,0,3355,0,0,0,0,0,0,0,2,4,0,42
Johnson,6/1/20,0,0,0,0,0,0,0,0,0,48,0,564,0,35,0,0,0,13,0,612,0,0,0,0,0,0,0,5,0,0,18
Lafayette,6/1/20,0,0,0,0,0,0,0,0,0,9,0,69,0,8,0,1,0,0,0,78,0,0,0,0,0,0,0,0,0,0,7
Lawrence,6/1/20,0,0,0,0,0,0,0,0,0,84,0,794,0,65,0,5,0,14,0,878,0,0,0,0,0,0,0,0,0,0,18
Lee,6/1/20,0,0,0,0,0,0,0,0,0,21,0,415,0,14,0,1,0,6,0,436,0,0,0,0,0,0,0,1,1,0,33
Lincoln,6/1/20,0,0,0,0,0,0,0,0,0,983,0,991,0,949,0,9,0,25,0,1974,0,0,0,0,0,0,0,1,0,0,5
LittleRiver,6/1/20,0,0,0,0,0,0,0,0,0,6,0,202,0,4,0,0,0,2,0,208,0,0,0,0,0,0,0,0,1,0,1
Logan,6/1/20,0,0,0,0,0,0,0,0,0,7,0,313,0,4,0,0,0,3,0,320,0,0,0,0,0,0,0,1,0,0,10
Lonoke,6/1/20,0,0,0,0,0,0,0,0,0,49,0,1890,0,46,0,0,0,3,0,1939,0,0,0,0,0,0,0,1,0,0,36
Madison,6/1/20,0,0,0,0,0,0,0,0,0,23,0,489,0,3,0,0,0,20,0,512,0,0,0,0,0,0,0,0,0,0,20
Marion,6/1/20,0,0,0,0,0,0,0,0,0,2,0,307,0,1,0,0,0,1,0,309,0,0,0,0,0,0,0,0,0,0,5
Miller,6/1/20,0,0,0,0,0,0,0,0,0,45,0,724,0,41,0,1,0,3,0,769,0,0,0,0,0,0,0,1,0,0,7
MissingCountyInfo,6/1/20,0,0,0,0,0,0,0,0,0,189,0,30481,0,119,0,0,0,70,0,30670,0,0,0,0,0,0,0,1,2,0,670
Mississippi,6/1/20,0,0,0,0,0,0,0,0,0,76,0,1515,0,64,0,2,0,10,0,1591,0,0,0,0,0,0,0,1,1,0,30
Monroe,6/1/20,0,0,0,0,0,0,0,0,0,5,0,165,0,5,0,0,0,0,0,170,0,0,0,0,0,0,0,0,0,0,5
Montgomery,6/1/20,0,0,0,0,0,0,0,0,0,2,0,148,0,1,0,0,0,1,0,150,0,0,0,0,0,0,0,0,0,0,0
Nevada,6/1/20,0,0,0,0,0,0,0,0,0,7,0,152,0,4,0,0,0,3,0,159,0,0,0,0,0,0,0,1,0,0,9
Newton,6/1/20,0,0,0,0,0,0,0,0,0,3,0,162,0,3,0,0,0,0,0,165,0,0,0,0,0,0,0,0,0,0,4
Ouachita,6/1/20,0,0,0,0,0,0,0,0,0,10,0,856,0,10,0,0,0,0,0,866,0,0,0,0,0,0,0,0,0,0,29
Perry,6/1/20,0,0,0,0,0,0,0,0,0,14,0,294,0,14,0,0,0,0,0,308,0,0,0,0,0,0,0,0,0,0,6
Phillips,6/1/20,0,0,0,0,0,0,0,0,0,22,0,604,0,8,0,1,0,13,0,626,0,0,0,0,0,0,0,1,-4,0,35
Pike,6/1/20,0,0,0,0,0,0,0,0,0,5,0,604,0,4,0,0,0,1,0,609,0,0,0,0,0,0,0,0,0,0,6
Poinsett,6/1/20,0,0,0,0,0,0,0,0,0,33,0,569,0,27,0,2,0,4,0,602,0,0,0,0,0,0,0,0,0,0,18
Polk,6/1/20,0,0,0,0,0,0,0,0,0,21,0,478,0,11,0,0,0,10,0,499,0,0,0,0,0,0,0,2,1,0,9
Pope,6/1/20,0,0,0,0,0,0,0,0,0,161,0,2621,0,95,0,1,0,65,0,2782,0,0,0,0,0,0,0,13,3,0,109
Prairie,6/1/20,0,0,0,0,0,0,0,0,0,2,0,108,0,2,0,0,0,0,0,110,0,0,0,0,0,0,0,0,0,0,1
Pulaski,6/1/20,0,0,0,0,0,0,0,0,0,903,0,13669,0,693,0,34,0,176,0,14572,0,0,0,0,0,0,0,15,9,0,270
Randolph,6/1/20,0,0,0,0,0,0,0,0,0,26,0,1055,0,22,0,0,0,4,0,1081,0,0,0,0,0,0,0,0,1,0,24
Saline,6/1/20,0,0,0,0,0,0,0,0,0,113,0,3556,0,89,0,1,0,23,0,3669,0,0,0,0,0,0,0,1,3,0,98
Scott,6/1/20,0,0,0,0,0,0,0,0,0,1,0,32,0,1,0,0,0,0,0,33,0,0,0,0,0,0,0,0,0,0,2
Searcy,6/1/20,0,0,0,0,0,0,0,0,0,7,0,471,0,6,0,0,0,1,0,478,0,0,0,0,0,0,0,0,0,0,16
Sebastian,6/1/20,0,0,0,0,0,0,0,0,0,43,0,1429,0,20,0,0,0,23,0,1472,0,0,0,0,0,0,0,3,2,0,91
Sevier,6/1/20,0,0,0,0,0,0,0,0,0,225,0,1020,0,82,0,2,0,141,0,1245,0,0,0,0,0,0,0,15,7,0,105
Sharp,6/1/20,0,0,0,0,0,0,0,0,0,46,0,416,0,34,0,2,0,10,0,462,0,0,0,0,0,0,0,0,0,0,3
St.Francis,6/1/20,0,0,0,0,0,0,0,0,0,676,0,2789,0,612,0,1,0,63,0,3465,0,0,0,0,0,0,0,4,12,0,38
Stone,6/1/20,0,0,0,0,0,0,0,0,0,9,0,384,0,8,0,0,0,1,0,393,0,0,0,0,0,0,0,0,0,0,4
Union,6/1/20,0,0,0,0,0,0,0,0,0,173,0,987,0,132,0,8,0,33,0,1160,0,0,0,0,0,0,0,0,20,0,19
VanBuren,6/1/20,0,0,0,0,0,0,0,0,0,28,0,539,0,26,0,2,0,0,0,567,0,0,0,0,0,0,0,0,0,0,4
Washington,6/1/20,0,0,0,0,0,0,0,0,0,562,0,5082,0,193,0,7,0,362,0,5644,0,0,0,0,0,0,0,53,13,0,197
White,6/1/20,0,0,0,0,0,0,0,0,0,44,0,1818,0,37,0,1,0,6,0,1862,0,0,0,0,0,0,0,0,0,0,22
Woodruff,6/1/20,0,0,0,0,0,0,0,0,0,1,0,131,0,1,0,0,0,0,0,132,0,0,0,0,0,0,0,0,0,0,0
Yell,6/1/20,0,0,0,0,0,0,0,0,0,162,0,521,0,77,0,1,0,84,0,683,0,0,0,0,0,0,0,21,6,0,131
Arkansas_all_counties,5/31/20,0,0,0,0,0,0,0,0,2990671,7253,0,122262,0,5275,0,133,0,1845,0,129515,0,0,0,0,0,0,0,240,109,0,3018
Arkansas_county,5/31/20,0,0,0,0,0,0,0,0,0,6,0,323,0,2,0,0,0,4,0,329,0,0,0,0,0,0,0,1,-1,0,8
Ashley,5/31/20,0,0,0,0,0,0,0,0,0,19,0,660,0,19,0,0,0,0,0,679,0,0,0,0,0,0,0,0,0,0,26
Baxter,5/31/20,0,0,0,0,0,0,0,0,0,12,0,707,0,6,0,0,0,6,0,719,0,0,0,0,0,0,0,1,0,0,48
Benton,5/31/20,0,0,0,0,0,0,0,0,0,578,0,10755,0,217,0,2,0,359,0,11333,0,0,0,0,0,0,0,71,16,0,344
Boone,5/31/20,0,0,0,0,0,0,0,0,0,6,0,819,0,4,0,0,0,2,0,825,0,0,0,0,0,0,0,0,0,0,27
Bradley,5/31/20,0,0,0,0,0,0,0,0,0,22,0,428,0,14,0,1,0,7,0,450,0,0,0,0,0,0,0,4,1,0,18
Calhoun,5/31/20,0,0,0,0,0,0,0,0,0,0,0,73,0,0,0,0,0,0,0,73,0,0,0,0,0,0,0,0,0,0,5
Carroll,5/31/20,0,0,0,0,0,0,0,0,0,24,0,909,0,7,0,1,0,16,0,933,0,0,0,0,0,0,0,0,0,0,24
Chicot,5/31/20,0,0,0,0,0,0,0,0,0,15,0,221,0,12,0,0,0,3,0,236,0,0,0,0,0,0,0,0,0,0,1
Clark,5/31/20,0,0,0,0,0,0,0,0,0,39,0,747,0,37,0,0,0,2,0,786,0,0,0,0,0,0,0,0,2,0,7
Clay,5/31/20,0,0,0,0,0,0,0,0,0,4,0,613,0,4,0,0,0,0,0,617,0,0,0,0,0,0,0,0,0,0,33
Cleburne,5/31/20,0,0,0,0,0,0,0,0,0,73,0,712,0,69,0,4,0,0,0,785,0,0,0,0,0,0,0,0,1,0,7
Cleveland,5/31/20,0,0,0,0,0,0,0,0,0,19,0,327,0,18,0,0,0,1,0,346,0,0,0,0,0,0,0,0,0,0,8
Columbia,5/31/20,0,0,0,0,0,0,0,0,0,23,0,412,0,16,0,2,0,5,0,435,0,0,0,0,0,0,0,-2,2,0,1
Conway,5/31/20,0,0,0,0,0,0,0,0,0,14,0,568,0,13,0,1,0,0,0,582,0,0,0,0,0,0,0,0,0,0,7
Craighead,5/31/20,0,0,0,0,0,0,0,0,0,220,0,4865,0,173,0,0,0,47,0,5085,0,0,0,0,0,0,0,8,4,0,131
Crawford,5/31/20,0,0,0,0,0,0,0,0,0,29,0,766,0,12,0,0,0,17,0,795,0,0,0,0,0,0,0,5,0,0,24
Crittenden,5/31/20,0,0,0,0,0,0,0,0,0,380,0,3063,0,246,0,9,0,125,0,3443,0,0,0,0,0,0,0,13,7,0,94
Cross,5/31/20,0,0,0,0,0,0,0,0,0,52,0,665,0,38,0,0,0,14,0,717,0,0,0,0,0,0,0,1,0,0,10
Dallas,5/31/20,0,0,0,0,0,0,0,0,0,1,0,166,0,1,0,0,0,0,0,167,0,0,0,0,0,0,0,0,0,0,1
Desha,5/31/20,0,0,0,0,0,0,0,0,0,19,0,456,0,18,0,0,0,1,0,475,0,0,0,0,0,0,0,0,0,0,11
Drew,5/31/20,0,0,0,0,0,0,0,0,0,20,0,612,0,16,0,1,0,3,0,632,0,0,0,0,0,0,0,1,0,0,14
Faulkner,5/31/20,0,0,0,0,0,0,0,0,0,102,0,3091,0,93,0,3,0,6,0,3193,0,0,0,0,0,0,0,0,1,0,60
Franklin,5/31/20,0,0,0,0,0,0,0,0,0,4,0,326,0,2,0,0,0,2,0,330,0,0,0,0,0,0,0,0,0,0,8
Fulton,5/31/20,0,0,0,0,0,0,0,0,0,7,0,354,0,4,0,0,0,3,0,361,0,0,0,0,0,0,0,0,0,0,20
Garland,5/31/20,0,0,0,0,0,0,0,0,0,136,0,3981,0,132,0,1,0,3,0,4117,0,0,0,0,0,0,0,0,1,0,73
Grant,5/31/20,0,0,0,0,0,0,0,0,0,18,0,491,0,17,0,0,0,1,0,509,0,0,0,0,0,0,0,0,0,0,7
Greene,5/31/20,0,0,0,0,0,0,0,0,0,64,0,1979,0,40,0,0,0,24,0,2043,0,0,0,0,0,0,0,0,3,0,43
Hempstead,5/31/20,0,0,0,0,0,0,0,0,0,18,0,353,0,12,0,1,0,5,0,371,0,0,0,0,0,0,0,2,1,0,7
HotSpring,5/31/20,0,0,0,0,0,0,0,0,0,32,0,840,0,30,0,0,0,2,0,872,0,0,0,0,0,0,0,0,0,0,5
Howard,5/31/20,0,0,0,0,0,0,0,0,0,21,0,276,0,16,0,0,0,5,0,297,0,0,0,0,0,0,0,1,1,0,5
Independence,5/31/20,0,0,0,0,0,0,0,0,0,31,0,971,0,27,0,0,0,4,0,1002,0,0,0,0,0,0,0,0,0,0,26
Izard,5/31/20,0,0,0,0,0,0,0,0,0,16,0,238,0,14,0,0,0,2,0,254,0,0,0,0,0,0,0,0,0,0,16
Jackson,5/31/20,0,0,0,0,0,0,0,0,0,3,0,263,0,1,0,0,0,2,0,266,0,0,0,0,0,0,0,2,0,0,5
Jefferson,5/31/20,0,0,0,0,0,0,0,0,0,521,0,2792,0,458,0,25,0,38,0,3313,0,0,0,0,0,0,0,4,1,0,98
Johnson,5/31/20,0,0,0,0,0,0,0,0,0,43,0,551,0,35,0,0,0,8,0,594,0,0,0,0,0,0,0,0,0,0,30
Lafayette,5/31/20,0,0,0,0,0,0,0,0,0,9,0,62,0,8,0,1,0,0,0,71,0,0,0,0,0,0,0,0,0,0,2
Lawrence,5/31/20,0,0,0,0,0,0,0,0,0,84,0,776,0,65,0,5,0,14,0,860,0,0,0,0,0,0,0,0,0,0,20
Lee,5/31/20,0,0,0,0,0,0,0,0,0,20,0,383,0,13,0,1,0,6,0,403,0,0,0,0,0,0,0,1,2,0,7
Lincoln,5/31/20,0,0,0,0,0,0,0,0,0,982,0,987,0,949,0,9,0,24,0,1969,0,0,0,0,0,0,0,4,4,0,11
LittleRiver,5/31/20,0,0,0,0,0,0,0,0,0,6,0,201,0,3,0,0,0,3,0,207,0,0,0,0,0,0,0,0,0,0,4
Logan,5/31/20,0,0,0,0,0,0,0,0,0,6,0,304,0,4,0,0,0,2,0,310,0,0,0,0,0,0,0,0,0,0,9
Lonoke,5/31/20,0,0,0,0,0,0,0,0,0,48,0,1855,0,46,0,0,0,2,0,1903,0,0,0,0,0,0,0,1,0,0,53
Madison,5/31/20,0,0,0,0,0,0,0,0,0,23,0,469,0,3,0,0,0,20,0,492,0,0,0,0,0,0,0,1,0,0,7
Marion,5/31/20,0,0,0,0,0,0,0,0,0,2,0,302,0,1,0,0,0,1,0,304,0,0,0,0,0,0,0,1,0,0,7
Miller,5/31/20,0,0,0,0,0,0,0,0,0,44,0,718,0,41,0,1,0,2,0,762,0,0,0,0,0,0,0,1,0,0,28
MissingCountyInfo,5/31/20,0,0,0,0,0,0,0,0,0,188,0,29812,0,117,0,0,0,71,0,30000,0,0,0,0,0,0,0,-8,-4,0,346
Mississippi,5/31/20,0,0,0,0,0,0,0,0,0,75,0,1486,0,63,0,2,0,10,0,1561,0,0,0,0,0,0,0,0,2,0,27
Monroe,5/31/20,0,0,0,0,0,0,0,0,0,5,0,160,0,5,0,0,0,0,0,165,0,0,0,0,0,0,0,0,0,0,2
Montgomery,5/31/20,0,0,0,0,0,0,0,0,0,2,0,148,0,1,0,0,0,1,0,150,0,0,0,0,0,0,0,0,0,0,1
Nevada,5/31/20,0,0,0,0,0,0,0,0,0,6,0,144,0,4,0,0,0,2,0,150,0,0,0,0,0,0,0,1,0,0,5
Newton,5/31/20,0,0,0,0,0,0,0,0,0,3,0,158,0,3,0,0,0,0,0,161,0,0,0,0,0,0,0,0,0,0,4
Ouachita,5/31/20,0,0,0,0,0,0,0,0,0,10,0,827,0,10,0,0,0,0,0,837,0,0,0,0,0,0,0,0,0,0,17
Perry,5/31/20,0,0,0,0,0,0,0,0,0,14,0,288,0,14,0,0,0,0,0,302,0,0,0,0,0,0,0,0,0,0,4
Phillips,5/31/20,0,0,0,0,0,0,0,0,0,21,0,570,0,12,0,1,0,8,0,591,0,0,0,0,0,0,0,1,4,0,26
Pike,5/31/20,0,0,0,0,0,0,0,0,0,5,0,598,0,4,0,0,0,1,0,603,0,0,0,0,0,0,0,0,0,0,4
Poinsett,5/31/20,0,0,0,0,0,0,0,0,0,33,0,551,0,27,0,2,0,4,0,584,0,0,0,0,0,0,0,0,1,0,9
Polk,5/31/20,0,0,0,0,0,0,0,0,0,19,0,471,0,10,0,0,0,9,0,490,0,0,0,0,0,0,0,2,1,0,14
Pope,5/31/20,0,0,0,0,0,0,0,0,0,148,0,2525,0,92,0,1,0,55,0,2673,0,0,0,0,0,0,0,6,8,0,60
Prairie,5/31/20,0,0,0,0,0,0,0,0,0,2,0,107,0,2,0,0,0,0,0,109,0,0,0,0,0,0,0,0,0,0,0
Pulaski,5/31/20,0,0,0,0,0,0,0,0,0,888,0,13414,0,684,0,34,0,170,0,14302,0,0,0,0,0,0,0,12,11,0,406
Randolph,5/31/20,0,0,0,0,0,0,0,0,0,26,0,1031,0,21,0,0,0,5,0,1057,0,0,0,0,0,0,0,0,0,0,9
Saline,5/31/20,0,0,0,0,0,0,0,0,0,112,0,3459,0,86,0,1,0,25,0,3571,0,0,0,0,0,0,0,0,2,0,39
Scott,5/31/20,0,0,0,0,0,0,0,0,0,1,0,30,0,1,0,0,0,0,0,31,0,0,0,0,0,0,0,0,0,0,2
Searcy,5/31/20,0,0,0,0,0,0,0,0,0,7,0,455,0,6,0,0,0,1,0,462,0,0,0,0,0,0,0,0,0,0,9
Sebastian,5/31/20,0,0,0,0,0,0,0,0,0,40,0,1341,0,18,0,0,0,22,0,1381,0,0,0,0,0,0,0,2,1,0,76
Sevier,5/31/20,0,0,0,0,0,0,0,0,0,210,0,930,0,75,0,2,0,133,0,1140,0,0,0,0,0,0,0,40,5,0,170
Sharp,5/31/20,0,0,0,0,0,0,0,0,0,46,0,413,0,34,0,2,0,10,0,459,0,0,0,0,0,0,0,0,0,0,17
St.Francis,5/31/20,0,0,0,0,0,0,0,0,0,672,0,2755,0,600,0,1,0,71,0,3427,0,0,0,0,0,0,0,0,12,0,20
Stone,5/31/20,0,0,0,0,0,0,0,0,0,9,0,380,0,8,0,0,0,1,0,389,0,0,0,0,0,0,0,0,0,0,54
Union,5/31/20,0,0,0,0,0,0,0,0,0,173,0,968,0,112,0,8,0,53,0,1141,0,0,0,0,0,0,0,2,2,0,23
VanBuren,5/31/20,0,0,0,0,0,0,0,0,0,28,0,535,0,26,0,2,0,0,0,563,0,0,0,0,0,0,0,0,0,0,1
Washington,5/31/20,0,0,0,0,0,0,0,0,0,509,0,4938,0,180,0,7,0,322,0,5447,0,0,0,0,0,0,0,57,13,0,218
White,5/31/20,0,0,0,0,0,0,0,0,0,44,0,1796,0,37,0,1,0,6,0,1840,0,0,0,0,0,0,0,0,0,0,28
Woodruff,5/31/20,0,0,0,0,0,0,0,0,0,1,0,131,0,1,0,0,0,0,0,132,0,0,0,0,0,0,0,0,0,0,0
Yell,5/31/20,0,0,0,0,0,0,0,0,0,141,0,411,0,71,0,1,0,69,0,552,0,0,0,0,0,0,0,4,10,0,27
Arkansas_all_counties,5/30/20,0,0,0,0,0,0,0,0,2990671,7013,0,119484,0,5166,0,133,0,1714,0,126497,0,0,0,0,0,0,0,236,220,1,3607
Arkansas_county,5/30/20,0,0,0,0,0,0,0,0,0,5,0,316,0,3,0,0,0,2,0,321,0,0,0,0,0,0,0,1,1,0,12
Ashley,5/30/20,0,0,0,0,0,0,0,0,0,19,0,634,0,19,0,0,0,0,0,653,0,0,0,0,0,0,0,0,0,0,25
Baxter,5/30/20,0,0,0,0,0,0,0,0,0,11,0,660,0,6,0,0,0,5,0,671,0,0,0,0,0,0,0,2,0,0,61
Benton,5/30/20,0,0,0,0,0,0,0,0,0,507,0,10482,0,201,0,2,0,304,0,10989,0,0,0,0,0,0,0,39,22,1,372
Boone,5/30/20,0,0,0,0,0,0,0,0,0,6,0,792,0,4,0,0,0,2,0,798,0,0,0,0,0,0,0,0,0,0,59
Bradley,5/30/20,0,0,0,0,0,0,0,0,0,18,0,414,0,13,0,1,0,4,0,432,0,0,0,0,0,0,0,0,0,0,12
Calhoun,5/30/20,0,0,0,0,0,0,0,0,0,0,0,68,0,0,0,0,0,0,0,68,0,0,0,0,0,0,0,0,0,0,1
Carroll,5/30/20,0,0,0,0,0,0,0,0,0,24,0,885,0,7,0,1,0,16,0,909,0,0,0,0,0,0,0,0,1,0,68
Chicot,5/30/20,0,0,0,0,0,0,0,0,0,15,0,220,0,12,0,0,0,3,0,235,0,0,0,0,0,0,0,0,0,0,6
Clark,5/30/20,0,0,0,0,0,0,0,0,0,39,0,740,0,35,0,0,0,4,0,779,0,0,0,0,0,0,0,0,0,0,10
Clay,5/30/20,0,0,0,0,0,0,0,0,0,4,0,580,0,4,0,0,0,0,0,584,0,0,0,0,0,0,0,0,0,0,55
Cleburne,5/30/20,0,0,0,0,0,0,0,0,0,73,0,705,0,68,0,4,0,1,0,778,0,0,0,0,0,0,0,0,0,0,19
Cleveland,5/30/20,0,0,0,0,0,0,0,0,0,19,0,319,0,18,0,0,0,1,0,338,0,0,0,0,0,0,0,0,0,0,14
Columbia,5/30/20,0,0,0,0,0,0,0,0,0,25,0,409,0,14,0,2,0,9,0,434,0,0,0,0,0,0,0,4,0,0,20
Conway,5/30/20,0,0,0,0,0,0,0,0,0,14,0,561,0,13,0,1,0,0,0,575,0,0,0,0,0,0,0,0,0,0,7
Craighead,5/30/20,0,0,0,0,0,0,0,0,0,212,0,4742,0,169,0,0,0,43,0,4954,0,0,0,0,0,0,0,6,15,0,309
Crawford,5/30/20,0,0,0,0,0,0,0,0,0,24,0,747,0,12,0,0,0,12,0,771,0,0,0,0,0,0,0,6,0,0,37
Crittenden,5/30/20,0,0,0,0,0,0,0,0,0,367,0,2982,0,239,0,9,0,119,0,3349,0,0,0,0,0,0,0,26,9,0,122
Cross,5/30/20,0,0,0,0,0,0,0,0,0,51,0,656,0,38,0,0,0,13,0,707,0,0,0,0,0,0,0,1,0,0,29
Dallas,5/30/20,0,0,0,0,0,0,0,0,0,1,0,165,0,1,0,0,0,0,0,166,0,0,0,0,0,0,0,0,0,0,10
Desha,5/30/20,0,0,0,0,0,0,0,0,0,19,0,445,0,18,0,0,0,1,0,464,0,0,0,0,0,0,0,0,0,0,10
Drew,5/30/20,0,0,0,0,0,0,0,0,0,19,0,599,0,16,0,1,0,2,0,618,0,0,0,0,0,0,0,0,0,0,13
Faulkner,5/30/20,0,0,0,0,0,0,0,0,0,102,0,3031,0,92,0,3,0,7,0,3133,0,0,0,0,0,0,0,0,1,0,78
Franklin,5/30/20,0,0,0,0,0,0,0,0,0,4,0,318,0,2,0,0,0,2,0,322,0,0,0,0,0,0,0,0,0,0,20
Fulton,5/30/20,0,0,0,0,0,0,0,0,0,7,0,334,0,4,0,0,0,3,0,341,0,0,0,0,0,0,0,0,0,0,20
Garland,5/30/20,0,0,0,0,0,0,0,0,0,136,0,3908,0,131,0,1,0,4,0,4044,0,0,0,0,0,0,0,0,0,0,39
Grant,5/30/20,0,0,0,0,0,0,0,0,0,18,0,484,0,17,0,0,0,1,0,502,0,0,0,0,0,0,0,0,0,0,10
Greene,5/30/20,0,0,0,0,0,0,0,0,0,64,0,1936,0,37,0,0,0,27,0,2000,0,0,0,0,0,0,0,1,3,0,105
Hempstead,5/30/20,0,0,0,0,0,0,0,0,0,16,0,348,0,11,0,1,0,4,0,364,0,0,0,0,0,0,0,1,3,0,21
HotSpring,5/30/20,0,0,0,0,0,0,0,0,0,32,0,835,0,30,0,0,0,2,0,867,0,0,0,0,0,0,0,0,0,0,11
Howard,5/30/20,0,0,0,0,0,0,0,0,0,20,0,272,0,15,0,0,0,5,0,292,0,0,0,0,0,0,0,1,0,0,3
Independence,5/30/20,0,0,0,0,0,0,0,0,0,31,0,945,0,27,0,0,0,4,0,976,0,0,0,0,0,0,0,1,0,0,114
Izard,5/30/20,0,0,0,0,0,0,0,0,0,16,0,222,0,14,0,0,0,2,0,238,0,0,0,0,0,0,0,0,0,0,11
Jackson,5/30/20,0,0,0,0,0,0,0,0,0,1,0,260,0,1,0,0,0,0,0,261,0,0,0,0,0,0,0,0,0,0,10
Jefferson,5/30/20,0,0,0,0,0,0,0,0,0,517,0,2698,0,457,0,25,0,35,0,3215,0,0,0,0,0,0,0,1,3,0,211
Johnson,5/30/20,0,0,0,0,0,0,0,0,0,43,0,521,0,35,0,0,0,8,0,564,0,0,0,0,0,0,0,1,0,0,64
Lafayette,5/30/20,0,0,0,0,0,0,0,0,0,9,0,60,0,8,0,1,0,0,0,69,0,0,0,0,0,0,0,0,0,0,1
Lawrence,5/30/20,0,0,0,0,0,0,0,0,0,84,0,756,0,65,0,5,0,14,0,840,0,0,0,0,0,0,0,2,0,0,56
Lee,5/30/20,0,0,0,0,0,0,0,0,0,19,0,377,0,11,0,1,0,7,0,396,0,0,0,0,0,0,0,1,0,0,10
Lincoln,5/30/20,0,0,0,0,0,0,0,0,0,978,0,980,0,945,0,9,0,24,0,1958,0,0,0,0,0,0,0,3,0,0,15
LittleRiver,5/30/20,0,0,0,0,0,0,0,0,0,6,0,197,0,3,0,0,0,3,0,203,0,0,0,0,0,0,0,0,1,0,8
Logan,5/30/20,0,0,0,0,0,0,0,0,0,6,0,295,0,4,0,0,0,2,0,301,0,0,0,0,0,0,0,1,0,0,10
Lonoke,5/30/20,0,0,0,0,0,0,0,0,0,47,0,1803,0,46,0,0,0,1,0,1850,0,0,0,0,0,0,0,0,1,0,46
Madison,5/30/20,0,0,0,0,0,0,0,0,0,22,0,463,0,3,0,0,0,19,0,485,0,0,0,0,0,0,0,9,1,0,25
Marion,5/30/20,0,0,0,0,0,0,0,0,0,1,0,296,0,1,0,0,0,0,0,297,0,0,0,0,0,0,0,0,0,0,15
Miller,5/30/20,0,0,0,0,0,0,0,0,0,43,0,691,0,41,0,1,0,1,0,734,0,0,0,0,0,0,0,1,0,0,11
MissingCountyInfo,5/30/20,0,0,0,0,0,0,0,0,0,196,0,29458,0,121,0,0,0,75,0,29654,0,0,0,0,0,0,0,3,2,0,-106
Mississippi,5/30/20,0,0,0,0,0,0,0,0,0,75,0,1459,0,61,0,2,0,12,0,1534,0,0,0,0,0,0,0,2,0,0,71
Monroe,5/30/20,0,0,0,0,0,0,0,0,0,5,0,158,0,5,0,0,0,0,0,163,0,0,0,0,0,0,0,0,0,0,2
Montgomery,5/30/20,0,0,0,0,0,0,0,0,0,2,0,147,0,1,0,0,0,1,0,149,0,0,0,0,0,0,0,0,0,0,1
Nevada,5/30/20,0,0,0,0,0,0,0,0,0,5,0,140,0,4,0,0,0,1,0,145,0,0,0,0,0,0,0,0,0,0,4
Newton,5/30/20,0,0,0,0,0,0,0,0,0,3,0,154,0,3,0,0,0,0,0,157,0,0,0,0,0,0,0,0,0,0,3
Ouachita,5/30/20,0,0,0,0,0,0,0,0,0,10,0,810,0,10,0,0,0,0,0,820,0,0,0,0,0,0,0,0,0,0,22
Perry,5/30/20,0,0,0,0,0,0,0,0,0,14,0,284,0,14,0,0,0,0,0,298,0,0,0,0,0,0,0,0,0,0,6
Phillips,5/30/20,0,0,0,0,0,0,0,0,0,20,0,545,0,8,0,1,0,11,0,565,0,0,0,0,0,0,0,1,0,0,51
Pike,5/30/20,0,0,0,0,0,0,0,0,0,5,0,594,0,4,0,0,0,1,0,599,0,0,0,0,0,0,0,0,0,0,15
Poinsett,5/30/20,0,0,0,0,0,0,0,0,0,33,0,542,0,26,0,2,0,5,0,575,0,0,0,0,0,0,0,2,0,0,45
Polk,5/30/20,0,0,0,0,0,0,0,0,0,17,0,459,0,9,0,0,0,8,0,476,0,0,0,0,0,0,0,0,0,0,17
Pope,5/30/20,0,0,0,0,0,0,0,0,0,142,0,2471,0,84,0,1,0,57,0,2613,0,0,0,0,0,0,0,6,6,0,74
Prairie,5/30/20,0,0,0,0,0,0,0,0,0,2,0,107,0,2,0,0,0,0,0,109,0,0,0,0,0,0,0,0,0,0,3
Pulaski,5/30/20,0,0,0,0,0,0,0,0,0,876,0,13020,0,673,0,34,0,169,0,13896,0,0,0,0,0,0,0,30,14,0,521
Randolph,5/30/20,0,0,0,0,0,0,0,0,0,26,0,1022,0,21,0,0,0,5,0,1048,0,0,0,0,0,0,0,0,0,0,56
Saline,5/30/20,0,0,0,0,0,0,0,0,0,112,0,3420,0,84,0,1,0,27,0,3532,0,0,0,0,0,0,0,2,1,0,101
Scott,5/30/20,0,0,0,0,0,0,0,0,0,1,0,28,0,1,0,0,0,0,0,29,0,0,0,0,0,0,0,0,0,0,2
Searcy,5/30/20,0,0,0,0,0,0,0,0,0,7,0,446,0,6,0,0,0,1,0,453,0,0,0,0,0,0,0,0,0,0,30
Sebastian,5/30/20,0,0,0,0,0,0,0,0,0,38,0,1267,0,17,0,0,0,21,0,1305,0,0,0,0,0,0,0,9,0,0,69
Sevier,5/30/20,0,0,0,0,0,0,0,0,0,170,0,800,0,70,0,2,0,98,0,970,0,0,0,0,0,0,0,8,24,0,165
Sharp,5/30/20,0,0,0,0,0,0,0,0,0,46,0,396,0,34,0,2,0,10,0,442,0,0,0,0,0,0,0,0,1,0,28
St.Francis,5/30/20,0,0,0,0,0,0,0,0,0,672,0,2735,0,588,0,1,0,83,0,3407,0,0,0,0,0,0,0,8,96,0,51
Stone,5/30/20,0,0,0,0,0,0,0,0,0,9,0,326,0,8,0,0,0,1,0,335,0,0,0,0,0,0,0,1,0,0,15
Union,5/30/20,0,0,0,0,0,0,0,0,0,171,0,947,0,110,0,8,0,53,0,1118,0,0,0,0,0,0,0,5,3,0,35
VanBuren,5/30/20,0,0,0,0,0,0,0,0,0,28,0,534,0,26,0,2,0,0,0,562,0,0,0,0,0,0,0,0,0,0,12
Washington,5/30/20,0,0,0,0,0,0,0,0,0,452,0,4777,0,167,0,7,0,278,0,5229,0,0,0,0,0,0,0,42,13,0,166
White,5/30/20,0,0,0,0,0,0,0,0,0,44,0,1768,0,37,0,1,0,6,0,1812,0,0,0,0,0,0,0,1,0,0,55
Woodruff,5/30/20,0,0,0,0,0,0,0,0,0,1,0,131,0,1,0,0,0,0,0,132,0,0,0,0,0,0,0,-1,0,0,12
Yell,5/30/20,0,0,0,0,0,0,0,0,0,137,0,388,0,61,0,1,0,75,0,525,0,0,0,0,0,0,0,9,9,0,25
Arkansas_all_counties,5/29/20,0,0,0,0,0,0,0,0,2990671,6777,0,116113,0,4946,0,132,0,1699,0,122890,0,0,0,0,0,0,0,239,363,7,3122
Arkansas_county,5/29/20,0,0,0,0,0,0,0,0,0,4,0,305,0,2,0,0,0,2,0,309,0,0,0,0,0,0,0,1,0,0,14
Ashley,5/29/20,0,0,0,0,0,0,0,0,0,19,0,609,0,19,0,0,0,0,0,628,0,0,0,0,0,0,0,0,0,0,14
Baxter,5/29/20,0,0,0,0,0,0,0,0,0,9,0,601,0,6,0,0,0,3,0,610,0,0,0,0,0,0,0,0,0,0,24
Benton,5/29/20,0,0,0,0,0,0,0,0,0,468,0,10149,0,179,0,1,0,288,0,10617,0,0,0,0,0,0,0,40,14,1,211
Boone,5/29/20,0,0,0,0,0,0,0,0,0,6,0,733,0,4,0,0,0,2,0,739,0,0,0,0,0,0,0,0,0,0,23
Bradley,5/29/20,0,0,0,0,0,0,0,0,0,18,0,402,0,13,0,1,0,4,0,420,0,0,0,0,0,0,0,0,1,0,1
Calhoun,5/29/20,0,0,0,0,0,0,0,0,0,0,0,67,0,0,0,0,0,0,0,67,0,0,0,0,0,0,0,0,0,0,1
Carroll,5/29/20,0,0,0,0,0,0,0,0,0,24,0,817,0,6,0,1,0,17,0,841,0,0,0,0,0,0,0,0,1,1,3
Chicot,5/29/20,0,0,0,0,0,0,0,0,0,15,0,214,0,12,0,0,0,3,0,229,0,0,0,0,0,0,0,0,3,0,2
Clark,5/29/20,0,0,0,0,0,0,0,0,0,39,0,730,0,35,0,0,0,4,0,769,0,0,0,0,0,0,0,1,1,0,-2
Clay,5/29/20,0,0,0,0,0,0,0,0,0,4,0,525,0,4,0,0,0,0,0,529,0,0,0,0,0,0,0,0,0,0,13
Cleburne,5/29/20,0,0,0,0,0,0,0,0,0,73,0,686,0,68,0,4,0,1,0,759,0,0,0,0,0,0,0,0,0,0,10
Cleveland,5/29/20,0,0,0,0,0,0,0,0,0,19,0,305,0,18,0,0,0,1,0,324,0,0,0,0,0,0,0,1,1,0,5
Columbia,5/29/20,0,0,0,0,0,0,0,0,0,21,0,393,0,14,0,2,0,5,0,414,0,0,0,0,0,0,0,1,1,0,63
Conway,5/29/20,0,0,0,0,0,0,0,0,0,14,0,554,0,13,0,1,0,0,0,568,0,0,0,0,0,0,0,0,0,0,-8
Craighead,5/29/20,0,0,0,0,0,0,0,0,0,206,0,4439,0,154,0,0,0,52,0,4645,0,0,0,0,0,0,0,3,4,0,140
Crawford,5/29/20,0,0,0,0,0,0,0,0,0,18,0,716,0,12,0,0,0,6,0,734,0,0,0,0,0,0,0,1,0,0,23
Crittenden,5/29/20,0,0,0,0,0,0,0,0,0,341,0,2886,0,230,0,9,0,102,0,3227,0,0,0,0,0,0,0,23,5,0,104
Cross,5/29/20,0,0,0,0,0,0,0,0,0,50,0,628,0,38,0,0,0,12,0,678,0,0,0,0,0,0,0,2,4,0,16
Dallas,5/29/20,0,0,0,0,0,0,0,0,0,1,0,155,0,1,0,0,0,0,0,156,0,0,0,0,0,0,0,0,0,0,6
Desha,5/29/20,0,0,0,0,0,0,0,0,0,19,0,435,0,18,0,0,0,1,0,454,0,0,0,0,0,0,0,0,0,0,3
Drew,5/29/20,0,0,0,0,0,0,0,0,0,19,0,586,0,16,0,1,0,2,0,605,0,0,0,0,0,0,0,0,0,0,4
Faulkner,5/29/20,0,0,0,0,0,0,0,0,0,102,0,2953,0,91,0,3,0,8,0,3055,0,0,0,0,0,0,0,1,2,0,50
Franklin,5/29/20,0,0,0,0,0,0,0,0,0,4,0,298,0,2,0,0,0,2,0,302,0,0,0,0,0,0,0,0,0,0,25
Fulton,5/29/20,0,0,0,0,0,0,0,0,0,7,0,314,0,4,0,0,0,3,0,321,0,0,0,0,0,0,0,0,0,0,17
Garland,5/29/20,0,0,0,0,0,0,0,0,0,136,0,3869,0,131,0,1,0,4,0,4005,0,0,0,0,0,0,0,0,1,0,-11
Grant,5/29/20,0,0,0,0,0,0,0,0,0,18,0,474,0,17,0,0,0,1,0,492,0,0,0,0,0,0,0,0,1,0,8
Greene,5/29/20,0,0,0,0,0,0,0,0,0,63,0,1832,0,34,0,0,0,29,0,1895,0,0,0,0,0,0,0,3,6,0,74
Hempstead,5/29/20,0,0,0,0,0,0,0,0,0,15,0,328,0,8,0,1,0,6,0,343,0,0,0,0,0,0,0,1,0,0,41
HotSpring,5/29/20,0,0,0,0,0,0,0,0,0,32,0,824,0,30,0,0,0,2,0,856,0,0,0,0,0,0,0,1,0,0,10
Howard,5/29/20,0,0,0,0,0,0,0,0,0,19,0,270,0,15,0,0,0,4,0,289,0,0,0,0,0,0,0,1,1,0,3
Independence,5/29/20,0,0,0,0,0,0,0,0,0,30,0,832,0,27,0,0,0,3,0,862,0,0,0,0,0,0,0,1,0,0,31
Izard,5/29/20,0,0,0,0,0,0,0,0,0,16,0,211,0,14,0,0,0,2,0,227,0,0,0,0,0,0,0,0,1,0,8
Jackson,5/29/20,0,0,0,0,0,0,0,0,0,1,0,250,0,1,0,0,0,0,0,251,0,0,0,0,0,0,0,0,0,0,4
Jefferson,5/29/20,0,0,0,0,0,0,0,0,0,516,0,2488,0,454,0,25,0,37,0,3004,0,0,0,0,0,0,0,1,170,1,69
Johnson,5/29/20,0,0,0,0,0,0,0,0,0,42,0,458,0,35,0,0,0,7,0,500,0,0,0,0,0,0,0,2,0,0,127
Lafayette,5/29/20,0,0,0,0,0,0,0,0,0,9,0,59,0,8,0,1,0,0,0,68,0,0,0,0,0,0,0,0,0,0,7
Lawrence,5/29/20,0,0,0,0,0,0,0,0,0,82,0,702,0,65,0,5,0,12,0,784,0,0,0,0,0,0,0,0,0,0,20
Lee,5/29/20,0,0,0,0,0,0,0,0,0,18,0,368,0,11,0,1,0,6,0,386,0,0,0,0,0,0,0,0,0,0,30
Lincoln,5/29/20,0,0,0,0,0,0,0,0,0,975,0,968,0,945,0,9,0,21,0,1943,0,0,0,0,0,0,0,0,0,0,1
LittleRiver,5/29/20,0,0,0,0,0,0,0,0,0,6,0,189,0,2,0,0,0,4,0,195,0,0,0,0,0,0,0,0,0,0,9
Logan,5/29/20,0,0,0,0,0,0,0,0,0,5,0,286,0,4,0,0,0,1,0,291,0,0,0,0,0,0,0,1,0,0,7
Lonoke,5/29/20,0,0,0,0,0,0,0,0,0,47,0,1757,0,45,0,0,0,2,0,1804,0,0,0,0,0,0,0,1,0,0,31
Madison,5/29/20,0,0,0,0,0,0,0,0,0,13,0,447,0,2,0,0,0,11,0,460,0,0,0,0,0,0,0,7,1,0,78
Marion,5/29/20,0,0,0,0,0,0,0,0,0,1,0,281,0,1,0,0,0,0,0,282,0,0,0,0,0,0,0,0,0,0,48
Miller,5/29/20,0,0,0,0,0,0,0,0,0,42,0,681,0,41,0,1,0,0,0,723,0,0,0,0,0,0,0,0,0,0,16
MissingCountyInfo,5/29/20,0,0,0,0,0,0,0,0,0,193,0,29567,0,119,0,0,0,74,0,29760,0,0,0,0,0,0,0,-6,0,0,643
Mississippi,5/29/20,0,0,0,0,0,0,0,0,0,73,0,1390,0,61,0,2,0,10,0,1463,0,0,0,0,0,0,0,0,4,0,62
Monroe,5/29/20,0,0,0,0,0,0,0,0,0,5,0,156,0,5,0,0,0,0,0,161,0,0,0,0,0,0,0,0,0,0,3
Montgomery,5/29/20,0,0,0,0,0,0,0,0,0,2,0,146,0,1,0,0,0,1,0,148,0,0,0,0,0,0,0,0,0,0,0
Nevada,5/29/20,0,0,0,0,0,0,0,0,0,5,0,136,0,4,0,0,0,1,0,141,0,0,0,0,0,0,0,0,0,0,2
Newton,5/29/20,0,0,0,0,0,0,0,0,0,3,0,151,0,3,0,0,0,0,0,154,0,0,0,0,0,0,0,0,0,0,2
Ouachita,5/29/20,0,0,0,0,0,0,0,0,0,10,0,788,0,10,0,0,0,0,0,798,0,0,0,0,0,0,0,0,0,0,2
Perry,5/29/20,0,0,0,0,0,0,0,0,0,14,0,278,0,14,0,0,0,0,0,292,0,0,0,0,0,0,0,0,0,0,8
Phillips,5/29/20,0,0,0,0,0,0,0,0,0,19,0,495,0,8,0,1,0,10,0,514,0,0,0,0,0,0,0,7,2,0,41
Pike,5/29/20,0,0,0,0,0,0,0,0,0,5,0,579,0,4,0,0,0,1,0,584,0,0,0,0,0,0,0,0,0,0,17
Poinsett,5/29/20,0,0,0,0,0,0,0,0,0,31,0,499,0,26,0,2,0,3,0,530,0,0,0,0,0,0,0,0,1,0,11
Polk,5/29/20,0,0,0,0,0,0,0,0,0,17,0,442,0,9,0,0,0,8,0,459,0,0,0,0,0,0,0,5,0,0,14
Pope,5/29/20,0,0,0,0,0,0,0,0,0,136,0,2403,0,78,0,1,0,57,0,2539,0,0,0,0,0,0,0,7,5,0,78
Prairie,5/29/20,0,0,0,0,0,0,0,0,0,2,0,104,0,2,0,0,0,0,0,106,0,0,0,0,0,0,0,0,0,0,1
Pulaski,5/29/20,0,0,0,0,0,0,0,0,0,846,0,12529,0,659,0,34,0,153,0,13375,0,0,0,0,0,0,0,16,8,3,241
Randolph,5/29/20,0,0,0,0,0,0,0,0,0,26,0,966,0,21,0,0,0,5,0,992,0,0,0,0,0,0,0,0,0,0,16
Saline,5/29/20,0,0,0,0,0,0,0,0,0,110,0,3321,0,83,0,1,0,26,0,3431,0,0,0,0,0,0,0,2,3,0,45
Scott,5/29/20,0,0,0,0,0,0,0,0,0,1,0,26,0,1,0,0,0,0,0,27,0,0,0,0,0,0,0,0,0,0,0
Searcy,5/29/20,0,0,0,0,0,0,0,0,0,7,0,416,0,6,0,0,0,1,0,423,0,0,0,0,0,0,0,0,0,0,9
Sebastian,5/29/20,0,0,0,0,0,0,0,0,0,29,0,1207,0,17,0,0,0,12,0,1236,0,0,0,0,0,0,0,5,0,0,35
Sevier,5/29/20,0,0,0,0,0,0,0,0,0,162,0,643,0,46,0,2,0,114,0,805,0,0,0,0,0,0,0,31,0,0,31
Sharp,5/29/20,0,0,0,0,0,0,0,0,0,46,0,368,0,33,0,2,0,11,0,414,0,0,0,0,0,0,0,1,0,0,18
St.Francis,5/29/20,0,0,0,0,0,0,0,0,0,664,0,2692,0,492,0,1,0,171,0,3356,0,0,0,0,0,0,0,4,77,0,35
Stone,5/29/20,0,0,0,0,0,0,0,0,0,8,0,312,0,8,0,0,0,0,0,320,0,0,0,0,0,0,0,0,0,0,5
Union,5/29/20,0,0,0,0,0,0,0,0,0,166,0,917,0,107,0,8,0,51,0,1083,0,0,0,0,0,0,0,2,2,0,9
VanBuren,5/29/20,0,0,0,0,0,0,0,0,0,28,0,522,0,26,0,2,0,0,0,550,0,0,0,0,0,0,0,0,0,0,3
Washington,5/29/20,0,0,0,0,0,0,0,0,0,410,0,4653,0,154,0,7,0,249,0,5063,0,0,0,0,0,0,0,58,21,1,240
White,5/29/20,0,0,0,0,0,0,0,0,0,43,0,1714,0,37,0,1,0,5,0,1757,0,0,0,0,0,0,0,0,0,0,24
Woodruff,5/29/20,0,0,0,0,0,0,0,0,0,2,0,118,0,1,0,0,0,1,0,120,0,0,0,0,0,0,0,0,0,0,4
Yell,5/29/20,0,0,0,0,0,0,0,0,0,128,0,372,0,52,0,1,0,75,0,500,0,0,0,0,0,0,0,14,12,0,21
Arkansas_all_counties,5/28/20,0,0,0,0,0,0,0,0,2990671,6538,0,113230,0,4583,0,125,0,1830,0,119768,0,0,0,0,0,0,0,261,159,5,1127
Arkansas_county,5/28/20,0,0,0,0,0,0,0,0,0,3,0,292,0,2,0,0,0,1,0,295,0,0,0,0,0,0,0,0,0,0,11
Ashley,5/28/20,0,0,0,0,0,0,0,0,0,19,0,595,0,19,0,0,0,0,0,614,0,0,0,0,0,0,0,0,1,0,13
Baxter,5/28/20,0,0,0,0,0,0,0,0,0,9,0,577,0,6,0,0,0,3,0,586,0,0,0,0,0,0,0,1,0,0,-5
Benton,5/28/20,0,0,0,0,0,0,0,0,0,428,0,9978,0,165,0,0,0,263,0,10406,0,0,0,0,0,0,0,89,6,0,532
Boone,5/28/20,0,0,0,0,0,0,0,0,0,6,0,710,0,4,0,0,0,2,0,716,0,0,0,0,0,0,0,0,0,0,15
Bradley,5/28/20,0,0,0,0,0,0,0,0,0,18,0,401,0,12,0,1,0,5,0,419,0,0,0,0,0,0,0,0,0,0,-4
Calhoun,5/28/20,0,0,0,0,0,0,0,0,0,0,0,66,0,0,0,0,0,0,0,66,0,0,0,0,0,0,0,0,0,0,1
Carroll,5/28/20,0,0,0,0,0,0,0,0,0,24,0,814,0,5,0,0,0,19,0,838,0,0,0,0,0,0,0,3,0,0,49
Chicot,5/28/20,0,0,0,0,0,0,0,0,0,15,0,212,0,9,0,0,0,6,0,227,0,0,0,0,0,0,0,1,0,0,4
Clark,5/28/20,0,0,0,0,0,0,0,0,0,38,0,733,0,34,0,0,0,4,0,771,0,0,0,0,0,0,0,1,0,0,12
Clay,5/28/20,0,0,0,0,0,0,0,0,0,4,0,512,0,4,0,0,0,0,0,516,0,0,0,0,0,0,0,0,0,0,-12
Cleburne,5/28/20,0,0,0,0,0,0,0,0,0,73,0,676,0,68,0,4,0,1,0,749,0,0,0,0,0,0,0,0,0,0,30
Cleveland,5/28/20,0,0,0,0,0,0,0,0,0,18,0,301,0,17,0,0,0,1,0,319,0,0,0,0,0,0,0,0,0,0,3
Columbia,5/28/20,0,0,0,0,0,0,0,0,0,20,0,331,0,13,0,2,0,5,0,351,0,0,0,0,0,0,0,0,1,0,5
Conway,5/28/20,0,0,0,0,0,0,0,0,0,14,0,562,0,13,0,1,0,0,0,576,0,0,0,0,0,0,0,0,0,0,17
Craighead,5/28/20,0,0,0,0,0,0,0,0,0,203,0,4302,0,150,0,0,0,53,0,4505,0,0,0,0,0,0,0,12,6,0,17
Crawford,5/28/20,0,0,0,0,0,0,0,0,0,17,0,694,0,12,0,0,0,5,0,711,0,0,0,0,0,0,0,0,0,0,19
Crittenden,5/28/20,0,0,0,0,0,0,0,0,0,318,0,2805,0,225,0,9,0,84,0,3123,0,0,0,0,0,0,0,17,3,0,49
Cross,5/28/20,0,0,0,0,0,0,0,0,0,48,0,614,0,34,0,0,0,14,0,662,0,0,0,0,0,0,0,2,0,0,0
Dallas,5/28/20,0,0,0,0,0,0,0,0,0,1,0,149,0,1,0,0,0,0,0,150,0,0,0,0,0,0,0,0,0,0,0
Desha,5/28/20,0,0,0,0,0,0,0,0,0,19,0,432,0,18,0,0,0,1,0,451,0,0,0,0,0,0,0,0,0,0,10
Drew,5/28/20,0,0,0,0,0,0,0,0,0,19,0,582,0,16,0,1,0,2,0,601,0,0,0,0,0,0,0,0,0,0,14
Faulkner,5/28/20,0,0,0,0,0,0,0,0,0,101,0,2904,0,89,0,3,0,9,0,3005,0,0,0,0,0,0,0,1,1,0,23
Franklin,5/28/20,0,0,0,0,0,0,0,0,0,4,0,273,0,2,0,0,0,2,0,277,0,0,0,0,0,0,0,0,0,0,9
Fulton,5/28/20,0,0,0,0,0,0,0,0,0,7,0,297,0,4,0,0,0,3,0,304,0,0,0,0,0,0,0,1,0,0,26
Garland,5/28/20,0,0,0,0,0,0,0,0,0,136,0,3880,0,130,0,1,0,5,0,4016,0,0,0,0,0,0,0,1,2,0,73
Grant,5/28/20,0,0,0,0,0,0,0,0,0,18,0,466,0,16,0,0,0,2,0,484,0,0,0,0,0,0,0,1,0,0,5
Greene,5/28/20,0,0,0,0,0,0,0,0,0,60,0,1761,0,28,0,0,0,32,0,1821,0,0,0,0,0,0,0,6,0,0,12
Hempstead,5/28/20,0,0,0,0,0,0,0,0,0,14,0,288,0,8,0,1,0,5,0,302,0,0,0,0,0,0,0,0,1,0,-1
HotSpring,5/28/20,0,0,0,0,0,0,0,0,0,31,0,815,0,30,0,0,0,1,0,846,0,0,0,0,0,0,0,1,0,0,24
Howard,5/28/20,0,0,0,0,0,0,0,0,0,18,0,268,0,14,0,0,0,4,0,286,0,0,0,0,0,0,0,1,0,0,5
Independence,5/28/20,0,0,0,0,0,0,0,0,0,29,0,802,0,27,0,0,0,2,0,831,0,0,0,0,0,0,0,0,2,0,19
Izard,5/28/20,0,0,0,0,0,0,0,0,0,16,0,203,0,13,0,0,0,3,0,219,0,0,0,0,0,0,0,1,0,0,8
Jackson,5/28/20,0,0,0,0,0,0,0,0,0,1,0,246,0,1,0,0,0,0,0,247,0,0,0,0,0,0,0,0,0,0,6
Jefferson,5/28/20,0,0,0,0,0,0,0,0,0,515,0,2420,0,284,0,24,0,207,0,2935,0,0,0,0,0,0,0,5,10,1,-5
Johnson,5/28/20,0,0,0,0,0,0,0,0,0,40,0,333,0,35,0,0,0,5,0,373,0,0,0,0,0,0,0,2,0,0,10
Lafayette,5/28/20,0,0,0,0,0,0,0,0,0,9,0,52,0,8,0,1,0,0,0,61,0,0,0,0,0,0,0,0,0,0,0
Lawrence,5/28/20,0,0,0,0,0,0,0,0,0,82,0,682,0,65,0,5,0,12,0,764,0,0,0,0,0,0,0,0,0,0,28
Lee,5/28/20,0,0,0,0,0,0,0,0,0,18,0,338,0,11,0,1,0,6,0,356,0,0,0,0,0,0,0,1,0,0,1
Lincoln,5/28/20,0,0,0,0,0,0,0,0,0,975,0,967,0,945,0,9,0,21,0,1942,0,0,0,0,0,0,0,0,2,1,-2
LittleRiver,5/28/20,0,0,0,0,0,0,0,0,0,6,0,180,0,2,0,0,0,4,0,186,0,0,0,0,0,0,0,1,1,0,1
Logan,5/28/20,0,0,0,0,0,0,0,0,0,4,0,280,0,4,0,0,0,0,0,284,0,0,0,0,0,0,0,0,0,0,6
Lonoke,5/28/20,0,0,0,0,0,0,0,0,0,46,0,1727,0,45,0,0,0,1,0,1773,0,0,0,0,0,0,0,1,0,0,26
Madison,5/28/20,0,0,0,0,0,0,0,0,0,6,0,376,0,1,0,0,0,5,0,382,0,0,0,0,0,0,0,0,0,0,12
Marion,5/28/20,0,0,0,0,0,0,0,0,0,1,0,233,0,1,0,0,0,0,0,234,0,0,0,0,0,0,0,0,0,0,0
Miller,5/28/20,0,0,0,0,0,0,0,0,0,42,0,665,0,41,0,1,0,0,0,707,0,0,0,0,0,0,0,0,0,0,4
MissingCountyInfo,5/28/20,0,0,0,0,0,0,0,0,0,199,0,28918,0,119,0,0,0,80,0,29117,0,0,0,0,0,0,0,18,0,0,-787
Mississippi,5/28/20,0,0,0,0,0,0,0,0,0,73,0,1328,0,57,0,2,0,14,0,1401,0,0,0,0,0,0,0,1,3,0,1
Monroe,5/28/20,0,0,0,0,0,0,0,0,0,5,0,153,0,5,0,0,0,0,0,158,0,0,0,0,0,0,0,0,0,0,2
Montgomery,5/28/20,0,0,0,0,0,0,0,0,0,2,0,146,0,1,0,0,0,1,0,148,0,0,0,0,0,0,0,1,0,0,3
Nevada,5/28/20,0,0,0,0,0,0,0,0,0,5,0,134,0,4,0,0,0,1,0,139,0,0,0,0,0,0,0,0,0,0,2
Newton,5/28/20,0,0,0,0,0,0,0,0,0,3,0,149,0,3,0,0,0,0,0,152,0,0,0,0,0,0,0,0,0,0,1
Ouachita,5/28/20,0,0,0,0,0,0,0,0,0,10,0,786,0,10,0,0,0,0,0,796,0,0,0,0,0,0,0,0,0,0,14
Perry,5/28/20,0,0,0,0,0,0,0,0,0,14,0,270,0,14,0,0,0,0,0,284,0,0,0,0,0,0,0,0,1,0,1
Phillips,5/28/20,0,0,0,0,0,0,0,0,0,12,0,461,0,6,0,1,0,5,0,473,0,0,0,0,0,0,0,0,0,0,-7
Pike,5/28/20,0,0,0,0,0,0,0,0,0,5,0,562,0,4,0,0,0,1,0,567,0,0,0,0,0,0,0,0,0,0,10
Poinsett,5/28/20,0,0,0,0,0,0,0,0,0,31,0,488,0,25,0,2,0,4,0,519,0,0,0,0,0,0,0,0,1,0,-17
Polk,5/28/20,0,0,0,0,0,0,0,0,0,12,0,433,0,9,0,0,0,3,0,445,0,0,0,0,0,0,0,1,0,0,17
Pope,5/28/20,0,0,0,0,0,0,0,0,0,129,0,2332,0,73,0,1,0,55,0,2461,0,0,0,0,0,0,0,4,10,0,20
Prairie,5/28/20,0,0,0,0,0,0,0,0,0,2,0,103,0,2,0,0,0,0,0,105,0,0,0,0,0,0,0,0,0,0,1
Pulaski,5/28/20,0,0,0,0,0,0,0,0,0,830,0,12304,0,651,0,31,0,148,0,13134,0,0,0,0,0,0,0,22,9,1,374
Randolph,5/28/20,0,0,0,0,0,0,0,0,0,26,0,950,0,21,0,0,0,5,0,976,0,0,0,0,0,0,0,0,0,0,1
Saline,5/28/20,0,0,0,0,0,0,0,0,0,108,0,3278,0,80,0,1,0,27,0,3386,0,0,0,0,0,0,0,9,0,0,64
Scott,5/28/20,0,0,0,0,0,0,0,0,0,1,0,26,0,1,0,0,0,0,0,27,0,0,0,0,0,0,0,0,0,0,0
Searcy,5/28/20,0,0,0,0,0,0,0,0,0,7,0,407,0,6,0,0,0,1,0,414,0,0,0,0,0,0,0,0,0,0,2
Sebastian,5/28/20,0,0,0,0,0,0,0,0,0,24,0,1177,0,17,0,0,0,7,0,1201,0,0,0,0,0,0,0,1,1,0,47
Sevier,5/28/20,0,0,0,0,0,0,0,0,0,131,0,643,0,46,0,2,0,83,0,774,0,0,0,0,0,0,0,11,2,0,18
Sharp,5/28/20,0,0,0,0,0,0,0,0,0,45,0,351,0,33,0,2,0,10,0,396,0,0,0,0,0,0,0,3,1,0,21
St.Francis,5/28/20,0,0,0,0,0,0,0,0,0,660,0,2661,0,415,0,1,0,244,0,3321,0,0,0,0,0,0,0,5,87,0,16
Stone,5/28/20,0,0,0,0,0,0,0,0,0,8,0,307,0,8,0,0,0,0,0,315,0,0,0,0,0,0,0,0,0,0,1
Union,5/28/20,0,0,0,0,0,0,0,0,0,164,0,910,0,105,0,8,0,51,0,1074,0,0,0,0,0,0,0,2,2,2,12
VanBuren,5/28/20,0,0,0,0,0,0,0,0,0,28,0,519,0,26,0,2,0,0,0,547,0,0,0,0,0,0,0,0,0,0,0
Washington,5/28/20,0,0,0,0,0,0,0,0,0,352,0,4471,0,133,0,6,0,213,0,4823,0,0,0,0,0,0,0,26,3,0,218
White,5/28/20,0,0,0,0,0,0,0,0,0,43,0,1690,0,37,0,1,0,5,0,1733,0,0,0,0,0,0,0,1,0,0,2
Woodruff,5/28/20,0,0,0,0,0,0,0,0,0,2,0,114,0,1,0,0,0,1,0,116,0,0,0,0,0,0,0,1,0,0,15
Yell,5/28/20,0,0,0,0,0,0,0,0,0,114,0,365,0,40,0,1,0,73,0,479,0,0,0,0,0,0,0,6,3,0,5
Arkansas_all_counties,5/27/20,0,0,0,0,0,0,0,0,2990671,6277,0,112364,0,4424,0,120,0,1733,0,118641,0,0,0,0,0,0,0,97,92,1,3142
Arkansas_county,5/27/20,0,0,0,0,0,0,0,0,0,3,0,281,0,2,0,0,0,1,0,284,0,0,0,0,0,0,0,0,0,0,9
Ashley,5/27/20,0,0,0,0,0,0,0,0,0,19,0,582,0,18,0,0,0,1,0,601,0,0,0,0,0,0,0,0,0,0,13
Baxter,5/27/20,0,0,0,0,0,0,0,0,0,8,0,583,0,6,0,0,0,2,0,591,0,0,0,0,0,0,0,0,1,0,5
Benton,5/27/20,0,0,0,0,0,0,0,0,0,339,0,9535,0,159,0,0,0,180,0,9874,0,0,0,0,0,0,0,24,6,0,354
Boone,5/27/20,0,0,0,0,0,0,0,0,0,6,0,695,0,4,0,0,0,2,0,701,0,0,0,0,0,0,0,0,0,0,11
Bradley,5/27/20,0,0,0,0,0,0,0,0,0,18,0,405,0,12,0,1,0,5,0,423,0,0,0,0,0,0,0,0,0,0,9
Calhoun,5/27/20,0,0,0,0,0,0,0,0,0,0,0,65,0,0,0,0,0,0,0,65,0,0,0,0,0,0,0,0,0,0,2
Carroll,5/27/20,0,0,0,0,0,0,0,0,0,21,0,768,0,5,0,0,0,16,0,789,0,0,0,0,0,0,0,4,0,0,23
Chicot,5/27/20,0,0,0,0,0,0,0,0,0,14,0,209,0,9,0,0,0,5,0,223,0,0,0,0,0,0,0,0,0,0,2
Clark,5/27/20,0,0,0,0,0,0,0,0,0,37,0,722,0,34,0,0,0,3,0,759,0,0,0,0,0,0,0,0,0,0,16
Clay,5/27/20,0,0,0,0,0,0,0,0,0,4,0,524,0,4,0,0,0,0,0,528,0,0,0,0,0,0,0,0,0,0,16
Cleburne,5/27/20,0,0,0,0,0,0,0,0,0,73,0,646,0,68,0,4,0,1,0,719,0,0,0,0,0,0,0,0,0,0,21
Cleveland,5/27/20,0,0,0,0,0,0,0,0,0,18,0,298,0,17,0,0,0,1,0,316,0,0,0,0,0,0,0,0,1,0,7
Columbia,5/27/20,0,0,0,0,0,0,0,0,0,20,0,326,0,12,0,2,0,6,0,346,0,0,0,0,0,0,0,0,0,0,3
Conway,5/27/20,0,0,0,0,0,0,0,0,0,14,0,545,0,13,0,1,0,0,0,559,0,0,0,0,0,0,0,0,0,0,9
Craighead,5/27/20,0,0,0,0,0,0,0,0,0,191,0,4297,0,144,0,0,0,47,0,4488,0,0,0,0,0,0,0,1,4,0,140
Crawford,5/27/20,0,0,0,0,0,0,0,0,0,17,0,675,0,12,0,0,0,5,0,692,0,0,0,0,0,0,0,0,0,0,39
Crittenden,5/27/20,0,0,0,0,0,0,0,0,0,301,0,2773,0,222,0,9,0,70,0,3074,0,0,0,0,0,0,0,4,6,0,63
Cross,5/27/20,0,0,0,0,0,0,0,0,0,46,0,616,0,34,0,0,0,12,0,662,0,0,0,0,0,0,0,0,2,0,12
Dallas,5/27/20,0,0,0,0,0,0,0,0,0,1,0,149,0,1,0,0,0,0,0,150,0,0,0,0,0,0,0,0,0,0,3
Desha,5/27/20,0,0,0,0,0,0,0,0,0,19,0,422,0,18,0,0,0,1,0,441,0,0,0,0,0,0,0,0,0,0,2
Drew,5/27/20,0,0,0,0,0,0,0,0,0,19,0,568,0,16,0,1,0,2,0,587,0,0,0,0,0,0,0,0,0,0,9
Faulkner,5/27/20,0,0,0,0,0,0,0,0,0,100,0,2882,0,88,0,3,0,9,0,2982,0,0,0,0,0,0,0,0,1,0,62
Franklin,5/27/20,0,0,0,0,0,0,0,0,0,4,0,264,0,2,0,0,0,2,0,268,0,0,0,0,0,0,0,0,0,0,11
Fulton,5/27/20,0,0,0,0,0,0,0,0,0,6,0,272,0,4,0,0,0,2,0,278,0,0,0,0,0,0,0,0,0,0,1
Garland,5/27/20,0,0,0,0,0,0,0,0,0,135,0,3808,0,128,0,1,0,6,0,3943,0,0,0,0,0,0,0,1,0,0,38
Grant,5/27/20,0,0,0,0,0,0,0,0,0,17,0,462,0,16,0,0,0,1,0,479,0,0,0,0,0,0,0,1,0,0,9
Greene,5/27/20,0,0,0,0,0,0,0,0,0,54,0,1755,0,28,0,0,0,26,0,1809,0,0,0,0,0,0,0,0,2,0,56
Hempstead,5/27/20,0,0,0,0,0,0,0,0,0,14,0,289,0,7,0,1,0,6,0,303,0,0,0,0,0,0,0,0,0,0,7
HotSpring,5/27/20,0,0,0,0,0,0,0,0,0,30,0,792,0,30,0,0,0,0,0,822,0,0,0,0,0,0,0,0,1,0,12
Howard,5/27/20,0,0,0,0,0,0,0,0,0,17,0,264,0,14,0,0,0,3,0,281,0,0,0,0,0,0,0,0,0,0,3
Independence,5/27/20,0,0,0,0,0,0,0,0,0,29,0,783,0,25,0,0,0,4,0,812,0,0,0,0,0,0,0,0,0,0,26
Izard,5/27/20,0,0,0,0,0,0,0,0,0,15,0,196,0,13,0,0,0,2,0,211,0,0,0,0,0,0,0,0,0,0,2
Jackson,5/27/20,0,0,0,0,0,0,0,0,0,1,0,240,0,1,0,0,0,0,0,241,0,0,0,0,0,0,0,0,0,0,1
Jefferson,5/27/20,0,0,0,0,0,0,0,0,0,510,0,2430,0,274,0,23,0,213,0,2940,0,0,0,0,0,0,0,0,5,0,39
Johnson,5/27/20,0,0,0,0,0,0,0,0,0,38,0,325,0,35,0,0,0,3,0,363,0,0,0,0,0,0,0,0,0,0,5
Lafayette,5/27/20,0,0,0,0,0,0,0,0,0,9,0,52,0,8,0,1,0,0,0,61,0,0,0,0,0,0,0,0,0,0,10
Lawrence,5/27/20,0,0,0,0,0,0,0,0,0,82,0,654,0,65,0,5,0,12,0,736,0,0,0,0,0,0,0,0,2,0,5
Lee,5/27/20,0,0,0,0,0,0,0,0,0,17,0,338,0,11,0,1,0,5,0,355,0,0,0,0,0,0,0,0,1,0,55
Lincoln,5/27/20,0,0,0,0,0,0,0,0,0,975,0,969,0,943,0,8,0,24,0,1944,0,0,0,0,0,0,0,0,0,0,6
LittleRiver,5/27/20,0,0,0,0,0,0,0,0,0,5,0,180,0,1,0,0,0,4,0,185,0,0,0,0,0,0,0,0,0,0,0
Logan,5/27/20,0,0,0,0,0,0,0,0,0,4,0,274,0,4,0,0,0,0,0,278,0,0,0,0,0,0,0,0,0,0,12
Lonoke,5/27/20,0,0,0,0,0,0,0,0,0,45,0,1702,0,45,0,0,0,0,0,1747,0,0,0,0,0,0,0,-1,0,0,54
Madison,5/27/20,0,0,0,0,0,0,0,0,0,6,0,364,0,1,0,0,0,5,0,370,0,0,0,0,0,0,0,0,0,0,4
Marion,5/27/20,0,0,0,0,0,0,0,0,0,1,0,233,0,1,0,0,0,0,0,234,0,0,0,0,0,0,0,0,0,0,1
Miller,5/27/20,0,0,0,0,0,0,0,0,0,42,0,661,0,41,0,1,0,0,0,703,0,0,0,0,0,0,0,0,0,0,12
MissingCountyInfo,5/27/20,0,0,0,0,0,0,0,0,0,181,0,29723,0,119,0,0,0,62,0,29904,0,0,0,0,0,0,0,7,1,0,852
Mississippi,5/27/20,0,0,0,0,0,0,0,0,0,72,0,1328,0,54,0,2,0,16,0,1400,0,0,0,0,0,0,0,0,0,0,46
Monroe,5/27/20,0,0,0,0,0,0,0,0,0,5,0,151,0,5,0,0,0,0,0,156,0,0,0,0,0,0,0,0,0,0,0
Montgomery,5/27/20,0,0,0,0,0,0,0,0,0,1,0,144,0,1,0,0,0,0,0,145,0,0,0,0,0,0,0,0,0,0,2
Nevada,5/27/20,0,0,0,0,0,0,0,0,0,5,0,132,0,4,0,0,0,1,0,137,0,0,0,0,0,0,0,1,1,0,3
Newton,5/27/20,0,0,0,0,0,0,0,0,0,3,0,148,0,3,0,0,0,0,0,151,0,0,0,0,0,0,0,0,0,0,2
Ouachita,5/27/20,0,0,0,0,0,0,0,0,0,10,0,772,0,10,0,0,0,0,0,782,0,0,0,0,0,0,0,0,0,0,10
Perry,5/27/20,0,0,0,0,0,0,0,0,0,14,0,269,0,13,0,0,0,1,0,283,0,0,0,0,0,0,0,1,1,0,3
Phillips,5/27/20,0,0,0,0,0,0,0,0,0,12,0,468,0,6,0,1,0,5,0,480,0,0,0,0,0,0,0,3,2,0,50
Pike,5/27/20,0,0,0,0,0,0,0,0,0,5,0,552,0,4,0,0,0,1,0,557,0,0,0,0,0,0,0,0,0,0,1
Poinsett,5/27/20,0,0,0,0,0,0,0,0,0,31,0,505,0,24,0,2,0,5,0,536,0,0,0,0,0,0,0,1,1,0,16
Polk,5/27/20,0,0,0,0,0,0,0,0,0,11,0,417,0,9,0,0,0,2,0,428,0,0,0,0,0,0,0,-1,1,0,6
Pope,5/27/20,0,0,0,0,0,0,0,0,0,125,0,2316,0,63,0,1,0,61,0,2441,0,0,0,0,0,0,0,1,2,0,33
Prairie,5/27/20,0,0,0,0,0,0,0,0,0,2,0,102,0,2,0,0,0,0,0,104,0,0,0,0,0,0,0,0,0,0,3
Pulaski,5/27/20,0,0,0,0,0,0,0,0,0,808,0,11952,0,642,0,30,0,136,0,12760,0,0,0,0,0,0,0,6,6,0,359
Randolph,5/27/20,0,0,0,0,0,0,0,0,0,26,0,949,0,21,0,0,0,5,0,975,0,0,0,0,0,0,0,0,0,0,7
Saline,5/27/20,0,0,0,0,0,0,0,0,0,99,0,3223,0,80,0,1,0,18,0,3322,0,0,0,0,0,0,0,-1,2,0,98
Scott,5/27/20,0,0,0,0,0,0,0,0,0,1,0,26,0,1,0,0,0,0,0,27,0,0,0,0,0,0,0,0,0,0,0
Searcy,5/27/20,0,0,0,0,0,0,0,0,0,7,0,405,0,6,0,0,0,1,0,412,0,0,0,0,0,0,0,0,0,0,2
Sebastian,5/27/20,0,0,0,0,0,0,0,0,0,23,0,1131,0,16,0,0,0,7,0,1154,0,0,0,0,0,0,0,1,0,0,55
Sevier,5/27/20,0,0,0,0,0,0,0,0,0,120,0,636,0,44,0,2,0,74,0,756,0,0,0,0,0,0,0,9,11,0,55
Sharp,5/27/20,0,0,0,0,0,0,0,0,0,42,0,333,0,32,0,2,0,8,0,375,0,0,0,0,0,0,0,0,-1,0,1
St.Francis,5/27/20,0,0,0,0,0,0,0,0,0,655,0,2650,0,328,0,1,0,326,0,3305,0,0,0,0,0,0,0,4,8,0,74
Stone,5/27/20,0,0,0,0,0,0,0,0,0,8,0,306,0,8,0,0,0,0,0,314,0,0,0,0,0,0,0,0,0,0,2
Union,5/27/20,0,0,0,0,0,0,0,0,0,162,0,900,0,103,0,6,0,53,0,1062,0,0,0,0,0,0,0,0,6,0,18
VanBuren,5/27/20,0,0,0,0,0,0,0,0,0,28,0,519,0,26,0,2,0,0,0,547,0,0,0,0,0,0,0,0,0,0,3
Washington,5/27/20,0,0,0,0,0,0,0,0,0,326,0,4279,0,130,0,6,0,190,0,4605,0,0,0,0,0,0,0,23,12,1,196
White,5/27/20,0,0,0,0,0,0,0,0,0,42,0,1689,0,37,0,1,0,4,0,1731,0,0,0,0,0,0,0,2,2,0,32
Woodruff,5/27/20,0,0,0,0,0,0,0,0,0,1,0,100,0,1,0,0,0,0,0,101,0,0,0,0,0,0,0,0,0,0,2
Yell,5/27/20,0,0,0,0,0,0,0,0,0,108,0,366,0,37,0,1,0,70,0,474,0,0,0,0,0,0,0,6,5,0,12
Arkansas_all_counties,5/26/20,0,0,0,0,0,0,0,0,2990671,6180,0,109319,0,4332,0,119,0,1729,0,115499,0,0,0,0,0,0,0,151,83,2,3877
Arkansas_county,5/26/20,0,0,0,0,0,0,0,0,0,3,0,272,0,2,0,0,0,1,0,275,0,0,0,0,0,0,0,0,0,0,11
Ashley,5/26/20,0,0,0,0,0,0,0,0,0,19,0,569,0,18,0,0,0,1,0,588,0,0,0,0,0,0,0,0,0,0,3
Baxter,5/26/20,0,0,0,0,0,0,0,0,0,8,0,578,0,5,0,0,0,3,0,586,0,0,0,0,0,0,0,1,0,0,15
Benton,5/26/20,0,0,0,0,0,0,0,0,0,315,0,9205,0,153,0,0,0,162,0,9520,0,0,0,0,0,0,0,18,7,0,542
Boone,5/26/20,0,0,0,0,0,0,0,0,0,6,0,684,0,4,0,0,0,2,0,690,0,0,0,0,0,0,0,0,0,0,59
Bradley,5/26/20,0,0,0,0,0,0,0,0,0,18,0,396,0,12,0,1,0,5,0,414,0,0,0,0,0,0,0,1,1,0,7
Calhoun,5/26/20,0,0,0,0,0,0,0,0,0,0,0,63,0,0,0,0,0,0,0,63,0,0,0,0,0,0,0,0,0,0,3
Carroll,5/26/20,0,0,0,0,0,0,0,0,0,17,0,749,0,5,0,0,0,12,0,766,0,0,0,0,0,0,0,2,0,0,96
Chicot,5/26/20,0,0,0,0,0,0,0,0,0,14,0,207,0,9,0,0,0,5,0,221,0,0,0,0,0,0,0,1,0,0,4
Clark,5/26/20,0,0,0,0,0,0,0,0,0,37,0,706,0,34,0,0,0,3,0,743,0,0,0,0,0,0,0,1,0,0,10
Clay,5/26/20,0,0,0,0,0,0,0,0,0,4,0,508,0,4,0,0,0,0,0,512,0,0,0,0,0,0,0,0,0,0,27
Cleburne,5/26/20,0,0,0,0,0,0,0,0,0,73,0,625,0,68,0,4,0,1,0,698,0,0,0,0,0,0,0,0,0,0,7
Cleveland,5/26/20,0,0,0,0,0,0,0,0,0,18,0,291,0,16,0,0,0,2,0,309,0,0,0,0,0,0,0,0,1,0,4
Columbia,5/26/20,0,0,0,0,0,0,0,0,0,20,0,323,0,12,0,2,0,6,0,343,0,0,0,0,0,0,0,0,0,0,1
Conway,5/26/20,0,0,0,0,0,0,0,0,0,14,0,536,0,13,0,1,0,0,0,550,0,0,0,0,0,0,0,0,1,0,6
Craighead,5/26/20,0,0,0,0,0,0,0,0,0,190,0,4158,0,140,0,0,0,50,0,4348,0,0,0,0,0,0,0,2,13,0,107
Crawford,5/26/20,0,0,0,0,0,0,0,0,0,17,0,636,0,12,0,0,0,5,0,653,0,0,0,0,0,0,0,3,1,0,49
Crittenden,5/26/20,0,0,0,0,0,0,0,0,0,297,0,2714,0,216,0,9,0,72,0,3011,0,0,0,0,0,0,0,4,4,0,52
Cross,5/26/20,0,0,0,0,0,0,0,0,0,46,0,604,0,32,0,0,0,14,0,650,0,0,0,0,0,0,0,4,0,0,23
Dallas,5/26/20,0,0,0,0,0,0,0,0,0,1,0,146,0,1,0,0,0,0,0,147,0,0,0,0,0,0,0,0,0,0,2
Desha,5/26/20,0,0,0,0,0,0,0,0,0,19,0,420,0,18,0,0,0,1,0,439,0,0,0,0,0,0,0,0,0,0,8
Drew,5/26/20,0,0,0,0,0,0,0,0,0,19,0,559,0,16,0,1,0,2,0,578,0,0,0,0,0,0,0,0,0,0,8
Faulkner,5/26/20,0,0,0,0,0,0,0,0,0,100,0,2820,0,87,0,3,0,10,0,2920,0,0,0,0,0,0,0,0,2,0,27
Franklin,5/26/20,0,0,0,0,0,0,0,0,0,4,0,253,0,2,0,0,0,2,0,257,0,0,0,0,0,0,0,0,0,0,13
Fulton,5/26/20,0,0,0,0,0,0,0,0,0,6,0,271,0,4,0,0,0,2,0,277,0,0,0,0,0,0,0,0,0,0,20
Garland,5/26/20,0,0,0,0,0,0,0,0,0,134,0,3771,0,128,0,1,0,5,0,3905,0,0,0,0,0,0,0,0,1,0,15
Grant,5/26/20,0,0,0,0,0,0,0,0,0,16,0,454,0,16,0,0,0,0,0,470,0,0,0,0,0,0,0,0,0,0,15
Greene,5/26/20,0,0,0,0,0,0,0,0,0,54,0,1699,0,26,0,0,0,28,0,1753,0,0,0,0,0,0,0,4,0,0,75
Hempstead,5/26/20,0,0,0,0,0,0,0,0,0,14,0,282,0,7,0,1,0,6,0,296,0,0,0,0,0,0,0,1,0,0,4
HotSpring,5/26/20,0,0,0,0,0,0,0,0,0,30,0,780,0,29,0,0,0,1,0,810,0,0,0,0,0,0,0,0,0,0,12
Howard,5/26/20,0,0,0,0,0,0,0,0,0,17,0,261,0,14,0,0,0,3,0,278,0,0,0,0,0,0,0,0,0,0,4
Independence,5/26/20,0,0,0,0,0,0,0,0,0,29,0,757,0,25,0,0,0,4,0,786,0,0,0,0,0,0,0,1,1,0,8
Izard,5/26/20,0,0,0,0,0,0,0,0,0,15,0,194,0,13,0,0,0,2,0,209,0,0,0,0,0,0,0,0,0,0,9
Jackson,5/26/20,0,0,0,0,0,0,0,0,0,1,0,239,0,1,0,0,0,0,0,240,0,0,0,0,0,0,0,0,0,0,9
Jefferson,5/26/20,0,0,0,0,0,0,0,0,0,510,0,2391,0,269,0,23,0,218,0,2901,0,0,0,0,0,0,0,6,7,0,71
Johnson,5/26/20,0,0,0,0,0,0,0,0,0,38,0,320,0,35,0,0,0,3,0,358,0,0,0,0,0,0,0,0,0,0,7
Lafayette,5/26/20,0,0,0,0,0,0,0,0,0,9,0,42,0,8,0,1,0,0,0,51,0,0,0,0,0,0,0,0,0,0,0
Lawrence,5/26/20,0,0,0,0,0,0,0,0,0,82,0,649,0,63,0,5,0,14,0,731,0,0,0,0,0,0,0,0,1,0,21
Lee,5/26/20,0,0,0,0,0,0,0,0,0,17,0,283,0,10,0,1,0,6,0,300,0,0,0,0,0,0,0,0,1,0,68
Lincoln,5/26/20,0,0,0,0,0,0,0,0,0,975,0,963,0,943,0,8,0,24,0,1938,0,0,0,0,0,0,0,0,0,0,5
LittleRiver,5/26/20,0,0,0,0,0,0,0,0,0,5,0,180,0,1,0,0,0,4,0,185,0,0,0,0,0,0,0,1,0,0,5
Logan,5/26/20,0,0,0,0,0,0,0,0,0,4,0,262,0,4,0,0,0,0,0,266,0,0,0,0,0,0,0,0,0,0,10
Lonoke,5/26/20,0,0,0,0,0,0,0,0,0,46,0,1647,0,45,0,0,0,1,0,1693,0,0,0,0,0,0,0,0,0,0,42
Madison,5/26/20,0,0,0,0,0,0,0,0,0,6,0,360,0,1,0,0,0,5,0,366,0,0,0,0,0,0,0,1,0,0,31
Marion,5/26/20,0,0,0,0,0,0,0,0,0,1,0,232,0,1,0,0,0,0,0,233,0,0,0,0,0,0,0,0,0,0,10
Miller,5/26/20,0,0,0,0,0,0,0,0,0,42,0,649,0,41,0,1,0,0,0,691,0,0,0,0,0,0,0,0,0,0,8
MissingCountyInfo,5/26/20,0,0,0,0,0,0,0,0,0,174,0,28878,0,118,0,0,0,56,0,29052,0,0,0,0,0,0,0,15,1,0,891
Mississippi,5/26/20,0,0,0,0,0,0,0,0,0,72,0,1282,0,54,0,2,0,16,0,1354,0,0,0,0,0,0,0,2,-1,0,292
Monroe,5/26/20,0,0,0,0,0,0,0,0,0,5,0,151,0,5,0,0,0,0,0,156,0,0,0,0,0,0,0,0,0,0,3
Montgomery,5/26/20,0,0,0,0,0,0,0,0,0,1,0,142,0,1,0,0,0,0,0,143,0,0,0,0,0,0,0,0,0,0,4
Nevada,5/26/20,0,0,0,0,0,0,0,0,0,4,0,130,0,3,0,0,0,1,0,134,0,0,0,0,0,0,0,0,0,0,3
Newton,5/26/20,0,0,0,0,0,0,0,0,0,3,0,146,0,3,0,0,0,0,0,149,0,0,0,0,0,0,0,0,0,0,25
Ouachita,5/26/20,0,0,0,0,0,0,0,0,0,10,0,762,0,10,0,0,0,0,0,772,0,0,0,0,0,0,0,0,1,0,18
Perry,5/26/20,0,0,0,0,0,0,0,0,0,13,0,267,0,12,0,0,0,1,0,280,0,0,0,0,0,0,0,0,0,0,12
Phillips,5/26/20,0,0,0,0,0,0,0,0,0,9,0,421,0,4,0,1,0,4,0,430,0,0,0,0,0,0,0,0,0,0,17
Pike,5/26/20,0,0,0,0,0,0,0,0,0,5,0,551,0,4,0,0,0,1,0,556,0,0,0,0,0,0,0,1,0,0,3
Poinsett,5/26/20,0,0,0,0,0,0,0,0,0,30,0,490,0,23,0,2,0,5,0,520,0,0,0,0,0,0,0,0,1,0,10
Polk,5/26/20,0,0,0,0,0,0,0,0,0,12,0,410,0,8,0,0,0,4,0,422,0,0,0,0,0,0,0,1,0,0,4
Pope,5/26/20,0,0,0,0,0,0,0,0,0,124,0,2284,0,61,0,1,0,62,0,2408,0,0,0,0,0,0,0,5,5,0,33
Prairie,5/26/20,0,0,0,0,0,0,0,0,0,2,0,99,0,2,0,0,0,0,0,101,0,0,0,0,0,0,0,0,0,0,3
Pulaski,5/26/20,0,0,0,0,0,0,0,0,0,802,0,11599,0,636,0,30,0,136,0,12401,0,0,0,0,0,0,0,9,11,1,260
Randolph,5/26/20,0,0,0,0,0,0,0,0,0,26,0,942,0,21,0,0,0,5,0,968,0,0,0,0,0,0,0,0,0,0,20
Saline,5/26/20,0,0,0,0,0,0,0,0,0,100,0,3124,0,78,0,1,0,21,0,3224,0,0,0,0,0,0,0,2,1,0,85
Scott,5/26/20,0,0,0,0,0,0,0,0,0,1,0,26,0,1,0,0,0,0,0,27,0,0,0,0,0,0,0,0,0,0,1
Searcy,5/26/20,0,0,0,0,0,0,0,0,0,7,0,403,0,6,0,0,0,1,0,410,0,0,0,0,0,0,0,1,0,0,63
Sebastian,5/26/20,0,0,0,0,0,0,0,0,0,22,0,1077,0,16,0,0,0,6,0,1099,0,0,0,0,0,0,0,2,1,0,85
Sevier,5/26/20,0,0,0,0,0,0,0,0,0,111,0,590,0,33,0,2,0,76,0,701,0,0,0,0,0,0,0,18,0,1,87
Sharp,5/26/20,0,0,0,0,0,0,0,0,0,42,0,332,0,33,0,2,0,7,0,374,0,0,0,0,0,0,0,0,11,0,31
St.Francis,5/26/20,0,0,0,0,0,0,0,0,0,651,0,2580,0,320,0,1,0,330,0,3231,0,0,0,0,0,0,0,12,6,0,72
Stone,5/26/20,0,0,0,0,0,0,0,0,0,8,0,304,0,8,0,0,0,0,0,312,0,0,0,0,0,0,0,0,0,0,86
Union,5/26/20,0,0,0,0,0,0,0,0,0,162,0,882,0,97,0,6,0,59,0,1044,0,0,0,0,0,0,0,2,1,0,10
VanBuren,5/26/20,0,0,0,0,0,0,0,0,0,28,0,516,0,26,0,2,0,0,0,544,0,0,0,0,0,0,0,0,0,0,5
Washington,5/26/20,0,0,0,0,0,0,0,0,0,303,0,4106,0,118,0,5,0,180,0,4409,0,0,0,0,0,0,0,27,1,0,198
White,5/26/20,0,0,0,0,0,0,0,0,0,40,0,1659,0,35,0,1,0,4,0,1699,0,0,0,0,0,0,0,0,0,0,10
Woodruff,5/26/20,0,0,0,0,0,0,0,0,0,1,0,98,0,1,0,0,0,0,0,99,0,0,0,0,0,0,0,0,0,0,5
Yell,5/26/20,0,0,0,0,0,0,0,0,0,102,0,360,0,32,0,1,0,69,0,462,0,0,0,0,0,0,0,3,3,0,8
Arkansas_all_counties,5/25/20,0,0,0,0,0,0,0,0,2990671,6029,0,105593,0,4249,0,117,0,1663,0,111622,0,0,0,0,0,0,0,107,101,1,3041
Arkansas_county,5/25/20,0,0,0,0,0,0,0,0,0,3,0,261,0,2,0,0,0,1,0,264,0,0,0,0,0,0,0,0,0,0,2
Ashley,5/25/20,0,0,0,0,0,0,0,0,0,19,0,566,0,18,0,0,0,1,0,585,0,0,0,0,0,0,0,0,0,0,16
Baxter,5/25/20,0,0,0,0,0,0,0,0,0,7,0,564,0,5,0,0,0,2,0,571,0,0,0,0,0,0,0,1,0,0,22
Benton,5/25/20,0,0,0,0,0,0,0,0,0,297,0,8681,0,146,0,0,0,151,0,8978,0,0,0,0,0,0,0,13,4,0,187
Boone,5/25/20,0,0,0,0,0,0,0,0,0,6,0,625,0,4,0,0,0,2,0,631,0,0,0,0,0,0,0,0,0,0,31
Bradley,5/25/20,0,0,0,0,0,0,0,0,0,17,0,390,0,11,0,1,0,5,0,407,0,0,0,0,0,0,0,0,0,0,16
Calhoun,5/25/20,0,0,0,0,0,0,0,0,0,0,0,60,0,0,0,0,0,0,0,60,0,0,0,0,0,0,0,0,0,0,2
Carroll,5/25/20,0,0,0,0,0,0,0,0,0,15,0,655,0,5,0,0,0,10,0,670,0,0,0,0,0,0,0,5,0,0,62
Chicot,5/25/20,0,0,0,0,0,0,0,0,0,13,0,204,0,9,0,0,0,4,0,217,0,0,0,0,0,0,0,0,0,0,1
Clark,5/25/20,0,0,0,0,0,0,0,0,0,36,0,697,0,34,0,0,0,2,0,733,0,0,0,0,0,0,0,0,0,0,7
Clay,5/25/20,0,0,0,0,0,0,0,0,0,4,0,481,0,4,0,0,0,0,0,485,0,0,0,0,0,0,0,0,1,0,13
Cleburne,5/25/20,0,0,0,0,0,0,0,0,0,73,0,618,0,68,0,4,0,1,0,691,0,0,0,0,0,0,0,0,0,0,20
Cleveland,5/25/20,0,0,0,0,0,0,0,0,0,18,0,287,0,15,0,0,0,3,0,305,0,0,0,0,0,0,0,0,0,0,6
Columbia,5/25/20,0,0,0,0,0,0,0,0,0,20,0,322,0,12,0,2,0,6,0,342,0,0,0,0,0,0,0,0,0,0,8
Conway,5/25/20,0,0,0,0,0,0,0,0,0,14,0,530,0,12,0,1,0,1,0,544,0,0,0,0,0,0,0,0,0,0,7
Craighead,5/25/20,0,0,0,0,0,0,0,0,0,188,0,4053,0,127,0,0,0,61,0,4241,0,0,0,0,0,0,0,3,2,0,211
Crawford,5/25/20,0,0,0,0,0,0,0,0,0,14,0,590,0,11,0,0,0,3,0,604,0,0,0,0,0,0,0,1,0,0,24
Crittenden,5/25/20,0,0,0,0,0,0,0,0,0,293,0,2666,0,212,0,9,0,72,0,2959,0,0,0,0,0,0,0,8,1,0,117
Cross,5/25/20,0,0,0,0,0,0,0,0,0,42,0,585,0,32,0,0,0,10,0,627,0,0,0,0,0,0,0,0,0,0,14
Dallas,5/25/20,0,0,0,0,0,0,0,0,0,1,0,144,0,1,0,0,0,0,0,145,0,0,0,0,0,0,0,0,0,0,3
Desha,5/25/20,0,0,0,0,0,0,0,0,0,19,0,412,0,18,0,0,0,1,0,431,0,0,0,0,0,0,0,0,0,0,1
Drew,5/25/20,0,0,0,0,0,0,0,0,0,19,0,551,0,16,0,1,0,2,0,570,0,0,0,0,0,0,0,0,0,0,4
Faulkner,5/25/20,0,0,0,0,0,0,0,0,0,100,0,2793,0,85,0,3,0,12,0,2893,0,0,0,0,0,0,0,0,1,0,50
Franklin,5/25/20,0,0,0,0,0,0,0,0,0,4,0,240,0,2,0,0,0,2,0,244,0,0,0,0,0,0,0,0,0,0,3
Fulton,5/25/20,0,0,0,0,0,0,0,0,0,6,0,251,0,4,0,0,0,2,0,257,0,0,0,0,0,0,0,0,1,0,27
Garland,5/25/20,0,0,0,0,0,0,0,0,0,134,0,3756,0,127,0,1,0,6,0,3890,0,0,0,0,0,0,0,1,0,0,101
Grant,5/25/20,0,0,0,0,0,0,0,0,0,16,0,439,0,16,0,0,0,0,0,455,0,0,0,0,0,0,0,0,0,0,10
Greene,5/25/20,0,0,0,0,0,0,0,0,0,50,0,1628,0,26,0,0,0,24,0,1678,0,0,0,0,0,0,0,5,1,0,87
Hempstead,5/25/20,0,0,0,0,0,0,0,0,0,13,0,279,0,7,0,1,0,5,0,292,0,0,0,0,0,0,0,0,0,0,13
HotSpring,5/25/20,0,0,0,0,0,0,0,0,0,30,0,768,0,29,0,0,0,1,0,798,0,0,0,0,0,0,0,0,0,0,17
Howard,5/25/20,0,0,0,0,0,0,0,0,0,17,0,257,0,14,0,0,0,3,0,274,0,0,0,0,0,0,0,1,0,0,4
Independence,5/25/20,0,0,0,0,0,0,0,0,0,28,0,750,0,24,0,0,0,4,0,778,0,0,0,0,0,0,0,0,0,0,25
Izard,5/25/20,0,0,0,0,0,0,0,0,0,15,0,185,0,13,0,0,0,2,0,200,0,0,0,0,0,0,0,0,0,0,2
Jackson,5/25/20,0,0,0,0,0,0,0,0,0,1,0,230,0,1,0,0,0,0,0,231,0,0,0,0,0,0,0,0,0,0,4
Jefferson,5/25/20,0,0,0,0,0,0,0,0,0,504,0,2326,0,262,0,23,0,219,0,2830,0,0,0,0,0,0,0,0,36,0,27
Johnson,5/25/20,0,0,0,0,0,0,0,0,0,38,0,313,0,35,0,0,0,3,0,351,0,0,0,0,0,0,0,0,0,0,3
Lafayette,5/25/20,0,0,0,0,0,0,0,0,0,9,0,42,0,8,0,1,0,0,0,51,0,0,0,0,0,0,0,0,0,0,2
Lawrence,5/25/20,0,0,0,0,0,0,0,0,0,82,0,628,0,62,0,5,0,15,0,710,0,0,0,0,0,0,0,0,1,0,21
Lee,5/25/20,0,0,0,0,0,0,0,0,0,17,0,215,0,9,0,1,0,7,0,232,0,0,0,0,0,0,0,2,2,0,18
Lincoln,5/25/20,0,0,0,0,0,0,0,0,0,975,0,958,0,943,0,8,0,24,0,1933,0,0,0,0,0,0,0,1,4,0,7
LittleRiver,5/25/20,0,0,0,0,0,0,0,0,0,4,0,176,0,1,0,0,0,3,0,180,0,0,0,0,0,0,0,2,1,0,5
Logan,5/25/20,0,0,0,0,0,0,0,0,0,4,0,252,0,4,0,0,0,0,0,256,0,0,0,0,0,0,0,0,0,0,7
Lonoke,5/25/20,0,0,0,0,0,0,0,0,0,46,0,1605,0,45,0,0,0,1,0,1651,0,0,0,0,0,0,0,0,0,0,31
Madison,5/25/20,0,0,0,0,0,0,0,0,0,5,0,330,0,1,0,0,0,4,0,335,0,0,0,0,0,0,0,2,0,0,67
Marion,5/25/20,0,0,0,0,0,0,0,0,0,1,0,222,0,1,0,0,0,0,0,223,0,0,0,0,0,0,0,0,0,0,68
Miller,5/25/20,0,0,0,0,0,0,0,0,0,42,0,641,0,41,0,1,0,0,0,683,0,0,0,0,0,0,0,0,1,0,17
MissingCountyInfo,5/25/20,0,0,0,0,0,0,0,0,0,159,0,28002,0,117,0,0,0,42,0,28161,0,0,0,0,0,0,0,9,3,0,630
Mississippi,5/25/20,0,0,0,0,0,0,0,0,0,70,0,992,0,55,0,2,0,13,0,1062,0,0,0,0,0,0,0,0,0,1,87
Monroe,5/25/20,0,0,0,0,0,0,0,0,0,5,0,148,0,5,0,0,0,0,0,153,0,0,0,0,0,0,0,0,0,0,4
Montgomery,5/25/20,0,0,0,0,0,0,0,0,0,1,0,138,0,1,0,0,0,0,0,139,0,0,0,0,0,0,0,0,0,0,4
Nevada,5/25/20,0,0,0,0,0,0,0,0,0,4,0,127,0,3,0,0,0,1,0,131,0,0,0,0,0,0,0,0,0,0,2
Newton,5/25/20,0,0,0,0,0,0,0,0,0,3,0,121,0,3,0,0,0,0,0,124,0,0,0,0,0,0,0,0,0,0,3
Ouachita,5/25/20,0,0,0,0,0,0,0,0,0,10,0,744,0,9,0,0,0,1,0,754,0,0,0,0,0,0,0,0,0,0,21
Perry,5/25/20,0,0,0,0,0,0,0,0,0,13,0,255,0,12,0,0,0,1,0,268,0,0,0,0,0,0,0,0,0,0,6
Phillips,5/25/20,0,0,0,0,0,0,0,0,0,9,0,404,0,4,0,1,0,4,0,413,0,0,0,0,0,0,0,0,0,0,18
Pike,5/25/20,0,0,0,0,0,0,0,0,0,4,0,549,0,4,0,0,0,0,0,553,0,0,0,0,0,0,0,0,0,0,19
Poinsett,5/25/20,0,0,0,0,0,0,0,0,0,30,0,480,0,22,0,2,0,6,0,510,0,0,0,0,0,0,0,-1,0,0,8
Polk,5/25/20,0,0,0,0,0,0,0,0,0,11,0,407,0,8,0,0,0,3,0,418,0,0,0,0,0,0,0,1,0,0,5
Pope,5/25/20,0,0,0,0,0,0,0,0,0,119,0,2256,0,56,0,1,0,62,0,2375,0,0,0,0,0,0,0,6,2,0,26
Prairie,5/25/20,0,0,0,0,0,0,0,0,0,2,0,96,0,2,0,0,0,0,0,98,0,0,0,0,0,0,0,0,0,0,1
Pulaski,5/25/20,0,0,0,0,0,0,0,0,0,793,0,11348,0,625,0,29,0,139,0,12141,0,0,0,0,0,0,0,8,7,0,281
Randolph,5/25/20,0,0,0,0,0,0,0,0,0,26,0,922,0,21,0,0,0,5,0,948,0,0,0,0,0,0,0,0,0,0,30
Saline,5/25/20,0,0,0,0,0,0,0,0,0,98,0,3041,0,77,0,1,0,20,0,3139,0,0,0,0,0,0,0,1,0,0,78
Scott,5/25/20,0,0,0,0,0,0,0,0,0,1,0,25,0,1,0,0,0,0,0,26,0,0,0,0,0,0,0,0,0,0,0
Searcy,5/25/20,0,0,0,0,0,0,0,0,0,6,0,341,0,6,0,0,0,0,0,347,0,0,0,0,0,0,0,0,0,0,19
Sebastian,5/25/20,0,0,0,0,0,0,0,0,0,20,0,994,0,15,0,0,0,5,0,1014,0,0,0,0,0,0,0,1,0,0,36
Sevier,5/25/20,0,0,0,0,0,0,0,0,0,93,0,521,0,33,0,1,0,59,0,614,0,0,0,0,0,0,0,9,5,0,56
Sharp,5/25/20,0,0,0,0,0,0,0,0,0,42,0,301,0,22,0,2,0,18,0,343,0,0,0,0,0,0,0,0,9,0,13
St.Francis,5/25/20,0,0,0,0,0,0,0,0,0,639,0,2520,0,314,0,1,0,324,0,3159,0,0,0,0,0,0,0,5,7,0,32
Stone,5/25/20,0,0,0,0,0,0,0,0,0,8,0,218,0,8,0,0,0,0,0,226,0,0,0,0,0,0,0,0,0,0,2
Union,5/25/20,0,0,0,0,0,0,0,0,0,160,0,874,0,96,0,6,0,58,0,1034,0,0,0,0,0,0,0,3,0,0,32
VanBuren,5/25/20,0,0,0,0,0,0,0,0,0,28,0,511,0,26,0,2,0,0,0,539,0,0,0,0,0,0,0,0,0,0,57
Washington,5/25/20,0,0,0,0,0,0,0,0,0,276,0,3935,0,117,0,5,0,154,0,4211,0,0,0,0,0,0,0,17,4,0,131
White,5/25/20,0,0,0,0,0,0,0,0,0,40,0,1649,0,35,0,1,0,4,0,1689,0,0,0,0,0,0,0,0,0,0,35
Woodruff,5/25/20,0,0,0,0,0,0,0,0,0,1,0,93,0,1,0,0,0,0,0,94,0,0,0,0,0,0,0,0,0,0,3
Yell,5/25/20,0,0,0,0,0,0,0,0,0,99,0,355,0,29,0,1,0,69,0,454,0,0,0,0,0,0,0,3,8,0,12
Arkansas_all_counties,5/24/20,0,0,0,0,0,0,0,0,2990671,5922,0,102659,0,4148,0,116,0,1658,0,108581,0,0,0,0,0,0,0,147,52,1,1987
Arkansas_county,5/24/20,0,0,0,0,0,0,0,0,0,3,0,259,0,2,0,0,0,1,0,262,0,0,0,0,0,0,0,1,0,0,7
Ashley,5/24/20,0,0,0,0,0,0,0,0,0,19,0,550,0,18,0,0,0,1,0,569,0,0,0,0,0,0,0,0,0,0,3
Baxter,5/24/20,0,0,0,0,0,0,0,0,0,6,0,543,0,5,0,0,0,1,0,549,0,0,0,0,0,0,0,0,0,0,11
Benton,5/24/20,0,0,0,0,0,0,0,0,0,284,0,8507,0,142,0,0,0,142,0,8791,0,0,0,0,0,0,0,47,6,0,265
Boone,5/24/20,0,0,0,0,0,0,0,0,0,6,0,594,0,4,0,0,0,2,0,600,0,0,0,0,0,0,0,0,0,0,5
Bradley,5/24/20,0,0,0,0,0,0,0,0,0,17,0,374,0,11,0,1,0,5,0,391,0,0,0,0,0,0,0,1,1,0,8
Calhoun,5/24/20,0,0,0,0,0,0,0,0,0,0,0,58,0,0,0,0,0,0,0,58,0,0,0,0,0,0,0,0,0,0,2
Carroll,5/24/20,0,0,0,0,0,0,0,0,0,10,0,598,0,5,0,0,0,5,0,608,0,0,0,0,0,0,0,0,0,0,11
Chicot,5/24/20,0,0,0,0,0,0,0,0,0,13,0,203,0,9,0,0,0,4,0,216,0,0,0,0,0,0,0,1,0,0,5
Clark,5/24/20,0,0,0,0,0,0,0,0,0,36,0,690,0,34,0,0,0,2,0,726,0,0,0,0,0,0,0,0,0,0,7
Clay,5/24/20,0,0,0,0,0,0,0,0,0,4,0,468,0,3,0,0,0,1,0,472,0,0,0,0,0,0,0,0,0,0,4
Cleburne,5/24/20,0,0,0,0,0,0,0,0,0,73,0,598,0,68,0,4,0,1,0,671,0,0,0,0,0,0,0,0,0,0,8
Cleveland,5/24/20,0,0,0,0,0,0,0,0,0,18,0,281,0,15,0,0,0,3,0,299,0,0,0,0,0,0,0,0,0,0,7
Columbia,5/24/20,0,0,0,0,0,0,0,0,0,20,0,314,0,12,0,2,0,6,0,334,0,0,0,0,0,0,0,0,0,0,13
Conway,5/24/20,0,0,0,0,0,0,0,0,0,14,0,523,0,12,0,1,0,1,0,537,0,0,0,0,0,0,0,0,0,0,10
Craighead,5/24/20,0,0,0,0,0,0,0,0,0,185,0,3845,0,125,0,0,0,60,0,4030,0,0,0,0,0,0,0,4,3,0,148
Crawford,5/24/20,0,0,0,0,0,0,0,0,0,13,0,567,0,11,0,0,0,2,0,580,0,0,0,0,0,0,0,0,0,0,2
Crittenden,5/24/20,0,0,0,0,0,0,0,0,0,285,0,2557,0,211,0,9,0,65,0,2842,0,0,0,0,0,0,0,5,2,0,68
Cross,5/24/20,0,0,0,0,0,0,0,0,0,42,0,571,0,32,0,0,0,10,0,613,0,0,0,0,0,0,0,0,3,0,11
Dallas,5/24/20,0,0,0,0,0,0,0,0,0,1,0,141,0,1,0,0,0,0,0,142,0,0,0,0,0,0,0,0,0,0,1
Desha,5/24/20,0,0,0,0,0,0,0,0,0,19,0,411,0,18,0,0,0,1,0,430,0,0,0,0,0,0,0,0,0,0,5
Drew,5/24/20,0,0,0,0,0,0,0,0,0,19,0,547,0,16,0,1,0,2,0,566,0,0,0,0,0,0,0,0,0,0,10
Faulkner,5/24/20,0,0,0,0,0,0,0,0,0,100,0,2743,0,84,0,3,0,13,0,2843,0,0,0,0,0,0,0,0,3,0,56
Franklin,5/24/20,0,0,0,0,0,0,0,0,0,4,0,237,0,2,0,0,0,2,0,241,0,0,0,0,0,0,0,0,0,0,19
Fulton,5/24/20,0,0,0,0,0,0,0,0,0,6,0,224,0,3,0,0,0,3,0,230,0,0,0,0,0,0,0,0,0,0,3
Garland,5/24/20,0,0,0,0,0,0,0,0,0,133,0,3656,0,127,0,1,0,5,0,3789,0,0,0,0,0,0,0,0,1,0,26
Grant,5/24/20,0,0,0,0,0,0,0,0,0,16,0,429,0,16,0,0,0,0,0,445,0,0,0,0,0,0,0,0,0,0,3
Greene,5/24/20,0,0,0,0,0,0,0,0,0,45,0,1546,0,25,0,0,0,20,0,1591,0,0,0,0,0,0,0,0,0,0,23
Hempstead,5/24/20,0,0,0,0,0,0,0,0,0,13,0,266,0,7,0,1,0,5,0,279,0,0,0,0,0,0,0,0,0,0,9
HotSpring,5/24/20,0,0,0,0,0,0,0,0,0,30,0,751,0,29,0,0,0,1,0,781,0,0,0,0,0,0,0,1,0,0,9
Howard,5/24/20,0,0,0,0,0,0,0,0,0,16,0,254,0,14,0,0,0,2,0,270,0,0,0,0,0,0,0,1,0,0,3
Independence,5/24/20,0,0,0,0,0,0,0,0,0,28,0,725,0,24,0,0,0,4,0,753,0,0,0,0,0,0,0,-1,0,0,43
Izard,5/24/20,0,0,0,0,0,0,0,0,0,15,0,183,0,13,0,0,0,2,0,198,0,0,0,0,0,0,0,1,0,0,5
Jackson,5/24/20,0,0,0,0,0,0,0,0,0,1,0,226,0,1,0,0,0,0,0,227,0,0,0,0,0,0,0,0,0,0,10
Jefferson,5/24/20,0,0,0,0,0,0,0,0,0,504,0,2299,0,226,0,23,0,255,0,2803,0,0,0,0,0,0,0,0,4,0,38
Johnson,5/24/20,0,0,0,0,0,0,0,0,0,38,0,310,0,35,0,0,0,3,0,348,0,0,0,0,0,0,0,0,0,0,2
Lafayette,5/24/20,0,0,0,0,0,0,0,0,0,9,0,40,0,8,0,1,0,0,0,49,0,0,0,0,0,0,0,0,0,0,1
Lawrence,5/24/20,0,0,0,0,0,0,0,0,0,82,0,607,0,61,0,5,0,16,0,689,0,0,0,0,0,0,0,0,1,0,14
Lee,5/24/20,0,0,0,0,0,0,0,0,0,15,0,199,0,7,0,1,0,7,0,214,0,0,0,0,0,0,0,1,0,0,8
Lincoln,5/24/20,0,0,0,0,0,0,0,0,0,974,0,952,0,939,0,8,0,27,0,1926,0,0,0,0,0,0,0,4,1,0,12
LittleRiver,5/24/20,0,0,0,0,0,0,0,0,0,2,0,173,0,0,0,0,0,2,0,175,0,0,0,0,0,0,0,1,0,0,13
Logan,5/24/20,0,0,0,0,0,0,0,0,0,4,0,245,0,4,0,0,0,0,0,249,0,0,0,0,0,0,0,0,0,0,4
Lonoke,5/24/20,0,0,0,0,0,0,0,0,0,46,0,1574,0,45,0,0,0,1,0,1620,0,0,0,0,0,0,0,0,1,0,23
Madison,5/24/20,0,0,0,0,0,0,0,0,0,3,0,265,0,1,0,0,0,2,0,268,0,0,0,0,0,0,0,0,0,0,2
Marion,5/24/20,0,0,0,0,0,0,0,0,0,1,0,154,0,1,0,0,0,0,0,155,0,0,0,0,0,0,0,0,0,0,4
Miller,5/24/20,0,0,0,0,0,0,0,0,0,42,0,624,0,40,0,1,0,1,0,666,0,0,0,0,0,0,0,0,0,0,22
MissingCountyInfo,5/24/20,0,0,0,0,0,0,0,0,0,150,0,27381,0,114,0,0,0,36,0,27531,0,0,0,0,0,0,0,2,0,0,282
Mississippi,5/24/20,0,0,0,0,0,0,0,0,0,70,0,905,0,55,0,1,0,14,0,975,0,0,0,0,0,0,0,0,0,0,16
Monroe,5/24/20,0,0,0,0,0,0,0,0,0,5,0,144,0,5,0,0,0,0,0,149,0,0,0,0,0,0,0,0,0,0,1
Montgomery,5/24/20,0,0,0,0,0,0,0,0,0,1,0,134,0,1,0,0,0,0,0,135,0,0,0,0,0,0,0,0,0,0,0
Nevada,5/24/20,0,0,0,0,0,0,0,0,0,4,0,125,0,3,0,0,0,1,0,129,0,0,0,0,0,0,0,0,0,0,2
Newton,5/24/20,0,0,0,0,0,0,0,0,0,3,0,118,0,3,0,0,0,0,0,121,0,0,0,0,0,0,0,0,0,0,1
Ouachita,5/24/20,0,0,0,0,0,0,0,0,0,10,0,723,0,9,0,0,0,1,0,733,0,0,0,0,0,0,0,0,0,0,18
Perry,5/24/20,0,0,0,0,0,0,0,0,0,13,0,249,0,12,0,0,0,1,0,262,0,0,0,0,0,0,0,1,0,0,4
Phillips,5/24/20,0,0,0,0,0,0,0,0,0,9,0,386,0,4,0,1,0,4,0,395,0,0,0,0,0,0,0,2,0,0,17
Pike,5/24/20,0,0,0,0,0,0,0,0,0,4,0,530,0,4,0,0,0,0,0,534,0,0,0,0,0,0,0,0,0,0,16
Poinsett,5/24/20,0,0,0,0,0,0,0,0,0,31,0,471,0,22,0,2,0,7,0,502,0,0,0,0,0,0,0,0,0,0,7
Polk,5/24/20,0,0,0,0,0,0,0,0,0,10,0,403,0,8,0,0,0,2,0,413,0,0,0,0,0,0,0,1,0,0,8
Pope,5/24/20,0,0,0,0,0,0,0,0,0,113,0,2236,0,54,0,1,0,58,0,2349,0,0,0,0,0,0,0,6,2,0,52
Prairie,5/24/20,0,0,0,0,0,0,0,0,0,2,0,95,0,2,0,0,0,0,0,97,0,0,0,0,0,0,0,0,0,0,4
Pulaski,5/24/20,0,0,0,0,0,0,0,0,0,785,0,11075,0,618,0,29,0,138,0,11860,0,0,0,0,0,0,0,12,4,0,214
Randolph,5/24/20,0,0,0,0,0,0,0,0,0,26,0,892,0,21,0,0,0,5,0,918,0,0,0,0,0,0,0,0,0,0,24
Saline,5/24/20,0,0,0,0,0,0,0,0,0,97,0,2964,0,77,0,1,0,19,0,3061,0,0,0,0,0,0,0,10,1,0,68
Scott,5/24/20,0,0,0,0,0,0,0,0,0,1,0,25,0,1,0,0,0,0,0,26,0,0,0,0,0,0,0,0,0,0,0
Searcy,5/24/20,0,0,0,0,0,0,0,0,0,6,0,322,0,6,0,0,0,0,0,328,0,0,0,0,0,0,0,0,0,0,4
Sebastian,5/24/20,0,0,0,0,0,0,0,0,0,19,0,959,0,15,0,0,0,4,0,978,0,0,0,0,0,0,0,0,0,0,11
Sevier,5/24/20,0,0,0,0,0,0,0,0,0,84,0,474,0,28,0,1,0,55,0,558,0,0,0,0,0,0,0,5,4,0,26
Sharp,5/24/20,0,0,0,0,0,0,0,0,0,42,0,288,0,13,0,2,0,27,0,330,0,0,0,0,0,0,0,0,1,0,5
St.Francis,5/24/20,0,0,0,0,0,0,0,0,0,634,0,2493,0,307,0,1,0,326,0,3127,0,0,0,0,0,0,0,6,3,0,42
Stone,5/24/20,0,0,0,0,0,0,0,0,0,8,0,216,0,8,0,0,0,0,0,224,0,0,0,0,0,0,0,0,0,0,7
Union,5/24/20,0,0,0,0,0,0,0,0,0,157,0,845,0,96,0,6,0,55,0,1002,0,0,0,0,0,0,0,5,6,1,24
VanBuren,5/24/20,0,0,0,0,0,0,0,0,0,28,0,454,0,26,0,2,0,0,0,482,0,0,0,0,0,0,0,0,0,0,18
Washington,5/24/20,0,0,0,0,0,0,0,0,0,259,0,3821,0,113,0,5,0,141,0,4080,0,0,0,0,0,0,0,26,3,0,103
White,5/24/20,0,0,0,0,0,0,0,0,0,40,0,1614,0,35,0,1,0,4,0,1654,0,0,0,0,0,0,0,2,0,0,30
Woodruff,5/24/20,0,0,0,0,0,0,0,0,0,1,0,90,0,1,0,0,0,0,0,91,0,0,0,0,0,0,0,0,0,0,2
Yell,5/24/20,0,0,0,0,0,0,0,0,0,96,0,346,0,21,0,1,0,74,0,442,0,0,0,0,0,0,0,2,5,0,18
Arkansas_all_counties,5/23/20,0,0,0,0,0,0,0,0,2990671,5775,0,100819,0,4096,0,115,0,1564,0,106594,0,0,0,0,0,0,0,163,67,2,3547
Arkansas_county,5/23/20,0,0,0,0,0,0,0,0,0,2,0,253,0,2,0,0,0,0,0,255,0,0,0,0,0,0,0,0,0,0,3
Ashley,5/23/20,0,0,0,0,0,0,0,0,0,19,0,547,0,18,0,0,0,1,0,566,0,0,0,0,0,0,0,0,0,0,23
Baxter,5/23/20,0,0,0,0,0,0,0,0,0,6,0,532,0,5,0,0,0,1,0,538,0,0,0,0,0,0,0,0,0,0,15
Benton,5/23/20,0,0,0,0,0,0,0,0,0,237,0,8289,0,136,0,0,0,101,0,8526,0,0,0,0,0,0,0,25,8,0,418
Boone,5/23/20,0,0,0,0,0,0,0,0,0,6,0,589,0,4,0,0,0,2,0,595,0,0,0,0,0,0,0,1,0,0,43
Bradley,5/23/20,0,0,0,0,0,0,0,0,0,16,0,367,0,10,0,1,0,5,0,383,0,0,0,0,0,0,0,0,0,0,4
Calhoun,5/23/20,0,0,0,0,0,0,0,0,0,0,0,56,0,0,0,0,0,0,0,56,0,0,0,0,0,0,0,0,0,0,2
Carroll,5/23/20,0,0,0,0,0,0,0,0,0,10,0,587,0,5,0,0,0,5,0,597,0,0,0,0,0,0,0,1,0,0,41
Chicot,5/23/20,0,0,0,0,0,0,0,0,0,12,0,199,0,9,0,0,0,3,0,211,0,0,0,0,0,0,0,0,0,0,8
Clark,5/23/20,0,0,0,0,0,0,0,0,0,36,0,683,0,34,0,0,0,2,0,719,0,0,0,0,0,0,0,0,0,0,11
Clay,5/23/20,0,0,0,0,0,0,0,0,0,4,0,464,0,3,0,0,0,1,0,468,0,0,0,0,0,0,0,0,0,0,8
Cleburne,5/23/20,0,0,0,0,0,0,0,0,0,73,0,590,0,68,0,4,0,1,0,663,0,0,0,0,0,0,0,0,0,0,9
Cleveland,5/23/20,0,0,0,0,0,0,0,0,0,18,0,274,0,15,0,0,0,3,0,292,0,0,0,0,0,0,0,0,1,0,2
Columbia,5/23/20,0,0,0,0,0,0,0,0,0,20,0,301,0,12,0,2,0,6,0,321,0,0,0,0,0,0,0,0,0,0,9
Conway,5/23/20,0,0,0,0,0,0,0,0,0,14,0,513,0,12,0,1,0,1,0,527,0,0,0,0,0,0,0,0,0,0,21
Craighead,5/23/20,0,0,0,0,0,0,0,0,0,181,0,3701,0,122,0,0,0,59,0,3882,0,0,0,0,0,0,0,7,7,0,280
Crawford,5/23/20,0,0,0,0,0,0,0,0,0,13,0,565,0,11,0,0,0,2,0,578,0,0,0,0,0,0,0,1,0,0,11
Crittenden,5/23/20,0,0,0,0,0,0,0,0,0,280,0,2494,0,209,0,9,0,62,0,2774,0,0,0,0,0,0,0,4,1,1,72
Cross,5/23/20,0,0,0,0,0,0,0,0,0,42,0,560,0,29,0,0,0,13,0,602,0,0,0,0,0,0,0,0,1,0,21
Dallas,5/23/20,0,0,0,0,0,0,0,0,0,1,0,140,0,1,0,0,0,0,0,141,0,0,0,0,0,0,0,0,0,0,3
Desha,5/23/20,0,0,0,0,0,0,0,0,0,19,0,406,0,18,0,0,0,1,0,425,0,0,0,0,0,0,0,1,0,0,13
Drew,5/23/20,0,0,0,0,0,0,0,0,0,19,0,537,0,16,0,1,0,2,0,556,0,0,0,0,0,0,0,0,0,0,11
Faulkner,5/23/20,0,0,0,0,0,0,0,0,0,100,0,2687,0,81,0,3,0,16,0,2787,0,0,0,0,0,0,0,2,0,0,64
Franklin,5/23/20,0,0,0,0,0,0,0,0,0,4,0,218,0,2,0,0,0,2,0,222,0,0,0,0,0,0,0,2,0,0,7
Fulton,5/23/20,0,0,0,0,0,0,0,0,0,6,0,221,0,3,0,0,0,3,0,227,0,0,0,0,0,0,0,0,0,0,8
Garland,5/23/20,0,0,0,0,0,0,0,0,0,133,0,3630,0,126,0,1,0,6,0,3763,0,0,0,0,0,0,0,1,3,0,91
Grant,5/23/20,0,0,0,0,0,0,0,0,0,16,0,426,0,16,0,0,0,0,0,442,0,0,0,0,0,0,0,0,0,0,0
Greene,5/23/20,0,0,0,0,0,0,0,0,0,45,0,1523,0,25,0,0,0,20,0,1568,0,0,0,0,0,0,0,3,1,0,63
Hempstead,5/23/20,0,0,0,0,0,0,0,0,0,13,0,257,0,7,0,1,0,5,0,270,0,0,0,0,0,0,0,2,0,0,54
HotSpring,5/23/20,0,0,0,0,0,0,0,0,0,29,0,743,0,29,0,0,0,0,0,772,0,0,0,0,0,0,0,0,1,0,16
Howard,5/23/20,0,0,0,0,0,0,0,0,0,15,0,252,0,14,0,0,0,1,0,267,0,0,0,0,0,0,0,0,0,0,8
Independence,5/23/20,0,0,0,0,0,0,0,0,0,29,0,681,0,24,0,0,0,5,0,710,0,0,0,0,0,0,0,2,1,0,36
Izard,5/23/20,0,0,0,0,0,0,0,0,0,14,0,179,0,13,0,0,0,1,0,193,0,0,0,0,0,0,0,0,2,0,5
Jackson,5/23/20,0,0,0,0,0,0,0,0,0,1,0,216,0,1,0,0,0,0,0,217,0,0,0,0,0,0,0,0,0,0,4
Jefferson,5/23/20,0,0,0,0,0,0,0,0,0,504,0,2261,0,222,0,23,0,259,0,2765,0,0,0,0,0,0,0,3,2,0,22
Johnson,5/23/20,0,0,0,0,0,0,0,0,0,38,0,308,0,35,0,0,0,3,0,346,0,0,0,0,0,0,0,2,0,0,5
Lafayette,5/23/20,0,0,0,0,0,0,0,0,0,9,0,39,0,8,0,1,0,0,0,48,0,0,0,0,0,0,0,0,0,0,2
Lawrence,5/23/20,0,0,0,0,0,0,0,0,0,82,0,593,0,60,0,5,0,17,0,675,0,0,0,0,0,0,0,1,0,0,9
Lee,5/23/20,0,0,0,0,0,0,0,0,0,14,0,192,0,7,0,1,0,6,0,206,0,0,0,0,0,0,0,1,1,0,7
Lincoln,5/23/20,0,0,0,0,0,0,0,0,0,970,0,944,0,938,0,8,0,24,0,1914,0,0,0,0,0,0,0,4,1,0,35
LittleRiver,5/23/20,0,0,0,0,0,0,0,0,0,1,0,161,0,0,0,0,0,1,0,162,0,0,0,0,0,0,0,0,0,0,7
Logan,5/23/20,0,0,0,0,0,0,0,0,0,4,0,241,0,4,0,0,0,0,0,245,0,0,0,0,0,0,0,0,0,0,10
Lonoke,5/23/20,0,0,0,0,0,0,0,0,0,46,0,1551,0,44,0,0,0,2,0,1597,0,0,0,0,0,0,0,0,1,0,33
Madison,5/23/20,0,0,0,0,0,0,0,0,0,3,0,263,0,1,0,0,0,2,0,266,0,0,0,0,0,0,0,0,0,0,15
Marion,5/23/20,0,0,0,0,0,0,0,0,0,1,0,150,0,1,0,0,0,0,0,151,0,0,0,0,0,0,0,0,0,0,3
Miller,5/23/20,0,0,0,0,0,0,0,0,0,42,0,602,0,40,0,1,0,1,0,644,0,0,0,0,0,0,0,0,2,0,20
MissingCountyInfo,5/23/20,0,0,0,0,0,0,0,0,0,148,0,27101,0,114,0,0,0,34,0,27249,0,0,0,0,0,0,0,4,0,0,960
Mississippi,5/23/20,0,0,0,0,0,0,0,0,0,70,0,889,0,55,0,1,0,14,0,959,0,0,0,0,0,0,0,0,0,0,32
Monroe,5/23/20,0,0,0,0,0,0,0,0,0,5,0,143,0,5,0,0,0,0,0,148,0,0,0,0,0,0,0,0,0,0,2
Montgomery,5/23/20,0,0,0,0,0,0,0,0,0,1,0,134,0,1,0,0,0,0,0,135,0,0,0,0,0,0,0,0,0,0,2
Nevada,5/23/20,0,0,0,0,0,0,0,0,0,4,0,123,0,3,0,0,0,1,0,127,0,0,0,0,0,0,0,0,0,0,11
Newton,5/23/20,0,0,0,0,0,0,0,0,0,3,0,117,0,3,0,0,0,0,0,120,0,0,0,0,0,0,0,0,0,0,7
Ouachita,5/23/20,0,0,0,0,0,0,0,0,0,10,0,705,0,9,0,0,0,1,0,715,0,0,0,0,0,0,0,0,0,0,23
Perry,5/23/20,0,0,0,0,0,0,0,0,0,12,0,246,0,12,0,0,0,0,0,258,0,0,0,0,0,0,0,0,0,0,7
Phillips,5/23/20,0,0,0,0,0,0,0,0,0,7,0,371,0,4,0,1,0,2,0,378,0,0,0,0,0,0,0,0,0,0,12
Pike,5/23/20,0,0,0,0,0,0,0,0,0,4,0,514,0,4,0,0,0,0,0,518,0,0,0,0,0,0,0,0,0,0,17
Poinsett,5/23/20,0,0,0,0,0,0,0,0,0,31,0,464,0,22,0,2,0,7,0,495,0,0,0,0,0,0,0,0,0,0,19
Polk,5/23/20,0,0,0,0,0,0,0,0,0,9,0,396,0,8,0,0,0,1,0,405,0,0,0,0,0,0,0,0,0,0,4
Pope,5/23/20,0,0,0,0,0,0,0,0,0,107,0,2190,0,52,0,1,0,54,0,2297,0,0,0,0,0,0,0,7,0,0,76
Prairie,5/23/20,0,0,0,0,0,0,0,0,0,2,0,91,0,2,0,0,0,0,0,93,0,0,0,0,0,0,0,0,0,0,2
Pulaski,5/23/20,0,0,0,0,0,0,0,0,0,773,0,10873,0,614,0,29,0,130,0,11646,0,0,0,0,0,0,0,12,12,0,273
Randolph,5/23/20,0,0,0,0,0,0,0,0,0,26,0,868,0,21,0,0,0,5,0,894,0,0,0,0,0,0,0,1,0,0,16
Saline,5/23/20,0,0,0,0,0,0,0,0,0,87,0,2906,0,76,0,1,0,10,0,2993,0,0,0,0,0,0,0,4,2,0,71
Scott,5/23/20,0,0,0,0,0,0,0,0,0,1,0,25,0,1,0,0,0,0,0,26,0,0,0,0,0,0,0,0,0,0,1
Searcy,5/23/20,0,0,0,0,0,0,0,0,0,6,0,318,0,6,0,0,0,0,0,324,0,0,0,0,0,0,0,0,0,0,6
Sebastian,5/23/20,0,0,0,0,0,0,0,0,0,19,0,948,0,15,0,0,0,4,0,967,0,0,0,0,0,0,0,1,0,0,41
Sevier,5/23/20,0,0,0,0,0,0,0,0,0,79,0,453,0,24,0,1,0,54,0,532,0,0,0,0,0,0,0,17,1,0,41
Sharp,5/23/20,0,0,0,0,0,0,0,0,0,42,0,283,0,12,0,2,0,28,0,325,0,0,0,0,0,0,0,0,1,0,23
St.Francis,5/23/20,0,0,0,0,0,0,0,0,0,628,0,2457,0,304,0,1,0,323,0,3085,0,0,0,0,0,0,0,7,7,0,58
Stone,5/23/20,0,0,0,0,0,0,0,0,0,8,0,209,0,8,0,0,0,0,0,217,0,0,0,0,0,0,0,0,0,0,6
Union,5/23/20,0,0,0,0,0,0,0,0,0,152,0,826,0,93,0,5,0,54,0,978,0,0,0,0,0,0,0,8,1,1,66
VanBuren,5/23/20,0,0,0,0,0,0,0,0,0,28,0,436,0,26,0,2,0,0,0,464,0,0,0,0,0,0,0,0,0,0,29
Washington,5/23/20,0,0,0,0,0,0,0,0,0,233,0,3744,0,110,0,5,0,118,0,3977,0,0,0,0,0,0,0,20,5,0,108
White,5/23/20,0,0,0,0,0,0,0,0,0,38,0,1586,0,35,0,1,0,2,0,1624,0,0,0,0,0,0,0,1,1,0,23
Woodruff,5/23/20,0,0,0,0,0,0,0,0,0,1,0,88,0,1,0,0,0,0,0,89,0,0,0,0,0,0,0,0,0,0,3
Yell,5/23/20,0,0,0,0,0,0,0,0,0,94,0,330,0,16,0,1,0,77,0,424,0,0,0,0,0,0,0,18,4,0,47
Arkansas_all_counties,5/22/20,0,0,0,0,0,0,0,0,2990671,5612,0,97435,0,4029,0,113,0,1470,0,103047,0,0,0,0,0,0,0,154,114,3,3771
Arkansas_county,5/22/20,0,0,0,0,0,0,0,0,0,2,0,250,0,2,0,0,0,0,0,252,0,0,0,0,0,0,0,0,0,0,9
Ashley,5/22/20,0,0,0,0,0,0,0,0,0,19,0,524,0,18,0,0,0,1,0,543,0,0,0,0,0,0,0,0,0,0,18
Baxter,5/22/20,0,0,0,0,0,0,0,0,0,6,0,517,0,5,0,0,0,1,0,523,0,0,0,0,0,0,0,0,0,0,31
Benton,5/22/20,0,0,0,0,0,0,0,0,0,212,0,7896,0,128,0,0,0,84,0,8108,0,0,0,0,0,0,0,22,5,0,121
Boone,5/22/20,0,0,0,0,0,0,0,0,0,5,0,547,0,4,0,0,0,1,0,552,0,0,0,0,0,0,0,0,0,0,7
Bradley,5/22/20,0,0,0,0,0,0,0,0,0,16,0,363,0,10,0,1,0,5,0,379,0,0,0,0,0,0,0,1,0,0,4
Calhoun,5/22/20,0,0,0,0,0,0,0,0,0,0,0,54,0,0,0,0,0,0,0,54,0,0,0,0,0,0,0,0,0,0,1
Carroll,5/22/20,0,0,0,0,0,0,0,0,0,9,0,547,0,5,0,0,0,4,0,556,0,0,0,0,0,0,0,1,0,0,17
Chicot,5/22/20,0,0,0,0,0,0,0,0,0,12,0,191,0,9,0,0,0,3,0,203,0,0,0,0,0,0,0,0,0,0,1
Clark,5/22/20,0,0,0,0,0,0,0,0,0,36,0,672,0,34,0,0,0,2,0,708,0,0,0,0,0,0,0,1,0,0,7
Clay,5/22/20,0,0,0,0,0,0,0,0,0,4,0,456,0,3,0,0,0,1,0,460,0,0,0,0,0,0,0,0,0,0,20
Cleburne,5/22/20,0,0,0,0,0,0,0,0,0,73,0,581,0,68,0,4,0,1,0,654,0,0,0,0,0,0,0,0,0,0,12
Cleveland,5/22/20,0,0,0,0,0,0,0,0,0,18,0,272,0,15,0,0,0,3,0,290,0,0,0,0,0,0,0,1,1,0,2
Columbia,5/22/20,0,0,0,0,0,0,0,0,0,20,0,292,0,12,0,2,0,6,0,312,0,0,0,0,0,0,0,0,0,0,8
Conway,5/22/20,0,0,0,0,0,0,0,0,0,14,0,492,0,12,0,1,0,1,0,506,0,0,0,0,0,0,0,0,0,0,10
Craighead,5/22/20,0,0,0,0,0,0,0,0,0,174,0,3428,0,115,0,0,0,59,0,3602,0,0,0,0,0,0,0,4,4,0,212
Crawford,5/22/20,0,0,0,0,0,0,0,0,0,12,0,555,0,11,0,0,0,1,0,567,0,0,0,0,0,0,0,0,1,0,6
Crittenden,5/22/20,0,0,0,0,0,0,0,0,0,276,0,2426,0,208,0,8,0,60,0,2702,0,0,0,0,0,0,0,9,4,0,198
Cross,5/22/20,0,0,0,0,0,0,0,0,0,42,0,539,0,28,0,0,0,14,0,581,0,0,0,0,0,0,0,1,0,0,24
Dallas,5/22/20,0,0,0,0,0,0,0,0,0,1,0,137,0,1,0,0,0,0,0,138,0,0,0,0,0,0,0,0,0,0,8
Desha,5/22/20,0,0,0,0,0,0,0,0,0,18,0,394,0,18,0,0,0,0,0,412,0,0,0,0,0,0,0,0,0,0,2
Drew,5/22/20,0,0,0,0,0,0,0,0,0,19,0,526,0,16,0,1,0,2,0,545,0,0,0,0,0,0,0,0,0,0,9
Faulkner,5/22/20,0,0,0,0,0,0,0,0,0,98,0,2625,0,81,0,3,0,14,0,2723,0,0,0,0,0,0,0,0,0,0,63
Franklin,5/22/20,0,0,0,0,0,0,0,0,0,2,0,213,0,2,0,0,0,0,0,215,0,0,0,0,0,0,0,0,0,0,5
Fulton,5/22/20,0,0,0,0,0,0,0,0,0,6,0,213,0,3,0,0,0,3,0,219,0,0,0,0,0,0,0,2,0,0,14
Garland,5/22/20,0,0,0,0,0,0,0,0,0,132,0,3540,0,123,0,1,0,8,0,3672,0,0,0,0,0,0,0,1,2,0,47
Grant,5/22/20,0,0,0,0,0,0,0,0,0,16,0,416,0,16,0,0,0,0,0,432,0,0,0,0,0,0,0,0,1,0,5
Greene,5/22/20,0,0,0,0,0,0,0,0,0,42,0,1463,0,24,0,0,0,18,0,1505,0,0,0,0,0,0,0,8,0,0,75
Hempstead,5/22/20,0,0,0,0,0,0,0,0,0,11,0,205,0,7,0,1,0,3,0,216,0,0,0,0,0,0,0,-1,0,0,2
HotSpring,5/22/20,0,0,0,0,0,0,0,0,0,29,0,727,0,28,0,0,0,1,0,756,0,0,0,0,0,0,0,0,2,0,18
Howard,5/22/20,0,0,0,0,0,0,0,0,0,15,0,244,0,14,0,0,0,1,0,259,0,0,0,0,0,0,0,1,0,0,8
Independence,5/22/20,0,0,0,0,0,0,0,0,0,27,0,647,0,23,0,0,0,4,0,674,0,0,0,0,0,0,0,0,2,0,12
Izard,5/22/20,0,0,0,0,0,0,0,0,0,14,0,174,0,11,0,0,0,3,0,188,0,0,0,0,0,0,0,0,0,0,4
Jackson,5/22/20,0,0,0,0,0,0,0,0,0,1,0,212,0,1,0,0,0,0,0,213,0,0,0,0,0,0,0,0,0,0,8
Jefferson,5/22/20,0,0,0,0,0,0,0,0,0,501,0,2242,0,220,0,23,0,258,0,2743,0,0,0,0,0,0,0,1,-48,1,25
Johnson,5/22/20,0,0,0,0,0,0,0,0,0,36,0,305,0,35,0,0,0,1,0,341,0,0,0,0,0,0,0,0,1,0,8
Lafayette,5/22/20,0,0,0,0,0,0,0,0,0,9,0,37,0,8,0,1,0,0,0,46,0,0,0,0,0,0,0,0,0,0,1
Lawrence,5/22/20,0,0,0,0,0,0,0,0,0,81,0,585,0,60,0,5,0,16,0,666,0,0,0,0,0,0,0,2,2,0,24
Lee,5/22/20,0,0,0,0,0,0,0,0,0,13,0,186,0,6,0,1,0,6,0,199,0,0,0,0,0,0,0,0,0,0,2
Lincoln,5/22/20,0,0,0,0,0,0,0,0,0,966,0,913,0,937,0,8,0,21,0,1879,0,0,0,0,0,0,0,0,14,0,6
LittleRiver,5/22/20,0,0,0,0,0,0,0,0,0,1,0,154,0,0,0,0,0,1,0,155,0,0,0,0,0,0,0,0,0,0,3
Logan,5/22/20,0,0,0,0,0,0,0,0,0,4,0,231,0,4,0,0,0,0,0,235,0,0,0,0,0,0,0,0,0,0,7
Lonoke,5/22/20,0,0,0,0,0,0,0,0,0,46,0,1518,0,43,0,0,0,3,0,1564,0,0,0,0,0,0,0,0,0,0,37
Madison,5/22/20,0,0,0,0,0,0,0,0,0,3,0,248,0,1,0,0,0,2,0,251,0,0,0,0,0,0,0,1,0,0,5
Marion,5/22/20,0,0,0,0,0,0,0,0,0,1,0,147,0,1,0,0,0,0,0,148,0,0,0,0,0,0,0,0,0,0,13
Miller,5/22/20,0,0,0,0,0,0,0,0,0,42,0,582,0,38,0,1,0,3,0,624,0,0,0,0,0,0,0,0,0,0,11
MissingCountyInfo,5/22/20,0,0,0,0,0,0,0,0,0,144,0,26145,0,114,0,0,0,30,0,26289,0,0,0,0,0,0,0,-17,1,0,-9447
Mississippi,5/22/20,0,0,0,0,0,0,0,0,0,70,0,857,0,55,0,1,0,14,0,927,0,0,0,0,0,0,0,1,3,0,28
Monroe,5/22/20,0,0,0,0,0,0,0,0,0,5,0,141,0,5,0,0,0,0,0,146,0,0,0,0,0,0,0,0,1,0,0
Montgomery,5/22/20,0,0,0,0,0,0,0,0,0,1,0,132,0,1,0,0,0,0,0,133,0,0,0,0,0,0,0,0,0,0,1
Nevada,5/22/20,0,0,0,0,0,0,0,0,0,4,0,112,0,3,0,0,0,1,0,116,0,0,0,0,0,0,0,0,0,0,3
Newton,5/22/20,0,0,0,0,0,0,0,0,0,3,0,110,0,3,0,0,0,0,0,113,0,0,0,0,0,0,0,0,0,0,0
Ouachita,5/22/20,0,0,0,0,0,0,0,0,0,10,0,682,0,9,0,0,0,1,0,692,0,0,0,0,0,0,0,0,0,0,21
Perry,5/22/20,0,0,0,0,0,0,0,0,0,12,0,239,0,11,0,0,0,1,0,251,0,0,0,0,0,0,0,0,0,0,9
Phillips,5/22/20,0,0,0,0,0,0,0,0,0,7,0,359,0,4,0,1,0,2,0,366,0,0,0,0,0,0,0,1,0,0,8
Pike,5/22/20,0,0,0,0,0,0,0,0,0,4,0,497,0,4,0,0,0,0,0,501,0,0,0,0,0,0,0,0,0,0,6
Poinsett,5/22/20,0,0,0,0,0,0,0,0,0,31,0,445,0,22,0,2,0,7,0,476,0,0,0,0,0,0,0,1,0,0,24
Polk,5/22/20,0,0,0,0,0,0,0,0,0,9,0,392,0,8,0,0,0,1,0,401,0,0,0,0,0,0,0,0,0,0,11
Pope,5/22/20,0,0,0,0,0,0,0,0,0,100,0,2121,0,52,0,1,0,47,0,2221,0,0,0,0,0,0,0,8,2,0,32
Prairie,5/22/20,0,0,0,0,0,0,0,0,0,2,0,89,0,2,0,0,0,0,0,91,0,0,0,0,0,0,0,0,0,0,0
Pulaski,5/22/20,0,0,0,0,0,0,0,0,0,761,0,10612,0,602,0,29,0,130,0,11373,0,0,0,0,0,0,0,21,9,1,241
Randolph,5/22/20,0,0,0,0,0,0,0,0,0,25,0,853,0,21,0,0,0,4,0,878,0,0,0,0,0,0,0,1,0,0,63
Saline,5/22/20,0,0,0,0,0,0,0,0,0,83,0,2839,0,74,0,1,0,8,0,2922,0,0,0,0,0,0,0,0,1,0,81
Scott,5/22/20,0,0,0,0,0,0,0,0,0,1,0,24,0,1,0,0,0,0,0,25,0,0,0,0,0,0,0,0,0,0,0
Searcy,5/22/20,0,0,0,0,0,0,0,0,0,6,0,312,0,6,0,0,0,0,0,318,0,0,0,0,0,0,0,0,0,0,4
Sebastian,5/22/20,0,0,0,0,0,0,0,0,0,18,0,908,0,15,0,0,0,3,0,926,0,0,0,0,0,0,0,0,0,0,16
Sevier,5/22/20,0,0,0,0,0,0,0,0,0,62,0,429,0,23,0,1,0,38,0,491,0,0,0,0,0,0,0,12,2,0,24
Sharp,5/22/20,0,0,0,0,0,0,0,0,0,42,0,260,0,11,0,2,0,29,0,302,0,0,0,0,0,0,0,0,2,0,26
St.Francis,5/22/20,0,0,0,0,0,0,0,0,0,621,0,2406,0,297,0,1,0,323,0,3027,0,0,0,0,0,0,0,21,31,1,175
Stone,5/22/20,0,0,0,0,0,0,0,0,0,8,0,203,0,8,0,0,0,0,0,211,0,0,0,0,0,0,0,0,0,0,3
Union,5/22/20,0,0,0,0,0,0,0,0,0,144,0,768,0,92,0,4,0,48,0,912,0,0,0,0,0,0,0,4,11,0,18
VanBuren,5/22/20,0,0,0,0,0,0,0,0,0,28,0,407,0,26,0,2,0,0,0,435,0,0,0,0,0,0,0,0,0,0,7
Washington,5/22/20,0,0,0,0,0,0,0,0,0,213,0,3656,0,105,0,5,0,103,0,3869,0,0,0,0,0,0,0,33,1,0,103
White,5/22/20,0,0,0,0,0,0,0,0,0,37,0,1564,0,34,0,1,0,2,0,1601,0,0,0,0,0,0,0,0,1,0,60
Woodruff,5/22/20,0,0,0,0,0,0,0,0,0,1,0,85,0,1,0,0,0,0,0,86,0,0,0,0,0,0,0,0,0,0,1
Yell,5/22/20,0,0,0,0,0,0,0,0,0,76,0,301,0,12,0,1,0,63,0,377,0,0,0,0,0,0,0,3,2,0,7
Arkansas_all_counties,5/21/20,0,0,0,0,0,0,0,0,2990671,5458,0,93818,0,3915,0,110,0,1433,0,99276,0,0,0,0,0,0,0,455,63,3,3018
Arkansas_county,5/21/20,0,0,0,0,0,0,0,0,0,2,0,241,0,2,0,0,0,0,0,243,0,0,0,0,0,0,0,0,0,0,7
Ashley,5/21/20,0,0,0,0,0,0,0,0,0,19,0,506,0,18,0,0,0,1,0,525,0,0,0,0,0,0,0,0,0,0,13
Baxter,5/21/20,0,0,0,0,0,0,0,0,0,6,0,486,0,5,0,0,0,1,0,492,0,0,0,0,0,0,0,0,0,0,6
Benton,5/21/20,0,0,0,0,0,0,0,0,0,190,0,7797,0,123,0,0,0,67,0,7987,0,0,0,0,0,0,0,27,3,0,531
Boone,5/21/20,0,0,0,0,0,0,0,0,0,5,0,540,0,4,0,0,0,1,0,545,0,0,0,0,0,0,0,0,0,0,12
Bradley,5/21/20,0,0,0,0,0,0,0,0,0,15,0,360,0,10,0,1,0,4,0,375,0,0,0,0,0,0,0,1,0,0,16
Calhoun,5/21/20,0,0,0,0,0,0,0,0,0,0,0,53,0,0,0,0,0,0,0,53,0,0,0,0,0,0,0,0,0,0,1
Carroll,5/21/20,0,0,0,0,0,0,0,0,0,8,0,531,0,5,0,0,0,3,0,539,0,0,0,0,0,0,0,2,0,0,34
Chicot,5/21/20,0,0,0,0,0,0,0,0,0,12,0,190,0,9,0,0,0,3,0,202,0,0,0,0,0,0,0,1,0,0,5
Clark,5/21/20,0,0,0,0,0,0,0,0,0,35,0,666,0,34,0,0,0,1,0,701,0,0,0,0,0,0,0,0,0,0,12
Clay,5/21/20,0,0,0,0,0,0,0,0,0,4,0,436,0,3,0,0,0,1,0,440,0,0,0,0,0,0,0,0,0,0,13
Cleburne,5/21/20,0,0,0,0,0,0,0,0,0,73,0,569,0,68,0,4,0,1,0,642,0,0,0,0,0,0,0,0,0,0,24
Cleveland,5/21/20,0,0,0,0,0,0,0,0,0,17,0,271,0,14,0,0,0,3,0,288,0,0,0,0,0,0,0,0,1,0,7
Columbia,5/21/20,0,0,0,0,0,0,0,0,0,20,0,284,0,12,0,2,0,6,0,304,0,0,0,0,0,0,0,0,0,0,4
Conway,5/21/20,0,0,0,0,0,0,0,0,0,14,0,482,0,12,0,1,0,1,0,496,0,0,0,0,0,0,0,0,0,0,8
Craighead,5/21/20,0,0,0,0,0,0,0,0,0,170,0,3220,0,111,0,0,0,59,0,3390,0,0,0,0,0,0,0,17,5,0,256
Crawford,5/21/20,0,0,0,0,0,0,0,0,0,12,0,549,0,10,0,0,0,2,0,561,0,0,0,0,0,0,0,0,1,0,14
Crittenden,5/21/20,0,0,0,0,0,0,0,0,0,267,0,2237,0,204,0,8,0,55,0,2504,0,0,0,0,0,0,0,17,2,0,71
Cross,5/21/20,0,0,0,0,0,0,0,0,0,41,0,516,0,28,0,0,0,13,0,557,0,0,0,0,0,0,0,1,1,0,17
Dallas,5/21/20,0,0,0,0,0,0,0,0,0,1,0,129,0,1,0,0,0,0,0,130,0,0,0,0,0,0,0,0,0,0,8
Desha,5/21/20,0,0,0,0,0,0,0,0,0,18,0,392,0,18,0,0,0,0,0,410,0,0,0,0,0,0,0,0,0,0,6
Drew,5/21/20,0,0,0,0,0,0,0,0,0,19,0,517,0,16,0,1,0,2,0,536,0,0,0,0,0,0,0,2,0,0,15
Faulkner,5/21/20,0,0,0,0,0,0,0,0,0,98,0,2562,0,81,0,3,0,14,0,2660,0,0,0,0,0,0,0,3,1,0,48
Franklin,5/21/20,0,0,0,0,0,0,0,0,0,2,0,208,0,2,0,0,0,0,0,210,0,0,0,0,0,0,0,0,0,0,12
Fulton,5/21/20,0,0,0,0,0,0,0,0,0,4,0,201,0,3,0,0,0,1,0,205,0,0,0,0,0,0,0,0,0,0,7
Garland,5/21/20,0,0,0,0,0,0,0,0,0,131,0,3494,0,121,0,1,0,9,0,3625,0,0,0,0,0,0,0,1,1,0,61
Grant,5/21/20,0,0,0,0,0,0,0,0,0,16,0,411,0,15,0,0,0,1,0,427,0,0,0,0,0,0,0,0,0,0,8
Greene,5/21/20,0,0,0,0,0,0,0,0,0,34,0,1396,0,24,0,0,0,10,0,1430,0,0,0,0,0,0,0,5,0,0,59
Hempstead,5/21/20,0,0,0,0,0,0,0,0,0,12,0,202,0,7,0,1,0,4,0,214,0,0,0,0,0,0,0,2,1,0,19
HotSpring,5/21/20,0,0,0,0,0,0,0,0,0,29,0,709,0,26,0,0,0,3,0,738,0,0,0,0,0,0,0,0,1,0,9
Howard,5/21/20,0,0,0,0,0,0,0,0,0,14,0,237,0,14,0,0,0,0,0,251,0,0,0,0,0,0,0,0,0,0,2
Independence,5/21/20,0,0,0,0,0,0,0,0,0,27,0,635,0,21,0,0,0,6,0,662,0,0,0,0,0,0,0,0,2,0,29
Izard,5/21/20,0,0,0,0,0,0,0,0,0,14,0,170,0,11,0,0,0,3,0,184,0,0,0,0,0,0,0,0,1,0,4
Jackson,5/21/20,0,0,0,0,0,0,0,0,0,1,0,204,0,1,0,0,0,0,0,205,0,0,0,0,0,0,0,0,0,0,8
Jefferson,5/21/20,0,0,0,0,0,0,0,0,0,500,0,2218,0,268,0,22,0,210,0,2718,0,0,0,0,0,0,0,1,57,1,34
Johnson,5/21/20,0,0,0,0,0,0,0,0,0,36,0,297,0,34,0,0,0,2,0,333,0,0,0,0,0,0,0,1,1,0,7
Lafayette,5/21/20,0,0,0,0,0,0,0,0,0,9,0,36,0,8,0,1,0,0,0,45,0,0,0,0,0,0,0,0,0,0,0
Lawrence,5/21/20,0,0,0,0,0,0,0,0,0,79,0,563,0,58,0,5,0,16,0,642,0,0,0,0,0,0,0,2,2,1,17
Lee,5/21/20,0,0,0,0,0,0,0,0,0,13,0,184,0,6,0,1,0,6,0,197,0,0,0,0,0,0,0,1,0,0,9
Lincoln,5/21/20,0,0,0,0,0,0,0,0,0,966,0,907,0,923,0,8,0,35,0,1873,0,0,0,0,0,0,0,0,1,0,7
LittleRiver,5/21/20,0,0,0,0,0,0,0,0,0,1,0,151,0,0,0,0,0,1,0,152,0,0,0,0,0,0,0,0,0,0,9
Logan,5/21/20,0,0,0,0,0,0,0,0,0,4,0,224,0,4,0,0,0,0,0,228,0,0,0,0,0,0,0,0,0,0,3
Lonoke,5/21/20,0,0,0,0,0,0,0,0,0,46,0,1481,0,43,0,0,0,3,0,1527,0,0,0,0,0,0,0,0,0,0,43
Madison,5/21/20,0,0,0,0,0,0,0,0,0,2,0,244,0,1,0,0,0,1,0,246,0,0,0,0,0,0,0,0,0,0,8
Marion,5/21/20,0,0,0,0,0,0,0,0,0,1,0,134,0,1,0,0,0,0,0,135,0,0,0,0,0,0,0,0,0,0,3
Miller,5/21/20,0,0,0,0,0,0,0,0,0,42,0,571,0,38,0,1,0,3,0,613,0,0,0,0,0,0,0,0,1,0,26
MissingCountyInfo,5/21/20,0,0,0,0,0,0,0,0,0,151,0,35585,0,113,0,0,0,38,0,35736,0,0,0,0,0,0,0,18,1,0,10868
Mississippi,5/21/20,0,0,0,0,0,0,0,0,0,69,0,830,0,52,0,1,0,16,0,899,0,0,0,0,0,0,0,3,3,0,39
Monroe,5/21/20,0,0,0,0,0,0,0,0,0,5,0,141,0,4,0,0,0,1,0,146,0,0,0,0,0,0,0,0,0,0,9
Montgomery,5/21/20,0,0,0,0,0,0,0,0,0,1,0,131,0,1,0,0,0,0,0,132,0,0,0,0,0,0,0,0,0,0,0
Nevada,5/21/20,0,0,0,0,0,0,0,0,0,4,0,109,0,3,0,0,0,1,0,113,0,0,0,0,0,0,0,0,0,0,3
Newton,5/21/20,0,0,0,0,0,0,0,0,0,3,0,110,0,3,0,0,0,0,0,113,0,0,0,0,0,0,0,0,0,0,2
Ouachita,5/21/20,0,0,0,0,0,0,0,0,0,10,0,661,0,9,0,0,0,1,0,671,0,0,0,0,0,0,0,0,1,0,5
Perry,5/21/20,0,0,0,0,0,0,0,0,0,12,0,230,0,11,0,0,0,1,0,242,0,0,0,0,0,0,0,0,0,0,7
Phillips,5/21/20,0,0,0,0,0,0,0,0,0,6,0,352,0,4,0,1,0,1,0,358,0,0,0,0,0,0,0,1,1,0,21
Pike,5/21/20,0,0,0,0,0,0,0,0,0,4,0,491,0,4,0,0,0,0,0,495,0,0,0,0,0,0,0,1,1,0,35
Poinsett,5/21/20,0,0,0,0,0,0,0,0,0,30,0,422,0,22,0,2,0,6,0,452,0,0,0,0,0,0,0,2,0,0,18
Polk,5/21/20,0,0,0,0,0,0,0,0,0,9,0,381,0,8,0,0,0,1,0,390,0,0,0,0,0,0,0,0,1,0,3
Pope,5/21/20,0,0,0,0,0,0,0,0,0,92,0,2097,0,50,0,1,0,41,0,2189,0,0,0,0,0,0,0,13,3,1,62
Prairie,5/21/20,0,0,0,0,0,0,0,0,0,2,0,89,0,2,0,0,0,0,0,91,0,0,0,0,0,0,0,0,0,0,6
Pulaski,5/21/20,0,0,0,0,0,0,0,0,0,740,0,10392,0,593,0,28,0,119,0,11132,0,0,0,0,0,0,0,13,6,0,359
Randolph,5/21/20,0,0,0,0,0,0,0,0,0,24,0,791,0,21,0,0,0,3,0,815,0,0,0,0,0,0,0,0,0,0,12
Saline,5/21/20,0,0,0,0,0,0,0,0,0,83,0,2758,0,73,0,1,0,9,0,2841,0,0,0,0,0,0,0,1,1,0,84
Scott,5/21/20,0,0,0,0,0,0,0,0,0,1,0,24,0,1,0,0,0,0,0,25,0,0,0,0,0,0,0,0,0,0,1
Searcy,5/21/20,0,0,0,0,0,0,0,0,0,6,0,308,0,6,0,0,0,0,0,314,0,0,0,0,0,0,0,0,0,0,7
Sebastian,5/21/20,0,0,0,0,0,0,0,0,0,18,0,892,0,15,0,0,0,3,0,910,0,0,0,0,0,0,0,0,0,0,32
Sevier,5/21/20,0,0,0,0,0,0,0,0,0,50,0,417,0,21,0,1,0,28,0,467,0,0,0,0,0,0,0,1,2,0,7
Sharp,5/21/20,0,0,0,0,0,0,0,0,0,42,0,234,0,9,0,2,0,31,0,276,0,0,0,0,0,0,0,2,1,0,8
St.Francis,5/21/20,0,0,0,0,0,0,0,0,0,600,0,2252,0,268,0,0,0,332,0,2852,0,0,0,0,0,0,0,235,6,0,741
Stone,5/21/20,0,0,0,0,0,0,0,0,0,8,0,200,0,8,0,0,0,0,0,208,0,0,0,0,0,0,0,0,0,0,4
Union,5/21/20,0,0,0,0,0,0,0,0,0,140,0,754,0,81,0,4,0,55,0,894,0,0,0,0,0,0,0,19,6,0,60
VanBuren,5/21/20,0,0,0,0,0,0,0,0,0,28,0,400,0,26,0,2,0,0,0,428,0,0,0,0,0,0,0,0,0,0,13
Washington,5/21/20,0,0,0,0,0,0,0,0,0,180,0,3586,0,104,0,5,0,71,0,3766,0,0,0,0,0,0,0,26,2,0,416
White,5/21/20,0,0,0,0,0,0,0,0,0,37,0,1504,0,33,0,1,0,3,0,1541,0,0,0,0,0,0,0,0,0,0,52
Woodruff,5/21/20,0,0,0,0,0,0,0,0,0,1,0,84,0,1,0,0,0,0,0,85,0,0,0,0,0,0,0,0,0,0,1
Yell,5/21/20,0,0,0,0,0,0,0,0,0,73,0,297,0,10,0,1,0,62,0,370,0,0,0,0,0,0,0,35,4,0,54
Arkansas_all_counties,5/20/20,0,0,0,0,0,0,0,0,2990671,5003,0,91255,0,3852,0,107,0,1044,0,96258,0,0,0,0,0,0,0,80,113,5,2557
Arkansas_county,5/20/20,0,0,0,0,0,0,0,0,0,2,0,234,0,2,0,0,0,0,0,236,0,0,0,0,0,0,0,0,0,0,15
Ashley,5/20/20,0,0,0,0,0,0,0,0,0,19,0,493,0,18,0,0,0,1,0,512,0,0,0,0,0,0,0,0,1,0,8
Baxter,5/20/20,0,0,0,0,0,0,0,0,0,6,0,480,0,5,0,0,0,1,0,486,0,0,0,0,0,0,0,0,0,0,5
Benton,5/20/20,0,0,0,0,0,0,0,0,0,163,0,7293,0,120,0,0,0,43,0,7456,0,0,0,0,0,0,0,8,2,0,220
Boone,5/20/20,0,0,0,0,0,0,0,0,0,5,0,528,0,4,0,0,0,1,0,533,0,0,0,0,0,0,0,0,0,0,19
Bradley,5/20/20,0,0,0,0,0,0,0,0,0,14,0,345,0,10,0,1,0,3,0,359,0,0,0,0,0,0,0,0,0,0,3
Calhoun,5/20/20,0,0,0,0,0,0,0,0,0,0,0,52,0,0,0,0,0,0,0,52,0,0,0,0,0,0,0,0,0,0,4
Carroll,5/20/20,0,0,0,0,0,0,0,0,0,6,0,499,0,5,0,0,0,1,0,505,0,0,0,0,0,0,0,0,0,0,20
Chicot,5/20/20,0,0,0,0,0,0,0,0,0,11,0,186,0,9,0,0,0,2,0,197,0,0,0,0,0,0,0,0,0,0,3
Clark,5/20/20,0,0,0,0,0,0,0,0,0,35,0,654,0,34,0,0,0,1,0,689,0,0,0,0,0,0,0,0,0,0,7
Clay,5/20/20,0,0,0,0,0,0,0,0,0,4,0,423,0,3,0,0,0,1,0,427,0,0,0,0,0,0,0,0,0,0,9
Cleburne,5/20/20,0,0,0,0,0,0,0,0,0,73,0,545,0,68,0,4,0,1,0,618,0,0,0,0,0,0,0,1,0,0,19
Cleveland,5/20/20,0,0,0,0,0,0,0,0,0,17,0,264,0,13,0,0,0,4,0,281,0,0,0,0,0,0,0,0,0,0,4
Columbia,5/20/20,0,0,0,0,0,0,0,0,0,20,0,280,0,12,0,2,0,6,0,300,0,0,0,0,0,0,0,2,0,0,6
Conway,5/20/20,0,0,0,0,0,0,0,0,0,14,0,474,0,12,0,1,0,1,0,488,0,0,0,0,0,0,0,0,0,0,14
Craighead,5/20/20,0,0,0,0,0,0,0,0,0,153,0,2981,0,106,0,0,0,47,0,3134,0,0,0,0,0,0,0,6,6,0,194
Crawford,5/20/20,0,0,0,0,0,0,0,0,0,12,0,535,0,9,0,0,0,3,0,547,0,0,0,0,0,0,0,0,3,0,20
Crittenden,5/20/20,0,0,0,0,0,0,0,0,0,250,0,2183,0,202,0,8,0,40,0,2433,0,0,0,0,0,0,0,9,2,1,95
Cross,5/20/20,0,0,0,0,0,0,0,0,0,40,0,500,0,27,0,0,0,13,0,540,0,0,0,0,0,0,0,1,0,0,14
Dallas,5/20/20,0,0,0,0,0,0,0,0,0,1,0,121,0,1,0,0,0,0,0,122,0,0,0,0,0,0,0,0,0,0,0
Desha,5/20/20,0,0,0,0,0,0,0,0,0,18,0,386,0,18,0,0,0,0,0,404,0,0,0,0,0,0,0,0,1,0,8
Drew,5/20/20,0,0,0,0,0,0,0,0,0,19,0,502,0,16,0,1,0,2,0,521,0,0,0,0,0,0,0,0,0,0,15
Faulkner,5/20/20,0,0,0,0,0,0,0,0,0,95,0,2517,0,80,0,3,0,12,0,2612,0,0,0,0,0,0,0,0,0,0,64
Franklin,5/20/20,0,0,0,0,0,0,0,0,0,2,0,196,0,2,0,0,0,0,0,198,0,0,0,0,0,0,0,0,0,0,6
Fulton,5/20/20,0,0,0,0,0,0,0,0,0,4,0,194,0,3,0,0,0,1,0,198,0,0,0,0,0,0,0,0,0,0,8
Garland,5/20/20,0,0,0,0,0,0,0,0,0,130,0,3434,0,120,0,1,0,9,0,3564,0,0,0,0,0,0,0,0,2,0,72
Grant,5/20/20,0,0,0,0,0,0,0,0,0,16,0,403,0,15,0,0,0,1,0,419,0,0,0,0,0,0,0,0,0,0,9
Greene,5/20/20,0,0,0,0,0,0,0,0,0,29,0,1342,0,24,0,0,0,5,0,1371,0,0,0,0,0,0,0,4,1,0,63
Hempstead,5/20/20,0,0,0,0,0,0,0,0,0,10,0,185,0,6,0,1,0,3,0,195,0,0,0,0,0,0,0,1,0,0,4
HotSpring,5/20/20,0,0,0,0,0,0,0,0,0,29,0,700,0,25,0,0,0,4,0,729,0,0,0,0,0,0,0,0,0,0,18
Howard,5/20/20,0,0,0,0,0,0,0,0,0,14,0,235,0,14,0,0,0,0,0,249,0,0,0,0,0,0,0,0,0,0,2
Independence,5/20/20,0,0,0,0,0,0,0,0,0,27,0,606,0,19,0,0,0,8,0,633,0,0,0,0,0,0,0,1,1,0,13
Izard,5/20/20,0,0,0,0,0,0,0,0,0,14,0,166,0,10,0,0,0,4,0,180,0,0,0,0,0,0,0,0,0,0,5
Jackson,5/20/20,0,0,0,0,0,0,0,0,0,1,0,196,0,1,0,0,0,0,0,197,0,0,0,0,0,0,0,0,0,0,10
Jefferson,5/20/20,0,0,0,0,0,0,0,0,0,499,0,2185,0,211,0,21,0,267,0,2684,0,0,0,0,0,0,0,2,15,1,42
Johnson,5/20/20,0,0,0,0,0,0,0,0,0,35,0,291,0,33,0,0,0,2,0,326,0,0,0,0,0,0,0,0,0,0,4
Lafayette,5/20/20,0,0,0,0,0,0,0,0,0,9,0,36,0,8,0,1,0,0,0,45,0,0,0,0,0,0,0,0,0,0,0
Lawrence,5/20/20,0,0,0,0,0,0,0,0,0,77,0,548,0,56,0,4,0,17,0,625,0,0,0,0,0,0,0,0,0,0,11
Lee,5/20/20,0,0,0,0,0,0,0,0,0,12,0,176,0,6,0,1,0,5,0,188,0,0,0,0,0,0,0,0,2,0,2
Lincoln,5/20/20,0,0,0,0,0,0,0,0,0,966,0,900,0,922,0,8,0,36,0,1866,0,0,0,0,0,0,0,1,36,0,3
LittleRiver,5/20/20,0,0,0,0,0,0,0,0,0,1,0,142,0,0,0,0,0,1,0,143,0,0,0,0,0,0,0,0,0,0,5
Logan,5/20/20,0,0,0,0,0,0,0,0,0,4,0,221,0,4,0,0,0,0,0,225,0,0,0,0,0,0,0,0,0,0,3
Lonoke,5/20/20,0,0,0,0,0,0,0,0,0,46,0,1438,0,43,0,0,0,3,0,1484,0,0,0,0,0,0,0,0,0,0,50
Madison,5/20/20,0,0,0,0,0,0,0,0,0,2,0,236,0,1,0,0,0,1,0,238,0,0,0,0,0,0,0,0,0,0,8
Marion,5/20/20,0,0,0,0,0,0,0,0,0,1,0,131,0,1,0,0,0,0,0,132,0,0,0,0,0,0,0,0,0,0,3
Miller,5/20/20,0,0,0,0,0,0,0,0,0,42,0,545,0,37,0,1,0,4,0,587,0,0,0,0,0,0,0,0,0,0,26
MissingCountyInfo,5/20/20,0,0,0,0,0,0,0,0,0,133,0,24735,0,112,0,0,0,21,0,24868,0,0,0,0,0,0,0,3,7,0,570
Mississippi,5/20/20,0,0,0,0,0,0,0,0,0,66,0,794,0,49,0,1,0,16,0,860,0,0,0,0,0,0,0,1,2,0,20
Monroe,5/20/20,0,0,0,0,0,0,0,0,0,5,0,132,0,4,0,0,0,1,0,137,0,0,0,0,0,0,0,0,0,0,4
Montgomery,5/20/20,0,0,0,0,0,0,0,0,0,1,0,131,0,1,0,0,0,0,0,132,0,0,0,0,0,0,0,0,0,0,4
Nevada,5/20/20,0,0,0,0,0,0,0,0,0,4,0,106,0,3,0,0,0,1,0,110,0,0,0,0,0,0,0,0,0,0,2
Newton,5/20/20,0,0,0,0,0,0,0,0,0,3,0,108,0,3,0,0,0,0,0,111,0,0,0,0,0,0,0,0,0,0,2
Ouachita,5/20/20,0,0,0,0,0,0,0,0,0,10,0,656,0,8,0,0,0,2,0,666,0,0,0,0,0,0,0,0,0,0,8
Perry,5/20/20,0,0,0,0,0,0,0,0,0,12,0,223,0,11,0,0,0,1,0,235,0,0,0,0,0,0,0,0,0,0,7
Phillips,5/20/20,0,0,0,0,0,0,0,0,0,5,0,332,0,3,0,1,0,1,0,337,0,0,0,0,0,0,0,0,0,0,30
Pike,5/20/20,0,0,0,0,0,0,0,0,0,3,0,457,0,3,0,0,0,0,0,460,0,0,0,0,0,0,0,0,0,0,9
Poinsett,5/20/20,0,0,0,0,0,0,0,0,0,28,0,406,0,22,0,2,0,4,0,434,0,0,0,0,0,0,0,0,0,0,24
Polk,5/20/20,0,0,0,0,0,0,0,0,0,9,0,378,0,7,0,0,0,2,0,387,0,0,0,0,0,0,0,1,0,0,16
Pope,5/20/20,0,0,0,0,0,0,0,0,0,79,0,2048,0,47,0,0,0,32,0,2127,0,0,0,0,0,0,0,3,1,0,33
Prairie,5/20/20,0,0,0,0,0,0,0,0,0,2,0,83,0,2,0,0,0,0,0,85,0,0,0,0,0,0,0,0,0,0,0
Pulaski,5/20/20,0,0,0,0,0,0,0,0,0,724,0,10049,0,587,0,28,0,109,0,10773,0,0,0,0,0,0,0,11,11,3,346
Randolph,5/20/20,0,0,0,0,0,0,0,0,0,24,0,779,0,21,0,0,0,3,0,803,0,0,0,0,0,0,0,1,0,0,14
Saline,5/20/20,0,0,0,0,0,0,0,0,0,82,0,2675,0,72,0,1,0,9,0,2757,0,0,0,0,0,0,0,0,0,0,70
Scott,5/20/20,0,0,0,0,0,0,0,0,0,1,0,23,0,1,0,0,0,0,0,24,0,0,0,0,0,0,0,0,0,0,1
Searcy,5/20/20,0,0,0,0,0,0,0,0,0,6,0,301,0,6,0,0,0,0,0,307,0,0,0,0,0,0,0,0,0,0,8
Sebastian,5/20/20,0,0,0,0,0,0,0,0,0,18,0,860,0,15,0,0,0,3,0,878,0,0,0,0,0,0,0,1,0,0,23
Sevier,5/20/20,0,0,0,0,0,0,0,0,0,49,0,411,0,19,0,1,0,29,0,460,0,0,0,0,0,0,0,3,1,0,11
Sharp,5/20/20,0,0,0,0,0,0,0,0,0,40,0,228,0,8,0,2,0,30,0,268,0,0,0,0,0,0,0,2,1,0,4
St.Francis,5/20/20,0,0,0,0,0,0,0,0,0,365,0,1754,0,262,0,0,0,103,0,2119,0,0,0,0,0,0,0,3,11,0,18
Stone,5/20/20,0,0,0,0,0,0,0,0,0,8,0,196,0,8,0,0,0,0,0,204,0,0,0,0,0,0,0,0,0,0,2
Union,5/20/20,0,0,0,0,0,0,0,0,0,121,0,713,0,75,0,4,0,42,0,834,0,0,0,0,0,0,0,4,4,0,45
VanBuren,5/20/20,0,0,0,0,0,0,0,0,0,28,0,387,0,26,0,2,0,0,0,415,0,0,0,0,0,0,0,0,0,0,8
Washington,5/20/20,0,0,0,0,0,0,0,0,0,154,0,3496,0,102,0,5,0,47,0,3650,0,0,0,0,0,0,0,3,3,0,69
White,5/20/20,0,0,0,0,0,0,0,0,0,37,0,1452,0,33,0,1,0,3,0,1489,0,0,0,0,0,0,0,0,0,0,62
Woodruff,5/20/20,0,0,0,0,0,0,0,0,0,1,0,83,0,1,0,0,0,0,0,84,0,0,0,0,0,0,0,0,0,0,4
Yell,5/20/20,0,0,0,0,0,0,0,0,0,38,0,278,0,6,0,1,0,31,0,316,0,0,0,0,0,0,0,8,0,0,10
Arkansas_all_counties,5/19/20,0,0,0,0,0,0,0,0,2990671,4923,0,88778,0,3739,0,102,0,1082,0,93701,0,0,0,0,0,0,0,110,94,2,6087
Arkansas_county,5/19/20,0,0,0,0,0,0,0,0,0,2,0,219,0,2,0,0,0,0,0,221,0,0,0,0,0,0,0,0,0,0,8
Ashley,5/19/20,0,0,0,0,0,0,0,0,0,19,0,485,0,17,0,0,0,2,0,504,0,0,0,0,0,0,0,1,0,0,8
Baxter,5/19/20,0,0,0,0,0,0,0,0,0,6,0,475,0,5,0,0,0,1,0,481,0,0,0,0,0,0,0,0,0,0,14
Benton,5/19/20,0,0,0,0,0,0,0,0,0,155,0,7081,0,118,0,0,0,37,0,7236,0,0,0,0,0,0,0,5,1,0,418
Boone,5/19/20,0,0,0,0,0,0,0,0,0,5,0,509,0,4,0,0,0,1,0,514,0,0,0,0,0,0,0,1,0,0,16
Bradley,5/19/20,0,0,0,0,0,0,0,0,0,14,0,342,0,10,0,1,0,3,0,356,0,0,0,0,0,0,0,-1,0,0,1
Calhoun,5/19/20,0,0,0,0,0,0,0,0,0,0,0,48,0,0,0,0,0,0,0,48,0,0,0,0,0,0,0,0,0,0,1
Carroll,5/19/20,0,0,0,0,0,0,0,0,0,6,0,479,0,5,0,0,0,1,0,485,0,0,0,0,0,0,0,0,0,0,28
Chicot,5/19/20,0,0,0,0,0,0,0,0,0,11,0,183,0,9,0,0,0,2,0,194,0,0,0,0,0,0,0,0,0,0,7
Clark,5/19/20,0,0,0,0,0,0,0,0,0,35,0,647,0,34,0,0,0,1,0,682,0,0,0,0,0,0,0,2,0,0,11
Clay,5/19/20,0,0,0,0,0,0,0,0,0,4,0,414,0,3,0,0,0,1,0,418,0,0,0,0,0,0,0,0,0,0,9
Cleburne,5/19/20,0,0,0,0,0,0,0,0,0,72,0,527,0,68,0,4,0,0,0,599,0,0,0,0,0,0,0,0,0,0,8
Cleveland,5/19/20,0,0,0,0,0,0,0,0,0,17,0,260,0,13,0,0,0,4,0,277,0,0,0,0,0,0,0,1,0,0,5
Columbia,5/19/20,0,0,0,0,0,0,0,0,0,18,0,276,0,12,0,2,0,4,0,294,0,0,0,0,0,0,0,2,0,0,9
Conway,5/19/20,0,0,0,0,0,0,0,0,0,14,0,460,0,12,0,1,0,1,0,474,0,0,0,0,0,0,0,0,0,0,10
Craighead,5/19/20,0,0,0,0,0,0,0,0,0,147,0,2793,0,100,0,0,0,47,0,2940,0,0,0,0,0,0,0,6,10,0,137
Crawford,5/19/20,0,0,0,0,0,0,0,0,0,12,0,515,0,6,0,0,0,6,0,527,0,0,0,0,0,0,0,1,1,0,17
Crittenden,5/19/20,0,0,0,0,0,0,0,0,0,241,0,2097,0,200,0,7,0,34,0,2338,0,0,0,0,0,0,0,4,4,0,90
Cross,5/19/20,0,0,0,0,0,0,0,0,0,39,0,487,0,27,0,0,0,12,0,526,0,0,0,0,0,0,0,3,0,0,33
Dallas,5/19/20,0,0,0,0,0,0,0,0,0,1,0,121,0,1,0,0,0,0,0,122,0,0,0,0,0,0,0,0,0,0,6
Desha,5/19/20,0,0,0,0,0,0,0,0,0,18,0,378,0,17,0,0,0,1,0,396,0,0,0,0,0,0,0,0,0,0,0
Drew,5/19/20,0,0,0,0,0,0,0,0,0,19,0,487,0,16,0,1,0,2,0,506,0,0,0,0,0,0,0,0,0,0,5
Faulkner,5/19/20,0,0,0,0,0,0,0,0,0,95,0,2453,0,80,0,3,0,12,0,2548,0,0,0,0,0,0,0,1,0,0,48
Franklin,5/19/20,0,0,0,0,0,0,0,0,0,2,0,190,0,2,0,0,0,0,0,192,0,0,0,0,0,0,0,0,0,0,8
Fulton,5/19/20,0,0,0,0,0,0,0,0,0,4,0,186,0,3,0,0,0,1,0,190,0,0,0,0,0,0,0,0,0,0,2
Garland,5/19/20,0,0,0,0,0,0,0,0,0,130,0,3362,0,118,0,1,0,11,0,3492,0,0,0,0,0,0,0,0,1,0,69
Grant,5/19/20,0,0,0,0,0,0,0,0,0,16,0,394,0,15,0,0,0,1,0,410,0,0,0,0,0,0,0,0,0,0,8
Greene,5/19/20,0,0,0,0,0,0,0,0,0,25,0,1283,0,23,0,0,0,2,0,1308,0,0,0,0,0,0,0,1,1,0,44
Hempstead,5/19/20,0,0,0,0,0,0,0,0,0,9,0,182,0,6,0,1,0,2,0,191,0,0,0,0,0,0,0,0,0,0,17
HotSpring,5/19/20,0,0,0,0,0,0,0,0,0,29,0,682,0,25,0,0,0,4,0,711,0,0,0,0,0,0,0,0,3,0,18
Howard,5/19/20,0,0,0,0,0,0,0,0,0,14,0,233,0,14,0,0,0,0,0,247,0,0,0,0,0,0,0,0,0,0,8
Independence,5/19/20,0,0,0,0,0,0,0,0,0,26,0,594,0,18,0,0,0,8,0,620,0,0,0,0,0,0,0,0,1,0,53
Izard,5/19/20,0,0,0,0,0,0,0,0,0,14,0,161,0,10,0,0,0,4,0,175,0,0,0,0,0,0,0,1,0,0,8
Jackson,5/19/20,0,0,0,0,0,0,0,0,0,1,0,186,0,1,0,0,0,0,0,187,0,0,0,0,0,0,0,0,0,0,3
Jefferson,5/19/20,0,0,0,0,0,0,0,0,0,497,0,2145,0,196,0,20,0,281,0,2642,0,0,0,0,0,0,0,6,1,1,55
Johnson,5/19/20,0,0,0,0,0,0,0,0,0,35,0,287,0,33,0,0,0,2,0,322,0,0,0,0,0,0,0,0,0,0,10
Lafayette,5/19/20,0,0,0,0,0,0,0,0,0,9,0,36,0,8,0,1,0,0,0,45,0,0,0,0,0,0,0,0,0,0,1
Lawrence,5/19/20,0,0,0,0,0,0,0,0,0,77,0,537,0,56,0,4,0,17,0,614,0,0,0,0,0,0,0,4,1,0,27
Lee,5/19/20,0,0,0,0,0,0,0,0,0,12,0,174,0,4,0,1,0,7,0,186,0,0,0,0,0,0,0,0,1,0,14
Lincoln,5/19/20,0,0,0,0,0,0,0,0,0,965,0,898,0,886,0,8,0,71,0,1863,0,0,0,0,0,0,0,0,11,0,6
LittleRiver,5/19/20,0,0,0,0,0,0,0,0,0,1,0,137,0,0,0,0,0,1,0,138,0,0,0,0,0,0,0,0,0,0,9
Logan,5/19/20,0,0,0,0,0,0,0,0,0,4,0,218,0,4,0,0,0,0,0,222,0,0,0,0,0,0,0,0,1,0,9
Lonoke,5/19/20,0,0,0,0,0,0,0,0,0,46,0,1388,0,43,0,0,0,3,0,1434,0,0,0,0,0,0,0,1,1,0,43
Madison,5/19/20,0,0,0,0,0,0,0,0,0,2,0,228,0,1,0,0,0,1,0,230,0,0,0,0,0,0,0,1,0,0,14
Marion,5/19/20,0,0,0,0,0,0,0,0,0,1,0,128,0,1,0,0,0,0,0,129,0,0,0,0,0,0,0,0,0,0,4
Miller,5/19/20,0,0,0,0,0,0,0,0,0,42,0,519,0,37,0,1,0,4,0,561,0,0,0,0,0,0,0,0,1,0,29
MissingCountyInfo,5/19/20,0,0,0,0,0,0,0,0,0,130,0,24168,0,105,0,0,0,25,0,24298,0,0,0,0,0,0,0,0,2,0,3538
Mississippi,5/19/20,0,0,0,0,0,0,0,0,0,65,0,775,0,47,0,1,0,17,0,840,0,0,0,0,0,0,0,3,17,1,41
Monroe,5/19/20,0,0,0,0,0,0,0,0,0,5,0,128,0,4,0,0,0,1,0,133,0,0,0,0,0,0,0,0,0,0,3
Montgomery,5/19/20,0,0,0,0,0,0,0,0,0,1,0,127,0,1,0,0,0,0,0,128,0,0,0,0,0,0,0,0,0,0,5
Nevada,5/19/20,0,0,0,0,0,0,0,0,0,4,0,104,0,3,0,0,0,1,0,108,0,0,0,0,0,0,0,0,0,0,5
Newton,5/19/20,0,0,0,0,0,0,0,0,0,3,0,106,0,3,0,0,0,0,0,109,0,0,0,0,0,0,0,0,0,0,3
Ouachita,5/19/20,0,0,0,0,0,0,0,0,0,10,0,648,0,8,0,0,0,2,0,658,0,0,0,0,0,0,0,0,1,0,30
Perry,5/19/20,0,0,0,0,0,0,0,0,0,12,0,216,0,11,0,0,0,1,0,228,0,0,0,0,0,0,0,0,3,0,4
Phillips,5/19/20,0,0,0,0,0,0,0,0,0,5,0,302,0,3,0,1,0,1,0,307,0,0,0,0,0,0,0,0,0,0,17
Pike,5/19/20,0,0,0,0,0,0,0,0,0,3,0,448,0,3,0,0,0,0,0,451,0,0,0,0,0,0,0,0,0,0,8
Poinsett,5/19/20,0,0,0,0,0,0,0,0,0,28,0,382,0,22,0,2,0,4,0,410,0,0,0,0,0,0,0,1,0,0,12
Polk,5/19/20,0,0,0,0,0,0,0,0,0,8,0,363,0,7,0,0,0,1,0,371,0,0,0,0,0,0,0,0,0,0,5
Pope,5/19/20,0,0,0,0,0,0,0,0,0,76,0,2018,0,46,0,0,0,30,0,2094,0,0,0,0,0,0,0,0,1,0,21
Prairie,5/19/20,0,0,0,0,0,0,0,0,0,2,0,83,0,2,0,0,0,0,0,85,0,0,0,0,0,0,0,0,0,0,0
Pulaski,5/19/20,0,0,0,0,0,0,0,0,0,713,0,9714,0,576,0,25,0,112,0,10427,0,0,0,0,0,0,0,20,16,0,401
Randolph,5/19/20,0,0,0,0,0,0,0,0,0,23,0,766,0,21,0,0,0,2,0,789,0,0,0,0,0,0,0,1,0,0,21
Saline,5/19/20,0,0,0,0,0,0,0,0,0,82,0,2605,0,72,0,1,0,9,0,2687,0,0,0,0,0,0,0,0,0,0,82
Scott,5/19/20,0,0,0,0,0,0,0,0,0,1,0,22,0,1,0,0,0,0,0,23,0,0,0,0,0,0,0,0,0,0,0
Searcy,5/19/20,0,0,0,0,0,0,0,0,0,6,0,293,0,6,0,0,0,0,0,299,0,0,0,0,0,0,0,0,0,0,13
Sebastian,5/19/20,0,0,0,0,0,0,0,0,0,17,0,838,0,15,0,0,0,2,0,855,0,0,0,0,0,0,0,1,0,0,31
Sevier,5/19/20,0,0,0,0,0,0,0,0,0,46,0,403,0,18,0,1,0,27,0,449,0,0,0,0,0,0,0,14,2,0,38
Sharp,5/19/20,0,0,0,0,0,0,0,0,0,38,0,226,0,7,0,2,0,29,0,264,0,0,0,0,0,0,0,1,1,0,7
St.Francis,5/19/20,0,0,0,0,0,0,0,0,0,362,0,1739,0,251,0,0,0,111,0,2101,0,0,0,0,0,0,0,13,9,0,197
Stone,5/19/20,0,0,0,0,0,0,0,0,0,8,0,194,0,8,0,0,0,0,0,202,0,0,0,0,0,0,0,0,0,0,16
Union,5/19/20,0,0,0,0,0,0,0,0,0,117,0,672,0,71,0,4,0,42,0,789,0,0,0,0,0,0,0,10,2,0,101
VanBuren,5/19/20,0,0,0,0,0,0,0,0,0,28,0,379,0,26,0,2,0,0,0,407,0,0,0,0,0,0,0,0,0,0,3
Washington,5/19/20,0,0,0,0,0,0,0,0,0,151,0,3430,0,99,0,5,0,47,0,3581,0,0,0,0,0,0,0,6,2,0,116
White,5/19/20,0,0,0,0,0,0,0,0,0,37,0,1390,0,33,0,1,0,3,0,1427,0,0,0,0,0,0,0,0,0,0,27
Woodruff,5/19/20,0,0,0,0,0,0,0,0,0,1,0,79,0,1,0,0,0,0,0,80,0,0,0,0,0,0,0,0,0,0,2
Yell,5/19/20,0,0,0,0,0,0,0,0,0,30,0,276,0,6,0,1,0,23,0,306,0,0,0,0,0,0,0,2,0,0,103
Arkansas_all_counties,5/18/20,0,0,0,0,0,0,0,0,2990671,4813,0,82801,0,3645,0,100,0,1068,0,87614,0,0,0,0,0,0,0,54,55,2,2429
Arkansas_county,5/18/20,0,0,0,0,0,0,0,0,0,2,0,211,0,2,0,0,0,0,0,213,0,0,0,0,0,0,0,0,0,0,7
Ashley,5/18/20,0,0,0,0,0,0,0,0,0,18,0,478,0,17,0,0,0,1,0,496,0,0,0,0,0,0,0,0,0,0,11
Baxter,5/18/20,0,0,0,0,0,0,0,0,0,6,0,461,0,5,0,0,0,1,0,467,0,0,0,0,0,0,0,0,0,0,15
Benton,5/18/20,0,0,0,0,0,0,0,0,0,150,0,6668,0,117,0,0,0,33,0,6818,0,0,0,0,0,0,0,1,1,0,190
Boone,5/18/20,0,0,0,0,0,0,0,0,0,4,0,494,0,4,0,0,0,0,0,498,0,0,0,0,0,0,0,0,0,0,3
Bradley,5/18/20,0,0,0,0,0,0,0,0,0,15,0,340,0,10,0,1,0,4,0,355,0,0,0,0,0,0,0,0,0,0,2
Calhoun,5/18/20,0,0,0,0,0,0,0,0,0,0,0,47,0,0,0,0,0,0,0,47,0,0,0,0,0,0,0,0,0,0,3
Carroll,5/18/20,0,0,0,0,0,0,0,0,0,6,0,451,0,5,0,0,0,1,0,457,0,0,0,0,0,0,0,1,0,0,23
Chicot,5/18/20,0,0,0,0,0,0,0,0,0,11,0,176,0,9,0,0,0,2,0,187,0,0,0,0,0,0,0,1,0,0,4
Clark,5/18/20,0,0,0,0,0,0,0,0,0,33,0,638,0,34,0,0,0,-1,0,671,0,0,0,0,0,0,0,-2,1,0,6
Clay,5/18/20,0,0,0,0,0,0,0,0,0,4,0,405,0,3,0,0,0,1,0,409,0,0,0,0,0,0,0,1,0,0,11
Cleburne,5/18/20,0,0,0,0,0,0,0,0,0,72,0,519,0,68,0,4,0,0,0,591,0,0,0,0,0,0,0,0,0,0,18
Cleveland,5/18/20,0,0,0,0,0,0,0,0,0,16,0,256,0,13,0,0,0,3,0,272,0,0,0,0,0,0,0,0,1,0,1
Columbia,5/18/20,0,0,0,0,0,0,0,0,0,16,0,269,0,12,0,2,0,2,0,285,0,0,0,0,0,0,0,1,1,0,6
Conway,5/18/20,0,0,0,0,0,0,0,0,0,14,0,450,0,12,0,1,0,1,0,464,0,0,0,0,0,0,0,0,0,0,4
Craighead,5/18/20,0,0,0,0,0,0,0,0,0,141,0,2662,0,90,0,0,0,51,0,2803,0,0,0,0,0,0,0,1,4,0,206
Crawford,5/18/20,0,0,0,0,0,0,0,0,0,11,0,499,0,5,0,0,0,6,0,510,0,0,0,0,0,0,0,0,0,0,9
Crittenden,5/18/20,0,0,0,0,0,0,0,0,0,237,0,2011,0,196,0,7,0,34,0,2248,0,0,0,0,0,0,0,3,1,0,43
Cross,5/18/20,0,0,0,0,0,0,0,0,0,36,0,457,0,27,0,0,0,9,0,493,0,0,0,0,0,0,0,1,2,0,23
Dallas,5/18/20,0,0,0,0,0,0,0,0,0,1,0,115,0,1,0,0,0,0,0,116,0,0,0,0,0,0,0,0,0,0,5
Desha,5/18/20,0,0,0,0,0,0,0,0,0,18,0,378,0,17,0,0,0,1,0,396,0,0,0,0,0,0,0,0,0,0,3
Drew,5/18/20,0,0,0,0,0,0,0,0,0,19,0,482,0,16,0,1,0,2,0,501,0,0,0,0,0,0,0,0,0,0,4
Faulkner,5/18/20,0,0,0,0,0,0,0,0,0,94,0,2406,0,80,0,3,0,11,0,2500,0,0,0,0,0,0,0,1,1,0,60
Franklin,5/18/20,0,0,0,0,0,0,0,0,0,2,0,182,0,2,0,0,0,0,0,184,0,0,0,0,0,0,0,0,0,0,4
Fulton,5/18/20,0,0,0,0,0,0,0,0,0,4,0,184,0,3,0,0,0,1,0,188,0,0,0,0,0,0,0,0,0,0,2
Garland,5/18/20,0,0,0,0,0,0,0,0,0,130,0,3293,0,117,0,1,0,12,0,3423,0,0,0,0,0,0,0,1,0,0,71
Grant,5/18/20,0,0,0,0,0,0,0,0,0,16,0,386,0,15,0,0,0,1,0,402,0,0,0,0,0,0,0,0,0,0,13
Greene,5/18/20,0,0,0,0,0,0,0,0,0,24,0,1240,0,22,0,0,0,2,0,1264,0,0,0,0,0,0,0,0,2,0,50
Hempstead,5/18/20,0,0,0,0,0,0,0,0,0,9,0,165,0,6,0,1,0,2,0,174,0,0,0,0,0,0,0,0,0,0,6
HotSpring,5/18/20,0,0,0,0,0,0,0,0,0,29,0,664,0,22,0,0,0,7,0,693,0,0,0,0,0,0,0,0,0,0,22
Howard,5/18/20,0,0,0,0,0,0,0,0,0,14,0,225,0,14,0,0,0,0,0,239,0,0,0,0,0,0,0,0,0,0,3
Independence,5/18/20,0,0,0,0,0,0,0,0,0,26,0,541,0,17,0,0,0,9,0,567,0,0,0,0,0,0,0,1,0,0,28
Izard,5/18/20,0,0,0,0,0,0,0,0,0,13,0,154,0,10,0,0,0,3,0,167,0,0,0,0,0,0,0,0,0,0,4
Jackson,5/18/20,0,0,0,0,0,0,0,0,0,1,0,183,0,1,0,0,0,0,0,184,0,0,0,0,0,0,0,0,0,0,8
Jefferson,5/18/20,0,0,0,0,0,0,0,0,0,491,0,2096,0,195,0,19,0,277,0,2587,0,0,0,0,0,0,0,0,5,0,33
Johnson,5/18/20,0,0,0,0,0,0,0,0,0,35,0,277,0,33,0,0,0,2,0,312,0,0,0,0,0,0,0,0,0,0,0
Lafayette,5/18/20,0,0,0,0,0,0,0,0,0,9,0,35,0,8,0,1,0,0,0,44,0,0,0,0,0,0,0,0,0,0,1
Lawrence,5/18/20,0,0,0,0,0,0,0,0,0,73,0,514,0,55,0,4,0,14,0,587,0,0,0,0,0,0,0,0,0,0,30
Lee,5/18/20,0,0,0,0,0,0,0,0,0,12,0,160,0,3,0,1,0,8,0,172,0,0,0,0,0,0,0,1,0,0,6
Lincoln,5/18/20,0,0,0,0,0,0,0,0,0,965,0,892,0,875,0,8,0,82,0,1857,0,0,0,0,0,0,0,10,8,0,17
LittleRiver,5/18/20,0,0,0,0,0,0,0,0,0,1,0,128,0,0,0,0,0,1,0,129,0,0,0,0,0,0,0,0,0,0,4
Logan,5/18/20,0,0,0,0,0,0,0,0,0,4,0,209,0,3,0,0,0,1,0,213,0,0,0,0,0,0,0,0,0,0,3
Lonoke,5/18/20,0,0,0,0,0,0,0,0,0,45,0,1346,0,42,0,0,0,3,0,1391,0,0,0,0,0,0,0,0,0,0,43
Madison,5/18/20,0,0,0,0,0,0,0,0,0,1,0,215,0,1,0,0,0,0,0,216,0,0,0,0,0,0,0,0,0,0,5
Marion,5/18/20,0,0,0,0,0,0,0,0,0,1,0,124,0,1,0,0,0,0,0,125,0,0,0,0,0,0,0,0,0,0,5
Miller,5/18/20,0,0,0,0,0,0,0,0,0,42,0,490,0,37,0,1,0,4,0,532,0,0,0,0,0,0,0,0,1,0,22
MissingCountyInfo,5/18/20,0,0,0,0,0,0,0,0,0,130,0,20630,0,103,0,0,0,27,0,20760,0,0,0,0,0,0,0,-2,-3,0,521
Mississippi,5/18/20,0,0,0,0,0,0,0,0,0,62,0,737,0,30,0,0,0,32,0,799,0,0,0,0,0,0,0,1,1,0,38
Monroe,5/18/20,0,0,0,0,0,0,0,0,0,5,0,125,0,4,0,0,0,1,0,130,0,0,0,0,0,0,0,0,0,0,1
Montgomery,5/18/20,0,0,0,0,0,0,0,0,0,1,0,122,0,1,0,0,0,0,0,123,0,0,0,0,0,0,0,0,0,0,7
Nevada,5/18/20,0,0,0,0,0,0,0,0,0,4,0,99,0,3,0,0,0,1,0,103,0,0,0,0,0,0,0,0,0,0,3
Newton,5/18/20,0,0,0,0,0,0,0,0,0,3,0,103,0,3,0,0,0,0,0,106,0,0,0,0,0,0,0,0,0,0,0
Ouachita,5/18/20,0,0,0,0,0,0,0,0,0,10,0,618,0,7,0,0,0,3,0,628,0,0,0,0,0,0,0,0,1,0,40
Perry,5/18/20,0,0,0,0,0,0,0,0,0,12,0,212,0,8,0,0,0,4,0,224,0,0,0,0,0,0,0,0,0,0,11
Phillips,5/18/20,0,0,0,0,0,0,0,0,0,5,0,285,0,3,0,1,0,1,0,290,0,0,0,0,0,0,0,0,0,0,8
Pike,5/18/20,0,0,0,0,0,0,0,0,0,3,0,440,0,3,0,0,0,0,0,443,0,0,0,0,0,0,0,0,0,0,8
Poinsett,5/18/20,0,0,0,0,0,0,0,0,0,27,0,371,0,22,0,2,0,3,0,398,0,0,0,0,0,0,0,1,0,0,15
Polk,5/18/20,0,0,0,0,0,0,0,0,0,8,0,358,0,7,0,0,0,1,0,366,0,0,0,0,0,0,0,0,0,0,5
Pope,5/18/20,0,0,0,0,0,0,0,0,0,76,0,1997,0,45,0,0,0,31,0,2073,0,0,0,0,0,0,0,3,0,0,19
Prairie,5/18/20,0,0,0,0,0,0,0,0,0,2,0,83,0,2,0,0,0,0,0,85,0,0,0,0,0,0,0,0,0,0,1
Pulaski,5/18/20,0,0,0,0,0,0,0,0,0,693,0,9333,0,560,0,25,0,108,0,10026,0,0,0,0,0,0,0,7,0,2,259
Randolph,5/18/20,0,0,0,0,0,0,0,0,0,22,0,746,0,21,0,0,0,1,0,768,0,0,0,0,0,0,0,0,0,0,12
Saline,5/18/20,0,0,0,0,0,0,0,0,0,82,0,2523,0,72,0,1,0,9,0,2605,0,0,0,0,0,0,0,0,0,0,82
Scott,5/18/20,0,0,0,0,0,0,0,0,0,1,0,22,0,1,0,0,0,0,0,23,0,0,0,0,0,0,0,0,0,0,0
Searcy,5/18/20,0,0,0,0,0,0,0,0,0,6,0,280,0,6,0,0,0,0,0,286,0,0,0,0,0,0,0,0,0,0,12
Sebastian,5/18/20,0,0,0,0,0,0,0,0,0,16,0,808,0,15,0,0,0,1,0,824,0,0,0,0,0,0,0,0,0,0,17
Sevier,5/18/20,0,0,0,0,0,0,0,0,0,32,0,379,0,16,0,1,0,15,0,411,0,0,0,0,0,0,0,4,1,0,17
Sharp,5/18/20,0,0,0,0,0,0,0,0,0,37,0,220,0,6,0,2,0,29,0,257,0,0,0,0,0,0,0,0,0,0,6
St.Francis,5/18/20,0,0,0,0,0,0,0,0,0,349,0,1555,0,242,0,0,0,107,0,1904,0,0,0,0,0,0,0,8,28,0,124
Stone,5/18/20,0,0,0,0,0,0,0,0,0,8,0,178,0,8,0,0,0,0,0,186,0,0,0,0,0,0,0,0,0,0,-5
Union,5/18/20,0,0,0,0,0,0,0,0,0,107,0,581,0,69,0,4,0,34,0,688,0,0,0,0,0,0,0,0,3,0,21
VanBuren,5/18/20,0,0,0,0,0,0,0,0,0,28,0,376,0,26,0,2,0,0,0,404,0,0,0,0,0,0,0,0,0,0,9
Washington,5/18/20,0,0,0,0,0,0,0,0,0,145,0,3320,0,97,0,5,0,43,0,3465,0,0,0,0,0,0,0,2,-1,0,91
White,5/18/20,0,0,0,0,0,0,0,0,0,37,0,1363,0,33,0,1,0,3,0,1400,0,0,0,0,0,0,0,1,0,0,48
Woodruff,5/18/20,0,0,0,0,0,0,0,0,0,1,0,77,0,1,0,0,0,0,0,78,0,0,0,0,0,0,0,0,0,0,3
Yell,5/18/20,0,0,0,0,0,0,0,0,0,28,0,275,0,6,0,1,0,21,0,303,0,0,0,0,0,0,0,5,0,0,8
Arkansas_all_counties,5/17/20,0,0,0,0,0,0,0,0,2990671,4759,0,80426,0,3590,0,98,0,1071,0,85185,0,0,0,0,0,0,0,181,118,0,1953
Arkansas_county,5/17/20,0,0,0,0,0,0,0,0,0,2,0,204,0,2,0,0,0,0,0,206,0,0,0,0,0,0,0,0,0,0,6
Ashley,5/17/20,0,0,0,0,0,0,0,0,0,18,0,467,0,17,0,0,0,1,0,485,0,0,0,0,0,0,0,0,0,0,15
Baxter,5/17/20,0,0,0,0,0,0,0,0,0,6,0,446,0,5,0,0,0,1,0,452,0,0,0,0,0,0,0,0,0,0,2
Benton,5/17/20,0,0,0,0,0,0,0,0,0,149,0,6479,0,116,0,0,0,33,0,6628,0,0,0,0,0,0,0,5,0,0,68
Boone,5/17/20,0,0,0,0,0,0,0,0,0,4,0,491,0,4,0,0,0,0,0,495,0,0,0,0,0,0,0,0,0,0,60
Bradley,5/17/20,0,0,0,0,0,0,0,0,0,15,0,338,0,10,0,1,0,4,0,353,0,0,0,0,0,0,0,0,0,0,4
Calhoun,5/17/20,0,0,0,0,0,0,0,0,0,0,0,44,0,0,0,0,0,0,0,44,0,0,0,0,0,0,0,0,0,0,0
Carroll,5/17/20,0,0,0,0,0,0,0,0,0,5,0,429,0,5,0,0,0,0,0,434,0,0,0,0,0,0,0,-1,-1,0,7
Chicot,5/17/20,0,0,0,0,0,0,0,0,0,10,0,173,0,9,0,0,0,1,0,183,0,0,0,0,0,0,0,0,0,0,-1
Clark,5/17/20,0,0,0,0,0,0,0,0,0,35,0,630,0,33,0,0,0,2,0,665,0,0,0,0,0,0,0,0,1,0,6
Clay,5/17/20,0,0,0,0,0,0,0,0,0,3,0,395,0,3,0,0,0,0,0,398,0,0,0,0,0,0,0,0,0,0,11
Cleburne,5/17/20,0,0,0,0,0,0,0,0,0,72,0,501,0,68,0,4,0,0,0,573,0,0,0,0,0,0,0,0,0,0,9
Cleveland,5/17/20,0,0,0,0,0,0,0,0,0,16,0,255,0,12,0,0,0,4,0,271,0,0,0,0,0,0,0,0,0,0,3
Columbia,5/17/20,0,0,0,0,0,0,0,0,0,15,0,264,0,11,0,2,0,2,0,279,0,0,0,0,0,0,0,0,0,0,2
Conway,5/17/20,0,0,0,0,0,0,0,0,0,14,0,446,0,12,0,1,0,1,0,460,0,0,0,0,0,0,0,0,0,0,9
Craighead,5/17/20,0,0,0,0,0,0,0,0,0,140,0,2457,0,86,0,0,0,54,0,2597,0,0,0,0,0,0,0,3,0,0,124
Crawford,5/17/20,0,0,0,0,0,0,0,0,0,11,0,490,0,5,0,0,0,6,0,501,0,0,0,0,0,0,0,0,0,0,4
Crittenden,5/17/20,0,0,0,0,0,0,0,0,0,234,0,1971,0,195,0,7,0,32,0,2205,0,0,0,0,0,0,0,4,3,0,81
Cross,5/17/20,0,0,0,0,0,0,0,0,0,35,0,435,0,25,0,0,0,10,0,470,0,0,0,0,0,0,0,0,0,0,34
Dallas,5/17/20,0,0,0,0,0,0,0,0,0,1,0,110,0,1,0,0,0,0,0,111,0,0,0,0,0,0,0,0,0,0,1
Desha,5/17/20,0,0,0,0,0,0,0,0,0,18,0,375,0,17,0,0,0,1,0,393,0,0,0,0,0,0,0,0,0,0,7
Drew,5/17/20,0,0,0,0,0,0,0,0,0,19,0,478,0,16,0,1,0,2,0,497,0,0,0,0,0,0,0,0,0,0,8
Faulkner,5/17/20,0,0,0,0,0,0,0,0,0,93,0,2347,0,79,0,3,0,11,0,2440,0,0,0,0,0,0,0,2,1,0,32
Franklin,5/17/20,0,0,0,0,0,0,0,0,0,2,0,178,0,2,0,0,0,0,0,180,0,0,0,0,0,0,0,0,0,0,3
Fulton,5/17/20,0,0,0,0,0,0,0,0,0,4,0,182,0,3,0,0,0,1,0,186,0,0,0,0,0,0,0,1,0,0,5
Garland,5/17/20,0,0,0,0,0,0,0,0,0,129,0,3223,0,117,0,1,0,11,0,3352,0,0,0,0,0,0,0,0,1,0,52
Grant,5/17/20,0,0,0,0,0,0,0,0,0,16,0,373,0,15,0,0,0,1,0,389,0,0,0,0,0,0,0,0,0,0,12
Greene,5/17/20,0,0,0,0,0,0,0,0,0,24,0,1190,0,21,0,0,0,3,0,1214,0,0,0,0,0,0,0,0,0,0,27
Hempstead,5/17/20,0,0,0,0,0,0,0,0,0,9,0,159,0,6,0,1,0,2,0,168,0,0,0,0,0,0,0,0,0,0,6
HotSpring,5/17/20,0,0,0,0,0,0,0,0,0,29,0,642,0,22,0,0,0,7,0,671,0,0,0,0,0,0,0,0,0,0,15
Howard,5/17/20,0,0,0,0,0,0,0,0,0,14,0,222,0,14,0,0,0,0,0,236,0,0,0,0,0,0,0,0,0,0,2
Independence,5/17/20,0,0,0,0,0,0,0,0,0,25,0,514,0,17,0,0,0,8,0,539,0,0,0,0,0,0,0,0,1,0,17
Izard,5/17/20,0,0,0,0,0,0,0,0,0,13,0,150,0,10,0,0,0,3,0,163,0,0,0,0,0,0,0,0,0,0,3
Jackson,5/17/20,0,0,0,0,0,0,0,0,0,1,0,175,0,1,0,0,0,0,0,176,0,0,0,0,0,0,0,0,0,0,0
Jefferson,5/17/20,0,0,0,0,0,0,0,0,0,491,0,2063,0,190,0,19,0,282,0,2554,0,0,0,0,0,0,0,129,3,0,155
Johnson,5/17/20,0,0,0,0,0,0,0,0,0,35,0,277,0,33,0,0,0,2,0,312,0,0,0,0,0,0,0,0,1,0,2
Lafayette,5/17/20,0,0,0,0,0,0,0,0,0,9,0,34,0,8,0,1,0,0,0,43,0,0,0,0,0,0,0,0,0,0,2
Lawrence,5/17/20,0,0,0,0,0,0,0,0,0,73,0,484,0,55,0,4,0,14,0,557,0,0,0,0,0,0,0,0,0,0,13
Lee,5/17/20,0,0,0,0,0,0,0,0,0,11,0,155,0,3,0,1,0,7,0,166,0,0,0,0,0,0,0,1,0,0,13
Lincoln,5/17/20,0,0,0,0,0,0,0,0,0,955,0,885,0,867,0,8,0,80,0,1840,0,0,0,0,0,0,0,0,9,0,36
LittleRiver,5/17/20,0,0,0,0,0,0,0,0,0,1,0,124,0,0,0,0,0,1,0,125,0,0,0,0,0,0,0,0,0,0,3
Logan,5/17/20,0,0,0,0,0,0,0,0,0,4,0,206,0,3,0,0,0,1,0,210,0,0,0,0,0,0,0,0,0,0,2
Lonoke,5/17/20,0,0,0,0,0,0,0,0,0,45,0,1303,0,42,0,0,0,3,0,1348,0,0,0,0,0,0,0,0,0,0,29
Madison,5/17/20,0,0,0,0,0,0,0,0,0,1,0,210,0,1,0,0,0,0,0,211,0,0,0,0,0,0,0,0,0,0,2
Marion,5/17/20,0,0,0,0,0,0,0,0,0,1,0,119,0,1,0,0,0,0,0,120,0,0,0,0,0,0,0,0,0,0,2
Miller,5/17/20,0,0,0,0,0,0,0,0,0,42,0,468,0,36,0,1,0,5,0,510,0,0,0,0,0,0,0,0,0,0,65
MissingCountyInfo,5/17/20,0,0,0,0,0,0,0,0,0,132,0,20107,0,109,0,0,0,23,0,20239,0,0,0,0,0,0,0,1,1,0,346
Mississippi,5/17/20,0,0,0,0,0,0,0,0,0,61,0,700,0,29,0,0,0,32,0,761,0,0,0,0,0,0,0,0,1,0,16
Monroe,5/17/20,0,0,0,0,0,0,0,0,0,5,0,124,0,4,0,0,0,1,0,129,0,0,0,0,0,0,0,0,0,0,12
Montgomery,5/17/20,0,0,0,0,0,0,0,0,0,1,0,115,0,1,0,0,0,0,0,116,0,0,0,0,0,0,0,0,0,0,1
Nevada,5/17/20,0,0,0,0,0,0,0,0,0,4,0,96,0,3,0,0,0,1,0,100,0,0,0,0,0,0,0,0,0,0,2
Newton,5/17/20,0,0,0,0,0,0,0,0,0,3,0,103,0,3,0,0,0,0,0,106,0,0,0,0,0,0,0,0,0,0,2
Ouachita,5/17/20,0,0,0,0,0,0,0,0,0,10,0,578,0,6,0,0,0,4,0,588,0,0,0,0,0,0,0,0,0,0,9
Perry,5/17/20,0,0,0,0,0,0,0,0,0,12,0,201,0,8,0,0,0,4,0,213,0,0,0,0,0,0,0,0,1,0,0
Phillips,5/17/20,0,0,0,0,0,0,0,0,0,5,0,277,0,3,0,1,0,1,0,282,0,0,0,0,0,0,0,1,0,0,5
Pike,5/17/20,0,0,0,0,0,0,0,0,0,3,0,432,0,3,0,0,0,0,0,435,0,0,0,0,0,0,0,0,0,0,14
Poinsett,5/17/20,0,0,0,0,0,0,0,0,0,26,0,357,0,22,0,2,0,2,0,383,0,0,0,0,0,0,0,0,0,0,15
Polk,5/17/20,0,0,0,0,0,0,0,0,0,8,0,353,0,7,0,0,0,1,0,361,0,0,0,0,0,0,0,1,0,0,12
Pope,5/17/20,0,0,0,0,0,0,0,0,0,73,0,1981,0,45,0,0,0,28,0,2054,0,0,0,0,0,0,0,10,0,0,29
Prairie,5/17/20,0,0,0,0,0,0,0,0,0,2,0,82,0,2,0,0,0,0,0,84,0,0,0,0,0,0,0,0,0,0,0
Pulaski,5/17/20,0,0,0,0,0,0,0,0,0,686,0,9081,0,560,0,23,0,103,0,9767,0,0,0,0,0,0,0,3,7,0,170
Randolph,5/17/20,0,0,0,0,0,0,0,0,0,22,0,734,0,21,0,0,0,1,0,756,0,0,0,0,0,0,0,0,0,0,16
Saline,5/17/20,0,0,0,0,0,0,0,0,0,82,0,2441,0,71,0,1,0,10,0,2523,0,0,0,0,0,0,0,1,0,0,49
Scott,5/17/20,0,0,0,0,0,0,0,0,0,1,0,22,0,1,0,0,0,0,0,23,0,0,0,0,0,0,0,0,0,0,0
Searcy,5/17/20,0,0,0,0,0,0,0,0,0,6,0,268,0,6,0,0,0,0,0,274,0,0,0,0,0,0,0,0,0,0,13
Sebastian,5/17/20,0,0,0,0,0,0,0,0,0,16,0,791,0,15,0,0,0,1,0,807,0,0,0,0,0,0,0,1,1,0,8
Sevier,5/17/20,0,0,0,0,0,0,0,0,0,28,0,366,0,15,0,1,0,12,0,394,0,0,0,0,0,0,0,1,0,0,2
Sharp,5/17/20,0,0,0,0,0,0,0,0,0,37,0,214,0,6,0,2,0,29,0,251,0,0,0,0,0,0,0,0,0,0,1
St.Francis,5/17/20,0,0,0,0,0,0,0,0,0,341,0,1439,0,214,0,0,0,127,0,1780,0,0,0,0,0,0,0,6,86,0,140
Stone,5/17/20,0,0,0,0,0,0,0,0,0,8,0,183,0,8,0,0,0,0,0,191,0,0,0,0,0,0,0,0,0,0,4
Union,5/17/20,0,0,0,0,0,0,0,0,0,107,0,560,0,66,0,4,0,37,0,667,0,0,0,0,0,0,0,0,0,0,7
VanBuren,5/17/20,0,0,0,0,0,0,0,0,0,28,0,367,0,26,0,2,0,0,0,395,0,0,0,0,0,0,0,0,0,0,5
Washington,5/17/20,0,0,0,0,0,0,0,0,0,143,0,3231,0,98,0,5,0,40,0,3374,0,0,0,0,0,0,0,2,2,0,65
White,5/17/20,0,0,0,0,0,0,0,0,0,36,0,1316,0,33,0,1,0,2,0,1352,0,0,0,0,0,0,0,0,0,0,31
Woodruff,5/17/20,0,0,0,0,0,0,0,0,0,1,0,74,0,1,0,0,0,0,0,75,0,0,0,0,0,0,0,0,0,0,4
Yell,5/17/20,0,0,0,0,0,0,0,0,0,23,0,272,0,6,0,1,0,16,0,295,0,0,0,0,0,0,0,10,0,0,17
Arkansas_all_counties,5/16/20,0,0,0,0,0,0,0,0,2990671,4578,0,78654,0,3472,0,98,0,1008,0,83232,0,0,0,0,0,0,0,115,82,0,1703
Arkansas_county,5/16/20,0,0,0,0,0,0,0,0,0,2,0,198,0,2,0,0,0,0,0,200,0,0,0,0,0,0,0,0,0,0,9
Ashley,5/16/20,0,0,0,0,0,0,0,0,0,18,0,452,0,17,0,0,0,1,0,470,0,0,0,0,0,0,0,0,0,0,11
Baxter,5/16/20,0,0,0,0,0,0,0,0,0,6,0,444,0,5,0,0,0,1,0,450,0,0,0,0,0,0,0,0,0,0,22
Benton,5/16/20,0,0,0,0,0,0,0,0,0,144,0,6416,0,116,0,0,0,28,0,6560,0,0,0,0,0,0,0,5,3,0,347
Boone,5/16/20,0,0,0,0,0,0,0,0,0,4,0,431,0,4,0,0,0,0,0,435,0,0,0,0,0,0,0,0,0,0,90
Bradley,5/16/20,0,0,0,0,0,0,0,0,0,15,0,334,0,10,0,1,0,4,0,349,0,0,0,0,0,0,0,2,0,0,21
Calhoun,5/16/20,0,0,0,0,0,0,0,0,0,0,0,44,0,0,0,0,0,0,0,44,0,0,0,0,0,0,0,0,0,0,3
Carroll,5/16/20,0,0,0,0,0,0,0,0,0,6,0,421,0,6,0,0,0,0,0,427,0,0,0,0,0,0,0,0,0,0,29
Chicot,5/16/20,0,0,0,0,0,0,0,0,0,10,0,174,0,9,0,0,0,1,0,184,0,0,0,0,0,0,0,0,0,0,23
Clark,5/16/20,0,0,0,0,0,0,0,0,0,35,0,624,0,32,0,0,0,3,0,659,0,0,0,0,0,0,0,0,2,0,15
Clay,5/16/20,0,0,0,0,0,0,0,0,0,3,0,384,0,3,0,0,0,0,0,387,0,0,0,0,0,0,0,0,0,0,5
Cleburne,5/16/20,0,0,0,0,0,0,0,0,0,72,0,492,0,68,0,4,0,0,0,564,0,0,0,0,0,0,0,0,0,0,37
Cleveland,5/16/20,0,0,0,0,0,0,0,0,0,16,0,252,0,12,0,0,0,4,0,268,0,0,0,0,0,0,0,0,0,0,11
Columbia,5/16/20,0,0,0,0,0,0,0,0,0,15,0,262,0,11,0,2,0,2,0,277,0,0,0,0,0,0,0,0,0,0,5
Conway,5/16/20,0,0,0,0,0,0,0,0,0,14,0,437,0,12,0,1,0,1,0,451,0,0,0,0,0,0,0,0,0,0,17
Craighead,5/16/20,0,0,0,0,0,0,0,0,0,137,0,2336,0,86,0,0,0,51,0,2473,0,0,0,0,0,0,0,7,3,0,155
Crawford,5/16/20,0,0,0,0,0,0,0,0,0,11,0,486,0,5,0,0,0,6,0,497,0,0,0,0,0,0,0,2,0,0,36
Crittenden,5/16/20,0,0,0,0,0,0,0,0,0,230,0,1894,0,192,0,7,0,31,0,2124,0,0,0,0,0,0,0,1,4,0,27
Cross,5/16/20,0,0,0,0,0,0,0,0,0,35,0,401,0,25,0,0,0,10,0,436,0,0,0,0,0,0,0,0,2,0,7
Dallas,5/16/20,0,0,0,0,0,0,0,0,0,1,0,109,0,1,0,0,0,0,0,110,0,0,0,0,0,0,0,0,0,0,10
Desha,5/16/20,0,0,0,0,0,0,0,0,0,18,0,368,0,17,0,0,0,1,0,386,0,0,0,0,0,0,0,0,0,0,11
Drew,5/16/20,0,0,0,0,0,0,0,0,0,19,0,470,0,16,0,1,0,2,0,489,0,0,0,0,0,0,0,0,0,0,12
Faulkner,5/16/20,0,0,0,0,0,0,0,0,0,91,0,2317,0,78,0,3,0,10,0,2408,0,0,0,0,0,0,0,3,3,0,70
Franklin,5/16/20,0,0,0,0,0,0,0,0,0,2,0,175,0,2,0,0,0,0,0,177,0,0,0,0,0,0,0,0,0,0,7
Fulton,5/16/20,0,0,0,0,0,0,0,0,0,3,0,178,0,3,0,0,0,0,0,181,0,0,0,0,0,0,0,0,0,0,14
Garland,5/16/20,0,0,0,0,0,0,0,0,0,129,0,3171,0,116,0,1,0,12,0,3300,0,0,0,0,0,0,0,2,0,0,62
Grant,5/16/20,0,0,0,0,0,0,0,0,0,16,0,361,0,15,0,0,0,1,0,377,0,0,0,0,0,0,0,0,0,0,10
Greene,5/16/20,0,0,0,0,0,0,0,0,0,24,0,1163,0,21,0,0,0,3,0,1187,0,0,0,0,0,0,0,0,0,0,26
Hempstead,5/16/20,0,0,0,0,0,0,0,0,0,9,0,153,0,6,0,1,0,2,0,162,0,0,0,0,0,0,0,0,0,0,20
HotSpring,5/16/20,0,0,0,0,0,0,0,0,0,29,0,627,0,22,0,0,0,7,0,656,0,0,0,0,0,0,0,0,1,0,27
Howard,5/16/20,0,0,0,0,0,0,0,0,0,14,0,220,0,14,0,0,0,0,0,234,0,0,0,0,0,0,0,0,0,0,26
Independence,5/16/20,0,0,0,0,0,0,0,0,0,25,0,497,0,16,0,0,0,9,0,522,0,0,0,0,0,0,0,2,1,0,64
Izard,5/16/20,0,0,0,0,0,0,0,0,0,13,0,147,0,10,0,0,0,3,0,160,0,0,0,0,0,0,0,0,0,0,17
Jackson,5/16/20,0,0,0,0,0,0,0,0,0,1,0,175,0,1,0,0,0,0,0,176,0,0,0,0,0,0,0,0,0,0,9
Jefferson,5/16/20,0,0,0,0,0,0,0,0,0,362,0,2037,0,187,0,19,0,156,0,2399,0,0,0,0,0,0,0,52,3,0,181
Johnson,5/16/20,0,0,0,0,0,0,0,0,0,35,0,275,0,32,0,0,0,3,0,310,0,0,0,0,0,0,0,0,0,0,11
Lafayette,5/16/20,0,0,0,0,0,0,0,0,0,9,0,32,0,8,0,1,0,0,0,41,0,0,0,0,0,0,0,0,0,0,3
Lawrence,5/16/20,0,0,0,0,0,0,0,0,0,73,0,471,0,55,0,4,0,14,0,544,0,0,0,0,0,0,0,1,4,0,22
Lee,5/16/20,0,0,0,0,0,0,0,0,0,10,0,143,0,3,0,1,0,6,0,153,0,0,0,0,0,0,0,0,0,0,8
Lincoln,5/16/20,0,0,0,0,0,0,0,0,0,955,0,849,0,858,0,8,0,89,0,1804,0,0,0,0,0,0,0,3,2,0,7
LittleRiver,5/16/20,0,0,0,0,0,0,0,0,0,1,0,121,0,0,0,0,0,1,0,122,0,0,0,0,0,0,0,1,0,0,8
Logan,5/16/20,0,0,0,0,0,0,0,0,0,4,0,204,0,3,0,0,0,1,0,208,0,0,0,0,0,0,0,0,0,0,21
Lonoke,5/16/20,0,0,0,0,0,0,0,0,0,45,0,1274,0,42,0,0,0,3,0,1319,0,0,0,0,0,0,0,0,2,0,33
Madison,5/16/20,0,0,0,0,0,0,0,0,0,1,0,208,0,1,0,0,0,0,0,209,0,0,0,0,0,0,0,0,0,0,11
Marion,5/16/20,0,0,0,0,0,0,0,0,0,1,0,117,0,1,0,0,0,0,0,118,0,0,0,0,0,0,0,0,0,0,7
Miller,5/16/20,0,0,0,0,0,0,0,0,0,42,0,403,0,36,0,1,0,5,0,445,0,0,0,0,0,0,0,0,1,0,1
MissingCountyInfo,5/16/20,0,0,0,0,0,0,0,0,0,131,0,19762,0,108,0,0,0,23,0,19893,0,0,0,0,0,0,0,-8,2,0,-1188
Mississippi,5/16/20,0,0,0,0,0,0,0,0,0,61,0,684,0,28,0,0,0,33,0,745,0,0,0,0,0,0,0,3,0,0,41
Monroe,5/16/20,0,0,0,0,0,0,0,0,0,5,0,112,0,4,0,0,0,1,0,117,0,0,0,0,0,0,0,0,0,0,11
Montgomery,5/16/20,0,0,0,0,0,0,0,0,0,1,0,114,0,1,0,0,0,0,0,115,0,0,0,0,0,0,0,0,0,0,4
Nevada,5/16/20,0,0,0,0,0,0,0,0,0,4,0,94,0,3,0,0,0,1,0,98,0,0,0,0,0,0,0,0,0,0,5
Newton,5/16/20,0,0,0,0,0,0,0,0,0,3,0,101,0,3,0,0,0,0,0,104,0,0,0,0,0,0,0,0,0,0,8
Ouachita,5/16/20,0,0,0,0,0,0,0,0,0,10,0,569,0,6,0,0,0,4,0,579,0,0,0,0,0,0,0,1,0,0,20
Perry,5/16/20,0,0,0,0,0,0,0,0,0,12,0,201,0,7,0,0,0,5,0,213,0,0,0,0,0,0,0,0,0,0,16
Phillips,5/16/20,0,0,0,0,0,0,0,0,0,4,0,273,0,3,0,1,0,0,0,277,0,0,0,0,0,0,0,0,0,0,8
Pike,5/16/20,0,0,0,0,0,0,0,0,0,3,0,418,0,3,0,0,0,0,0,421,0,0,0,0,0,0,0,0,0,0,15
Poinsett,5/16/20,0,0,0,0,0,0,0,0,0,26,0,342,0,22,0,2,0,2,0,368,0,0,0,0,0,0,0,1,0,0,21
Polk,5/16/20,0,0,0,0,0,0,0,0,0,7,0,342,0,7,0,0,0,0,0,349,0,0,0,0,0,0,0,0,0,0,19
Pope,5/16/20,0,0,0,0,0,0,0,0,0,63,0,1962,0,45,0,0,0,18,0,2025,0,0,0,0,0,0,0,2,1,0,49
Prairie,5/16/20,0,0,0,0,0,0,0,0,0,2,0,82,0,2,0,0,0,0,0,84,0,0,0,0,0,0,0,0,0,0,13
Pulaski,5/16/20,0,0,0,0,0,0,0,0,0,683,0,8914,0,553,0,23,0,107,0,9597,0,0,0,0,0,0,0,14,11,0,307
Randolph,5/16/20,0,0,0,0,0,0,0,0,0,22,0,718,0,21,0,0,0,1,0,740,0,0,0,0,0,0,0,0,0,0,18
Saline,5/16/20,0,0,0,0,0,0,0,0,0,81,0,2393,0,71,0,1,0,9,0,2474,0,0,0,0,0,0,0,1,1,0,104
Scott,5/16/20,0,0,0,0,0,0,0,0,0,1,0,22,0,1,0,0,0,0,0,23,0,0,0,0,0,0,0,0,0,0,6
Searcy,5/16/20,0,0,0,0,0,0,0,0,0,6,0,255,0,6,0,0,0,0,0,261,0,0,0,0,0,0,0,0,0,0,25
Sebastian,5/16/20,0,0,0,0,0,0,0,0,0,15,0,784,0,14,0,0,0,1,0,799,0,0,0,0,0,0,0,0,0,0,80
Sevier,5/16/20,0,0,0,0,0,0,0,0,0,27,0,365,0,15,0,1,0,11,0,392,0,0,0,0,0,0,0,2,3,0,11
Sharp,5/16/20,0,0,0,0,0,0,0,0,0,37,0,213,0,6,0,2,0,29,0,250,0,0,0,0,0,0,0,0,0,0,20
St.Francis,5/16/20,0,0,0,0,0,0,0,0,0,335,0,1305,0,128,0,0,0,207,0,1640,0,0,0,0,0,0,0,2,29,0,28
Stone,5/16/20,0,0,0,0,0,0,0,0,0,8,0,179,0,8,0,0,0,0,0,187,0,0,0,0,0,0,0,0,0,0,23
Union,5/16/20,0,0,0,0,0,0,0,0,0,107,0,553,0,66,0,4,0,37,0,660,0,0,0,0,0,0,0,2,1,0,71
VanBuren,5/16/20,0,0,0,0,0,0,0,0,0,28,0,362,0,26,0,2,0,0,0,390,0,0,0,0,0,0,0,0,0,0,24
Washington,5/16/20,0,0,0,0,0,0,0,0,0,141,0,3168,0,96,0,5,0,40,0,3309,0,0,0,0,0,0,0,10,3,0,284
White,5/16/20,0,0,0,0,0,0,0,0,0,36,0,1285,0,33,0,1,0,2,0,1321,0,0,0,0,0,0,0,0,1,0,60
Woodruff,5/16/20,0,0,0,0,0,0,0,0,0,1,0,70,0,1,0,0,0,0,0,71,0,0,0,0,0,0,0,0,0,0,6
Yell,5/16/20,0,0,0,0,0,0,0,0,0,13,0,265,0,6,0,1,0,6,0,278,0,0,0,0,0,0,0,4,0,0,26
Arkansas_all_counties,5/15/20,0,0,0,0,0,0,0,0,2990671,4463,0,77066,0,3390,0,98,0,975,0,81529,0,0,0,0,0,0,0,97,50,0,3024
Arkansas_county,5/15/20,0,0,0,0,0,0,0,0,0,2,0,189,0,2,0,0,0,0,0,191,0,0,0,0,0,0,0,0,0,0,3
Ashley,5/15/20,0,0,0,0,0,0,0,0,0,18,0,441,0,17,0,0,0,1,0,459,0,0,0,0,0,0,0,0,0,0,11
Baxter,5/15/20,0,0,0,0,0,0,0,0,0,6,0,422,0,5,0,0,0,1,0,428,0,0,0,0,0,0,0,0,0,0,11
Benton,5/15/20,0,0,0,0,0,0,0,0,0,139,0,6074,0,113,0,0,0,26,0,6213,0,0,0,0,0,0,0,3,2,0,227
Boone,5/15/20,0,0,0,0,0,0,0,0,0,4,0,341,0,4,0,0,0,0,0,345,0,0,0,0,0,0,0,0,0,0,23
Bradley,5/15/20,0,0,0,0,0,0,0,0,0,13,0,315,0,10,0,1,0,2,0,328,0,0,0,0,0,0,0,1,0,0,22
Calhoun,5/15/20,0,0,0,0,0,0,0,0,0,0,0,41,0,0,0,0,0,0,0,41,0,0,0,0,0,0,0,0,0,0,3
Carroll,5/15/20,0,0,0,0,0,0,0,0,0,6,0,392,0,6,0,0,0,0,0,398,0,0,0,0,0,0,0,0,0,0,13
Chicot,5/15/20,0,0,0,0,0,0,0,0,0,10,0,151,0,9,0,0,0,1,0,161,0,0,0,0,0,0,0,0,0,0,4
Clark,5/15/20,0,0,0,0,0,0,0,0,0,35,0,609,0,31,0,0,0,4,0,644,0,0,0,0,0,0,0,0,0,0,6
Clay,5/15/20,0,0,0,0,0,0,0,0,0,3,0,379,0,3,0,0,0,0,0,382,0,0,0,0,0,0,0,0,0,0,3
Cleburne,5/15/20,0,0,0,0,0,0,0,0,0,72,0,455,0,68,0,4,0,0,0,527,0,0,0,0,0,0,0,0,0,0,8
Cleveland,5/15/20,0,0,0,0,0,0,0,0,0,16,0,241,0,12,0,0,0,4,0,257,0,0,0,0,0,0,0,1,0,0,8
Columbia,5/15/20,0,0,0,0,0,0,0,0,0,15,0,257,0,11,0,2,0,2,0,272,0,0,0,0,0,0,0,0,1,0,7
Conway,5/15/20,0,0,0,0,0,0,0,0,0,14,0,420,0,12,0,1,0,1,0,434,0,0,0,0,0,0,0,0,0,0,11
Craighead,5/15/20,0,0,0,0,0,0,0,0,0,130,0,2188,0,83,0,0,0,47,0,2318,0,0,0,0,0,0,0,3,1,0,45
Crawford,5/15/20,0,0,0,0,0,0,0,0,0,9,0,452,0,5,0,0,0,4,0,461,0,0,0,0,0,0,0,1,0,0,15
Crittenden,5/15/20,0,0,0,0,0,0,0,0,0,229,0,1868,0,188,0,7,0,34,0,2097,0,0,0,0,0,0,0,10,4,0,55
Cross,5/15/20,0,0,0,0,0,0,0,0,0,35,0,394,0,23,0,0,0,12,0,429,0,0,0,0,0,0,0,0,0,0,13
Dallas,5/15/20,0,0,0,0,0,0,0,0,0,1,0,99,0,1,0,0,0,0,0,100,0,0,0,0,0,0,0,0,0,0,5
Desha,5/15/20,0,0,0,0,0,0,0,0,0,18,0,357,0,17,0,0,0,1,0,375,0,0,0,0,0,0,0,0,0,0,6
Drew,5/15/20,0,0,0,0,0,0,0,0,0,19,0,458,0,16,0,1,0,2,0,477,0,0,0,0,0,0,0,0,0,0,24
Faulkner,5/15/20,0,0,0,0,0,0,0,0,0,88,0,2250,0,75,0,3,0,10,0,2338,0,0,0,0,0,0,0,5,0,0,70
Franklin,5/15/20,0,0,0,0,0,0,0,0,0,2,0,168,0,2,0,0,0,0,0,170,0,0,0,0,0,0,0,0,0,0,3
Fulton,5/15/20,0,0,0,0,0,0,0,0,0,3,0,164,0,3,0,0,0,0,0,167,0,0,0,0,0,0,0,0,0,0,7
Garland,5/15/20,0,0,0,0,0,0,0,0,0,127,0,3111,0,116,0,1,0,10,0,3238,0,0,0,0,0,0,0,1,1,0,51
Grant,5/15/20,0,0,0,0,0,0,0,0,0,16,0,351,0,15,0,0,0,1,0,367,0,0,0,0,0,0,0,0,0,0,8
Greene,5/15/20,0,0,0,0,0,0,0,0,0,24,0,1137,0,21,0,0,0,3,0,1161,0,0,0,0,0,0,0,0,0,0,19
Hempstead,5/15/20,0,0,0,0,0,0,0,0,0,9,0,133,0,6,0,1,0,2,0,142,0,0,0,0,0,0,0,2,0,0,5
HotSpring,5/15/20,0,0,0,0,0,0,0,0,0,29,0,600,0,21,0,0,0,8,0,629,0,0,0,0,0,0,0,0,1,0,23
Howard,5/15/20,0,0,0,0,0,0,0,0,0,14,0,194,0,14,0,0,0,0,0,208,0,0,0,0,0,0,0,0,0,0,-2
Independence,5/15/20,0,0,0,0,0,0,0,0,0,23,0,435,0,15,0,0,0,8,0,458,0,0,0,0,0,0,0,1,3,0,19
Izard,5/15/20,0,0,0,0,0,0,0,0,0,13,0,130,0,10,0,0,0,3,0,143,0,0,0,0,0,0,0,0,2,0,5
Jackson,5/15/20,0,0,0,0,0,0,0,0,0,1,0,166,0,1,0,0,0,0,0,167,0,0,0,0,0,0,0,0,0,0,2
Jefferson,5/15/20,0,0,0,0,0,0,0,0,0,310,0,1908,0,184,0,19,0,107,0,2218,0,0,0,0,0,0,0,10,3,0,103
Johnson,5/15/20,0,0,0,0,0,0,0,0,0,35,0,264,0,32,0,0,0,3,0,299,0,0,0,0,0,0,0,0,0,0,2
Lafayette,5/15/20,0,0,0,0,0,0,0,0,0,9,0,29,0,8,0,1,0,0,0,38,0,0,0,0,0,0,0,0,0,0,1
Lawrence,5/15/20,0,0,0,0,0,0,0,0,0,72,0,450,0,51,0,4,0,17,0,522,0,0,0,0,0,0,0,0,0,0,20
Lee,5/15/20,0,0,0,0,0,0,0,0,0,10,0,135,0,3,0,1,0,6,0,145,0,0,0,0,0,0,0,0,0,0,3
Lincoln,5/15/20,0,0,0,0,0,0,0,0,0,952,0,845,0,856,0,8,0,88,0,1797,0,0,0,0,0,0,0,3,0,0,15
LittleRiver,5/15/20,0,0,0,0,0,0,0,0,0,0,0,114,0,0,0,0,0,0,0,114,0,0,0,0,0,0,0,0,0,0,0
Logan,5/15/20,0,0,0,0,0,0,0,0,0,4,0,183,0,3,0,0,0,1,0,187,0,0,0,0,0,0,0,0,0,0,6
Lonoke,5/15/20,0,0,0,0,0,0,0,0,0,45,0,1241,0,40,0,0,0,5,0,1286,0,0,0,0,0,0,0,1,0,0,27
Madison,5/15/20,0,0,0,0,0,0,0,0,0,1,0,197,0,1,0,0,0,0,0,198,0,0,0,0,0,0,0,0,0,0,6
Marion,5/15/20,0,0,0,0,0,0,0,0,0,1,0,110,0,1,0,0,0,0,0,111,0,0,0,0,0,0,0,0,0,0,5
Miller,5/15/20,0,0,0,0,0,0,0,0,0,42,0,402,0,35,0,1,0,6,0,444,0,0,0,0,0,0,0,2,0,0,5
MissingCountyInfo,5/15/20,0,0,0,0,0,0,0,0,0,139,0,20942,0,106,0,0,0,33,0,21081,0,0,0,0,0,0,0,4,0,0,957
Mississippi,5/15/20,0,0,0,0,0,0,0,0,0,58,0,646,0,28,0,0,0,30,0,704,0,0,0,0,0,0,0,3,2,0,40
Monroe,5/15/20,0,0,0,0,0,0,0,0,0,5,0,101,0,4,0,0,0,1,0,106,0,0,0,0,0,0,0,0,0,0,32
Montgomery,5/15/20,0,0,0,0,0,0,0,0,0,1,0,110,0,1,0,0,0,0,0,111,0,0,0,0,0,0,0,0,0,0,2
Nevada,5/15/20,0,0,0,0,0,0,0,0,0,4,0,89,0,3,0,0,0,1,0,93,0,0,0,0,0,0,0,1,0,0,7
Newton,5/15/20,0,0,0,0,0,0,0,0,0,3,0,93,0,3,0,0,0,0,0,96,0,0,0,0,0,0,0,0,0,0,5
Ouachita,5/15/20,0,0,0,0,0,0,0,0,0,9,0,550,0,6,0,0,0,3,0,559,0,0,0,0,0,0,0,0,0,0,117
Perry,5/15/20,0,0,0,0,0,0,0,0,0,12,0,185,0,7,0,0,0,5,0,197,0,0,0,0,0,0,0,2,0,0,13
Phillips,5/15/20,0,0,0,0,0,0,0,0,0,4,0,265,0,3,0,1,0,0,0,269,0,0,0,0,0,0,0,0,0,0,14
Pike,5/15/20,0,0,0,0,0,0,0,0,0,3,0,403,0,3,0,0,0,0,0,406,0,0,0,0,0,0,0,0,0,0,12
Poinsett,5/15/20,0,0,0,0,0,0,0,0,0,25,0,322,0,22,0,2,0,1,0,347,0,0,0,0,0,0,0,0,0,0,10
Polk,5/15/20,0,0,0,0,0,0,0,0,0,7,0,323,0,7,0,0,0,0,0,330,0,0,0,0,0,0,0,0,0,0,10
Pope,5/15/20,0,0,0,0,0,0,0,0,0,61,0,1915,0,44,0,0,0,17,0,1976,0,0,0,0,0,0,0,9,1,0,60
Prairie,5/15/20,0,0,0,0,0,0,0,0,0,2,0,69,0,2,0,0,0,0,0,71,0,0,0,0,0,0,0,0,0,0,0
Pulaski,5/15/20,0,0,0,0,0,0,0,0,0,669,0,8621,0,542,0,23,0,104,0,9290,0,0,0,0,0,0,0,8,15,0,264
Randolph,5/15/20,0,0,0,0,0,0,0,0,0,22,0,700,0,21,0,0,0,1,0,722,0,0,0,0,0,0,0,0,2,0,10
Saline,5/15/20,0,0,0,0,0,0,0,0,0,80,0,2290,0,70,0,1,0,9,0,2370,0,0,0,0,0,0,0,2,2,0,70
Scott,5/15/20,0,0,0,0,0,0,0,0,0,1,0,16,0,1,0,0,0,0,0,17,0,0,0,0,0,0,0,0,0,0,0
Searcy,5/15/20,0,0,0,0,0,0,0,0,0,6,0,230,0,6,0,0,0,0,0,236,0,0,0,0,0,0,0,0,0,0,60
Sebastian,5/15/20,0,0,0,0,0,0,0,0,0,15,0,704,0,14,0,0,0,1,0,719,0,0,0,0,0,0,0,0,0,0,8
Sevier,5/15/20,0,0,0,0,0,0,0,0,0,25,0,356,0,12,0,1,0,12,0,381,0,0,0,0,0,0,0,0,0,0,22
Sharp,5/15/20,0,0,0,0,0,0,0,0,0,37,0,193,0,6,0,2,0,29,0,230,0,0,0,0,0,0,0,1,0,0,2
St.Francis,5/15/20,0,0,0,0,0,0,0,0,0,333,0,1279,0,99,0,0,0,234,0,1612,0,0,0,0,0,0,0,17,4,0,161
Stone,5/15/20,0,0,0,0,0,0,0,0,0,8,0,156,0,8,0,0,0,0,0,164,0,0,0,0,0,0,0,0,0,0,5
Union,5/15/20,0,0,0,0,0,0,0,0,0,105,0,484,0,65,0,4,0,36,0,589,0,0,0,0,0,0,0,0,2,0,23
VanBuren,5/15/20,0,0,0,0,0,0,0,0,0,28,0,338,0,26,0,2,0,0,0,366,0,0,0,0,0,0,0,0,0,0,7
Washington,5/15/20,0,0,0,0,0,0,0,0,0,131,0,2894,0,93,0,5,0,33,0,3025,0,0,0,0,0,0,0,5,2,0,138
White,5/15/20,0,0,0,0,0,0,0,0,0,36,0,1225,0,32,0,1,0,3,0,1261,0,0,0,0,0,0,0,0,0,0,40
Woodruff,5/15/20,0,0,0,0,0,0,0,0,0,1,0,64,0,1,0,0,0,0,0,65,0,0,0,0,0,0,0,0,0,0,1
Yell,5/15/20,0,0,0,0,0,0,0,0,0,9,0,243,0,6,0,1,0,2,0,252,0,0,0,0,0,0,0,0,0,0,-20
Arkansas_all_counties,5/14/20,0,0,0,0,0,0,0,0,2990671,4366,0,74139,0,3277,0,98,0,991,0,78505,0,0,0,0,0,0,0,130,57,1,2687
Arkansas_county,5/14/20,0,0,0,0,0,0,0,0,0,2,0,186,0,2,0,0,0,0,0,188,0,0,0,0,0,0,0,0,0,0,5
Ashley,5/14/20,0,0,0,0,0,0,0,0,0,18,0,430,0,17,0,0,0,1,0,448,0,0,0,0,0,0,0,0,0,0,3
Baxter,5/14/20,0,0,0,0,0,0,0,0,0,6,0,411,0,5,0,0,0,1,0,417,0,0,0,0,0,0,0,1,0,0,8
Benton,5/14/20,0,0,0,0,0,0,0,0,0,136,0,5850,0,111,0,0,0,25,0,5986,0,0,0,0,0,0,0,5,2,0,257
Boone,5/14/20,0,0,0,0,0,0,0,0,0,4,0,318,0,4,0,0,0,0,0,322,0,0,0,0,0,0,0,0,0,0,15
Bradley,5/14/20,0,0,0,0,0,0,0,0,0,12,0,294,0,10,0,1,0,1,0,306,0,0,0,0,0,0,0,0,0,0,14
Calhoun,5/14/20,0,0,0,0,0,0,0,0,0,0,0,38,0,0,0,0,0,0,0,38,0,0,0,0,0,0,0,0,0,0,1
Carroll,5/14/20,0,0,0,0,0,0,0,0,0,6,0,379,0,6,0,0,0,0,0,385,0,0,0,0,0,0,0,0,0,0,19
Chicot,5/14/20,0,0,0,0,0,0,0,0,0,10,0,147,0,9,0,0,0,1,0,157,0,0,0,0,0,0,0,0,1,0,1
Clark,5/14/20,0,0,0,0,0,0,0,0,0,35,0,602,0,31,0,0,0,4,0,637,0,0,0,0,0,0,0,0,0,0,7
Clay,5/14/20,0,0,0,0,0,0,0,0,0,3,0,376,0,3,0,0,0,0,0,379,0,0,0,0,0,0,0,0,0,0,9
Cleburne,5/14/20,0,0,0,0,0,0,0,0,0,72,0,447,0,68,0,4,0,0,0,519,0,0,0,0,0,0,0,0,0,0,10
Cleveland,5/14/20,0,0,0,0,0,0,0,0,0,15,0,234,0,12,0,0,0,3,0,249,0,0,0,0,0,0,0,0,-1,0,7
Columbia,5/14/20,0,0,0,0,0,0,0,0,0,15,0,250,0,10,0,2,0,3,0,265,0,0,0,0,0,0,0,0,1,0,4
Conway,5/14/20,0,0,0,0,0,0,0,0,0,14,0,409,0,12,0,1,0,1,0,423,0,0,0,0,0,0,0,0,0,0,12
Craighead,5/14/20,0,0,0,0,0,0,0,0,0,127,0,2146,0,82,0,0,0,45,0,2273,0,0,0,0,0,0,0,14,3,0,147
Crawford,5/14/20,0,0,0,0,0,0,0,0,0,8,0,438,0,5,0,0,0,3,0,446,0,0,0,0,0,0,0,0,0,0,26
Crittenden,5/14/20,0,0,0,0,0,0,0,0,0,219,0,1823,0,184,0,7,0,28,0,2042,0,0,0,0,0,0,0,3,4,0,44
Cross,5/14/20,0,0,0,0,0,0,0,0,0,35,0,381,0,23,0,0,0,12,0,416,0,0,0,0,0,0,0,1,1,0,11
Dallas,5/14/20,0,0,0,0,0,0,0,0,0,1,0,94,0,1,0,0,0,0,0,95,0,0,0,0,0,0,0,0,0,0,1
Desha,5/14/20,0,0,0,0,0,0,0,0,0,18,0,351,0,17,0,0,0,1,0,369,0,0,0,0,0,0,0,1,1,0,34
Drew,5/14/20,0,0,0,0,0,0,0,0,0,19,0,434,0,16,0,1,0,2,0,453,0,0,0,0,0,0,0,0,2,0,14
Faulkner,5/14/20,0,0,0,0,0,0,0,0,0,83,0,2185,0,75,0,3,0,5,0,2268,0,0,0,0,0,0,0,0,2,0,54
Franklin,5/14/20,0,0,0,0,0,0,0,0,0,2,0,165,0,2,0,0,0,0,0,167,0,0,0,0,0,0,0,0,0,0,8
Fulton,5/14/20,0,0,0,0,0,0,0,0,0,3,0,157,0,3,0,0,0,0,0,160,0,0,0,0,0,0,0,0,0,0,6
Garland,5/14/20,0,0,0,0,0,0,0,0,0,126,0,3061,0,115,0,1,0,10,0,3187,0,0,0,0,0,0,0,5,0,0,62
Grant,5/14/20,0,0,0,0,0,0,0,0,0,16,0,343,0,15,0,0,0,1,0,359,0,0,0,0,0,0,0,0,0,0,10
Greene,5/14/20,0,0,0,0,0,0,0,0,0,24,0,1118,0,21,0,0,0,3,0,1142,0,0,0,0,0,0,0,0,1,0,49
Hempstead,5/14/20,0,0,0,0,0,0,0,0,0,7,0,130,0,6,0,1,0,0,0,137,0,0,0,0,0,0,0,0,0,0,2
HotSpring,5/14/20,0,0,0,0,0,0,0,0,0,29,0,577,0,20,0,0,0,9,0,606,0,0,0,0,0,0,0,1,1,0,8
Howard,5/14/20,0,0,0,0,0,0,0,0,0,14,0,196,0,14,0,0,0,0,0,210,0,0,0,0,0,0,0,0,0,0,2
Independence,5/14/20,0,0,0,0,0,0,0,0,0,22,0,417,0,12,0,0,0,10,0,439,0,0,0,0,0,0,0,3,1,0,34
Izard,5/14/20,0,0,0,0,0,0,0,0,0,13,0,125,0,8,0,0,0,5,0,138,0,0,0,0,0,0,0,0,0,0,1
Jackson,5/14/20,0,0,0,0,0,0,0,0,0,1,0,164,0,1,0,0,0,0,0,165,0,0,0,0,0,0,0,0,0,0,10
Jefferson,5/14/20,0,0,0,0,0,0,0,0,0,300,0,1815,0,181,0,19,0,100,0,2115,0,0,0,0,0,0,0,20,9,0,35
Johnson,5/14/20,0,0,0,0,0,0,0,0,0,35,0,262,0,32,0,0,0,3,0,297,0,0,0,0,0,0,0,0,0,0,7
Lafayette,5/14/20,0,0,0,0,0,0,0,0,0,9,0,28,0,8,0,1,0,0,0,37,0,0,0,0,0,0,0,0,0,0,2
Lawrence,5/14/20,0,0,0,0,0,0,0,0,0,72,0,430,0,51,0,4,0,17,0,502,0,0,0,0,0,0,0,1,8,0,9
Lee,5/14/20,0,0,0,0,0,0,0,0,0,10,0,132,0,3,0,1,0,6,0,142,0,0,0,0,0,0,0,1,0,0,4
Lincoln,5/14/20,0,0,0,0,0,0,0,0,0,949,0,833,0,856,0,8,0,85,0,1782,0,0,0,0,0,0,0,7,2,1,9
LittleRiver,5/14/20,0,0,0,0,0,0,0,0,0,0,0,114,0,0,0,0,0,0,0,114,0,0,0,0,0,0,0,0,0,0,2
Logan,5/14/20,0,0,0,0,0,0,0,0,0,4,0,177,0,3,0,0,0,1,0,181,0,0,0,0,0,0,0,0,1,0,8
Lonoke,5/14/20,0,0,0,0,0,0,0,0,0,44,0,1215,0,40,0,0,0,4,0,1259,0,0,0,0,0,0,0,1,1,0,37
Madison,5/14/20,0,0,0,0,0,0,0,0,0,1,0,191,0,1,0,0,0,0,0,192,0,0,0,0,0,0,0,0,0,0,15
Marion,5/14/20,0,0,0,0,0,0,0,0,0,1,0,105,0,1,0,0,0,0,0,106,0,0,0,0,0,0,0,0,0,0,6
Miller,5/14/20,0,0,0,0,0,0,0,0,0,40,0,399,0,35,0,1,0,4,0,439,0,0,0,0,0,0,0,0,0,0,6
MissingCountyInfo,5/14/20,0,0,0,0,0,0,0,0,0,135,0,19989,0,104,0,0,0,31,0,20124,0,0,0,0,0,0,0,-5,0,0,807
Mississippi,5/14/20,0,0,0,0,0,0,0,0,0,55,0,609,0,26,0,0,0,29,0,664,0,0,0,0,0,0,0,1,4,0,37
Monroe,5/14/20,0,0,0,0,0,0,0,0,0,5,0,69,0,4,0,0,0,1,0,74,0,0,0,0,0,0,0,0,0,0,4
Montgomery,5/14/20,0,0,0,0,0,0,0,0,0,1,0,108,0,1,0,0,0,0,0,109,0,0,0,0,0,0,0,0,0,0,1
Nevada,5/14/20,0,0,0,0,0,0,0,0,0,3,0,83,0,3,0,0,0,0,0,86,0,0,0,0,0,0,0,0,0,0,-2
Newton,5/14/20,0,0,0,0,0,0,0,0,0,3,0,88,0,3,0,0,0,0,0,91,0,0,0,0,0,0,0,0,0,0,1
Ouachita,5/14/20,0,0,0,0,0,0,0,0,0,9,0,433,0,6,0,0,0,3,0,442,0,0,0,0,0,0,0,0,0,0,8
Perry,5/14/20,0,0,0,0,0,0,0,0,0,10,0,174,0,7,0,0,0,3,0,184,0,0,0,0,0,0,0,2,0,0,18
Phillips,5/14/20,0,0,0,0,0,0,0,0,0,4,0,251,0,3,0,1,0,0,0,255,0,0,0,0,0,0,0,0,0,0,4
Pike,5/14/20,0,0,0,0,0,0,0,0,0,3,0,391,0,3,0,0,0,0,0,394,0,0,0,0,0,0,0,0,0,0,4
Poinsett,5/14/20,0,0,0,0,0,0,0,0,0,25,0,312,0,22,0,2,0,1,0,337,0,0,0,0,0,0,0,0,0,0,17
Polk,5/14/20,0,0,0,0,0,0,0,0,0,7,0,313,0,7,0,0,0,0,0,320,0,0,0,0,0,0,0,0,0,0,0
Pope,5/14/20,0,0,0,0,0,0,0,0,0,52,0,1864,0,43,0,0,0,9,0,1916,0,0,0,0,0,0,0,1,0,0,27
Prairie,5/14/20,0,0,0,0,0,0,0,0,0,2,0,69,0,2,0,0,0,0,0,71,0,0,0,0,0,0,0,0,0,0,3
Pulaski,5/14/20,0,0,0,0,0,0,0,0,0,661,0,8365,0,527,0,23,0,111,0,9026,0,0,0,0,0,0,0,14,8,0,299
Randolph,5/14/20,0,0,0,0,0,0,0,0,0,22,0,690,0,19,0,0,0,3,0,712,0,0,0,0,0,0,0,0,0,0,7
Saline,5/14/20,0,0,0,0,0,0,0,0,0,78,0,2222,0,68,0,1,0,9,0,2300,0,0,0,0,0,0,0,2,0,0,76
Scott,5/14/20,0,0,0,0,0,0,0,0,0,1,0,16,0,1,0,0,0,0,0,17,0,0,0,0,0,0,0,0,0,0,0
Searcy,5/14/20,0,0,0,0,0,0,0,0,0,6,0,170,0,6,0,0,0,0,0,176,0,0,0,0,0,0,0,0,0,0,2
Sebastian,5/14/20,0,0,0,0,0,0,0,0,0,15,0,696,0,14,0,0,0,1,0,711,0,0,0,0,0,0,0,0,0,0,29
Sevier,5/14/20,0,0,0,0,0,0,0,0,0,24,0,335,0,12,0,1,0,11,0,359,0,0,0,0,0,0,0,0,1,0,1
Sharp,5/14/20,0,0,0,0,0,0,0,0,0,36,0,192,0,6,0,2,0,28,0,228,0,0,0,0,0,0,0,10,0,0,14
St.Francis,5/14/20,0,0,0,0,0,0,0,0,0,316,0,1135,0,95,0,0,0,221,0,1451,0,0,0,0,0,0,0,6,5,0,72
Stone,5/14/20,0,0,0,0,0,0,0,0,0,8,0,151,0,8,0,0,0,0,0,159,0,0,0,0,0,0,0,0,0,0,2
Union,5/14/20,0,0,0,0,0,0,0,0,0,105,0,461,0,63,0,4,0,38,0,566,0,0,0,0,0,0,0,21,1,0,32
VanBuren,5/14/20,0,0,0,0,0,0,0,0,0,28,0,331,0,26,0,2,0,0,0,359,0,0,0,0,0,0,0,0,0,0,5
Washington,5/14/20,0,0,0,0,0,0,0,0,0,126,0,2761,0,91,0,5,0,30,0,2887,0,0,0,0,0,0,0,12,0,0,126
White,5/14/20,0,0,0,0,0,0,0,0,0,36,0,1185,0,32,0,1,0,3,0,1221,0,0,0,0,0,0,0,0,0,0,49
Woodruff,5/14/20,0,0,0,0,0,0,0,0,0,1,0,63,0,1,0,0,0,0,0,64,0,0,0,0,0,0,0,0,0,0,6
Yell,5/14/20,0,0,0,0,0,0,0,0,0,9,0,263,0,6,0,1,0,2,0,272,0,0,0,0,0,0,0,2,0,0,30
Arkansas_all_counties,5/13/20,0,0,0,0,0,0,0,0,2990671,4236,0,71582,0,3277,0,97,0,862,0,75818,0,0,0,0,0,0,0,72,57,2,2603
Arkansas_county,5/13/20,0,0,0,0,0,0,0,0,0,2,0,181,0,2,0,0,0,0,0,183,0,0,0,0,0,0,0,0,0,0,15
Ashley,5/13/20,0,0,0,0,0,0,0,0,0,18,0,427,0,17,0,0,0,1,0,445,0,0,0,0,0,0,0,0,0,0,8
Baxter,5/13/20,0,0,0,0,0,0,0,0,0,5,0,404,0,5,0,0,0,0,0,409,0,0,0,0,0,0,0,0,0,0,4
Benton,5/13/20,0,0,0,0,0,0,0,0,0,131,0,5598,0,109,0,0,0,22,0,5729,0,0,0,0,0,0,0,4,4,0,286
Boone,5/13/20,0,0,0,0,0,0,0,0,0,4,0,303,0,4,0,0,0,0,0,307,0,0,0,0,0,0,0,0,0,0,14
Bradley,5/13/20,0,0,0,0,0,0,0,0,0,12,0,280,0,10,0,1,0,1,0,292,0,0,0,0,0,0,0,1,0,0,8
Calhoun,5/13/20,0,0,0,0,0,0,0,0,0,0,0,37,0,0,0,0,0,0,0,37,0,0,0,0,0,0,0,0,0,0,1
Carroll,5/13/20,0,0,0,0,0,0,0,0,0,6,0,360,0,6,0,0,0,0,0,366,0,0,0,0,0,0,0,0,0,0,14
Chicot,5/13/20,0,0,0,0,0,0,0,0,0,10,0,146,0,9,0,0,0,1,0,156,0,0,0,0,0,0,0,0,1,0,5
Clark,5/13/20,0,0,0,0,0,0,0,0,0,35,0,595,0,31,0,0,0,4,0,630,0,0,0,0,0,0,0,1,1,0,9
Clay,5/13/20,0,0,0,0,0,0,0,0,0,3,0,367,0,3,0,0,0,0,0,370,0,0,0,0,0,0,0,0,0,0,7
Cleburne,5/13/20,0,0,0,0,0,0,0,0,0,72,0,437,0,68,0,4,0,0,0,509,0,0,0,0,0,0,0,0,0,0,23
Cleveland,5/13/20,0,0,0,0,0,0,0,0,0,15,0,227,0,13,0,0,0,2,0,242,0,0,0,0,0,0,0,2,1,0,8
Columbia,5/13/20,0,0,0,0,0,0,0,0,0,15,0,246,0,9,0,2,0,4,0,261,0,0,0,0,0,0,0,0,1,0,5
Conway,5/13/20,0,0,0,0,0,0,0,0,0,14,0,397,0,12,0,1,0,1,0,411,0,0,0,0,0,0,0,1,1,0,2
Craighead,5/13/20,0,0,0,0,0,0,0,0,0,113,0,2013,0,79,0,0,0,34,0,2126,0,0,0,0,0,0,0,10,4,0,123
Crawford,5/13/20,0,0,0,0,0,0,0,0,0,8,0,412,0,5,0,0,0,3,0,420,0,0,0,0,0,0,0,0,0,0,15
Crittenden,5/13/20,0,0,0,0,0,0,0,0,0,216,0,1782,0,180,0,7,0,29,0,1998,0,0,0,0,0,0,0,4,2,0,59
Cross,5/13/20,0,0,0,0,0,0,0,0,0,34,0,371,0,22,0,0,0,12,0,405,0,0,0,0,0,0,0,3,2,0,21
Dallas,5/13/20,0,0,0,0,0,0,0,0,0,1,0,93,0,1,0,0,0,0,0,94,0,0,0,0,0,0,0,0,0,0,1
Desha,5/13/20,0,0,0,0,0,0,0,0,0,17,0,318,0,16,0,0,0,1,0,335,0,0,0,0,0,0,0,0,0,0,19
Drew,5/13/20,0,0,0,0,0,0,0,0,0,19,0,420,0,14,0,1,0,4,0,439,0,0,0,0,0,0,0,0,0,0,9
Faulkner,5/13/20,0,0,0,0,0,0,0,0,0,83,0,2131,0,73,0,3,0,7,0,2214,0,0,0,0,0,0,0,1,0,1,48
Franklin,5/13/20,0,0,0,0,0,0,0,0,0,2,0,157,0,2,0,0,0,0,0,159,0,0,0,0,0,0,0,0,0,0,6
Fulton,5/13/20,0,0,0,0,0,0,0,0,0,3,0,151,0,3,0,0,0,0,0,154,0,0,0,0,0,0,0,0,0,0,10
Garland,5/13/20,0,0,0,0,0,0,0,0,0,121,0,3004,0,115,0,1,0,5,0,3125,0,0,0,0,0,0,0,1,1,0,92
Grant,5/13/20,0,0,0,0,0,0,0,0,0,16,0,333,0,15,0,0,0,1,0,349,0,0,0,0,0,0,0,1,1,0,9
Greene,5/13/20,0,0,0,0,0,0,0,0,0,24,0,1069,0,20,0,0,0,4,0,1093,0,0,0,0,0,0,0,0,1,0,38
Hempstead,5/13/20,0,0,0,0,0,0,0,0,0,7,0,128,0,6,0,1,0,0,0,135,0,0,0,0,0,0,0,0,1,0,6
HotSpring,5/13/20,0,0,0,0,0,0,0,0,0,28,0,570,0,19,0,0,0,9,0,598,0,0,0,0,0,0,0,1,1,0,15
Howard,5/13/20,0,0,0,0,0,0,0,0,0,14,0,194,0,14,0,0,0,0,0,208,0,0,0,0,0,0,0,0,0,0,7
Independence,5/13/20,0,0,0,0,0,0,0,0,0,19,0,386,0,11,0,0,0,8,0,405,0,0,0,0,0,0,0,2,1,0,45
Izard,5/13/20,0,0,0,0,0,0,0,0,0,13,0,124,0,8,0,0,0,5,0,137,0,0,0,0,0,0,0,0,0,0,9
Jackson,5/13/20,0,0,0,0,0,0,0,0,0,1,0,154,0,1,0,0,0,0,0,155,0,0,0,0,0,0,0,0,0,0,9
Jefferson,5/13/20,0,0,0,0,0,0,0,0,0,280,0,1800,0,172,0,19,0,89,0,2080,0,0,0,0,0,0,0,7,5,0,48
Johnson,5/13/20,0,0,0,0,0,0,0,0,0,35,0,255,0,32,0,0,0,3,0,290,0,0,0,0,0,0,0,0,0,0,8
Lafayette,5/13/20,0,0,0,0,0,0,0,0,0,9,0,26,0,8,0,1,0,0,0,35,0,0,0,0,0,0,0,0,1,0,0
Lawrence,5/13/20,0,0,0,0,0,0,0,0,0,71,0,422,0,43,0,4,0,24,0,493,0,0,0,0,0,0,0,0,2,0,14
Lee,5/13/20,0,0,0,0,0,0,0,0,0,9,0,129,0,3,0,1,0,5,0,138,0,0,0,0,0,0,0,0,0,0,2
Lincoln,5/13/20,0,0,0,0,0,0,0,0,0,942,0,831,0,854,0,7,0,81,0,1773,0,0,0,0,0,0,0,0,0,0,6
LittleRiver,5/13/20,0,0,0,0,0,0,0,0,0,0,0,112,0,0,0,0,0,0,0,112,0,0,0,0,0,0,0,0,0,0,0
Logan,5/13/20,0,0,0,0,0,0,0,0,0,4,0,169,0,2,0,0,0,2,0,173,0,0,0,0,0,0,0,1,0,0,4
Lonoke,5/13/20,0,0,0,0,0,0,0,0,0,43,0,1179,0,39,0,0,0,4,0,1222,0,0,0,0,0,0,0,-1,-1,0,44
Madison,5/13/20,0,0,0,0,0,0,0,0,0,1,0,176,0,1,0,0,0,0,0,177,0,0,0,0,0,0,0,0,0,0,1
Marion,5/13/20,0,0,0,0,0,0,0,0,0,1,0,99,0,1,0,0,0,0,0,100,0,0,0,0,0,0,0,0,0,0,-1
Miller,5/13/20,0,0,0,0,0,0,0,0,0,40,0,393,0,35,0,1,0,4,0,433,0,0,0,0,0,0,0,2,0,0,11
MissingCountyInfo,5/13/20,0,0,0,0,0,0,0,0,0,140,0,19177,0,104,0,0,0,36,0,19317,0,0,0,0,0,0,0,3,5,0,716
Mississippi,5/13/20,0,0,0,0,0,0,0,0,0,54,0,573,0,22,0,0,0,32,0,627,0,0,0,0,0,0,0,1,1,0,25
Monroe,5/13/20,0,0,0,0,0,0,0,0,0,5,0,65,0,4,0,0,0,1,0,70,0,0,0,0,0,0,0,0,0,0,0
Montgomery,5/13/20,0,0,0,0,0,0,0,0,0,1,0,107,0,1,0,0,0,0,0,108,0,0,0,0,0,0,0,0,0,0,-1
Nevada,5/13/20,0,0,0,0,0,0,0,0,0,3,0,85,0,3,0,0,0,0,0,88,0,0,0,0,0,0,0,0,1,0,3
Newton,5/13/20,0,0,0,0,0,0,0,0,0,3,0,87,0,3,0,0,0,0,0,90,0,0,0,0,0,0,0,0,0,0,2
Ouachita,5/13/20,0,0,0,0,0,0,0,0,0,9,0,425,0,6,0,0,0,3,0,434,0,0,0,0,0,0,0,1,0,0,20
Perry,5/13/20,0,0,0,0,0,0,0,0,0,8,0,158,0,7,0,0,0,1,0,166,0,0,0,0,0,0,0,0,0,0,7
Phillips,5/13/20,0,0,0,0,0,0,0,0,0,4,0,247,0,3,0,1,0,0,0,251,0,0,0,0,0,0,0,0,0,0,5
Pike,5/13/20,0,0,0,0,0,0,0,0,0,3,0,387,0,3,0,0,0,0,0,390,0,0,0,0,0,0,0,0,0,0,13
Poinsett,5/13/20,0,0,0,0,0,0,0,0,0,25,0,295,0,22,0,2,0,1,0,320,0,0,0,0,0,0,0,0,2,0,10
Polk,5/13/20,0,0,0,0,0,0,0,0,0,7,0,313,0,7,0,0,0,0,0,320,0,0,0,0,0,0,0,0,0,0,6
Pope,5/13/20,0,0,0,0,0,0,0,0,0,51,0,1838,0,43,0,0,0,8,0,1889,0,0,0,0,0,0,0,3,1,0,44
Prairie,5/13/20,0,0,0,0,0,0,0,0,0,2,0,66,0,2,0,0,0,0,0,68,0,0,0,0,0,0,0,0,0,0,3
Pulaski,5/13/20,0,0,0,0,0,0,0,0,0,647,0,8080,0,514,0,23,0,110,0,8727,0,0,0,0,0,0,0,7,8,0,292
Randolph,5/13/20,0,0,0,0,0,0,0,0,0,22,0,683,0,19,0,0,0,3,0,705,0,0,0,0,0,0,0,0,0,0,17
Saline,5/13/20,0,0,0,0,0,0,0,0,0,76,0,2148,0,68,0,1,0,7,0,2224,0,0,0,0,0,0,0,1,1,0,77
Scott,5/13/20,0,0,0,0,0,0,0,0,0,1,0,16,0,1,0,0,0,0,0,17,0,0,0,0,0,0,0,0,0,0,-1
Searcy,5/13/20,0,0,0,0,0,0,0,0,0,6,0,168,0,6,0,0,0,0,0,174,0,0,0,0,0,0,0,0,0,0,0
Sebastian,5/13/20,0,0,0,0,0,0,0,0,0,15,0,667,0,14,0,0,0,1,0,682,0,0,0,0,0,0,0,0,0,0,24
Sevier,5/13/20,0,0,0,0,0,0,0,0,0,24,0,334,0,11,0,1,0,12,0,358,0,0,0,0,0,0,0,3,0,0,11
Sharp,5/13/20,0,0,0,0,0,0,0,0,0,26,0,188,0,6,0,2,0,18,0,214,0,0,0,0,0,0,0,1,0,0,11
St.Francis,5/13/20,0,0,0,0,0,0,0,0,0,310,0,1069,0,90,0,0,0,220,0,1379,0,0,0,0,0,0,0,5,3,0,46
Stone,5/13/20,0,0,0,0,0,0,0,0,0,8,0,149,0,8,0,0,0,0,0,157,0,0,0,0,0,0,0,0,0,0,6
Union,5/13/20,0,0,0,0,0,0,0,0,0,84,0,450,0,62,0,4,0,18,0,534,0,0,0,0,0,0,0,4,5,0,5
VanBuren,5/13/20,0,0,0,0,0,0,0,0,0,28,0,326,0,26,0,2,0,0,0,354,0,0,0,0,0,0,0,0,0,0,2
Washington,5/13/20,0,0,0,0,0,0,0,0,0,114,0,2647,0,91,0,5,0,18,0,2761,0,0,0,0,0,0,0,3,1,1,88
White,5/13/20,0,0,0,0,0,0,0,0,0,36,0,1136,0,32,0,1,0,3,0,1172,0,0,0,0,0,0,0,-1,1,0,67
Woodruff,5/13/20,0,0,0,0,0,0,0,0,0,1,0,57,0,1,0,0,0,0,0,58,0,0,0,0,0,0,0,0,0,0,9
Yell,5/13/20,0,0,0,0,0,0,0,0,0,7,0,235,0,6,0,1,0,0,0,242,0,0,0,0,0,0,0,0,0,0,9
Arkansas_all_counties,5/12/20,0,0,0,0,0,0,0,0,2990671,4164,0,69051,0,3220,0,95,0,849,0,73215,0,0,0,0,0,0,0,121,71,1,2892
Arkansas_county,5/12/20,0,0,0,0,0,0,0,0,0,2,0,166,0,2,0,0,0,0,0,168,0,0,0,0,0,0,0,0,0,0,9
Ashley,5/12/20,0,0,0,0,0,0,0,0,0,18,0,419,0,17,0,0,0,1,0,437,0,0,0,0,0,0,0,0,1,0,18
Baxter,5/12/20,0,0,0,0,0,0,0,0,0,5,0,400,0,5,0,0,0,0,0,405,0,0,0,0,0,0,0,0,0,0,11
Benton,5/12/20,0,0,0,0,0,0,0,0,0,127,0,5316,0,105,0,0,0,22,0,5443,0,0,0,0,0,0,0,4,2,0,383
Boone,5/12/20,0,0,0,0,0,0,0,0,0,4,0,289,0,4,0,0,0,0,0,293,0,0,0,0,0,0,0,0,0,0,26
Bradley,5/12/20,0,0,0,0,0,0,0,0,0,11,0,273,0,10,0,1,0,0,0,284,0,0,0,0,0,0,0,0,1,0,5
Calhoun,5/12/20,0,0,0,0,0,0,0,0,0,0,0,36,0,0,0,0,0,0,0,36,0,0,0,0,0,0,0,0,0,0,1
Carroll,5/12/20,0,0,0,0,0,0,0,0,0,6,0,346,0,6,0,0,0,0,0,352,0,0,0,0,0,0,0,0,0,0,16
Chicot,5/12/20,0,0,0,0,0,0,0,0,0,10,0,141,0,8,0,0,0,2,0,151,0,0,0,0,0,0,0,0,0,0,4
Clark,5/12/20,0,0,0,0,0,0,0,0,0,34,0,587,0,30,0,0,0,4,0,621,0,0,0,0,0,0,0,1,1,0,1
Clay,5/12/20,0,0,0,0,0,0,0,0,0,3,0,360,0,3,0,0,0,0,0,363,0,0,0,0,0,0,0,-1,1,0,14
Cleburne,5/12/20,0,0,0,0,0,0,0,0,0,72,0,414,0,68,0,4,0,0,0,486,0,0,0,0,0,0,0,0,0,0,12
Cleveland,5/12/20,0,0,0,0,0,0,0,0,0,13,0,221,0,12,0,0,0,1,0,234,0,0,0,0,0,0,0,0,0,0,0
Columbia,5/12/20,0,0,0,0,0,0,0,0,0,15,0,241,0,8,0,2,0,5,0,256,0,0,0,0,0,0,0,0,2,0,1
Conway,5/12/20,0,0,0,0,0,0,0,0,0,13,0,396,0,11,0,1,0,1,0,409,0,0,0,0,0,0,0,0,1,0,13
Craighead,5/12/20,0,0,0,0,0,0,0,0,0,103,0,1900,0,77,0,0,0,26,0,2003,0,0,0,0,0,0,0,5,5,0,97
Crawford,5/12/20,0,0,0,0,0,0,0,0,0,8,0,397,0,5,0,0,0,3,0,405,0,0,0,0,0,0,0,3,1,0,20
Crittenden,5/12/20,0,0,0,0,0,0,0,0,0,212,0,1727,0,178,0,7,0,27,0,1939,0,0,0,0,0,0,0,2,7,0,23
Cross,5/12/20,0,0,0,0,0,0,0,0,0,31,0,353,0,20,0,0,0,11,0,384,0,0,0,0,0,0,0,2,0,0,19
Dallas,5/12/20,0,0,0,0,0,0,0,0,0,1,0,92,0,1,0,0,0,0,0,93,0,0,0,0,0,0,0,0,0,0,4
Desha,5/12/20,0,0,0,0,0,0,0,0,0,17,0,299,0,16,0,0,0,1,0,316,0,0,0,0,0,0,0,0,1,0,2
Drew,5/12/20,0,0,0,0,0,0,0,0,0,19,0,411,0,14,0,1,0,4,0,430,0,0,0,0,0,0,0,0,0,0,10
Faulkner,5/12/20,0,0,0,0,0,0,0,0,0,82,0,2084,0,73,0,2,0,7,0,2166,0,0,0,0,0,0,0,0,0,0,31
Franklin,5/12/20,0,0,0,0,0,0,0,0,0,2,0,151,0,2,0,0,0,0,0,153,0,0,0,0,0,0,0,0,0,0,10
Fulton,5/12/20,0,0,0,0,0,0,0,0,0,3,0,141,0,3,0,0,0,0,0,144,0,0,0,0,0,0,0,0,0,0,6
Garland,5/12/20,0,0,0,0,0,0,0,0,0,120,0,2913,0,114,0,1,0,5,0,3033,0,0,0,0,0,0,0,1,1,0,65
Grant,5/12/20,0,0,0,0,0,0,0,0,0,15,0,325,0,14,0,0,0,1,0,340,0,0,0,0,0,0,0,0,0,0,2
Greene,5/12/20,0,0,0,0,0,0,0,0,0,24,0,1031,0,19,0,0,0,5,0,1055,0,0,0,0,0,0,0,1,0,0,23
Hempstead,5/12/20,0,0,0,0,0,0,0,0,0,7,0,122,0,5,0,1,0,1,0,129,0,0,0,0,0,0,0,0,0,0,3
HotSpring,5/12/20,0,0,0,0,0,0,0,0,0,27,0,556,0,18,0,0,0,9,0,583,0,0,0,0,0,0,0,1,1,0,13
Howard,5/12/20,0,0,0,0,0,0,0,0,0,14,0,187,0,14,0,0,0,0,0,201,0,0,0,0,0,0,0,0,1,0,1
Independence,5/12/20,0,0,0,0,0,0,0,0,0,17,0,343,0,10,0,0,0,7,0,360,0,0,0,0,0,0,0,0,0,0,5
Izard,5/12/20,0,0,0,0,0,0,0,0,0,13,0,115,0,8,0,0,0,5,0,128,0,0,0,0,0,0,0,0,1,0,6
Jackson,5/12/20,0,0,0,0,0,0,0,0,0,1,0,145,0,1,0,0,0,0,0,146,0,0,0,0,0,0,0,0,0,0,6
Jefferson,5/12/20,0,0,0,0,0,0,0,0,0,273,0,1759,0,167,0,19,0,87,0,2032,0,0,0,0,0,0,0,35,4,0,259
Johnson,5/12/20,0,0,0,0,0,0,0,0,0,35,0,247,0,32,0,0,0,3,0,282,0,0,0,0,0,0,0,1,0,0,12
Lafayette,5/12/20,0,0,0,0,0,0,0,0,0,9,0,26,0,7,0,1,0,1,0,35,0,0,0,0,0,0,0,0,0,0,1
Lawrence,5/12/20,0,0,0,0,0,0,0,0,0,71,0,408,0,41,0,4,0,26,0,479,0,0,0,0,0,0,0,2,1,0,6
Lee,5/12/20,0,0,0,0,0,0,0,0,0,9,0,127,0,3,0,1,0,5,0,136,0,0,0,0,0,0,0,4,0,0,20
Lincoln,5/12/20,0,0,0,0,0,0,0,0,0,942,0,825,0,854,0,7,0,81,0,1767,0,0,0,0,0,0,0,1,1,0,26
LittleRiver,5/12/20,0,0,0,0,0,0,0,0,0,0,0,112,0,0,0,0,0,0,0,112,0,0,0,0,0,0,0,0,0,0,8
Logan,5/12/20,0,0,0,0,0,0,0,0,0,3,0,166,0,2,0,0,0,1,0,169,0,0,0,0,0,0,0,0,0,0,-1
Lonoke,5/12/20,0,0,0,0,0,0,0,0,0,44,0,1134,0,40,0,0,0,4,0,1178,0,0,0,0,0,0,0,-1,0,0,63
Madison,5/12/20,0,0,0,0,0,0,0,0,0,1,0,175,0,1,0,0,0,0,0,176,0,0,0,0,0,0,0,0,0,0,4
Marion,5/12/20,0,0,0,0,0,0,0,0,0,1,0,100,0,1,0,0,0,0,0,101,0,0,0,0,0,0,0,0,0,0,3
Miller,5/12/20,0,0,0,0,0,0,0,0,0,38,0,384,0,35,0,1,0,2,0,422,0,0,0,0,0,0,0,1,0,0,12
MissingCountyInfo,5/12/20,0,0,0,0,0,0,0,0,0,137,0,18464,0,99,0,0,0,38,0,18601,0,0,0,0,0,0,0,6,2,0,811
Mississippi,5/12/20,0,0,0,0,0,0,0,0,0,53,0,549,0,21,0,0,0,32,0,602,0,0,0,0,0,0,0,1,3,0,35
Monroe,5/12/20,0,0,0,0,0,0,0,0,0,5,0,65,0,4,0,0,0,1,0,70,0,0,0,0,0,0,0,0,0,0,1
Montgomery,5/12/20,0,0,0,0,0,0,0,0,0,1,0,108,0,1,0,0,0,0,0,109,0,0,0,0,0,0,0,0,1,0,4
Nevada,5/12/20,0,0,0,0,0,0,0,0,0,3,0,82,0,2,0,0,0,1,0,85,0,0,0,0,0,0,0,0,1,0,0
Newton,5/12/20,0,0,0,0,0,0,0,0,0,3,0,85,0,3,0,0,0,0,0,88,0,0,0,0,0,0,0,0,0,0,0
Ouachita,5/12/20,0,0,0,0,0,0,0,0,0,8,0,406,0,6,0,0,0,2,0,414,0,0,0,0,0,0,0,-1,-1,0,9
Perry,5/12/20,0,0,0,0,0,0,0,0,0,8,0,151,0,7,0,0,0,1,0,159,0,0,0,0,0,0,0,0,0,0,3
Phillips,5/12/20,0,0,0,0,0,0,0,0,0,4,0,242,0,3,0,1,0,0,0,246,0,0,0,0,0,0,0,0,0,0,10
Pike,5/12/20,0,0,0,0,0,0,0,0,0,3,0,374,0,3,0,0,0,0,0,377,0,0,0,0,0,0,0,0,0,0,1
Poinsett,5/12/20,0,0,0,0,0,0,0,0,0,25,0,285,0,20,0,2,0,3,0,310,0,0,0,0,0,0,0,0,1,0,5
Polk,5/12/20,0,0,0,0,0,0,0,0,0,7,0,307,0,7,0,0,0,0,0,314,0,0,0,0,0,0,0,0,0,0,4
Pope,5/12/20,0,0,0,0,0,0,0,0,0,48,0,1797,0,42,0,0,0,6,0,1845,0,0,0,0,0,0,0,0,0,0,12
Prairie,5/12/20,0,0,0,0,0,0,0,0,0,2,0,63,0,2,0,0,0,0,0,65,0,0,0,0,0,0,0,0,0,0,-1
Pulaski,5/12/20,0,0,0,0,0,0,0,0,0,640,0,7795,0,506,0,23,0,111,0,8435,0,0,0,0,0,0,0,10,16,0,300
Randolph,5/12/20,0,0,0,0,0,0,0,0,0,22,0,666,0,19,0,0,0,3,0,688,0,0,0,0,0,0,0,0,0,0,5
Saline,5/12/20,0,0,0,0,0,0,0,0,0,75,0,2072,0,67,0,1,0,7,0,2147,0,0,0,0,0,0,0,2,2,0,61
Scott,5/12/20,0,0,0,0,0,0,0,0,0,1,0,17,0,1,0,0,0,0,0,18,0,0,0,0,0,0,0,0,0,0,2
Searcy,5/12/20,0,0,0,0,0,0,0,0,0,6,0,168,0,6,0,0,0,0,0,174,0,0,0,0,0,0,0,0,0,0,2
Sebastian,5/12/20,0,0,0,0,0,0,0,0,0,15,0,643,0,14,0,0,0,1,0,658,0,0,0,0,0,0,0,0,1,0,20
Sevier,5/12/20,0,0,0,0,0,0,0,0,0,21,0,326,0,11,0,1,0,9,0,347,0,0,0,0,0,0,0,0,-1,0,6
Sharp,5/12/20,0,0,0,0,0,0,0,0,0,25,0,178,0,6,0,2,0,17,0,203,0,0,0,0,0,0,0,9,0,0,19
St.Francis,5/12/20,0,0,0,0,0,0,0,0,0,305,0,1028,0,87,0,0,0,218,0,1333,0,0,0,0,0,0,0,26,5,0,113
Stone,5/12/20,0,0,0,0,0,0,0,0,0,8,0,143,0,8,0,0,0,0,0,151,0,0,0,0,0,0,0,0,0,0,4
Union,5/12/20,0,0,0,0,0,0,0,0,0,80,0,449,0,57,0,4,0,19,0,529,0,0,0,0,0,0,0,4,2,0,24
VanBuren,5/12/20,0,0,0,0,0,0,0,0,0,28,0,324,0,26,0,2,0,0,0,352,0,0,0,0,0,0,0,0,0,0,7
Washington,5/12/20,0,0,0,0,0,0,0,0,0,111,0,2562,0,90,0,4,0,17,0,2673,0,0,0,0,0,0,0,1,6,1,137
White,5/12/20,0,0,0,0,0,0,0,0,0,37,0,1068,0,31,0,1,0,5,0,1105,0,0,0,0,0,0,0,1,0,0,22
Woodruff,5/12/20,0,0,0,0,0,0,0,0,0,1,0,48,0,1,0,0,0,0,0,49,0,0,0,0,0,0,0,0,0,0,0
Yell,5/12/20,0,0,0,0,0,0,0,0,0,7,0,226,0,6,0,1,0,0,0,233,0,0,0,0,0,0,0,0,0,0,3
Arkansas_all_counties,5/11/20,0,0,0,0,0,0,0,0,2990671,4043,0,66280,0,3149,0,94,0,800,0,70323,0,0,0,0,0,0,0,31,37,3,1315
Arkansas_county,5/11/20,0,0,0,0,0,0,0,0,0,2,0,157,0,2,0,0,0,0,0,159,0,0,0,0,0,0,0,0,0,0,3
Ashley,5/11/20,0,0,0,0,0,0,0,0,0,18,0,401,0,16,0,0,0,2,0,419,0,0,0,0,0,0,0,0,0,0,5
Baxter,5/11/20,0,0,0,0,0,0,0,0,0,5,0,389,0,5,0,0,0,0,0,394,0,0,0,0,0,0,0,0,0,0,6
Benton,5/11/20,0,0,0,0,0,0,0,0,0,123,0,4937,0,103,0,0,0,20,0,5060,0,0,0,0,0,0,0,0,2,0,117
Boone,5/11/20,0,0,0,0,0,0,0,0,0,4,0,263,0,4,0,0,0,0,0,267,0,0,0,0,0,0,0,0,0,0,3
Bradley,5/11/20,0,0,0,0,0,0,0,0,0,11,0,268,0,9,0,1,0,1,0,279,0,0,0,0,0,0,0,0,0,0,1
Calhoun,5/11/20,0,0,0,0,0,0,0,0,0,0,0,35,0,0,0,0,0,0,0,35,0,0,0,0,0,0,0,0,0,0,-1
Carroll,5/11/20,0,0,0,0,0,0,0,0,0,6,0,330,0,6,0,0,0,0,0,336,0,0,0,0,0,0,0,0,0,0,1
Chicot,5/11/20,0,0,0,0,0,0,0,0,0,10,0,137,0,8,0,0,0,2,0,147,0,0,0,0,0,0,0,0,0,0,1
Clark,5/11/20,0,0,0,0,0,0,0,0,0,33,0,587,0,29,0,0,0,4,0,620,0,0,0,0,0,0,0,0,1,0,11
Clay,5/11/20,0,0,0,0,0,0,0,0,0,4,0,345,0,3,0,0,0,1,0,349,0,0,0,0,0,0,0,1,1,0,9
Cleburne,5/11/20,0,0,0,0,0,0,0,0,0,72,0,402,0,67,0,4,0,1,0,474,0,0,0,0,0,0,0,0,0,0,10
Cleveland,5/11/20,0,0,0,0,0,0,0,0,0,13,0,221,0,12,0,0,0,1,0,234,0,0,0,0,0,0,0,0,1,0,10
Columbia,5/11/20,0,0,0,0,0,0,0,0,0,15,0,240,0,6,0,2,0,7,0,255,0,0,0,0,0,0,0,0,0,0,7
Conway,5/11/20,0,0,0,0,0,0,0,0,0,13,0,383,0,10,0,1,0,2,0,396,0,0,0,0,0,0,0,0,0,0,5
Craighead,5/11/20,0,0,0,0,0,0,0,0,0,98,0,1808,0,72,0,0,0,26,0,1906,0,0,0,0,0,0,0,1,1,0,47
Crawford,5/11/20,0,0,0,0,0,0,0,0,0,5,0,380,0,4,0,0,0,1,0,385,0,0,0,0,0,0,0,0,0,0,1
Crittenden,5/11/20,0,0,0,0,0,0,0,0,0,210,0,1706,0,171,0,7,0,32,0,1916,0,0,0,0,0,0,0,0,2,0,37
Cross,5/11/20,0,0,0,0,0,0,0,0,0,29,0,336,0,20,0,0,0,9,0,365,0,0,0,0,0,0,0,0,0,0,9
Dallas,5/11/20,0,0,0,0,0,0,0,0,0,1,0,88,0,1,0,0,0,0,0,89,0,0,0,0,0,0,0,0,0,0,1
Desha,5/11/20,0,0,0,0,0,0,0,0,0,17,0,297,0,15,0,0,0,2,0,314,0,0,0,0,0,0,0,1,0,0,3
Drew,5/11/20,0,0,0,0,0,0,0,0,0,19,0,401,0,14,0,1,0,4,0,420,0,0,0,0,0,0,0,0,0,0,1
Faulkner,5/11/20,0,0,0,0,0,0,0,0,0,82,0,2053,0,73,0,2,0,7,0,2135,0,0,0,0,0,0,0,0,0,0,23
Franklin,5/11/20,0,0,0,0,0,0,0,0,0,2,0,141,0,2,0,0,0,0,0,143,0,0,0,0,0,0,0,0,0,0,3
Fulton,5/11/20,0,0,0,0,0,0,0,0,0,3,0,135,0,3,0,0,0,0,0,138,0,0,0,0,0,0,0,0,1,0,6
Garland,5/11/20,0,0,0,0,0,0,0,0,0,119,0,2849,0,113,0,1,0,5,0,2968,0,0,0,0,0,0,0,0,0,0,38
Grant,5/11/20,0,0,0,0,0,0,0,0,0,15,0,323,0,14,0,0,0,1,0,338,0,0,0,0,0,0,0,0,0,0,13
Greene,5/11/20,0,0,0,0,0,0,0,0,0,23,0,1009,0,19,0,0,0,4,0,1032,0,0,0,0,0,0,0,0,1,0,25
Hempstead,5/11/20,0,0,0,0,0,0,0,0,0,7,0,119,0,5,0,1,0,1,0,126,0,0,0,0,0,0,0,0,0,0,4
HotSpring,5/11/20,0,0,0,0,0,0,0,0,0,26,0,544,0,17,0,0,0,9,0,570,0,0,0,0,0,0,0,0,0,0,11
Howard,5/11/20,0,0,0,0,0,0,0,0,0,14,0,186,0,13,0,0,0,1,0,200,0,0,0,0,0,0,0,0,0,0,2
Independence,5/11/20,0,0,0,0,0,0,0,0,0,17,0,338,0,10,0,0,0,7,0,355,0,0,0,0,0,0,0,0,0,0,11
Izard,5/11/20,0,0,0,0,0,0,0,0,0,13,0,109,0,7,0,0,0,6,0,122,0,0,0,0,0,0,0,2,0,0,0
Jackson,5/11/20,0,0,0,0,0,0,0,0,0,1,0,139,0,1,0,0,0,0,0,140,0,0,0,0,0,0,0,0,0,0,2
Jefferson,5/11/20,0,0,0,0,0,0,0,0,0,238,0,1535,0,164,0,19,0,55,0,1773,0,0,0,0,0,0,0,4,19,0,54
Johnson,5/11/20,0,0,0,0,0,0,0,0,0,34,0,236,0,31,0,0,0,3,0,270,0,0,0,0,0,0,0,0,0,0,0
Lafayette,5/11/20,0,0,0,0,0,0,0,0,0,9,0,25,0,7,0,1,0,1,0,34,0,0,0,0,0,0,0,0,0,0,0
Lawrence,5/11/20,0,0,0,0,0,0,0,0,0,69,0,404,0,40,0,4,0,25,0,473,0,0,0,0,0,0,0,-1,1,0,2
Lee,5/11/20,0,0,0,0,0,0,0,0,0,5,0,111,0,3,0,1,0,1,0,116,0,0,0,0,0,0,0,0,0,0,7
Lincoln,5/11/20,0,0,0,0,0,0,0,0,0,941,0,800,0,853,0,7,0,81,0,1741,0,0,0,0,0,0,0,4,0,0,26
LittleRiver,5/11/20,0,0,0,0,0,0,0,0,0,0,0,104,0,0,0,0,0,0,0,104,0,0,0,0,0,0,0,0,0,0,-1
Logan,5/11/20,0,0,0,0,0,0,0,0,0,3,0,167,0,2,0,0,0,1,0,170,0,0,0,0,0,0,0,0,0,0,1
Lonoke,5/11/20,0,0,0,0,0,0,0,0,0,45,0,1070,0,40,0,0,0,5,0,1115,0,0,0,0,0,0,0,0,0,0,27
Madison,5/11/20,0,0,0,0,0,0,0,0,0,1,0,171,0,1,0,0,0,0,0,172,0,0,0,0,0,0,0,0,0,0,8
Marion,5/11/20,0,0,0,0,0,0,0,0,0,1,0,97,0,1,0,0,0,0,0,98,0,0,0,0,0,0,0,0,0,0,2
Miller,5/11/20,0,0,0,0,0,0,0,0,0,37,0,373,0,35,0,1,0,1,0,410,0,0,0,0,0,0,0,1,2,0,17
MissingCountyInfo,5/11/20,0,0,0,0,0,0,0,0,0,131,0,17659,0,97,0,0,0,34,0,17790,0,0,0,0,0,0,0,4,1,0,297
Mississippi,5/11/20,0,0,0,0,0,0,0,0,0,52,0,515,0,18,0,0,0,34,0,567,0,0,0,0,0,0,0,0,1,0,17
Monroe,5/11/20,0,0,0,0,0,0,0,0,0,5,0,64,0,4,0,0,0,1,0,69,0,0,0,0,0,0,0,0,0,0,3
Montgomery,5/11/20,0,0,0,0,0,0,0,0,0,1,0,104,0,0,0,0,0,1,0,105,0,0,0,0,0,0,0,0,0,0,2
Nevada,5/11/20,0,0,0,0,0,0,0,0,0,3,0,82,0,1,0,0,0,2,0,85,0,0,0,0,0,0,0,0,0,0,1
Newton,5/11/20,0,0,0,0,0,0,0,0,0,3,0,85,0,3,0,0,0,0,0,88,0,0,0,0,0,0,0,0,0,0,2
Ouachita,5/11/20,0,0,0,0,0,0,0,0,0,9,0,396,0,7,0,0,0,2,0,405,0,0,0,0,0,0,0,0,2,0,10
Perry,5/11/20,0,0,0,0,0,0,0,0,0,8,0,148,0,7,0,0,0,1,0,156,0,0,0,0,0,0,0,0,0,0,3
Phillips,5/11/20,0,0,0,0,0,0,0,0,0,4,0,232,0,3,0,1,0,0,0,236,0,0,0,0,0,0,0,0,0,0,2
Pike,5/11/20,0,0,0,0,0,0,0,0,0,3,0,373,0,3,0,0,0,0,0,376,0,0,0,0,0,0,0,0,0,0,3
Poinsett,5/11/20,0,0,0,0,0,0,0,0,0,25,0,280,0,19,0,2,0,4,0,305,0,0,0,0,0,0,0,0,0,0,1
Polk,5/11/20,0,0,0,0,0,0,0,0,0,7,0,303,0,7,0,0,0,0,0,310,0,0,0,0,0,0,0,0,0,0,4
Pope,5/11/20,0,0,0,0,0,0,0,0,0,48,0,1785,0,42,0,0,0,6,0,1833,0,0,0,0,0,0,0,1,1,0,10
Prairie,5/11/20,0,0,0,0,0,0,0,0,0,2,0,64,0,2,0,0,0,0,0,66,0,0,0,0,0,0,0,0,0,0,2
Pulaski,5/11/20,0,0,0,0,0,0,0,0,0,630,0,7505,0,490,0,23,0,117,0,8135,0,0,0,0,0,0,0,3,4,0,158
Randolph,5/11/20,0,0,0,0,0,0,0,0,0,22,0,661,0,19,0,0,0,3,0,683,0,0,0,0,0,0,0,1,1,0,7
Saline,5/11/20,0,0,0,0,0,0,0,0,0,73,0,2013,0,65,0,1,0,7,0,2086,0,0,0,0,0,0,0,0,0,0,42
Scott,5/11/20,0,0,0,0,0,0,0,0,0,1,0,15,0,1,0,0,0,0,0,16,0,0,0,0,0,0,0,0,0,0,1
Searcy,5/11/20,0,0,0,0,0,0,0,0,0,6,0,166,0,6,0,0,0,0,0,172,0,0,0,0,0,0,0,0,0,0,0
Sebastian,5/11/20,0,0,0,0,0,0,0,0,0,15,0,623,0,13,0,0,0,2,0,638,0,0,0,0,0,0,0,0,0,0,23
Sevier,5/11/20,0,0,0,0,0,0,0,0,0,21,0,320,0,12,0,1,0,8,0,341,0,0,0,0,0,0,0,3,1,0,5
Sharp,5/11/20,0,0,0,0,0,0,0,0,0,16,0,168,0,6,0,2,0,8,0,184,0,0,0,0,0,0,0,5,1,1,17
St.Francis,5/11/20,0,0,0,0,0,0,0,0,0,279,0,941,0,82,0,0,0,197,0,1220,0,0,0,0,0,0,0,1,0,0,360
Stone,5/11/20,0,0,0,0,0,0,0,0,0,8,0,139,0,8,0,0,0,0,0,147,0,0,0,0,0,0,0,0,0,0,0
Union,5/11/20,0,0,0,0,0,0,0,0,0,76,0,429,0,55,0,4,0,17,0,505,0,0,0,0,0,0,0,0,2,2,17
VanBuren,5/11/20,0,0,0,0,0,0,0,0,0,28,0,317,0,26,0,2,0,0,0,345,0,0,0,0,0,0,0,0,0,0,-2
Washington,5/11/20,0,0,0,0,0,0,0,0,0,110,0,2426,0,84,0,3,0,23,0,2536,0,0,0,0,0,0,0,0,1,0,50
White,5/11/20,0,0,0,0,0,0,0,0,0,36,0,1047,0,31,0,1,0,4,0,1083,0,0,0,0,0,0,0,0,1,0,12
Woodruff,5/11/20,0,0,0,0,0,0,0,0,0,1,0,48,0,1,0,0,0,0,0,49,0,0,0,0,0,0,0,0,0,0,2
Yell,5/11/20,0,0,0,0,0,0,0,0,0,7,0,223,0,6,0,1,0,0,0,230,0,0,0,0,0,0,0,0,1,0,-1
Arkansas_all_counties,5/10/20,0,0,0,0,0,0,0,0,2990671,4012,0,64996,0,3112,0,91,0,809,0,69008,0,0,0,0,0,0,0,28,55,1,1558
Arkansas_county,5/10/20,0,0,0,0,0,0,0,0,0,2,0,154,0,2,0,0,0,0,0,156,0,0,0,0,0,0,0,0,0,0,43
Ashley,5/10/20,0,0,0,0,0,0,0,0,0,18,0,396,0,16,0,0,0,2,0,414,0,0,0,0,0,0,0,1,2,0,20
Baxter,5/10/20,0,0,0,0,0,0,0,0,0,5,0,383,0,5,0,0,0,0,0,388,0,0,0,0,0,0,0,0,0,0,15
Benton,5/10/20,0,0,0,0,0,0,0,0,0,123,0,4820,0,101,0,0,0,22,0,4943,0,0,0,0,0,0,0,7,6,0,691
Boone,5/10/20,0,0,0,0,0,0,0,0,0,4,0,260,0,4,0,0,0,0,0,264,0,0,0,0,0,0,0,0,0,0,50
Bradley,5/10/20,0,0,0,0,0,0,0,0,0,11,0,267,0,9,0,1,0,1,0,278,0,0,0,0,0,0,0,0,2,0,15
Calhoun,5/10/20,0,0,0,0,0,0,0,0,0,0,0,36,0,0,0,0,0,0,0,36,0,0,0,0,0,0,0,0,0,0,8
Carroll,5/10/20,0,0,0,0,0,0,0,0,0,6,0,329,0,6,0,0,0,0,0,335,0,0,0,0,0,0,0,0,1,0,30
Chicot,5/10/20,0,0,0,0,0,0,0,0,0,10,0,136,0,8,0,0,0,2,0,146,0,0,0,0,0,0,0,0,1,0,17
Clark,5/10/20,0,0,0,0,0,0,0,0,0,33,0,576,0,28,0,0,0,5,0,609,0,0,0,0,0,0,0,1,0,0,121
Clay,5/10/20,0,0,0,0,0,0,0,0,0,3,0,337,0,2,0,0,0,1,0,340,0,0,0,0,0,0,0,0,0,0,19
Cleburne,5/10/20,0,0,0,0,0,0,0,0,0,72,0,392,0,67,0,4,0,1,0,464,0,0,0,0,0,0,0,0,0,0,148
Cleveland,5/10/20,0,0,0,0,0,0,0,0,0,13,0,211,0,11,0,0,0,2,0,224,0,0,0,0,0,0,0,0,0,0,13
Columbia,5/10/20,0,0,0,0,0,0,0,0,0,15,0,233,0,6,0,2,0,7,0,248,0,0,0,0,0,0,0,0,1,0,13
Conway,5/10/20,0,0,0,0,0,0,0,0,0,13,0,378,0,10,0,1,0,2,0,391,0,0,0,0,0,0,0,0,1,0,41
Craighead,5/10/20,0,0,0,0,0,0,0,0,0,97,0,1762,0,71,0,0,0,26,0,1859,0,0,0,0,0,0,0,5,1,0,158
Crawford,5/10/20,0,0,0,0,0,0,0,0,0,5,0,379,0,4,0,0,0,1,0,384,0,0,0,0,0,0,0,0,0,0,114
Crittenden,5/10/20,0,0,0,0,0,0,0,0,0,210,0,1669,0,169,0,7,0,34,0,1879,0,0,0,0,0,0,0,5,4,0,304
Cross,5/10/20,0,0,0,0,0,0,0,0,0,29,0,327,0,20,0,0,0,9,0,356,0,0,0,0,0,0,0,2,2,0,60
Dallas,5/10/20,0,0,0,0,0,0,0,0,0,1,0,87,0,1,0,0,0,0,0,88,0,0,0,0,0,0,0,0,0,0,17
Desha,5/10/20,0,0,0,0,0,0,0,0,0,16,0,295,0,15,0,0,0,1,0,311,0,0,0,0,0,0,0,0,1,0,22
Drew,5/10/20,0,0,0,0,0,0,0,0,0,19,0,400,0,14,0,1,0,4,0,419,0,0,0,0,0,0,0,0,3,0,29
Faulkner,5/10/20,0,0,0,0,0,0,0,0,0,82,0,2030,0,73,0,2,0,7,0,2112,0,0,0,0,0,0,0,1,3,0,191
Franklin,5/10/20,0,0,0,0,0,0,0,0,0,2,0,138,0,2,0,0,0,0,0,140,0,0,0,0,0,0,0,0,0,0,22
Fulton,5/10/20,0,0,0,0,0,0,0,0,0,3,0,129,0,2,0,0,0,1,0,132,0,0,0,0,0,0,0,0,0,0,12
Garland,5/10/20,0,0,0,0,0,0,0,0,0,119,0,2811,0,113,0,1,0,5,0,2930,0,0,0,0,0,0,0,1,1,0,152
Grant,5/10/20,0,0,0,0,0,0,0,0,0,15,0,310,0,14,0,0,0,1,0,325,0,0,0,0,0,0,0,0,2,0,43
Greene,5/10/20,0,0,0,0,0,0,0,0,0,23,0,984,0,18,0,0,0,5,0,1007,0,0,0,0,0,0,0,1,1,0,81
Hempstead,5/10/20,0,0,0,0,0,0,0,0,0,7,0,115,0,5,0,1,0,1,0,122,0,0,0,0,0,0,0,0,0,0,11
HotSpring,5/10/20,0,0,0,0,0,0,0,0,0,26,0,533,0,17,0,0,0,9,0,559,0,0,0,0,0,0,0,4,3,0,119
Howard,5/10/20,0,0,0,0,0,0,0,0,0,14,0,184,0,13,0,0,0,1,0,198,0,0,0,0,0,0,0,0,0,0,29
Independence,5/10/20,0,0,0,0,0,0,0,0,0,17,0,327,0,10,0,0,0,7,0,344,0,0,0,0,0,0,0,5,1,0,80
Izard,5/10/20,0,0,0,0,0,0,0,0,0,11,0,111,0,7,0,0,0,4,0,122,0,0,0,0,0,0,0,0,3,0,23
Jackson,5/10/20,0,0,0,0,0,0,0,0,0,1,0,137,0,1,0,0,0,0,0,138,0,0,0,0,0,0,0,0,0,0,21
Jefferson,5/10/20,0,0,0,0,0,0,0,0,0,234,0,1485,0,157,0,19,0,58,0,1719,0,0,0,0,0,0,0,8,12,0,79
Johnson,5/10/20,0,0,0,0,0,0,0,0,0,34,0,236,0,31,0,0,0,3,0,270,0,0,0,0,0,0,0,0,0,0,17
Lafayette,5/10/20,0,0,0,0,0,0,0,0,0,9,0,25,0,7,0,1,0,1,0,34,0,0,0,0,0,0,0,0,0,0,3
Lawrence,5/10/20,0,0,0,0,0,0,0,0,0,70,0,401,0,39,0,4,0,27,0,471,0,0,0,0,0,0,0,1,1,0,49
Lee,5/10/20,0,0,0,0,0,0,0,0,0,5,0,104,0,3,0,1,0,1,0,109,0,0,0,0,0,0,0,1,0,0,14
Lincoln,5/10/20,0,0,0,0,0,0,0,0,0,937,0,778,0,853,0,7,0,77,0,1715,0,0,0,0,0,0,0,30,66,1,46
LittleRiver,5/10/20,0,0,0,0,0,0,0,0,0,0,0,105,0,0,0,0,0,0,0,105,0,0,0,0,0,0,0,0,0,0,2
Logan,5/10/20,0,0,0,0,0,0,0,0,0,3,0,166,0,2,0,0,0,1,0,169,0,0,0,0,0,0,0,0,0,0,46
Lonoke,5/10/20,0,0,0,0,0,0,0,0,0,45,0,1043,0,40,0,0,0,5,0,1088,0,0,0,0,0,0,0,1,2,0,124
Madison,5/10/20,0,0,0,0,0,0,0,0,0,1,0,163,0,1,0,0,0,0,0,164,0,0,0,0,0,0,0,0,0,0,20
Marion,5/10/20,0,0,0,0,0,0,0,0,0,1,0,95,0,1,0,0,0,0,0,96,0,0,0,0,0,0,0,0,0,0,5
Miller,5/10/20,0,0,0,0,0,0,0,0,0,36,0,357,0,33,0,1,0,2,0,393,0,0,0,0,0,0,0,0,2,0,21
MissingCountyInfo,5/10/20,0,0,0,0,0,0,0,0,0,127,0,17366,0,96,0,0,0,31,0,17493,0,0,0,0,0,0,0,-27,2,0,-3105
Mississippi,5/10/20,0,0,0,0,0,0,0,0,0,52,0,498,0,17,0,0,0,35,0,550,0,0,0,0,0,0,0,5,3,0,79
Monroe,5/10/20,0,0,0,0,0,0,0,0,0,5,0,61,0,4,0,0,0,1,0,66,0,0,0,0,0,0,0,0,0,0,28
Montgomery,5/10/20,0,0,0,0,0,0,0,0,0,1,0,102,0,0,0,0,0,1,0,103,0,0,0,0,0,0,0,0,0,0,8
Nevada,5/10/20,0,0,0,0,0,0,0,0,0,3,0,81,0,1,0,0,0,2,0,84,0,0,0,0,0,0,0,0,0,0,22
Newton,5/10/20,0,0,0,0,0,0,0,0,0,3,0,83,0,3,0,0,0,0,0,86,0,0,0,0,0,0,0,0,0,0,2
Ouachita,5/10/20,0,0,0,0,0,0,0,0,0,9,0,386,0,5,0,0,0,4,0,395,0,0,0,0,0,0,0,1,0,0,45
Perry,5/10/20,0,0,0,0,0,0,0,0,0,8,0,145,0,7,0,0,0,1,0,153,0,0,0,0,0,0,0,1,1,0,10
Phillips,5/10/20,0,0,0,0,0,0,0,0,0,4,0,230,0,3,0,1,0,0,0,234,0,0,0,0,0,0,0,0,0,0,26
Pike,5/10/20,0,0,0,0,0,0,0,0,0,3,0,370,0,3,0,0,0,0,0,373,0,0,0,0,0,0,0,0,0,0,31
Poinsett,5/10/20,0,0,0,0,0,0,0,0,0,25,0,279,0,19,0,2,0,4,0,304,0,0,0,0,0,0,0,0,2,0,38
Polk,5/10/20,0,0,0,0,0,0,0,0,0,7,0,299,0,7,0,0,0,0,0,306,0,0,0,0,0,0,0,0,0,0,13
Pope,5/10/20,0,0,0,0,0,0,0,0,0,47,0,1776,0,41,0,0,0,6,0,1823,0,0,0,0,0,0,0,0,2,0,95
Prairie,5/10/20,0,0,0,0,0,0,0,0,0,2,0,62,0,2,0,0,0,0,0,64,0,0,0,0,0,0,0,0,0,0,16
Pulaski,5/10/20,0,0,0,0,0,0,0,0,0,627,0,7350,0,486,0,23,0,118,0,7977,0,0,0,0,0,0,0,24,24,1,951
Randolph,5/10/20,0,0,0,0,0,0,0,0,0,21,0,655,0,18,0,0,0,3,0,676,0,0,0,0,0,0,0,0,0,0,45
Saline,5/10/20,0,0,0,0,0,0,0,0,0,73,0,1971,0,65,0,1,0,7,0,2044,0,0,0,0,0,0,0,1,5,0,319
Scott,5/10/20,0,0,0,0,0,0,0,0,0,1,0,14,0,1,0,0,0,0,0,15,0,0,0,0,0,0,0,0,0,0,9
Searcy,5/10/20,0,0,0,0,0,0,0,0,0,6,0,166,0,6,0,0,0,0,0,172,0,0,0,0,0,0,0,0,0,0,12
Sebastian,5/10/20,0,0,0,0,0,0,0,0,0,15,0,600,0,13,0,0,0,2,0,615,0,0,0,0,0,0,0,1,0,0,257
Sevier,5/10/20,0,0,0,0,0,0,0,0,0,18,0,318,0,11,0,1,0,6,0,336,0,0,0,0,0,0,0,2,1,0,25
Sharp,5/10/20,0,0,0,0,0,0,0,0,0,11,0,156,0,5,0,1,0,5,0,167,0,0,0,0,0,0,0,3,1,0,39
St.Francis,5/10/20,0,0,0,0,0,0,0,0,0,278,0,582,0,82,0,0,0,196,0,860,0,0,0,0,0,0,0,170,1,0,170
Stone,5/10/20,0,0,0,0,0,0,0,0,0,8,0,139,0,8,0,0,0,0,0,147,0,0,0,0,0,0,0,0,0,0,41
Union,5/10/20,0,0,0,0,0,0,0,0,0,76,0,412,0,53,0,2,0,21,0,488,0,0,0,0,0,0,0,3,3,1,86
VanBuren,5/10/20,0,0,0,0,0,0,0,0,0,28,0,319,0,26,0,2,0,0,0,347,0,0,0,0,0,0,0,0,1,0,45
Washington,5/10/20,0,0,0,0,0,0,0,0,0,110,0,2376,0,83,0,3,0,24,0,2486,0,0,0,0,0,0,0,5,4,0,576
White,5/10/20,0,0,0,0,0,0,0,0,0,36,0,1035,0,30,0,1,0,5,0,1071,0,0,0,0,0,0,0,1,1,0,114
Woodruff,5/10/20,0,0,0,0,0,0,0,0,0,1,0,46,0,1,0,0,0,0,0,47,0,0,0,0,0,0,0,0,0,0,6
Yell,5/10/20,0,0,0,0,0,0,0,0,0,7,0,224,0,5,0,1,0,1,0,231,0,0,0,0,0,0,0,0,1,0,18
Arkansas_all_counties,5/9/20,0,0,0,0,0,0,0,0,2990671,3984,0,63466,0,3057,0,90,0,837,0,67450,0,0,0,0,0,0,0,237,89,2,1922
Arkansas_county,5/9/20,0,0,0,0,0,0,0,0,0,2,0,111,0,2,0,0,0,0,0,113,0,0,0,0,0,0,0,0,0,0,0
Ashley,5/9/20,0,0,0,0,0,0,0,0,0,17,0,377,0,14,0,0,0,3,0,394,0,0,0,0,0,0,0,0,3,0,0
Baxter,5/9/20,0,0,0,0,0,0,0,0,0,5,0,368,0,5,0,0,0,0,0,373,0,0,0,0,0,0,0,0,0,0,0
Benton,5/9/20,0,0,0,0,0,0,0,0,0,116,0,4136,0,95,0,0,0,21,0,4252,0,0,0,0,0,0,0,0,14,0,0
Boone,5/9/20,0,0,0,0,0,0,0,0,0,4,0,210,0,4,0,0,0,0,0,214,0,0,0,0,0,0,0,0,0,0,0
Bradley,5/9/20,0,0,0,0,0,0,0,0,0,11,0,252,0,7,0,1,0,3,0,263,0,0,0,0,0,0,0,0,2,0,0
Calhoun,5/9/20,0,0,0,0,0,0,0,0,0,0,0,28,0,0,0,0,0,0,0,28,0,0,0,0,0,0,0,0,0,0,0
Carroll,5/9/20,0,0,0,0,0,0,0,0,0,6,0,299,0,5,0,0,0,1,0,305,0,0,0,0,0,0,0,0,1,0,0
Chicot,5/9/20,0,0,0,0,0,0,0,0,0,10,0,119,0,7,0,0,0,3,0,129,0,0,0,0,0,0,0,0,2,0,0
Clark,5/9/20,0,0,0,0,0,0,0,0,0,32,0,456,0,28,0,0,0,4,0,488,0,0,0,0,0,0,0,0,1,0,0
Clay,5/9/20,0,0,0,0,0,0,0,0,0,3,0,318,0,2,0,0,0,1,0,321,0,0,0,0,0,0,0,0,0,0,0
Cleburne,5/9/20,0,0,0,0,0,0,0,0,0,72,0,244,0,67,0,4,0,1,0,316,0,0,0,0,0,0,0,0,1,0,0
Cleveland,5/9/20,0,0,0,0,0,0,0,0,0,13,0,198,0,11,0,0,0,2,0,211,0,0,0,0,0,0,0,0,0,0,0
Columbia,5/9/20,0,0,0,0,0,0,0,0,0,15,0,220,0,5,0,2,0,8,0,235,0,0,0,0,0,0,0,0,1,0,0
Conway,5/9/20,0,0,0,0,0,0,0,0,0,13,0,337,0,9,0,1,0,3,0,350,0,0,0,0,0,0,0,0,1,0,0
Craighead,5/9/20,0,0,0,0,0,0,0,0,0,92,0,1609,0,70,0,0,0,22,0,1701,0,0,0,0,0,0,0,0,9,0,0
Crawford,5/9/20,0,0,0,0,0,0,0,0,0,5,0,265,0,4,0,0,0,1,0,270,0,0,0,0,0,0,0,0,0,0,0
Crittenden,5/9/20,0,0,0,0,0,0,0,0,0,205,0,1370,0,165,0,7,0,33,0,1575,0,0,0,0,0,0,0,0,13,0,0
Cross,5/9/20,0,0,0,0,0,0,0,0,0,27,0,269,0,18,0,0,0,9,0,296,0,0,0,0,0,0,0,0,5,0,0
Dallas,5/9/20,0,0,0,0,0,0,0,0,0,1,0,70,0,1,0,0,0,0,0,71,0,0,0,0,0,0,0,0,0,0,0
Desha,5/9/20,0,0,0,0,0,0,0,0,0,16,0,273,0,14,0,0,0,2,0,289,0,0,0,0,0,0,0,0,2,0,0
Drew,5/9/20,0,0,0,0,0,0,0,0,0,19,0,371,0,11,0,1,0,7,0,390,0,0,0,0,0,0,0,0,2,0,0
Faulkner,5/9/20,0,0,0,0,0,0,0,0,0,81,0,1840,0,70,0,2,0,9,0,1921,0,0,0,0,0,0,0,0,4,0,0
Franklin,5/9/20,0,0,0,0,0,0,0,0,0,2,0,116,0,2,0,0,0,0,0,118,0,0,0,0,0,0,0,0,0,0,0
Fulton,5/9/20,0,0,0,0,0,0,0,0,0,3,0,117,0,2,0,0,0,1,0,120,0,0,0,0,0,0,0,0,2,0,0
Garland,5/9/20,0,0,0,0,0,0,0,0,0,118,0,2660,0,112,0,1,0,5,0,2778,0,0,0,0,0,0,0,0,1,0,0
Grant,5/9/20,0,0,0,0,0,0,0,0,0,15,0,267,0,12,0,0,0,3,0,282,0,0,0,0,0,0,0,0,0,0,0
Greene,5/9/20,0,0,0,0,0,0,0,0,0,22,0,904,0,17,0,0,0,5,0,926,0,0,0,0,0,0,0,0,5,0,0
Hempstead,5/9/20,0,0,0,0,0,0,0,0,0,7,0,104,0,5,0,1,0,1,0,111,0,0,0,0,0,0,0,0,1,0,0
HotSpring,5/9/20,0,0,0,0,0,0,0,0,0,22,0,418,0,14,0,0,0,8,0,440,0,0,0,0,0,0,0,0,1,0,0
Howard,5/9/20,0,0,0,0,0,0,0,0,0,14,0,155,0,13,0,0,0,1,0,169,0,0,0,0,0,0,0,0,0,0,0
Independence,5/9/20,0,0,0,0,0,0,0,0,0,12,0,252,0,9,0,0,0,3,0,264,0,0,0,0,0,0,0,0,0,0,0
Izard,5/9/20,0,0,0,0,0,0,0,0,0,11,0,88,0,4,0,0,0,7,0,99,0,0,0,0,0,0,0,0,0,0,0
Jackson,5/9/20,0,0,0,0,0,0,0,0,0,1,0,116,0,1,0,0,0,0,0,117,0,0,0,0,0,0,0,0,0,0,0
Jefferson,5/9/20,0,0,0,0,0,0,0,0,0,226,0,1414,0,145,0,19,0,62,0,1640,0,0,0,0,0,0,0,0,20,0,0
Johnson,5/9/20,0,0,0,0,0,0,0,0,0,34,0,219,0,31,0,0,0,3,0,253,0,0,0,0,0,0,0,0,4,0,0
Lafayette,5/9/20,0,0,0,0,0,0,0,0,0,9,0,22,0,7,0,1,0,1,0,31,0,0,0,0,0,0,0,0,2,0,0
Lawrence,5/9/20,0,0,0,0,0,0,0,0,0,69,0,353,0,38,0,4,0,27,0,422,0,0,0,0,0,0,0,0,9,0,0
Lee,5/9/20,0,0,0,0,0,0,0,0,0,4,0,91,0,3,0,1,0,0,0,95,0,0,0,0,0,0,0,0,1,0,0
Lincoln,5/9/20,0,0,0,0,0,0,0,0,0,907,0,762,0,817,0,6,0,84,0,1669,0,0,0,0,0,0,0,0,563,0,0
LittleRiver,5/9/20,0,0,0,0,0,0,0,0,0,0,0,103,0,0,0,0,0,0,0,103,0,0,0,0,0,0,0,0,0,0,0
Logan,5/9/20,0,0,0,0,0,0,0,0,0,3,0,120,0,2,0,0,0,1,0,123,0,0,0,0,0,0,0,0,0,0,0
Lonoke,5/9/20,0,0,0,0,0,0,0,0,0,44,0,920,0,38,0,0,0,6,0,964,0,0,0,0,0,0,0,0,2,0,0
Madison,5/9/20,0,0,0,0,0,0,0,0,0,1,0,143,0,1,0,0,0,0,0,144,0,0,0,0,0,0,0,0,0,0,0
Marion,5/9/20,0,0,0,0,0,0,0,0,0,1,0,90,0,1,0,0,0,0,0,91,0,0,0,0,0,0,0,0,0,0,0
Miller,5/9/20,0,0,0,0,0,0,0,0,0,36,0,336,0,31,0,1,0,4,0,372,0,0,0,0,0,0,0,0,3,0,0
MissingCountyInfo,5/9/20,0,0,0,0,0,0,0,0,0,154,0,20444,0,94,0,0,0,60,0,20598,0,0,0,0,0,0,0,0,30,0,0
Mississippi,5/9/20,0,0,0,0,0,0,0,0,0,47,0,424,0,14,0,0,0,33,0,471,0,0,0,0,0,0,0,0,4,0,0
Monroe,5/9/20,0,0,0,0,0,0,0,0,0,4,0,34,0,4,0,0,0,0,0,38,0,0,0,0,0,0,0,0,0,0,0
Montgomery,5/9/20,0,0,0,0,0,0,0,0,0,1,0,94,0,0,0,0,0,1,0,95,0,0,0,0,0,0,0,0,0,0,0
Nevada,5/9/20,0,0,0,0,0,0,0,0,0,3,0,59,0,1,0,0,0,2,0,62,0,0,0,0,0,0,0,0,0,0,0
Newton,5/9/20,0,0,0,0,0,0,0,0,0,3,0,81,0,3,0,0,0,0,0,84,0,0,0,0,0,0,0,0,1,0,0
Ouachita,5/9/20,0,0,0,0,0,0,0,0,0,8,0,342,0,5,0,0,0,3,0,350,0,0,0,0,0,0,0,0,0,0,0
Perry,5/9/20,0,0,0,0,0,0,0,0,0,7,0,136,0,6,0,0,0,1,0,143,0,0,0,0,0,0,0,0,0,0,0
Phillips,5/9/20,0,0,0,0,0,0,0,0,0,4,0,204,0,3,0,1,0,0,0,208,0,0,0,0,0,0,0,0,0,0,0
Pike,5/9/20,0,0,0,0,0,0,0,0,0,3,0,339,0,3,0,0,0,0,0,342,0,0,0,0,0,0,0,0,1,0,0
Poinsett,5/9/20,0,0,0,0,0,0,0,0,0,25,0,241,0,17,0,2,0,6,0,266,0,0,0,0,0,0,0,0,3,0,0
Polk,5/9/20,0,0,0,0,0,0,0,0,0,7,0,286,0,7,0,0,0,0,0,293,0,0,0,0,0,0,0,0,0,0,0
Pope,5/9/20,0,0,0,0,0,0,0,0,0,47,0,1681,0,39,0,0,0,8,0,1728,0,0,0,0,0,0,0,0,2,0,0
Prairie,5/9/20,0,0,0,0,0,0,0,0,0,2,0,46,0,2,0,0,0,0,0,48,0,0,0,0,0,0,0,0,0,0,0
Pulaski,5/9/20,0,0,0,0,0,0,0,0,0,603,0,6423,0,462,0,22,0,119,0,7026,0,0,0,0,0,0,0,0,64,0,0
Randolph,5/9/20,0,0,0,0,0,0,0,0,0,21,0,610,0,18,0,0,0,3,0,631,0,0,0,0,0,0,0,0,4,0,0
Saline,5/9/20,0,0,0,0,0,0,0,0,0,72,0,1653,0,60,0,1,0,11,0,1725,0,0,0,0,0,0,0,0,5,0,0
Scott,5/9/20,0,0,0,0,0,0,0,0,0,1,0,5,0,1,0,0,0,0,0,6,0,0,0,0,0,0,0,0,0,0,0
Searcy,5/9/20,0,0,0,0,0,0,0,0,0,6,0,154,0,6,0,0,0,0,0,160,0,0,0,0,0,0,0,0,0,0,0
Sebastian,5/9/20,0,0,0,0,0,0,0,0,0,14,0,344,0,13,0,0,0,1,0,358,0,0,0,0,0,0,0,0,0,0,0
Sevier,5/9/20,0,0,0,0,0,0,0,0,0,16,0,295,0,0,0,1,0,15,0,311,0,0,0,0,0,0,0,0,1,0,0
Sharp,5/9/20,0,0,0,0,0,0,0,0,0,8,0,120,0,4,0,1,0,3,0,128,0,0,0,0,0,0,0,0,1,0,0
St.Francis,5/9/20,0,0,0,0,0,0,0,0,0,108,0,582,0,81,0,0,0,27,0,690,0,0,0,0,0,0,0,0,10,0,0
Stone,5/9/20,0,0,0,0,0,0,0,0,0,8,0,98,0,8,0,0,0,0,0,106,0,0,0,0,0,0,0,0,0,0,0
Union,5/9/20,0,0,0,0,0,0,0,0,0,73,0,329,0,50,0,1,0,22,0,402,0,0,0,0,0,0,0,0,17,0,0
VanBuren,5/9/20,0,0,0,0,0,0,0,0,0,28,0,274,0,25,0,2,0,1,0,302,0,0,0,0,0,0,0,0,1,0,0
Washington,5/9/20,0,0,0,0,0,0,0,0,0,105,0,1805,0,79,0,3,0,23,0,1910,0,0,0,0,0,0,0,0,18,0,0
White,5/9/20,0,0,0,0,0,0,0,0,0,35,0,922,0,29,0,1,0,5,0,957,0,0,0,0,0,0,0,0,0,0,0
Woodruff,5/9/20,0,0,0,0,0,0,0,0,0,1,0,40,0,1,0,0,0,0,0,41,0,0,0,0,0,0,0,0,0,0,0
Yell,5/9/20,0,0,0,0,0,0,0,0,0,7,0,206,0,4,0,1,0,2,0,213,0,0,0,0,0,0,0,0,1,0,0
Arkansas_all_counties,5/8/20,0,0,0,0,0,0,0,0,2990671,3747,0,61781,0,2968,0,88,0,691,0,65528,0,0,0,0,0,0,0,82,101,0,2209
Arkansas_county,5/8/20,0,0,0,0,0,0,0,0,0,2,0,111,0,2,0,0,0,0,0,113,0,0,0,0,0,0,0,0,0,0,9
Ashley,5/8/20,0,0,0,0,0,0,0,0,0,17,0,377,0,14,0,0,0,3,0,394,0,0,0,0,0,0,0,0,3,0,6
Baxter,5/8/20,0,0,0,0,0,0,0,0,0,5,0,368,0,5,0,0,0,0,0,373,0,0,0,0,0,0,0,0,0,0,12
Benton,5/8/20,0,0,0,0,0,0,0,0,0,116,0,4136,0,95,0,0,0,21,0,4252,0,0,0,0,0,0,0,4,14,0,258
Boone,5/8/20,0,0,0,0,0,0,0,0,0,4,0,210,0,4,0,0,0,0,0,214,0,0,0,0,0,0,0,0,0,0,16
Bradley,5/8/20,0,0,0,0,0,0,0,0,0,11,0,252,0,7,0,1,0,3,0,263,0,0,0,0,0,0,0,0,2,0,3
Calhoun,5/8/20,0,0,0,0,0,0,0,0,0,0,0,28,0,0,0,0,0,0,0,28,0,0,0,0,0,0,0,0,0,0,3
Carroll,5/8/20,0,0,0,0,0,0,0,0,0,6,0,299,0,5,0,0,0,1,0,305,0,0,0,0,0,0,0,0,1,0,11
Chicot,5/8/20,0,0,0,0,0,0,0,0,0,10,0,119,0,7,0,0,0,3,0,129,0,0,0,0,0,0,0,0,2,0,1
Clark,5/8/20,0,0,0,0,0,0,0,0,0,32,0,456,0,28,0,0,0,4,0,488,0,0,0,0,0,0,0,0,1,0,13
Clay,5/8/20,0,0,0,0,0,0,0,0,0,3,0,318,0,2,0,0,0,1,0,321,0,0,0,0,0,0,0,0,0,0,3
Cleburne,5/8/20,0,0,0,0,0,0,0,0,0,72,0,244,0,67,0,4,0,1,0,316,0,0,0,0,0,0,0,0,1,0,9
Cleveland,5/8/20,0,0,0,0,0,0,0,0,0,13,0,198,0,11,0,0,0,2,0,211,0,0,0,0,0,0,0,1,0,0,4
Columbia,5/8/20,0,0,0,0,0,0,0,0,0,15,0,220,0,5,0,2,0,8,0,235,0,0,0,0,0,0,0,0,1,0,6
Conway,5/8/20,0,0,0,0,0,0,0,0,0,13,0,337,0,9,0,1,0,3,0,350,0,0,0,0,0,0,0,0,1,0,8
Craighead,5/8/20,0,0,0,0,0,0,0,0,0,92,0,1609,0,70,0,0,0,22,0,1701,0,0,0,0,0,0,0,1,9,0,26
Crawford,5/8/20,0,0,0,0,0,0,0,0,0,5,0,265,0,4,0,0,0,1,0,270,0,0,0,0,0,0,0,0,0,0,11
Crittenden,5/8/20,0,0,0,0,0,0,0,0,0,205,0,1370,0,165,0,7,0,33,0,1575,0,0,0,0,0,0,0,2,13,0,43
Cross,5/8/20,0,0,0,0,0,0,0,0,0,27,0,269,0,18,0,0,0,9,0,296,0,0,0,0,0,0,0,0,5,0,6
Dallas,5/8/20,0,0,0,0,0,0,0,0,0,1,0,70,0,1,0,0,0,0,0,71,0,0,0,0,0,0,0,0,0,0,3
Desha,5/8/20,0,0,0,0,0,0,0,0,0,16,0,273,0,14,0,0,0,2,0,289,0,0,0,0,0,0,0,-1,2,0,5
Drew,5/8/20,0,0,0,0,0,0,0,0,0,19,0,371,0,11,0,1,0,7,0,390,0,0,0,0,0,0,0,0,2,0,11
Faulkner,5/8/20,0,0,0,0,0,0,0,0,0,81,0,1840,0,70,0,2,0,9,0,1921,0,0,0,0,0,0,0,1,4,0,63
Franklin,5/8/20,0,0,0,0,0,0,0,0,0,2,0,116,0,2,0,0,0,0,0,118,0,0,0,0,0,0,0,0,0,0,5
Fulton,5/8/20,0,0,0,0,0,0,0,0,0,3,0,117,0,2,0,0,0,1,0,120,0,0,0,0,0,0,0,0,2,0,2
Garland,5/8/20,0,0,0,0,0,0,0,0,0,118,0,2660,0,112,0,1,0,5,0,2778,0,0,0,0,0,0,0,0,1,0,30
Grant,5/8/20,0,0,0,0,0,0,0,0,0,15,0,267,0,12,0,0,0,3,0,282,0,0,0,0,0,0,0,1,0,0,12
Greene,5/8/20,0,0,0,0,0,0,0,0,0,22,0,904,0,17,0,0,0,5,0,926,0,0,0,0,0,0,0,1,5,0,13
Hempstead,5/8/20,0,0,0,0,0,0,0,0,0,7,0,104,0,5,0,1,0,1,0,111,0,0,0,0,0,0,0,0,1,0,3
HotSpring,5/8/20,0,0,0,0,0,0,0,0,0,22,0,418,0,14,0,0,0,8,0,440,0,0,0,0,0,0,0,0,1,0,13
Howard,5/8/20,0,0,0,0,0,0,0,0,0,14,0,155,0,13,0,0,0,1,0,169,0,0,0,0,0,0,0,0,0,0,2
Independence,5/8/20,0,0,0,0,0,0,0,0,0,12,0,252,0,9,0,0,0,3,0,264,0,0,0,0,0,0,0,1,0,0,6
Izard,5/8/20,0,0,0,0,0,0,0,0,0,11,0,88,0,4,0,0,0,7,0,99,0,0,0,0,0,0,0,0,0,0,3
Jackson,5/8/20,0,0,0,0,0,0,0,0,0,1,0,116,0,1,0,0,0,0,0,117,0,0,0,0,0,0,0,0,0,0,3
Jefferson,5/8/20,0,0,0,0,0,0,0,0,0,226,0,1414,0,145,0,19,0,62,0,1640,0,0,0,0,0,0,0,3,20,0,24
Johnson,5/8/20,0,0,0,0,0,0,0,0,0,34,0,219,0,31,0,0,0,3,0,253,0,0,0,0,0,0,0,3,4,0,17
Lafayette,5/8/20,0,0,0,0,0,0,0,0,0,9,0,22,0,7,0,1,0,1,0,31,0,0,0,0,0,0,0,0,2,0,0
Lawrence,5/8/20,0,0,0,0,0,0,0,0,0,69,0,353,0,38,0,4,0,27,0,422,0,0,0,0,0,0,0,0,9,0,7
Lee,5/8/20,0,0,0,0,0,0,0,0,0,4,0,91,0,3,0,1,0,0,0,95,0,0,0,0,0,0,0,0,1,0,2
Lincoln,5/8/20,0,0,0,0,0,0,0,0,0,907,0,762,0,817,0,6,0,84,0,1669,0,0,0,0,0,0,0,18,563,0,26
LittleRiver,5/8/20,0,0,0,0,0,0,0,0,0,0,0,103,0,0,0,0,0,0,0,103,0,0,0,0,0,0,0,0,0,0,0
Logan,5/8/20,0,0,0,0,0,0,0,0,0,3,0,120,0,2,0,0,0,1,0,123,0,0,0,0,0,0,0,0,0,0,5
Lonoke,5/8/20,0,0,0,0,0,0,0,0,0,44,0,920,0,38,0,0,0,6,0,964,0,0,0,0,0,0,0,0,2,0,35
Madison,5/8/20,0,0,0,0,0,0,0,0,0,1,0,143,0,1,0,0,0,0,0,144,0,0,0,0,0,0,0,0,0,0,4
Marion,5/8/20,0,0,0,0,0,0,0,0,0,1,0,90,0,1,0,0,0,0,0,91,0,0,0,0,0,0,0,0,0,0,4
Miller,5/8/20,0,0,0,0,0,0,0,0,0,36,0,336,0,31,0,1,0,4,0,372,0,0,0,0,0,0,0,1,3,0,8
MissingCountyInfo,5/8/20,0,0,0,0,0,0,0,0,0,154,0,20444,0,94,0,0,0,60,0,20598,0,0,0,0,0,0,0,-5,30,0,753
Mississippi,5/8/20,0,0,0,0,0,0,0,0,0,47,0,424,0,14,0,0,0,33,0,471,0,0,0,0,0,0,0,5,4,0,41
Monroe,5/8/20,0,0,0,0,0,0,0,0,0,4,0,34,0,4,0,0,0,0,0,38,0,0,0,0,0,0,0,0,0,0,1
Montgomery,5/8/20,0,0,0,0,0,0,0,0,0,1,0,94,0,0,0,0,0,1,0,95,0,0,0,0,0,0,0,0,0,0,4
Nevada,5/8/20,0,0,0,0,0,0,0,0,0,3,0,59,0,1,0,0,0,2,0,62,0,0,0,0,0,0,0,1,0,0,1
Newton,5/8/20,0,0,0,0,0,0,0,0,0,3,0,81,0,3,0,0,0,0,0,84,0,0,0,0,0,0,0,0,1,0,2
Ouachita,5/8/20,0,0,0,0,0,0,0,0,0,8,0,342,0,5,0,0,0,3,0,350,0,0,0,0,0,0,0,1,0,0,9
Perry,5/8/20,0,0,0,0,0,0,0,0,0,7,0,136,0,6,0,0,0,1,0,143,0,0,0,0,0,0,0,0,0,0,5
Phillips,5/8/20,0,0,0,0,0,0,0,0,0,4,0,204,0,3,0,1,0,0,0,208,0,0,0,0,0,0,0,-1,0,0,2
Pike,5/8/20,0,0,0,0,0,0,0,0,0,3,0,339,0,3,0,0,0,0,0,342,0,0,0,0,0,0,0,0,1,0,7
Poinsett,5/8/20,0,0,0,0,0,0,0,0,0,25,0,241,0,17,0,2,0,6,0,266,0,0,0,0,0,0,0,0,3,0,7
Polk,5/8/20,0,0,0,0,0,0,0,0,0,7,0,286,0,7,0,0,0,0,0,293,0,0,0,0,0,0,0,0,0,0,2
Pope,5/8/20,0,0,0,0,0,0,0,0,0,47,0,1681,0,39,0,0,0,8,0,1728,0,0,0,0,0,0,0,1,2,0,29
Prairie,5/8/20,0,0,0,0,0,0,0,0,0,2,0,46,0,2,0,0,0,0,0,48,0,0,0,0,0,0,0,0,0,0,1
Pulaski,5/8/20,0,0,0,0,0,0,0,0,0,603,0,6423,0,462,0,22,0,119,0,7026,0,0,0,0,0,0,0,21,64,0,286
Randolph,5/8/20,0,0,0,0,0,0,0,0,0,21,0,610,0,18,0,0,0,3,0,631,0,0,0,0,0,0,0,0,4,0,10
Saline,5/8/20,0,0,0,0,0,0,0,0,0,72,0,1653,0,60,0,1,0,11,0,1725,0,0,0,0,0,0,0,3,5,0,112
Scott,5/8/20,0,0,0,0,0,0,0,0,0,1,0,5,0,1,0,0,0,0,0,6,0,0,0,0,0,0,0,0,0,0,0
Searcy,5/8/20,0,0,0,0,0,0,0,0,0,6,0,154,0,6,0,0,0,0,0,160,0,0,0,0,0,0,0,0,0,0,9
Sebastian,5/8/20,0,0,0,0,0,0,0,0,0,14,0,344,0,13,0,0,0,1,0,358,0,0,0,0,0,0,0,0,0,0,14
Sevier,5/8/20,0,0,0,0,0,0,0,0,0,16,0,295,0,10,0,1,0,5,0,311,0,0,0,0,0,0,0,2,1,0,5
Sharp,5/8/20,0,0,0,0,0,0,0,0,0,8,0,120,0,4,0,1,0,3,0,128,0,0,0,0,0,0,0,1,1,0,4
St.Francis,5/8/20,0,0,0,0,0,0,0,0,0,108,0,582,0,81,0,0,0,27,0,690,0,0,0,0,0,0,0,6,10,0,23
Stone,5/8/20,0,0,0,0,0,0,0,0,0,8,0,98,0,8,0,0,0,0,0,106,0,0,0,0,0,0,0,0,0,0,2
Union,5/8/20,0,0,0,0,0,0,0,0,0,73,0,329,0,50,0,1,0,22,0,402,0,0,0,0,0,0,0,6,17,0,18
VanBuren,5/8/20,0,0,0,0,0,0,0,0,0,28,0,274,0,25,0,2,0,1,0,302,0,0,0,0,0,0,0,0,1,0,6
Washington,5/8/20,0,0,0,0,0,0,0,0,0,105,0,1805,0,79,0,3,0,23,0,1910,0,0,0,0,0,0,0,5,18,0,60
White,5/8/20,0,0,0,0,0,0,0,0,0,35,0,922,0,29,0,1,0,5,0,957,0,0,0,0,0,0,0,0,0,0,36
Woodruff,5/8/20,0,0,0,0,0,0,0,0,0,1,0,40,0,1,0,0,0,0,0,41,0,0,0,0,0,0,0,0,0,0,2
Yell,5/8/20,0,0,0,0,0,0,0,0,0,7,0,206,0,4,0,1,0,2,0,213,0,0,0,0,0,0,0,0,1,0,5
Arkansas_all_counties,5/7/20,0,0,0,0,0,0,0,0,2990671,3665,0,59654,0,2867,0,88,0,710,0,63319,0,0,0,0,0,0,0,97,758,3,4316
Arkansas_county,5/7/20,0,0,0,0,0,0,0,0,0,2,0,102,0,2,0,0,0,0,0,104,0,0,0,0,0,0,0,0,0,0,7
Ashley,5/7/20,0,0,0,0,0,0,0,0,0,17,0,371,0,11,0,0,0,6,0,388,0,0,0,0,0,0,0,2,10,0,8
Baxter,5/7/20,0,0,0,0,0,0,0,0,0,5,0,356,0,5,0,0,0,0,0,361,0,0,0,0,0,0,0,0,0,0,6
Benton,5/7/20,0,0,0,0,0,0,0,0,0,112,0,3882,0,81,0,0,0,31,0,3994,0,0,0,0,0,0,0,1,0,0,305
Boone,5/7/20,0,0,0,0,0,0,0,0,0,4,0,194,0,4,0,0,0,0,0,198,0,0,0,0,0,0,0,0,0,0,10
Bradley,5/7/20,0,0,0,0,0,0,0,0,0,11,0,249,0,5,0,1,0,5,0,260,0,0,0,0,0,0,0,0,0,0,8
Calhoun,5/7/20,0,0,0,0,0,0,0,0,0,0,0,25,0,0,0,0,0,0,0,25,0,0,0,0,0,0,0,0,0,0,3
Carroll,5/7/20,0,0,0,0,0,0,0,0,0,6,0,288,0,4,0,0,0,2,0,294,0,0,0,0,0,0,0,0,0,0,14
Chicot,5/7/20,0,0,0,0,0,0,0,0,0,10,0,118,0,5,0,0,0,5,0,128,0,0,0,0,0,0,0,1,0,0,2
Clark,5/7/20,0,0,0,0,0,0,0,0,0,32,0,443,0,27,0,0,0,5,0,475,0,0,0,0,0,0,0,0,0,0,18
Clay,5/7/20,0,0,0,0,0,0,0,0,0,3,0,315,0,2,0,0,0,1,0,318,0,0,0,0,0,0,0,0,0,0,26
Cleburne,5/7/20,0,0,0,0,0,0,0,0,0,72,0,235,0,66,0,4,0,2,0,307,0,0,0,0,0,0,0,0,0,0,26
Cleveland,5/7/20,0,0,0,0,0,0,0,0,0,12,0,195,0,11,0,0,0,1,0,207,0,0,0,0,0,0,0,1,0,0,4
Columbia,5/7/20,0,0,0,0,0,0,0,0,0,15,0,214,0,4,0,2,0,9,0,229,0,0,0,0,0,0,0,2,0,0,38
Conway,5/7/20,0,0,0,0,0,0,0,0,0,13,0,329,0,8,0,1,0,4,0,342,0,0,0,0,0,0,0,0,1,0,9
Craighead,5/7/20,0,0,0,0,0,0,0,0,0,91,0,1584,0,61,0,0,0,30,0,1675,0,0,0,0,0,0,0,5,5,0,347
Crawford,5/7/20,0,0,0,0,0,0,0,0,0,5,0,254,0,4,0,0,0,1,0,259,0,0,0,0,0,0,0,1,0,0,18
Crittenden,5/7/20,0,0,0,0,0,0,0,0,0,203,0,1329,0,152,0,7,0,44,0,1532,0,0,0,0,0,0,0,6,2,0,168
Cross,5/7/20,0,0,0,0,0,0,0,0,0,27,0,263,0,13,0,0,0,14,0,290,0,0,0,0,0,0,0,2,0,0,40
Dallas,5/7/20,0,0,0,0,0,0,0,0,0,1,0,67,0,1,0,0,0,0,0,68,0,0,0,0,0,0,0,0,0,0,4
Desha,5/7/20,0,0,0,0,0,0,0,0,0,17,0,267,0,12,0,0,0,5,0,284,0,0,0,0,0,0,0,1,0,0,11
Drew,5/7/20,0,0,0,0,0,0,0,0,0,19,0,360,0,9,0,1,0,9,0,379,0,0,0,0,0,0,0,3,0,0,101
Faulkner,5/7/20,0,0,0,0,0,0,0,0,0,80,0,1778,0,66,0,2,0,12,0,1858,0,0,0,0,0,0,0,3,0,0,96
Franklin,5/7/20,0,0,0,0,0,0,0,0,0,2,0,111,0,2,0,0,0,0,0,113,0,0,0,0,0,0,0,0,0,0,4
Fulton,5/7/20,0,0,0,0,0,0,0,0,0,3,0,115,0,0,0,0,0,3,0,118,0,0,0,0,0,0,0,0,0,0,5
Garland,5/7/20,0,0,0,0,0,0,0,0,0,118,0,2630,0,111,0,1,0,6,0,2748,0,0,0,0,0,0,0,1,3,0,89
Grant,5/7/20,0,0,0,0,0,0,0,0,0,14,0,256,0,12,0,0,0,2,0,270,0,0,0,0,0,0,0,0,0,0,21
Greene,5/7/20,0,0,0,0,0,0,0,0,0,21,0,892,0,12,0,0,0,9,0,913,0,0,0,0,0,0,0,0,0,0,97
Hempstead,5/7/20,0,0,0,0,0,0,0,0,0,7,0,101,0,4,0,1,0,2,0,108,0,0,0,0,0,0,0,0,0,0,3
HotSpring,5/7/20,0,0,0,0,0,0,0,0,0,22,0,405,0,13,0,0,0,9,0,427,0,0,0,0,0,0,0,1,0,0,16
Howard,5/7/20,0,0,0,0,0,0,0,0,0,14,0,153,0,13,0,0,0,1,0,167,0,0,0,0,0,0,0,0,0,0,12
Independence,5/7/20,0,0,0,0,0,0,0,0,0,11,0,247,0,9,0,0,0,2,0,258,0,0,0,0,0,0,0,0,1,0,34
Izard,5/7/20,0,0,0,0,0,0,0,0,0,11,0,85,0,4,0,0,0,7,0,96,0,0,0,0,0,0,0,0,0,0,17
Jackson,5/7/20,0,0,0,0,0,0,0,0,0,1,0,113,0,1,0,0,0,0,0,114,0,0,0,0,0,0,0,0,0,0,25
Jefferson,5/7/20,0,0,0,0,0,0,0,0,0,223,0,1393,0,125,0,19,0,79,0,1616,0,0,0,0,0,0,0,23,1,0,69
Johnson,5/7/20,0,0,0,0,0,0,0,0,0,31,0,205,0,27,0,0,0,4,0,236,0,0,0,0,0,0,0,0,-1,0,10
Lafayette,5/7/20,0,0,0,0,0,0,0,0,0,9,0,22,0,5,0,1,0,3,0,31,0,0,0,0,0,0,0,1,0,0,3
Lawrence,5/7/20,0,0,0,0,0,0,0,0,0,69,0,346,0,29,0,4,0,36,0,415,0,0,0,0,0,0,0,1,0,0,50
Lee,5/7/20,0,0,0,0,0,0,0,0,0,4,0,89,0,2,0,1,0,1,0,93,0,0,0,0,0,0,0,0,0,0,13
Lincoln,5/7/20,0,0,0,0,0,0,0,0,0,889,0,754,0,254,0,6,0,629,0,1643,0,0,0,0,0,0,0,22,0,0,44
LittleRiver,5/7/20,0,0,0,0,0,0,0,0,0,0,0,103,0,0,0,0,0,0,0,103,0,0,0,0,0,0,0,0,0,0,0
Logan,5/7/20,0,0,0,0,0,0,0,0,0,3,0,115,0,2,0,0,0,1,0,118,0,0,0,0,0,0,0,1,0,0,6
Lonoke,5/7/20,0,0,0,0,0,0,0,0,0,44,0,885,0,36,0,0,0,8,0,929,0,0,0,0,0,0,0,0,0,0,100
Madison,5/7/20,0,0,0,0,0,0,0,0,0,1,0,139,0,1,0,0,0,0,0,140,0,0,0,0,0,0,0,0,0,0,5
Marion,5/7/20,0,0,0,0,0,0,0,0,0,1,0,86,0,1,0,0,0,0,0,87,0,0,0,0,0,0,0,0,0,0,3
Miller,5/7/20,0,0,0,0,0,0,0,0,0,35,0,329,0,28,0,1,0,6,0,364,0,0,0,0,0,0,0,0,1,0,7
MissingCountyInfo,5/7/20,0,0,0,0,0,0,0,0,0,159,0,19686,0,64,0,0,0,95,0,19845,0,0,0,0,0,0,0,-7,3,0,919
Mississippi,5/7/20,0,0,0,0,0,0,0,0,0,42,0,388,0,10,0,0,0,32,0,430,0,0,0,0,0,0,0,0,0,0,99
Monroe,5/7/20,0,0,0,0,0,0,0,0,0,4,0,33,0,4,0,0,0,0,0,37,0,0,0,0,0,0,0,0,0,0,6
Montgomery,5/7/20,0,0,0,0,0,0,0,0,0,1,0,90,0,0,0,0,0,1,0,91,0,0,0,0,0,0,0,0,0,0,2
Nevada,5/7/20,0,0,0,0,0,0,0,0,0,2,0,59,0,1,0,0,0,1,0,61,0,0,0,0,0,0,0,0,0,0,2
Newton,5/7/20,0,0,0,0,0,0,0,0,0,3,0,79,0,2,0,0,0,1,0,82,0,0,0,0,0,0,0,0,0,0,0
Ouachita,5/7/20,0,0,0,0,0,0,0,0,0,7,0,334,0,5,0,0,0,2,0,341,0,0,0,0,0,0,0,0,0,0,12
Perry,5/7/20,0,0,0,0,0,0,0,0,0,7,0,131,0,6,0,0,0,1,0,138,0,0,0,0,0,0,0,0,0,0,6
Phillips,5/7/20,0,0,0,0,0,0,0,0,0,5,0,201,0,3,0,1,0,1,0,206,0,0,0,0,0,0,0,0,0,0,8
Pike,5/7/20,0,0,0,0,0,0,0,0,0,3,0,332,0,2,0,0,0,1,0,335,0,0,0,0,0,0,0,0,0,0,7
Poinsett,5/7/20,0,0,0,0,0,0,0,0,0,25,0,234,0,14,0,2,0,9,0,259,0,0,0,0,0,0,0,0,0,0,47
Polk,5/7/20,0,0,0,0,0,0,0,0,0,7,0,284,0,7,0,0,0,0,0,291,0,0,0,0,0,0,0,0,0,0,3
Pope,5/7/20,0,0,0,0,0,0,0,0,0,46,0,1653,0,37,0,0,0,9,0,1699,0,0,0,0,0,0,0,0,0,0,41
Prairie,5/7/20,0,0,0,0,0,0,0,0,0,2,0,45,0,2,0,0,0,0,0,47,0,0,0,0,0,0,0,0,0,0,18
Pulaski,5/7/20,0,0,0,0,0,0,0,0,0,582,0,6158,0,398,0,22,0,162,0,6740,0,0,0,0,0,0,0,10,4,1,394
Randolph,5/7/20,0,0,0,0,0,0,0,0,0,21,0,600,0,14,0,0,0,7,0,621,0,0,0,0,0,0,0,2,0,0,29
Saline,5/7/20,0,0,0,0,0,0,0,0,0,69,0,1544,0,55,0,1,0,13,0,1613,0,0,0,0,0,0,0,2,0,0,80
Scott,5/7/20,0,0,0,0,0,0,0,0,0,1,0,5,0,1,0,0,0,0,0,6,0,0,0,0,0,0,0,0,0,0,0
Searcy,5/7/20,0,0,0,0,0,0,0,0,0,6,0,145,0,6,0,0,0,0,0,151,0,0,0,0,0,0,0,0,0,0,3
Sebastian,5/7/20,0,0,0,0,0,0,0,0,0,14,0,330,0,13,0,0,0,1,0,344,0,0,0,0,0,0,0,0,-1,0,23
Sevier,5/7/20,0,0,0,0,0,0,0,0,0,14,0,292,0,9,0,1,0,4,0,306,0,0,0,0,0,0,0,0,0,0,10
Sharp,5/7/20,0,0,0,0,0,0,0,0,0,7,0,117,0,3,0,1,0,3,0,124,0,0,0,0,0,0,0,0,0,1,52
St.Francis,5/7/20,0,0,0,0,0,0,0,0,0,102,0,565,0,71,0,0,0,31,0,667,0,0,0,0,0,0,0,5,0,0,86
Stone,5/7/20,0,0,0,0,0,0,0,0,0,8,0,96,0,8,0,0,0,0,0,104,0,0,0,0,0,0,0,0,0,0,3
Union,5/7/20,0,0,0,0,0,0,0,0,0,67,0,317,0,33,0,1,0,33,0,384,0,0,0,0,0,0,0,0,0,1,16
VanBuren,5/7/20,0,0,0,0,0,0,0,0,0,28,0,268,0,24,0,2,0,2,0,296,0,0,0,0,0,0,0,0,0,0,3
Washington,5/7/20,0,0,0,0,0,0,0,0,0,100,0,1750,0,61,0,3,0,36,0,1850,0,0,0,0,0,0,0,7,0,0,138
White,5/7/20,0,0,0,0,0,0,0,0,0,35,0,886,0,29,0,1,0,5,0,921,0,0,0,0,0,0,0,0,1,0,375
Woodruff,5/7/20,0,0,0,0,0,0,0,0,0,1,0,38,0,1,0,0,0,0,0,39,0,0,0,0,0,0,0,0,0,0,23
Yell,5/7/20,0,0,0,0,0,0,0,0,0,7,0,201,0,3,0,1,0,3,0,208,0,0,0,0,0,0,0,0,0,0,7
Arkansas_all_counties,5/6/20,0,0,0,0,0,0,0,0,2990671,3568,0,55435,0,2109,0,85,0,1374,0,59003,0,0,0,0,0,0,0,72,59,3,2699
Arkansas_county,5/6/20,0,0,0,0,0,0,0,0,0,2,0,95,0,2,0,0,0,0,0,97,0,0,0,0,0,0,0,-1,0,0,10
Ashley,5/6/20,0,0,0,0,0,0,0,0,0,15,0,365,0,11,0,0,0,4,0,380,0,0,0,0,0,0,0,0,1,0,12
Baxter,5/6/20,0,0,0,0,0,0,0,0,0,5,0,350,0,5,0,0,0,0,0,355,0,0,0,0,0,0,0,0,0,0,12
Benton,5/6/20,0,0,0,0,0,0,0,0,0,111,0,3578,0,81,0,0,0,30,0,3689,0,0,0,0,0,0,0,1,1,0,250
Boone,5/6/20,0,0,0,0,0,0,0,0,0,4,0,184,0,4,0,0,0,0,0,188,0,0,0,0,0,0,0,0,0,0,11
Bradley,5/6/20,0,0,0,0,0,0,0,0,0,11,0,241,0,5,0,1,0,5,0,252,0,0,0,0,0,0,0,0,0,0,8
Calhoun,5/6/20,0,0,0,0,0,0,0,0,0,0,0,22,0,0,0,0,0,0,0,22,0,0,0,0,0,0,0,0,0,0,1
Carroll,5/6/20,0,0,0,0,0,0,0,0,0,6,0,274,0,4,0,0,0,2,0,280,0,0,0,0,0,0,0,0,0,0,12
Chicot,5/6/20,0,0,0,0,0,0,0,0,0,9,0,117,0,5,0,0,0,4,0,126,0,0,0,0,0,0,0,0,0,0,2
Clark,5/6/20,0,0,0,0,0,0,0,0,0,32,0,425,0,27,0,0,0,5,0,457,0,0,0,0,0,0,0,0,0,0,60
Clay,5/6/20,0,0,0,0,0,0,0,0,0,3,0,289,0,2,0,0,0,1,0,292,0,0,0,0,0,0,0,0,2,0,17
Cleburne,5/6/20,0,0,0,0,0,0,0,0,0,72,0,209,0,66,0,4,0,2,0,281,0,0,0,0,0,0,0,0,0,0,27
Cleveland,5/6/20,0,0,0,0,0,0,0,0,0,11,0,192,0,11,0,0,0,0,0,203,0,0,0,0,0,0,0,0,1,0,6
Columbia,5/6/20,0,0,0,0,0,0,0,0,0,13,0,178,0,4,0,2,0,7,0,191,0,0,0,0,0,0,0,0,0,0,4
Conway,5/6/20,0,0,0,0,0,0,0,0,0,13,0,320,0,7,0,1,0,5,0,333,0,0,0,0,0,0,0,0,1,0,8
Craighead,5/6/20,0,0,0,0,0,0,0,0,0,86,0,1242,0,56,0,0,0,30,0,1328,0,0,0,0,0,0,0,2,4,0,78
Crawford,5/6/20,0,0,0,0,0,0,0,0,0,4,0,237,0,4,0,0,0,0,0,241,0,0,0,0,0,0,0,0,0,0,25
Crittenden,5/6/20,0,0,0,0,0,0,0,0,0,197,0,1167,0,150,0,7,0,40,0,1364,0,0,0,0,0,0,0,1,5,0,16
Cross,5/6/20,0,0,0,0,0,0,0,0,0,25,0,225,0,13,0,0,0,12,0,250,0,0,0,0,0,0,0,0,1,0,10
Dallas,5/6/20,0,0,0,0,0,0,0,0,0,1,0,63,0,1,0,0,0,0,0,64,0,0,0,0,0,0,0,0,0,0,4
Desha,5/6/20,0,0,0,0,0,0,0,0,0,16,0,257,0,12,0,0,0,4,0,273,0,0,0,0,0,0,0,0,2,0,17
Drew,5/6/20,0,0,0,0,0,0,0,0,0,16,0,262,0,9,0,1,0,6,0,278,0,0,0,0,0,0,0,0,0,0,13
Faulkner,5/6/20,0,0,0,0,0,0,0,0,0,77,0,1685,0,66,0,2,0,9,0,1762,0,0,0,0,0,0,0,0,5,0,65
Franklin,5/6/20,0,0,0,0,0,0,0,0,0,2,0,107,0,2,0,0,0,0,0,109,0,0,0,0,0,0,0,0,1,0,6
Fulton,5/6/20,0,0,0,0,0,0,0,0,0,3,0,110,0,0,0,0,0,3,0,113,0,0,0,0,0,0,0,2,0,0,5
Garland,5/6/20,0,0,0,0,0,0,0,0,0,117,0,2542,0,108,0,1,0,8,0,2659,0,0,0,0,0,0,0,0,2,1,55
Grant,5/6/20,0,0,0,0,0,0,0,0,0,14,0,235,0,12,0,0,0,2,0,249,0,0,0,0,0,0,0,0,0,0,11
Greene,5/6/20,0,0,0,0,0,0,0,0,0,21,0,795,0,12,0,0,0,9,0,816,0,0,0,0,0,0,0,1,1,0,31
Hempstead,5/6/20,0,0,0,0,0,0,0,0,0,7,0,98,0,4,0,1,0,2,0,105,0,0,0,0,0,0,0,0,0,0,4
HotSpring,5/6/20,0,0,0,0,0,0,0,0,0,21,0,390,0,13,0,0,0,8,0,411,0,0,0,0,0,0,0,1,2,0,20
Howard,5/6/20,0,0,0,0,0,0,0,0,0,14,0,141,0,13,0,0,0,1,0,155,0,0,0,0,0,0,0,0,0,0,0
Independence,5/6/20,0,0,0,0,0,0,0,0,0,11,0,213,0,8,0,0,0,3,0,224,0,0,0,0,0,0,0,0,-1,0,9
Izard,5/6/20,0,0,0,0,0,0,0,0,0,11,0,68,0,4,0,0,0,7,0,79,0,0,0,0,0,0,0,1,0,0,2
Jackson,5/6/20,0,0,0,0,0,0,0,0,0,1,0,88,0,1,0,0,0,0,0,89,0,0,0,0,0,0,0,0,0,0,3
Jefferson,5/6/20,0,0,0,0,0,0,0,0,0,200,0,1347,0,124,0,19,0,57,0,1547,0,0,0,0,0,0,0,2,4,0,54
Johnson,5/6/20,0,0,0,0,0,0,0,0,0,31,0,195,0,28,0,0,0,3,0,226,0,0,0,0,0,0,0,0,2,0,15
Lafayette,5/6/20,0,0,0,0,0,0,0,0,0,8,0,20,0,5,0,1,0,2,0,28,0,0,0,0,0,0,0,0,0,0,2
Lawrence,5/6/20,0,0,0,0,0,0,0,0,0,68,0,297,0,29,0,4,0,35,0,365,0,0,0,0,0,0,0,1,1,0,6
Lee,5/6/20,0,0,0,0,0,0,0,0,0,4,0,76,0,2,0,1,0,1,0,80,0,0,0,0,0,0,0,1,0,0,2
Lincoln,5/6/20,0,0,0,0,0,0,0,0,0,867,0,732,0,254,0,6,0,607,0,1599,0,0,0,0,0,0,0,22,2,1,31
LittleRiver,5/6/20,0,0,0,0,0,0,0,0,0,0,0,103,0,0,0,0,0,0,0,103,0,0,0,0,0,0,0,0,0,0,0
Logan,5/6/20,0,0,0,0,0,0,0,0,0,2,0,110,0,2,0,0,0,0,0,112,0,0,0,0,0,0,0,0,0,0,6
Lonoke,5/6/20,0,0,0,0,0,0,0,0,0,44,0,785,0,36,0,0,0,8,0,829,0,0,0,0,0,0,0,0,3,0,51
Madison,5/6/20,0,0,0,0,0,0,0,0,0,1,0,134,0,1,0,0,0,0,0,135,0,0,0,0,0,0,0,0,0,0,6
Marion,5/6/20,0,0,0,0,0,0,0,0,0,1,0,83,0,1,0,0,0,0,0,84,0,0,0,0,0,0,0,0,0,0,3
Miller,5/6/20,0,0,0,0,0,0,0,0,0,35,0,322,0,27,0,1,0,7,0,357,0,0,0,0,0,0,0,0,0,0,5
MissingCountyInfo,5/6/20,0,0,0,0,0,0,0,0,0,166,0,18760,0,61,0,0,0,105,0,18926,0,0,0,0,0,0,0,0,1,0,784
Mississippi,5/6/20,0,0,0,0,0,0,0,0,0,42,0,289,0,10,0,0,0,32,0,331,0,0,0,0,0,0,0,19,1,0,67
Monroe,5/6/20,0,0,0,0,0,0,0,0,0,4,0,27,0,4,0,0,0,0,0,31,0,0,0,0,0,0,0,0,0,0,5
Montgomery,5/6/20,0,0,0,0,0,0,0,0,0,1,0,88,0,0,0,0,0,1,0,89,0,0,0,0,0,0,0,0,0,0,4
Nevada,5/6/20,0,0,0,0,0,0,0,0,0,2,0,57,0,1,0,0,0,1,0,59,0,0,0,0,0,0,0,0,0,0,4
Newton,5/6/20,0,0,0,0,0,0,0,0,0,3,0,79,0,2,0,0,0,1,0,82,0,0,0,0,0,0,0,0,0,0,0
Ouachita,5/6/20,0,0,0,0,0,0,0,0,0,7,0,322,0,5,0,0,0,2,0,329,0,0,0,0,0,0,0,0,0,0,13
Perry,5/6/20,0,0,0,0,0,0,0,0,0,7,0,125,0,6,0,0,0,1,0,132,0,0,0,0,0,0,0,0,0,0,6
Phillips,5/6/20,0,0,0,0,0,0,0,0,0,5,0,193,0,3,0,1,0,1,0,198,0,0,0,0,0,0,0,-1,0,0,7
Pike,5/6/20,0,0,0,0,0,0,0,0,0,3,0,325,0,2,0,0,0,1,0,328,0,0,0,0,0,0,0,0,0,0,10
Poinsett,5/6/20,0,0,0,0,0,0,0,0,0,25,0,187,0,14,0,2,0,9,0,212,0,0,0,0,0,0,0,2,3,0,13
Polk,5/6/20,0,0,0,0,0,0,0,0,0,7,0,281,0,7,0,0,0,0,0,288,0,0,0,0,0,0,0,-1,0,0,1
Pope,5/6/20,0,0,0,0,0,0,0,0,0,46,0,1612,0,37,0,0,0,9,0,1658,0,0,0,0,0,0,0,1,0,0,52
Prairie,5/6/20,0,0,0,0,0,0,0,0,0,2,0,27,0,2,0,0,0,0,0,29,0,0,0,0,0,0,0,0,0,0,0
Pulaski,5/6/20,0,0,0,0,0,0,0,0,0,572,0,5774,0,394,0,21,0,157,0,6346,0,0,0,0,0,0,0,9,11,1,451
Randolph,5/6/20,0,0,0,0,0,0,0,0,0,19,0,573,0,14,0,0,0,5,0,592,0,0,0,0,0,0,0,0,0,0,11
Saline,5/6/20,0,0,0,0,0,0,0,0,0,67,0,1466,0,55,0,1,0,11,0,1533,0,0,0,0,0,0,0,0,2,0,85
Scott,5/6/20,0,0,0,0,0,0,0,0,0,1,0,5,0,1,0,0,0,0,0,6,0,0,0,0,0,0,0,0,0,0,0
Searcy,5/6/20,0,0,0,0,0,0,0,0,0,6,0,142,0,6,0,0,0,0,0,148,0,0,0,0,0,0,0,0,0,0,7
Sebastian,5/6/20,0,0,0,0,0,0,0,0,0,14,0,307,0,14,0,0,0,0,0,321,0,0,0,0,0,0,0,1,1,0,33
Sevier,5/6/20,0,0,0,0,0,0,0,0,0,14,0,282,0,9,0,1,0,4,0,296,0,0,0,0,0,0,0,0,0,0,5
Sharp,5/6/20,0,0,0,0,0,0,0,0,0,7,0,65,0,3,0,0,0,4,0,72,0,0,0,0,0,0,0,-2,0,0,-2
St.Francis,5/6/20,0,0,0,0,0,0,0,0,0,97,0,484,0,71,0,0,0,26,0,581,0,0,0,0,0,0,0,2,0,0,7
Stone,5/6/20,0,0,0,0,0,0,0,0,0,8,0,93,0,8,0,0,0,0,0,101,0,0,0,0,0,0,0,0,0,0,5
Union,5/6/20,0,0,0,0,0,0,0,0,0,67,0,301,0,33,0,0,0,34,0,368,0,0,0,0,0,0,0,5,1,0,17
VanBuren,5/6/20,0,0,0,0,0,0,0,0,0,28,0,265,0,24,0,2,0,2,0,293,0,0,0,0,0,0,0,0,0,0,6
Washington,5/6/20,0,0,0,0,0,0,0,0,0,93,0,1619,0,61,0,3,0,29,0,1712,0,0,0,0,0,0,0,2,0,0,79
White,5/6/20,0,0,0,0,0,0,0,0,0,35,0,511,0,28,0,1,0,6,0,546,0,0,0,0,0,0,0,0,0,0,24
Woodruff,5/6/20,0,0,0,0,0,0,0,0,0,1,0,15,0,1,0,0,0,0,0,16,0,0,0,0,0,0,0,0,0,0,1
Yell,5/6/20,0,0,0,0,0,0,0,0,0,7,0,194,0,3,0,1,0,3,0,201,0,0,0,0,0,0,0,1,0,0,10
Arkansas_all_counties,5/5/20,0,0,0,0,0,0,0,0,2990671,3496,0,52808,0,2050,0,82,0,1364,0,56304,0,0,0,0,0,0,0,38,2040,2,1862
Arkansas_county,5/5/20,0,0,0,0,0,0,0,0,0,3,0,84,0,2,0,0,0,1,0,87,0,0,0,0,0,0,0,0,0,0,3
Ashley,5/5/20,0,0,0,0,0,0,0,0,0,15,0,353,0,10,0,0,0,5,0,368,0,0,0,0,0,0,0,0,0,0,14
Baxter,5/5/20,0,0,0,0,0,0,0,0,0,5,0,338,0,5,0,0,0,0,0,343,0,0,0,0,0,0,0,0,0,0,12
Benton,5/5/20,0,0,0,0,0,0,0,0,0,110,0,3329,0,80,0,0,0,30,0,3439,0,0,0,0,0,0,0,3,2,0,203
Boone,5/5/20,0,0,0,0,0,0,0,0,0,4,0,173,0,4,0,0,0,0,0,177,0,0,0,0,0,0,0,0,0,0,10
Bradley,5/5/20,0,0,0,0,0,0,0,0,0,11,0,233,0,5,0,1,0,5,0,244,0,0,0,0,0,0,0,0,0,0,4
Calhoun,5/5/20,0,0,0,0,0,0,0,0,0,0,0,21,0,0,0,0,0,0,0,21,0,0,0,0,0,0,0,0,0,0,2
Carroll,5/5/20,0,0,0,0,0,0,0,0,0,6,0,262,0,4,0,0,0,2,0,268,0,0,0,0,0,0,0,0,0,0,10
Chicot,5/5/20,0,0,0,0,0,0,0,0,0,9,0,115,0,5,0,0,0,4,0,124,0,0,0,0,0,0,0,0,1,0,0
Clark,5/5/20,0,0,0,0,0,0,0,0,0,32,0,365,0,27,0,0,0,5,0,397,0,0,0,0,0,0,0,0,0,0,161
Clay,5/5/20,0,0,0,0,0,0,0,0,0,3,0,272,0,0,0,0,0,3,0,275,0,0,0,0,0,0,0,0,0,0,4
Cleburne,5/5/20,0,0,0,0,0,0,0,0,0,72,0,182,0,66,0,4,0,2,0,254,0,0,0,0,0,0,0,0,0,0,6
Cleveland,5/5/20,0,0,0,0,0,0,0,0,0,11,0,186,0,10,0,0,0,1,0,197,0,0,0,0,0,0,0,0,0,0,1
Columbia,5/5/20,0,0,0,0,0,0,0,0,0,13,0,174,0,4,0,2,0,7,0,187,0,0,0,0,0,0,0,0,0,0,10
Conway,5/5/20,0,0,0,0,0,0,0,0,0,13,0,312,0,6,0,1,0,6,0,325,0,0,0,0,0,0,0,0,0,0,3
Craighead,5/5/20,0,0,0,0,0,0,0,0,0,84,0,1166,0,52,0,0,0,32,0,1250,0,0,0,0,0,0,0,3,4,0,49
Crawford,5/5/20,0,0,0,0,0,0,0,0,0,4,0,212,0,4,0,0,0,0,0,216,0,0,0,0,0,0,0,0,0,0,7
Crittenden,5/5/20,0,0,0,0,0,0,0,0,0,196,0,1152,0,145,0,7,0,44,0,1348,0,0,0,0,0,0,0,0,1,0,31
Cross,5/5/20,0,0,0,0,0,0,0,0,0,25,0,215,0,12,0,0,0,13,0,240,0,0,0,0,0,0,0,1,1,0,4
Dallas,5/5/20,0,0,0,0,0,0,0,0,0,1,0,59,0,1,0,0,0,0,0,60,0,0,0,0,0,0,0,0,0,0,6
Desha,5/5/20,0,0,0,0,0,0,0,0,0,16,0,240,0,10,0,0,0,6,0,256,0,0,0,0,0,0,0,0,0,0,6
Drew,5/5/20,0,0,0,0,0,0,0,0,0,16,0,249,0,9,0,1,0,6,0,265,0,0,0,0,0,0,0,0,0,0,3
Faulkner,5/5/20,0,0,0,0,0,0,0,0,0,77,0,1620,0,61,0,2,0,14,0,1697,0,0,0,0,0,0,0,1,4,0,17
Franklin,5/5/20,0,0,0,0,0,0,0,0,0,2,0,101,0,1,0,0,0,1,0,103,0,0,0,0,0,0,0,0,0,0,2
Fulton,5/5/20,0,0,0,0,0,0,0,0,0,1,0,107,0,0,0,0,0,1,0,108,0,0,0,0,0,0,0,0,0,0,11
Garland,5/5/20,0,0,0,0,0,0,0,0,0,117,0,2487,0,106,0,0,0,11,0,2604,0,0,0,0,0,0,0,0,1,0,259
Grant,5/5/20,0,0,0,0,0,0,0,0,0,14,0,224,0,12,0,0,0,2,0,238,0,0,0,0,0,0,0,0,0,0,17
Greene,5/5/20,0,0,0,0,0,0,0,0,0,20,0,765,0,11,0,0,0,9,0,785,0,0,0,0,0,0,0,1,0,0,21
Hempstead,5/5/20,0,0,0,0,0,0,0,0,0,7,0,94,0,4,0,1,0,2,0,101,0,0,0,0,0,0,0,0,0,0,2
HotSpring,5/5/20,0,0,0,0,0,0,0,0,0,20,0,371,0,11,0,0,0,9,0,391,0,0,0,0,0,0,0,0,0,0,13
Howard,5/5/20,0,0,0,0,0,0,0,0,0,14,0,141,0,13,0,0,0,1,0,155,0,0,0,0,0,0,0,0,0,0,0
Independence,5/5/20,0,0,0,0,0,0,0,0,0,11,0,204,0,9,0,0,0,2,0,215,0,0,0,0,0,0,0,1,0,0,7
Izard,5/5/20,0,0,0,0,0,0,0,0,0,10,0,67,0,4,0,0,0,6,0,77,0,0,0,0,0,0,0,1,0,0,4
Jackson,5/5/20,0,0,0,0,0,0,0,0,0,1,0,85,0,1,0,0,0,0,0,86,0,0,0,0,0,0,0,0,0,0,1
Jefferson,5/5/20,0,0,0,0,0,0,0,0,0,198,0,1295,0,120,0,19,0,59,0,1493,0,0,0,0,0,0,0,6,2,1,57
Johnson,5/5/20,0,0,0,0,0,0,0,0,0,31,0,180,0,26,0,0,0,5,0,211,0,0,0,0,0,0,0,0,0,0,1
Lafayette,5/5/20,0,0,0,0,0,0,0,0,0,8,0,18,0,5,0,1,0,2,0,26,0,0,0,0,0,0,0,0,0,0,0
Lawrence,5/5/20,0,0,0,0,0,0,0,0,0,67,0,292,0,28,0,4,0,35,0,359,0,0,0,0,0,0,0,1,1,0,2
Lee,5/5/20,0,0,0,0,0,0,0,0,0,3,0,75,0,2,0,1,0,0,0,78,0,0,0,0,0,0,0,0,0,0,1
Lincoln,5/5/20,0,0,0,0,0,0,0,0,0,845,0,723,0,252,0,5,0,588,0,1568,0,0,0,0,0,0,0,11,0,1,20
LittleRiver,5/5/20,0,0,0,0,0,0,0,0,0,0,0,103,0,0,0,0,0,0,0,103,0,0,0,0,0,0,0,0,0,0,1
Logan,5/5/20,0,0,0,0,0,0,0,0,0,2,0,104,0,2,0,0,0,0,0,106,0,0,0,0,0,0,0,0,0,0,5
Lonoke,5/5/20,0,0,0,0,0,0,0,0,0,44,0,734,0,33,0,0,0,11,0,778,0,0,0,0,0,0,0,0,4,0,86
Madison,5/5/20,0,0,0,0,0,0,0,0,0,1,0,128,0,1,0,0,0,0,0,129,0,0,0,0,0,0,0,0,1,0,6
Marion,5/5/20,0,0,0,0,0,0,0,0,0,1,0,80,0,1,0,0,0,0,0,81,0,0,0,0,0,0,0,0,0,0,1
Miller,5/5/20,0,0,0,0,0,0,0,0,0,35,0,317,0,27,0,1,0,7,0,352,0,0,0,0,0,0,0,0,0,0,5
MissingCountyInfo,5/5/20,0,0,0,0,0,0,0,0,0,166,0,17976,0,60,0,NA,0,106,0,18142,0,0,0,0,0,0,0,-10,3,NA,186
Mississippi,5/5/20,0,0,0,0,0,0,0,0,0,23,0,241,0,9,0,0,0,14,0,264,0,0,0,0,0,0,0,2,1,0,11
Monroe,5/5/20,0,0,0,0,0,0,0,0,0,4,0,22,0,4,0,0,0,0,0,26,0,0,0,0,0,0,0,0,0,0,1
Montgomery,5/5/20,0,0,0,0,0,0,0,0,0,1,0,84,0,0,0,0,0,1,0,85,0,0,0,0,0,0,0,0,0,0,2
Nevada,5/5/20,0,0,0,0,0,0,0,0,0,2,0,53,0,1,0,0,0,1,0,55,0,0,0,0,0,0,0,0,0,0,4
Newton,5/5/20,0,0,0,0,0,0,0,0,0,3,0,79,0,2,0,0,0,1,0,82,0,0,0,0,0,0,0,0,0,0,0
Ouachita,5/5/20,0,0,0,0,0,0,0,0,0,7,0,309,0,5,0,0,0,2,0,316,0,0,0,0,0,0,0,0,0,0,13
Perry,5/5/20,0,0,0,0,0,0,0,0,0,7,0,119,0,6,0,0,0,1,0,126,0,0,0,0,0,0,0,0,0,0,1
Phillips,5/5/20,0,0,0,0,0,0,0,0,0,6,0,185,0,3,0,1,0,2,0,191,0,0,0,0,0,0,0,0,0,0,21
Pike,5/5/20,0,0,0,0,0,0,0,0,0,3,0,315,0,2,0,0,0,1,0,318,0,0,0,0,0,0,0,0,0,0,3
Poinsett,5/5/20,0,0,0,0,0,0,0,0,0,23,0,176,0,11,0,2,0,10,0,199,0,0,0,0,0,0,0,0,0,0,46
Polk,5/5/20,0,0,0,0,0,0,0,0,0,8,0,279,0,7,0,0,0,1,0,287,0,0,0,0,0,0,0,0,0,0,2
Pope,5/5/20,0,0,0,0,0,0,0,0,0,45,0,1561,0,37,0,0,0,8,0,1606,0,0,0,0,0,0,0,1,2,0,7
Prairie,5/5/20,0,0,0,0,0,0,0,0,0,2,0,27,0,2,0,0,0,0,0,29,0,0,0,0,0,0,0,0,0,0,2
Pulaski,5/5/20,0,0,0,0,0,0,0,0,0,563,0,5332,0,383,0,20,0,160,0,5895,0,0,0,0,0,0,0,12,6,0,211
Randolph,5/5/20,0,0,0,0,0,0,0,0,0,19,0,562,0,14,0,0,0,5,0,581,0,0,0,0,0,0,0,0,0,0,7
Saline,5/5/20,0,0,0,0,0,0,0,0,0,67,0,1381,0,53,0,1,0,13,0,1448,0,0,0,0,0,0,0,-1,3,0,65
Scott,5/5/20,0,0,0,0,0,0,0,0,0,1,0,5,0,1,0,0,0,0,0,6,0,0,0,0,0,0,0,0,0,0,0
Searcy,5/5/20,0,0,0,0,0,0,0,0,0,6,0,135,0,6,0,0,0,0,0,141,0,0,0,0,0,0,0,0,0,0,0
Sebastian,5/5/20,0,0,0,0,0,0,0,0,0,13,0,275,0,13,0,0,0,0,0,288,0,0,0,0,0,0,0,0,0,0,17
Sevier,5/5/20,0,0,0,0,0,0,0,0,0,14,0,277,0,9,0,1,0,4,0,291,0,0,0,0,0,0,0,2,0,0,54
Sharp,5/5/20,0,0,0,0,0,0,0,0,0,9,0,65,0,3,0,0,0,6,0,74,0,0,0,0,0,0,0,0,0,0,0
St.Francis,5/5/20,0,0,0,0,0,0,0,0,0,95,0,479,0,71,0,0,0,24,0,574,0,0,0,0,0,0,0,2,1,0,5
Stone,5/5/20,0,0,0,0,0,0,0,0,0,8,0,88,0,8,0,0,0,0,0,96,0,0,0,0,0,0,0,0,0,0,0
Union,5/5/20,0,0,0,0,0,0,0,0,0,62,0,289,0,32,0,0,0,30,0,351,0,0,0,0,0,0,0,1,1,0,5
VanBuren,5/5/20,0,0,0,0,0,0,0,0,0,28,0,259,0,24,0,2,0,2,0,287,0,0,0,0,0,0,0,0,0,0,3
Washington,5/5/20,0,0,0,0,0,0,0,0,0,91,0,1542,0,61,0,3,0,27,0,1633,0,0,0,0,0,0,0,0,2,0,70
White,5/5/20,0,0,0,0,0,0,0,0,0,35,0,487,0,28,0,1,0,6,0,522,0,0,0,0,0,0,0,0,0,0,36
Woodruff,5/5/20,0,0,0,0,0,0,0,0,0,1,0,14,0,1,0,0,0,0,0,15,0,0,0,0,0,0,0,0,0,0,2
Yell,5/5/20,0,0,0,0,0,0,0,0,0,6,0,185,0,3,0,1,0,2,0,191,0,0,0,0,0,0,0,0,0,0,0
Arkansas_all_counties,5/4/20,0,0,0,0,0,0,0,0,2990671,3458,0,50984,0,2016,0,80,0,1362,0,54442,0,0,0,0,0,0,0,27,17,4,1552
Arkansas_county,5/4/20,0,0,0,0,0,0,0,0,0,3,0,81,0,2,0,0,0,1,0,84,0,0,0,0,0,0,0,0,0,0,3
Ashley,5/4/20,0,0,0,0,0,0,0,0,0,15,0,339,0,10,0,0,0,5,0,354,0,0,0,0,0,0,0,-1,0,0,9
Baxter,5/4/20,0,0,0,0,0,0,0,0,0,5,0,326,0,5,0,0,0,0,0,331,0,0,0,0,0,0,0,0,0,0,7
Benton,5/4/20,0,0,0,0,0,0,0,0,0,107,0,3129,0,78,0,0,0,29,0,3236,0,0,0,0,0,0,0,1,0,0,193
Boone,5/4/20,0,0,0,0,0,0,0,0,0,4,0,163,0,4,0,0,0,0,0,167,0,0,0,0,0,0,0,0,0,0,3
Bradley,5/4/20,0,0,0,0,0,0,0,0,0,11,0,229,0,5,0,1,0,5,0,240,0,0,0,0,0,0,0,0,0,0,7
Calhoun,5/4/20,0,0,0,0,0,0,0,0,0,0,0,19,0,0,0,0,0,0,0,19,0,0,0,0,0,0,0,0,0,0,0
Carroll,5/4/20,0,0,0,0,0,0,0,0,0,6,0,252,0,4,0,0,0,2,0,258,0,0,0,0,0,0,0,0,0,0,6
Chicot,5/4/20,0,0,0,0,0,0,0,0,0,9,0,115,0,6,0,0,0,3,0,124,0,0,0,0,0,0,0,0,0,0,41
Clark,5/4/20,0,0,0,0,0,0,0,0,0,32,0,204,0,27,0,0,0,5,0,236,0,0,0,0,0,0,0,1,0,0,16
Clay,5/4/20,0,0,0,0,0,0,0,0,0,3,0,268,0,0,0,0,0,3,0,271,0,0,0,0,0,0,0,0,0,0,15
Cleburne,5/4/20,0,0,0,0,0,0,0,0,0,72,0,176,0,66,0,4,0,2,0,248,0,0,0,0,0,0,0,-1,-1,0,5
Cleveland,5/4/20,0,0,0,0,0,0,0,0,0,11,0,185,0,10,0,0,0,1,0,196,0,0,0,0,0,0,0,0,2,0,1
Columbia,5/4/20,0,0,0,0,0,0,0,0,0,13,0,164,0,4,0,2,0,7,0,177,0,0,0,0,0,0,0,0,0,0,2
Conway,5/4/20,0,0,0,0,0,0,0,0,0,13,0,309,0,6,0,1,0,6,0,322,0,0,0,0,0,0,0,0,1,0,14
Craighead,5/4/20,0,0,0,0,0,0,0,0,0,81,0,1120,0,48,0,0,0,33,0,1201,0,0,0,0,0,0,0,0,0,0,35
Crawford,5/4/20,0,0,0,0,0,0,0,0,0,4,0,205,0,4,0,0,0,0,0,209,0,0,0,0,0,0,0,-1,0,0,2
Crittenden,5/4/20,0,0,0,0,0,0,0,0,0,196,0,1121,0,144,0,7,0,45,0,1317,0,0,0,0,0,0,0,-1,0,2,5
Cross,5/4/20,0,0,0,0,0,0,0,0,0,24,0,212,0,11,0,0,0,13,0,236,0,0,0,0,0,0,0,0,0,0,4
Dallas,5/4/20,0,0,0,0,0,0,0,0,0,1,0,53,0,1,0,0,0,0,0,54,0,0,0,0,0,0,0,0,0,0,0
Desha,5/4/20,0,0,0,0,0,0,0,0,0,16,0,234,0,10,0,0,0,6,0,250,0,0,0,0,0,0,0,0,0,0,5
Drew,5/4/20,0,0,0,0,0,0,0,0,0,16,0,246,0,9,0,1,0,6,0,262,0,0,0,0,0,0,0,1,1,0,3
Faulkner,5/4/20,0,0,0,0,0,0,0,0,0,76,0,1604,0,57,0,2,0,17,0,1680,0,0,0,0,0,0,0,-1,0,0,61
Franklin,5/4/20,0,0,0,0,0,0,0,0,0,2,0,99,0,1,0,0,0,1,0,101,0,0,0,0,0,0,0,0,0,0,9
Fulton,5/4/20,0,0,0,0,0,0,0,0,0,1,0,96,0,0,0,0,0,1,0,97,0,0,0,0,0,0,0,0,0,0,6
Garland,5/4/20,0,0,0,0,0,0,0,0,0,117,0,2228,0,105,0,0,0,12,0,2345,0,0,0,0,0,0,0,-1,-1,0,38
Grant,5/4/20,0,0,0,0,0,0,0,0,0,14,0,207,0,12,0,0,0,2,0,221,0,0,0,0,0,0,0,0,1,0,4
Greene,5/4/20,0,0,0,0,0,0,0,0,0,19,0,745,0,11,0,0,0,8,0,764,0,0,0,0,0,0,0,0,0,0,19
Hempstead,5/4/20,0,0,0,0,0,0,0,0,0,7,0,92,0,4,0,1,0,2,0,99,0,0,0,0,0,0,0,1,0,0,6
HotSpring,5/4/20,0,0,0,0,0,0,0,0,0,20,0,358,0,11,0,0,0,9,0,378,0,0,0,0,0,0,0,0,0,0,14
Howard,5/4/20,0,0,0,0,0,0,0,0,0,14,0,141,0,13,0,0,0,1,0,155,0,0,0,0,0,0,0,1,0,0,4
Independence,5/4/20,0,0,0,0,0,0,0,0,0,10,0,198,0,9,0,0,0,1,0,208,0,0,0,0,0,0,0,0,0,0,5
Izard,5/4/20,0,0,0,0,0,0,0,0,0,9,0,64,0,4,0,0,0,5,0,73,0,0,0,0,0,0,0,0,0,0,0
Jackson,5/4/20,0,0,0,0,0,0,0,0,0,1,0,84,0,1,0,0,0,0,0,85,0,0,0,0,0,0,0,0,0,0,1
Jefferson,5/4/20,0,0,0,0,0,0,0,0,0,192,0,1244,0,118,0,18,0,56,0,1436,0,0,0,0,0,0,0,8,1,1,38
Johnson,5/4/20,0,0,0,0,0,0,0,0,0,31,0,179,0,26,0,0,0,5,0,210,0,0,0,0,0,0,0,0,1,0,1
Lafayette,5/4/20,0,0,0,0,0,0,0,0,0,8,0,18,0,5,0,1,0,2,0,26,0,0,0,0,0,0,0,0,0,0,1
Lawrence,5/4/20,0,0,0,0,0,0,0,0,0,66,0,291,0,27,0,4,0,35,0,357,0,0,0,0,0,0,0,0,0,0,12
Lee,5/4/20,0,0,0,0,0,0,0,0,0,3,0,74,0,2,0,1,0,0,0,77,0,0,0,0,0,0,0,0,0,0,2
Lincoln,5/4/20,0,0,0,0,0,0,0,0,0,834,0,714,0,252,0,4,0,578,0,1548,0,0,0,0,0,0,0,12,0,0,14
LittleRiver,5/4/20,0,0,0,0,0,0,0,0,0,0,0,102,0,0,0,0,0,0,0,102,0,0,0,0,0,0,0,0,0,0,2
Logan,5/4/20,0,0,0,0,0,0,0,0,0,2,0,99,0,2,0,0,0,0,0,101,0,0,0,0,0,0,0,-1,0,-1,1
Lonoke,5/4/20,0,0,0,0,0,0,0,0,0,44,0,648,0,29,0,0,0,15,0,692,0,0,0,0,0,0,0,1,-1,0,87
Madison,5/4/20,0,0,0,0,0,0,0,0,0,1,0,122,0,0,0,0,0,1,0,123,0,0,0,0,0,0,0,0,0,0,5
Marion,5/4/20,0,0,0,0,0,0,0,0,0,1,0,79,0,1,0,0,0,0,0,80,0,0,0,0,0,0,0,0,0,0,3
Miller,5/4/20,0,0,0,0,0,0,0,0,0,35,0,312,0,27,0,1,0,7,0,347,0,0,0,0,0,0,0,0,0,0,6
MissingCountyInfo,5/4/20,0,0,0,0,0,0,0,0,0,176,0,17780,0,62,0,NA,0,114,0,17956,0,0,0,0,0,0,0,2,5,NA,364
Mississippi,5/4/20,0,0,0,0,0,0,0,0,0,21,0,232,0,8,0,0,0,13,0,253,0,0,0,0,0,0,0,1,0,0,14
Monroe,5/4/20,0,0,0,0,0,0,0,0,0,4,0,21,0,4,0,0,0,0,0,25,0,0,0,0,0,0,0,0,0,0,1
Montgomery,5/4/20,0,0,0,0,0,0,0,0,0,1,0,82,0,0,0,0,0,1,0,83,0,0,0,0,0,0,0,0,0,0,2
Nevada,5/4/20,0,0,0,0,0,0,0,0,0,2,0,49,0,1,0,0,0,1,0,51,0,0,0,0,0,0,0,1,0,0,4
Newton,5/4/20,0,0,0,0,0,0,0,0,0,3,0,79,0,2,0,0,0,1,0,82,0,0,0,0,0,0,0,0,0,0,1
Ouachita,5/4/20,0,0,0,0,0,0,0,0,0,7,0,296,0,5,0,0,0,2,0,303,0,0,0,0,0,0,0,0,0,0,16
Perry,5/4/20,0,0,0,0,0,0,0,0,0,7,0,118,0,6,0,0,0,1,0,125,0,0,0,0,0,0,0,0,0,0,12
Phillips,5/4/20,0,0,0,0,0,0,0,0,0,6,0,164,0,3,0,1,0,2,0,170,0,0,0,0,0,0,0,0,0,0,1
Pike,5/4/20,0,0,0,0,0,0,0,0,0,3,0,312,0,2,0,0,0,1,0,315,0,0,0,0,0,0,0,0,0,0,6
Poinsett,5/4/20,0,0,0,0,0,0,0,0,0,23,0,130,0,11,0,2,0,10,0,153,0,0,0,0,0,0,0,0,0,0,2
Polk,5/4/20,0,0,0,0,0,0,0,0,0,8,0,277,0,7,0,0,0,1,0,285,0,0,0,0,0,0,0,0,0,0,4
Pope,5/4/20,0,0,0,0,0,0,0,0,0,44,0,1555,0,35,0,0,0,9,0,1599,0,0,0,0,0,0,0,0,0,0,15
Prairie,5/4/20,0,0,0,0,0,0,0,0,0,2,0,25,0,2,0,0,0,0,0,27,0,0,0,0,0,0,0,0,1,0,2
Pulaski,5/4/20,0,0,0,0,0,0,0,0,0,551,0,5133,0,377,0,20,0,154,0,5684,0,0,0,0,0,0,0,1,5,1,206
Randolph,5/4/20,0,0,0,0,0,0,0,0,0,19,0,555,0,14,0,0,0,5,0,574,0,0,0,0,0,0,0,1,0,0,12
Saline,5/4/20,0,0,0,0,0,0,0,0,0,68,0,1315,0,50,0,1,0,17,0,1383,0,0,0,0,0,0,0,0,1,0,51
Scott,5/4/20,0,0,0,0,0,0,0,0,0,1,0,5,0,1,0,0,0,0,0,6,0,0,0,0,0,0,0,0,0,0,0
Searcy,5/4/20,0,0,0,0,0,0,0,0,0,6,0,135,0,6,0,0,0,0,0,141,0,0,0,0,0,0,0,0,0,0,7
Sebastian,5/4/20,0,0,0,0,0,0,0,0,0,13,0,258,0,13,0,0,0,0,0,271,0,0,0,0,0,0,0,0,0,0,10
Sevier,5/4/20,0,0,0,0,0,0,0,0,0,12,0,225,0,9,0,1,0,2,0,237,0,0,0,0,0,0,0,0,0,0,6
Sharp,5/4/20,0,0,0,0,0,0,0,0,0,9,0,65,0,3,0,0,0,6,0,74,0,0,0,0,0,0,0,0,0,0,1
St.Francis,5/4/20,0,0,0,0,0,0,0,0,0,93,0,476,0,70,0,0,0,23,0,569,0,0,0,0,0,0,0,6,0,0,1
Stone,5/4/20,0,0,0,0,0,0,0,0,0,8,0,88,0,8,0,0,0,0,0,96,0,0,0,0,0,0,0,0,0,0,3
Union,5/4/20,0,0,0,0,0,0,0,0,0,61,0,285,0,31,0,0,0,30,0,346,0,0,0,0,0,0,0,1,0,0,15
VanBuren,5/4/20,0,0,0,0,0,0,0,0,0,28,0,256,0,24,0,2,0,2,0,284,0,0,0,0,0,0,0,0,0,0,4
Washington,5/4/20,0,0,0,0,0,0,0,0,0,91,0,1472,0,59,0,3,0,29,0,1563,0,0,0,0,0,0,0,1,1,0,46
White,5/4/20,0,0,0,0,0,0,0,0,0,35,0,451,0,28,0,1,0,6,0,486,0,0,0,0,0,0,0,0,0,0,29
Woodruff,5/4/20,0,0,0,0,0,0,0,0,0,1,0,12,0,1,0,0,0,0,0,13,0,0,0,0,0,0,0,0,0,0,0
Yell,5/4/20,0,0,0,0,0,0,0,0,0,6,0,185,0,3,0,1,0,2,0,191,0,0,0,0,0,0,0,1,0,1,2
Arkansas_all_counties,5/3/20,0,0,0,0,0,0,0,0,2990671,3431,0,49459,0,1999,0,76,0,1356,0,52890,0,0,0,0,0,0,0,59,NA,3,1308
Arkansas_county,5/3/20,0,0,0,0,0,0,0,0,0,3,0,78,0,2,0,0,0,1,0,81,0,0,0,0,0,0,0,1,NA,0,3
Ashley,5/3/20,0,0,0,0,0,0,0,0,0,16,0,329,0,10,0,0,0,6,0,345,0,0,0,0,0,0,0,0,NA,0,5
Baxter,5/3/20,0,0,0,0,0,0,0,0,0,5,0,319,0,5,0,0,0,0,0,324,0,0,0,0,0,0,0,0,NA,0,2
Benton,5/3/20,0,0,0,0,0,0,0,0,0,106,0,2937,0,78,0,0,0,28,0,3043,0,0,0,0,0,0,0,6,NA,0,66
Boone,5/3/20,0,0,0,0,0,0,0,0,0,4,0,160,0,4,0,0,0,0,0,164,0,0,0,0,0,0,0,0,NA,0,0
Bradley,5/3/20,0,0,0,0,0,0,0,0,0,11,0,222,0,5,0,1,0,5,0,233,0,0,0,0,0,0,0,0,NA,0,3
Calhoun,5/3/20,0,0,0,0,0,0,0,0,0,0,0,19,0,0,0,0,0,0,0,19,0,0,0,0,0,0,0,0,NA,0,0
Carroll,5/3/20,0,0,0,0,0,0,0,0,0,6,0,246,0,4,0,0,0,2,0,252,0,0,0,0,0,0,0,0,NA,0,10
Chicot,5/3/20,0,0,0,0,0,0,0,0,0,9,0,74,0,6,0,0,0,3,0,83,0,0,0,0,0,0,0,0,NA,0,15
Clark,5/3/20,0,0,0,0,0,0,0,0,0,31,0,189,0,27,0,0,0,4,0,220,0,0,0,0,0,0,0,0,NA,0,26
Clay,5/3/20,0,0,0,0,0,0,0,0,0,3,0,253,0,0,0,0,0,3,0,256,0,0,0,0,0,0,0,0,NA,0,2
Cleburne,5/3/20,0,0,0,0,0,0,0,0,0,73,0,170,0,67,0,4,0,2,0,243,0,0,0,0,0,0,0,0,NA,0,6
Cleveland,5/3/20,0,0,0,0,0,0,0,0,0,11,0,184,0,8,0,0,0,3,0,195,0,0,0,0,0,0,0,0,NA,0,4
Columbia,5/3/20,0,0,0,0,0,0,0,0,0,13,0,162,0,4,0,2,0,7,0,175,0,0,0,0,0,0,0,0,NA,0,2
Conway,5/3/20,0,0,0,0,0,0,0,0,0,13,0,295,0,5,0,1,0,7,0,308,0,0,0,0,0,0,0,0,NA,0,10
Craighead,5/3/20,0,0,0,0,0,0,0,0,0,81,0,1085,0,48,0,0,0,33,0,1166,0,0,0,0,0,0,0,0,NA,0,20
Crawford,5/3/20,0,0,0,0,0,0,0,0,0,5,0,202,0,4,0,0,0,1,0,207,0,0,0,0,0,0,0,0,NA,0,9
Crittenden,5/3/20,0,0,0,0,0,0,0,0,0,197,0,1115,0,144,0,5,0,48,0,1312,0,0,0,0,0,0,0,4,NA,0,31
Cross,5/3/20,0,0,0,0,0,0,0,0,0,24,0,208,0,11,0,0,0,13,0,232,0,0,0,0,0,0,0,3,NA,0,12
Dallas,5/3/20,0,0,0,0,0,0,0,0,0,1,0,53,0,1,0,0,0,0,0,54,0,0,0,0,0,0,0,0,NA,0,0
Desha,5/3/20,0,0,0,0,0,0,0,0,0,16,0,229,0,10,0,0,0,6,0,245,0,0,0,0,0,0,0,0,NA,0,72
Drew,5/3/20,0,0,0,0,0,0,0,0,0,16,0,243,0,8,0,1,0,7,0,259,0,0,0,0,0,0,0,1,NA,0,11
Faulkner,5/3/20,0,0,0,0,0,0,0,0,0,77,0,1542,0,57,0,2,0,18,0,1619,0,0,0,0,0,0,0,1,NA,0,49
Franklin,5/3/20,0,0,0,0,0,0,0,0,0,2,0,90,0,1,0,0,0,1,0,92,0,0,0,0,0,0,0,0,NA,0,1
Fulton,5/3/20,0,0,0,0,0,0,0,0,0,1,0,90,0,0,0,0,0,1,0,91,0,0,0,0,0,0,0,0,NA,0,2
Garland,5/3/20,0,0,0,0,0,0,0,0,0,118,0,2189,0,106,0,0,0,12,0,2307,0,0,0,0,0,0,0,1,NA,0,71
Grant,5/3/20,0,0,0,0,0,0,0,0,0,14,0,203,0,11,0,0,0,3,0,217,0,0,0,0,0,0,0,0,NA,0,3
Greene,5/3/20,0,0,0,0,0,0,0,0,0,19,0,726,0,11,0,0,0,8,0,745,0,0,0,0,0,0,0,3,NA,0,21
Hempstead,5/3/20,0,0,0,0,0,0,0,0,0,6,0,87,0,4,0,1,0,1,0,93,0,0,0,0,0,0,0,0,NA,0,3
HotSpring,5/3/20,0,0,0,0,0,0,0,0,0,20,0,344,0,11,0,0,0,9,0,364,0,0,0,0,0,0,0,1,NA,0,10
Howard,5/3/20,0,0,0,0,0,0,0,0,0,13,0,138,0,13,0,0,0,0,0,151,0,0,0,0,0,0,0,0,NA,0,0
Independence,5/3/20,0,0,0,0,0,0,0,0,0,10,0,193,0,9,0,0,0,1,0,203,0,0,0,0,0,0,0,0,NA,0,6
Izard,5/3/20,0,0,0,0,0,0,0,0,0,9,0,64,0,4,0,0,0,5,0,73,0,0,0,0,0,0,0,3,NA,0,3
Jackson,5/3/20,0,0,0,0,0,0,0,0,0,1,0,83,0,1,0,0,0,0,0,84,0,0,0,0,0,0,0,0,NA,0,1
Jefferson,5/3/20,0,0,0,0,0,0,0,0,0,184,0,1214,0,117,0,17,0,50,0,1398,0,0,0,0,0,0,0,6,NA,1,22
Johnson,5/3/20,0,0,0,0,0,0,0,0,0,31,0,178,0,25,0,0,0,6,0,209,0,0,0,0,0,0,0,0,NA,0,3
Lafayette,5/3/20,0,0,0,0,0,0,0,0,0,8,0,17,0,5,0,1,0,2,0,25,0,0,0,0,0,0,0,0,NA,0,0
Lawrence,5/3/20,0,0,0,0,0,0,0,0,0,66,0,279,0,27,0,4,0,35,0,345,0,0,0,0,0,0,0,6,NA,0,9
Lee,5/3/20,0,0,0,0,0,0,0,0,0,3,0,72,0,2,0,1,0,0,0,75,0,0,0,0,0,0,0,0,NA,0,6
Lincoln,5/3/20,0,0,0,0,0,0,0,0,0,822,0,712,0,252,0,4,0,566,0,1534,0,0,0,0,0,0,0,5,NA,1,12
LittleRiver,5/3/20,0,0,0,0,0,0,0,0,0,0,0,100,0,0,0,0,0,0,0,100,0,0,0,0,0,0,0,0,NA,0,0
Logan,5/3/20,0,0,0,0,0,0,0,0,0,3,0,97,0,2,0,1,0,0,0,100,0,0,0,0,0,0,0,0,NA,1,5
Lonoke,5/3/20,0,0,0,0,0,0,0,0,0,43,0,562,0,30,0,0,0,13,0,605,0,0,0,0,0,0,0,2,NA,0,30
Madison,5/3/20,0,0,0,0,0,0,0,0,0,1,0,117,0,0,0,0,0,1,0,118,0,0,0,0,0,0,0,0,NA,0,2
Marion,5/3/20,0,0,0,0,0,0,0,0,0,1,0,76,0,1,0,0,0,0,0,77,0,0,0,0,0,0,0,0,NA,0,0
Miller,5/3/20,0,0,0,0,0,0,0,0,0,35,0,306,0,27,0,1,0,7,0,341,0,0,0,0,0,0,0,1,NA,0,6
MissingCountyInfo,5/3/20,0,0,0,0,0,0,0,0,0,174,0,17418,0,57,0,NA,0,117,0,17592,0,0,0,0,0,0,0,-4,NA,NA,245
Mississippi,5/3/20,0,0,0,0,0,0,0,0,0,20,0,219,0,8,0,0,0,12,0,239,0,0,0,0,0,0,0,0,NA,0,18
Monroe,5/3/20,0,0,0,0,0,0,0,0,0,4,0,20,0,4,0,0,0,0,0,24,0,0,0,0,0,0,0,0,NA,0,0
Montgomery,5/3/20,0,0,0,0,0,0,0,0,0,1,0,80,0,0,0,0,0,1,0,81,0,0,0,0,0,0,0,0,NA,0,1
Nevada,5/3/20,0,0,0,0,0,0,0,0,0,1,0,46,0,1,0,0,0,0,0,47,0,0,0,0,0,0,0,0,NA,0,0
Newton,5/3/20,0,0,0,0,0,0,0,0,0,3,0,78,0,2,0,0,0,1,0,81,0,0,0,0,0,0,0,0,NA,0,0
Ouachita,5/3/20,0,0,0,0,0,0,0,0,0,7,0,280,0,5,0,0,0,2,0,287,0,0,0,0,0,0,0,0,NA,0,15
Perry,5/3/20,0,0,0,0,0,0,0,0,0,7,0,106,0,6,0,0,0,1,0,113,0,0,0,0,0,0,0,0,NA,0,3
Phillips,5/3/20,0,0,0,0,0,0,0,0,0,6,0,163,0,3,0,1,0,2,0,169,0,0,0,0,0,0,0,1,NA,0,34
Pike,5/3/20,0,0,0,0,0,0,0,0,0,3,0,306,0,2,0,0,0,1,0,309,0,0,0,0,0,0,0,0,NA,0,11
Poinsett,5/3/20,0,0,0,0,0,0,0,0,0,23,0,128,0,11,0,2,0,10,0,151,0,0,0,0,0,0,0,0,NA,0,1
Polk,5/3/20,0,0,0,0,0,0,0,0,0,8,0,273,0,7,0,0,0,1,0,281,0,0,0,0,0,0,0,1,NA,0,8
Pope,5/3/20,0,0,0,0,0,0,0,0,0,44,0,1540,0,35,0,0,0,9,0,1584,0,0,0,0,0,0,0,0,NA,0,37
Prairie,5/3/20,0,0,0,0,0,0,0,0,0,2,0,23,0,1,0,0,0,1,0,25,0,0,0,0,0,0,0,0,NA,0,0
Pulaski,5/3/20,0,0,0,0,0,0,0,0,0,550,0,4928,0,372,0,19,0,159,0,5478,0,0,0,0,0,0,0,11,NA,0,137
Randolph,5/3/20,0,0,0,0,0,0,0,0,0,18,0,544,0,14,0,0,0,4,0,562,0,0,0,0,0,0,0,0,NA,0,9
Saline,5/3/20,0,0,0,0,0,0,0,0,0,68,0,1264,0,49,0,1,0,18,0,1332,0,0,0,0,0,0,0,1,NA,0,30
Scott,5/3/20,0,0,0,0,0,0,0,0,0,1,0,5,0,1,0,0,0,0,0,6,0,0,0,0,0,0,0,0,NA,0,0
Searcy,5/3/20,0,0,0,0,0,0,0,0,0,6,0,128,0,6,0,0,0,0,0,134,0,0,0,0,0,0,0,0,NA,0,4
Sebastian,5/3/20,0,0,0,0,0,0,0,0,0,13,0,248,0,13,0,0,0,0,0,261,0,0,0,0,0,0,0,0,NA,0,10
Sevier,5/3/20,0,0,0,0,0,0,0,0,0,12,0,219,0,9,0,1,0,2,0,231,0,0,0,0,0,0,0,0,NA,0,0
Sharp,5/3/20,0,0,0,0,0,0,0,0,0,9,0,64,0,3,0,0,0,6,0,73,0,0,0,0,0,0,0,0,NA,0,0
St.Francis,5/3/20,0,0,0,0,0,0,0,0,0,93,0,475,0,70,0,0,0,23,0,568,0,0,0,0,0,0,0,6,NA,0,59
Stone,5/3/20,0,0,0,0,0,0,0,0,0,8,0,85,0,8,0,0,0,0,0,93,0,0,0,0,0,0,0,0,NA,0,0
Union,5/3/20,0,0,0,0,0,0,0,0,0,60,0,271,0,31,0,0,0,29,0,331,0,0,0,0,0,0,0,6,NA,0,9
VanBuren,5/3/20,0,0,0,0,0,0,0,0,0,28,0,252,0,24,0,2,0,2,0,280,0,0,0,0,0,0,0,0,NA,0,2
Washington,5/3/20,0,0,0,0,0,0,0,0,0,90,0,1427,0,58,0,3,0,29,0,1517,0,0,0,0,0,0,0,3,NA,0,80
White,5/3/20,0,0,0,0,0,0,0,0,0,35,0,422,0,28,0,1,0,6,0,457,0,0,0,0,0,0,0,1,NA,0,7
Woodruff,5/3/20,0,0,0,0,0,0,0,0,0,1,0,12,0,1,0,0,0,0,0,13,0,0,0,0,0,0,0,0,NA,0,0
Yell,5/3/20,0,0,0,0,0,0,0,0,0,5,0,184,0,3,0,0,0,2,0,189,0,0,0,0,0,0,0,1,NA,0,14
Arkansas_all_counties,5/2/20,0,0,0,0,0,0,0,0,2990671,3372,0,48210,0,1987,0,73,0,1312,0,51582,0,0,0,0,0,0,0,51,NA,9,1906
Arkansas_county,5/2/20,0,0,0,0,0,0,0,0,0,2,0,76,0,2,0,0,0,0,0,78,0,0,0,0,0,0,0,0,NA,0,2
Ashley,5/2/20,0,0,0,0,0,0,0,0,0,16,0,324,0,10,0,0,0,6,0,340,0,0,0,0,0,0,0,0,NA,0,18
Baxter,5/2/20,0,0,0,0,0,0,0,0,0,5,0,317,0,5,0,0,0,0,0,322,0,0,0,0,0,0,0,0,NA,0,54
Benton,5/2/20,0,0,0,0,0,0,0,0,0,112,0,2865,0,78,0,0,0,34,0,2977,0,0,0,0,0,0,0,5,NA,0,217
Boone,5/2/20,0,0,0,0,0,0,0,0,0,4,0,160,0,4,0,0,0,0,0,164,0,0,0,0,0,0,0,0,NA,0,11
Bradley,5/2/20,0,0,0,0,0,0,0,0,0,11,0,219,0,5,0,1,0,5,0,230,0,0,0,0,0,0,0,0,NA,0,1
Calhoun,5/2/20,0,0,0,0,0,0,0,0,0,0,0,19,0,0,0,0,0,0,0,19,0,0,0,0,0,0,0,0,NA,0,0
Carroll,5/2/20,0,0,0,0,0,0,0,0,0,6,0,236,0,3,0,0,0,3,0,242,0,0,0,0,0,0,0,1,NA,0,14
Chicot,5/2/20,0,0,0,0,0,0,0,0,0,9,0,59,0,6,0,0,0,3,0,68,0,0,0,0,0,0,0,0,NA,0,1
Clark,5/2/20,0,0,0,0,0,0,0,0,0,31,0,163,0,27,0,0,0,4,0,194,0,0,0,0,0,0,0,1,NA,0,8
Clay,5/2/20,0,0,0,0,0,0,0,0,0,3,0,251,0,0,0,0,0,3,0,254,0,0,0,0,0,0,0,0,NA,0,6
Cleburne,5/2/20,0,0,0,0,0,0,0,0,0,73,0,164,0,67,0,4,0,2,0,237,0,0,0,0,0,0,0,0,NA,0,2
Cleveland,5/2/20,0,0,0,0,0,0,0,0,0,11,0,180,0,8,0,0,0,3,0,191,0,0,0,0,0,0,0,0,NA,0,8
Columbia,5/2/20,0,0,0,0,0,0,0,0,0,13,0,160,0,4,0,2,0,7,0,173,0,0,0,0,0,0,0,0,NA,2,4
Conway,5/2/20,0,0,0,0,0,0,0,0,0,13,0,285,0,5,0,1,0,7,0,298,0,0,0,0,0,0,0,0,NA,0,7
Craighead,5/2/20,0,0,0,0,0,0,0,0,0,81,0,1065,0,48,0,0,0,33,0,1146,0,0,0,0,0,0,0,7,NA,0,66
Crawford,5/2/20,0,0,0,0,0,0,0,0,0,5,0,193,0,4,0,0,0,1,0,198,0,0,0,0,0,0,0,1,NA,0,6
Crittenden,5/2/20,0,0,0,0,0,0,0,0,0,193,0,1088,0,144,0,5,0,44,0,1281,0,0,0,0,0,0,0,5,NA,0,42
Cross,5/2/20,0,0,0,0,0,0,0,0,0,21,0,199,0,12,0,0,0,9,0,220,0,0,0,0,0,0,0,2,NA,0,5
Dallas,5/2/20,0,0,0,0,0,0,0,0,0,1,0,53,0,1,0,0,0,0,0,54,0,0,0,0,0,0,0,0,NA,0,0
Desha,5/2/20,0,0,0,0,0,0,0,0,0,16,0,157,0,9,0,0,0,7,0,173,0,0,0,0,0,0,0,0,NA,0,3
Drew,5/2/20,0,0,0,0,0,0,0,0,0,15,0,233,0,8,0,1,0,6,0,248,0,0,0,0,0,0,0,-1,NA,0,11
Faulkner,5/2/20,0,0,0,0,0,0,0,0,0,76,0,1494,0,57,0,2,0,17,0,1570,0,0,0,0,0,0,0,0,NA,0,42
Franklin,5/2/20,0,0,0,0,0,0,0,0,0,2,0,89,0,1,0,0,0,1,0,91,0,0,0,0,0,0,0,0,NA,0,6
Fulton,5/2/20,0,0,0,0,0,0,0,0,0,1,0,88,0,0,0,0,0,1,0,89,0,0,0,0,0,0,0,0,NA,0,2
Garland,5/2/20,0,0,0,0,0,0,0,0,0,117,0,2119,0,105,0,0,0,12,0,2236,0,0,0,0,0,0,0,0,NA,0,65
Grant,5/2/20,0,0,0,0,0,0,0,0,0,14,0,200,0,11,0,0,0,3,0,214,0,0,0,0,0,0,0,0,NA,0,5
Greene,5/2/20,0,0,0,0,0,0,0,0,0,16,0,708,0,10,0,0,0,6,0,724,0,0,0,0,0,0,0,0,NA,0,32
Hempstead,5/2/20,0,0,0,0,0,0,0,0,0,6,0,84,0,4,0,1,0,1,0,90,0,0,0,0,0,0,0,1,NA,0,2
HotSpring,5/2/20,0,0,0,0,0,0,0,0,0,19,0,335,0,10,0,0,0,9,0,354,0,0,0,0,0,0,0,0,NA,0,14
Howard,5/2/20,0,0,0,0,0,0,0,0,0,13,0,138,0,13,0,0,0,0,0,151,0,0,0,0,0,0,0,0,NA,0,0
Independence,5/2/20,0,0,0,0,0,0,0,0,0,10,0,187,0,9,0,0,0,1,0,197,0,0,0,0,0,0,0,0,NA,0,7
Izard,5/2/20,0,0,0,0,0,0,0,0,0,6,0,64,0,4,0,0,0,2,0,70,0,0,0,0,0,0,0,0,NA,0,6
Jackson,5/2/20,0,0,0,0,0,0,0,0,0,1,0,82,0,1,0,0,0,0,0,83,0,0,0,0,0,0,0,0,NA,0,4
Jefferson,5/2/20,0,0,0,0,0,0,0,0,0,178,0,1198,0,116,0,16,0,46,0,1376,0,0,0,0,0,0,0,1,NA,1,23
Johnson,5/2/20,0,0,0,0,0,0,0,0,0,31,0,175,0,25,0,0,0,6,0,206,0,0,0,0,0,0,0,0,NA,0,8
Lafayette,5/2/20,0,0,0,0,0,0,0,0,0,8,0,17,0,5,0,1,0,2,0,25,0,0,0,0,0,0,0,0,NA,0,1
Lawrence,5/2/20,0,0,0,0,0,0,0,0,0,60,0,276,0,27,0,4,0,29,0,336,0,0,0,0,0,0,0,1,NA,2,15
Lee,5/2/20,0,0,0,0,0,0,0,0,0,3,0,66,0,2,0,1,0,0,0,69,0,0,0,0,0,0,0,0,NA,0,3
Lincoln,5/2/20,0,0,0,0,0,0,0,0,0,817,0,705,0,252,0,2,0,563,0,1522,0,0,0,0,0,0,0,1,NA,3,6
LittleRiver,5/2/20,0,0,0,0,0,0,0,0,0,0,0,100,0,0,0,0,0,0,0,100,0,0,0,0,0,0,0,0,NA,0,4
Logan,5/2/20,0,0,0,0,0,0,0,0,0,3,0,92,0,2,0,0,0,1,0,95,0,0,0,0,0,0,0,0,NA,0,5
Lonoke,5/2/20,0,0,0,0,0,0,0,0,0,41,0,534,0,30,0,0,0,11,0,575,0,0,0,0,0,0,0,0,NA,0,12
Madison,5/2/20,0,0,0,0,0,0,0,0,0,1,0,115,0,0,0,0,0,1,0,116,0,0,0,0,0,0,0,0,NA,0,2
Marion,5/2/20,0,0,0,0,0,0,0,0,0,1,0,76,0,1,0,0,0,0,0,77,0,0,0,0,0,0,0,0,NA,0,8
Miller,5/2/20,0,0,0,0,0,0,0,0,0,34,0,301,0,27,0,1,0,6,0,335,0,0,0,0,0,0,0,0,NA,0,49
MissingCountyInfo,5/2/20,0,0,0,0,0,0,0,0,0,178,0,17169,0,54,0,NA,0,124,0,17347,0,0,0,0,0,0,0,5,NA,NA,617
Mississippi,5/2/20,0,0,0,0,0,0,0,0,0,20,0,201,0,8,0,0,0,12,0,221,0,0,0,0,0,0,0,0,NA,0,19
Monroe,5/2/20,0,0,0,0,0,0,0,0,0,4,0,20,0,4,0,0,0,0,0,24,0,0,0,0,0,0,0,0,NA,0,0
Montgomery,5/2/20,0,0,0,0,0,0,0,0,0,1,0,79,0,0,0,0,0,1,0,80,0,0,0,0,0,0,0,0,NA,0,3
Nevada,5/2/20,0,0,0,0,0,0,0,0,0,1,0,46,0,1,0,0,0,0,0,47,0,0,0,0,0,0,0,0,NA,0,1
Newton,5/2/20,0,0,0,0,0,0,0,0,0,3,0,78,0,2,0,0,0,1,0,81,0,0,0,0,0,0,0,0,NA,0,1
Ouachita,5/2/20,0,0,0,0,0,0,0,0,0,7,0,265,0,5,0,0,0,2,0,272,0,0,0,0,0,0,0,0,NA,0,3
Perry,5/2/20,0,0,0,0,0,0,0,0,0,7,0,103,0,4,0,0,0,3,0,110,0,0,0,0,0,0,0,0,NA,0,3
Phillips,5/2/20,0,0,0,0,0,0,0,0,0,5,0,130,0,3,0,1,0,1,0,135,0,0,0,0,0,0,0,0,NA,0,14
Pike,5/2/20,0,0,0,0,0,0,0,0,0,3,0,295,0,2,0,0,0,1,0,298,0,0,0,0,0,0,0,0,NA,0,13
Poinsett,5/2/20,0,0,0,0,0,0,0,0,0,23,0,127,0,11,0,2,0,10,0,150,0,0,0,0,0,0,0,0,NA,0,4
Polk,5/2/20,0,0,0,0,0,0,0,0,0,7,0,266,0,7,0,0,0,0,0,273,0,0,0,0,0,0,0,-1,NA,0,6
Pope,5/2/20,0,0,0,0,0,0,0,0,0,44,0,1503,0,35,0,0,0,9,0,1547,0,0,0,0,0,0,0,1,NA,0,41
Prairie,5/2/20,0,0,0,0,0,0,0,0,0,2,0,23,0,1,0,0,0,1,0,25,0,0,0,0,0,0,0,0,NA,0,0
Pulaski,5/2/20,0,0,0,0,0,0,0,0,0,539,0,4802,0,373,0,19,0,147,0,5341,0,0,0,0,0,0,0,14,NA,1,209
Randolph,5/2/20,0,0,0,0,0,0,0,0,0,18,0,535,0,14,0,0,0,4,0,553,0,0,0,0,0,0,0,1,NA,0,31
Saline,5/2/20,0,0,0,0,0,0,0,0,0,67,0,1235,0,48,0,1,0,18,0,1302,0,0,0,0,0,0,0,0,NA,0,44
Scott,5/2/20,0,0,0,0,0,0,0,0,0,1,0,5,0,1,0,0,0,0,0,6,0,0,0,0,0,0,0,0,NA,0,0
Searcy,5/2/20,0,0,0,0,0,0,0,0,0,6,0,124,0,6,0,0,0,0,0,130,0,0,0,0,0,0,0,0,NA,0,3
Sebastian,5/2/20,0,0,0,0,0,0,0,0,0,13,0,238,0,13,0,0,0,0,0,251,0,0,0,0,0,0,0,0,NA,0,14
Sevier,5/2/20,0,0,0,0,0,0,0,0,0,12,0,219,0,9,0,1,0,2,0,231,0,0,0,0,0,0,0,0,NA,0,2
Sharp,5/2/20,0,0,0,0,0,0,0,0,0,9,0,64,0,3,0,0,0,6,0,73,0,0,0,0,0,0,0,0,NA,0,5
St.Francis,5/2/20,0,0,0,0,0,0,0,0,0,87,0,422,0,69,0,0,0,18,0,509,0,0,0,0,0,0,0,3,NA,0,9
Stone,5/2/20,0,0,0,0,0,0,0,0,0,8,0,85,0,7,0,0,0,1,0,93,0,0,0,0,0,0,0,1,NA,0,1
Union,5/2/20,0,0,0,0,0,0,0,0,0,54,0,268,0,30,0,0,0,24,0,322,0,0,0,0,0,0,0,0,NA,0,5
VanBuren,5/2/20,0,0,0,0,0,0,0,0,0,28,0,250,0,24,0,2,0,2,0,278,0,0,0,0,0,0,0,0,NA,0,3
Washington,5/2/20,0,0,0,0,0,0,0,0,0,87,0,1350,0,58,0,3,0,26,0,1437,0,0,0,0,0,0,0,1,NA,0,27
White,5/2/20,0,0,0,0,0,0,0,0,0,34,0,416,0,28,0,1,0,5,0,450,0,0,0,0,0,0,0,0,NA,0,14
Woodruff,5/2/20,0,0,0,0,0,0,0,0,0,1,0,12,0,1,0,0,0,0,0,13,0,0,0,0,0,0,0,0,NA,0,0
Yell,5/2/20,0,0,0,0,0,0,0,0,0,4,0,171,0,3,0,0,0,1,0,175,0,0,0,0,0,0,0,1,NA,0,7
Arkansas_all_counties,5/1/20,0,0,0,0,0,0,0,0,2990671,3321,0,46355,0,1973,0,64,0,1284,0,49676,0,0,0,0,0,0,0,66,NA,4,1297
Arkansas_county,5/1/20,0,0,0,0,0,0,0,0,0,2,0,74,0,2,0,0,0,0,0,76,0,0,0,0,0,0,0,0,NA,0,4
Ashley,5/1/20,0,0,0,0,0,0,0,0,0,16,0,306,0,10,0,0,0,6,0,322,0,0,0,0,0,0,0,1,NA,0,9
Baxter,5/1/20,0,0,0,0,0,0,0,0,0,5,0,263,0,5,0,0,0,0,0,268,0,0,0,0,0,0,0,0,NA,0,3
Benton,5/1/20,0,0,0,0,0,0,0,0,0,107,0,2653,0,77,0,0,0,30,0,2760,0,0,0,0,0,0,0,6,NA,0,156
Boone,5/1/20,0,0,0,0,0,0,0,0,0,4,0,149,0,4,0,0,0,0,0,153,0,0,0,0,0,0,0,-1,NA,0,4
Bradley,5/1/20,0,0,0,0,0,0,0,0,0,11,0,218,0,5,0,1,0,5,0,229,0,0,0,0,0,0,0,-1,NA,0,5
Calhoun,5/1/20,0,0,0,0,0,0,0,0,0,0,0,19,0,0,0,0,0,0,0,19,0,0,0,0,0,0,0,0,NA,0,0
Carroll,5/1/20,0,0,0,0,0,0,0,0,0,5,0,223,0,3,0,0,0,2,0,228,0,0,0,0,0,0,0,0,NA,0,13
Chicot,5/1/20,0,0,0,0,0,0,0,0,0,9,0,58,0,6,0,0,0,3,0,67,0,0,0,0,0,0,0,0,NA,0,5
Clark,5/1/20,0,0,0,0,0,0,0,0,0,30,0,156,0,27,0,0,0,3,0,186,0,0,0,0,0,0,0,0,NA,0,-1
Clay,5/1/20,0,0,0,0,0,0,0,0,0,3,0,245,0,0,0,0,0,3,0,248,0,0,0,0,0,0,0,0,NA,0,10
Cleburne,5/1/20,0,0,0,0,0,0,0,0,0,73,0,162,0,67,0,4,0,2,0,235,0,0,0,0,0,0,0,0,NA,0,4
Cleveland,5/1/20,0,0,0,0,0,0,0,0,0,11,0,172,0,7,0,0,0,4,0,183,0,0,0,0,0,0,0,0,NA,0,5
Columbia,5/1/20,0,0,0,0,0,0,0,0,0,13,0,156,0,3,0,0,0,10,0,169,0,0,0,0,0,0,0,1,NA,0,4
Conway,5/1/20,0,0,0,0,0,0,0,0,0,13,0,278,0,5,0,1,0,7,0,291,0,0,0,0,0,0,0,0,NA,0,11
Craighead,5/1/20,0,0,0,0,0,0,0,0,0,74,0,1006,0,46,0,0,0,28,0,1080,0,0,0,0,0,0,0,0,NA,0,53
Crawford,5/1/20,0,0,0,0,0,0,0,0,0,4,0,188,0,4,0,0,0,0,0,192,0,0,0,0,0,0,0,0,NA,0,12
Crittenden,5/1/20,0,0,0,0,0,0,0,0,0,188,0,1051,0,142,0,5,0,41,0,1239,0,0,0,0,0,0,0,4,NA,0,34
Cross,5/1/20,0,0,0,0,0,0,0,0,0,19,0,196,0,11,0,0,0,8,0,215,0,0,0,0,0,0,0,2,NA,0,10
Dallas,5/1/20,0,0,0,0,0,0,0,0,0,1,0,53,0,1,0,0,0,0,0,54,0,0,0,0,0,0,0,0,NA,0,-1
Desha,5/1/20,0,0,0,0,0,0,0,0,0,16,0,154,0,9,0,0,0,7,0,170,0,0,0,0,0,0,0,0,NA,0,11
Drew,5/1/20,0,0,0,0,0,0,0,0,0,16,0,221,0,8,0,1,0,7,0,237,0,0,0,0,0,0,0,0,NA,0,7
Faulkner,5/1/20,0,0,0,0,0,0,0,0,0,76,0,1452,0,57,0,2,0,17,0,1528,0,0,0,0,0,0,0,0,NA,0,57
Franklin,5/1/20,0,0,0,0,0,0,0,0,0,2,0,83,0,1,0,0,0,1,0,85,0,0,0,0,0,0,0,0,NA,0,2
Fulton,5/1/20,0,0,0,0,0,0,0,0,0,1,0,86,0,0,0,0,0,1,0,87,0,0,0,0,0,0,0,0,NA,0,10
Garland,5/1/20,0,0,0,0,0,0,0,0,0,117,0,2054,0,102,0,0,0,15,0,2171,0,0,0,0,0,0,0,1,NA,0,-1
Grant,5/1/20,0,0,0,0,0,0,0,0,0,14,0,195,0,11,0,0,0,3,0,209,0,0,0,0,0,0,0,0,NA,0,8
Greene,5/1/20,0,0,0,0,0,0,0,0,0,16,0,676,0,10,0,0,0,6,0,692,0,0,0,0,0,0,0,0,NA,0,11
Hempstead,5/1/20,0,0,0,0,0,0,0,0,0,5,0,83,0,4,0,1,0,0,0,88,0,0,0,0,0,0,0,-1,NA,0,-5
HotSpring,5/1/20,0,0,0,0,0,0,0,0,0,19,0,321,0,9,0,0,0,10,0,340,0,0,0,0,0,0,0,1,NA,0,22
Howard,5/1/20,0,0,0,0,0,0,0,0,0,13,0,138,0,13,0,0,0,0,0,151,0,0,0,0,0,0,0,0,NA,0,9
Independence,5/1/20,0,0,0,0,0,0,0,0,0,10,0,180,0,9,0,0,0,1,0,190,0,0,0,0,0,0,0,1,NA,0,11
Izard,5/1/20,0,0,0,0,0,0,0,0,0,6,0,58,0,4,0,0,0,2,0,64,0,0,0,0,0,0,0,1,NA,0,0
Jackson,5/1/20,0,0,0,0,0,0,0,0,0,1,0,78,0,1,0,0,0,0,0,79,0,0,0,0,0,0,0,0,NA,0,0
Jefferson,5/1/20,0,0,0,0,0,0,0,0,0,177,0,1176,0,116,0,15,0,46,0,1353,0,0,0,0,0,0,0,8,NA,1,23
Johnson,5/1/20,0,0,0,0,0,0,0,0,0,31,0,167,0,25,0,0,0,6,0,198,0,0,0,0,0,0,0,1,NA,0,8
Lafayette,5/1/20,0,0,0,0,0,0,0,0,0,8,0,16,0,5,0,1,0,2,0,24,0,0,0,0,0,0,0,1,NA,0,-1
Lawrence,5/1/20,0,0,0,0,0,0,0,0,0,59,0,262,0,27,0,2,0,30,0,321,0,0,0,0,0,0,0,10,NA,1,12
Lee,5/1/20,0,0,0,0,0,0,0,0,0,3,0,63,0,2,0,1,0,0,0,66,0,0,0,0,0,0,0,0,NA,0,0
Lincoln,5/1/20,0,0,0,0,0,0,0,0,0,816,0,700,0,253,0,0,0,563,0,1516,0,0,0,0,0,0,0,2,NA,0,3
LittleRiver,5/1/20,0,0,0,0,0,0,0,0,0,0,0,96,0,0,0,0,0,0,0,96,0,0,0,0,0,0,0,0,NA,0,-7
Logan,5/1/20,0,0,0,0,0,0,0,0,0,3,0,87,0,2,0,0,0,1,0,90,0,0,0,0,0,0,0,0,NA,0,7
Lonoke,5/1/20,0,0,0,0,0,0,0,0,0,41,0,522,0,29,0,0,0,12,0,563,0,0,0,0,0,0,0,0,NA,0,-4
Madison,5/1/20,0,0,0,0,0,0,0,0,0,1,0,113,0,0,0,0,0,1,0,114,0,0,0,0,0,0,0,0,NA,0,4
Marion,5/1/20,0,0,0,0,0,0,0,0,0,1,0,68,0,1,0,0,0,0,0,69,0,0,0,0,0,0,0,0,NA,0,4
Miller,5/1/20,0,0,0,0,0,0,0,0,0,34,0,252,0,27,0,1,0,6,0,286,0,0,0,0,0,0,0,0,NA,0,2
MissingCountyInfo,5/1/20,0,0,0,0,0,0,0,0,0,173,0,16557,0,63,0,NA,0,110,0,16730,0,0,0,0,0,0,0,-2,NA,NA,325
Mississippi,5/1/20,0,0,0,0,0,0,0,0,0,20,0,182,0,8,0,0,0,12,0,202,0,0,0,0,0,0,0,4,NA,0,-9
Monroe,5/1/20,0,0,0,0,0,0,0,0,0,4,0,20,0,4,0,0,0,0,0,24,0,0,0,0,0,0,0,0,NA,0,0
Montgomery,5/1/20,0,0,0,0,0,0,0,0,0,1,0,76,0,0,0,0,0,1,0,77,0,0,0,0,0,0,0,0,NA,0,3
Nevada,5/1/20,0,0,0,0,0,0,0,0,0,1,0,45,0,1,0,0,0,0,0,46,0,0,0,0,0,0,0,0,NA,0,0
Newton,5/1/20,0,0,0,0,0,0,0,0,0,3,0,77,0,2,0,0,0,1,0,80,0,0,0,0,0,0,0,0,NA,0,1
Ouachita,5/1/20,0,0,0,0,0,0,0,0,0,7,0,262,0,5,0,0,0,2,0,269,0,0,0,0,0,0,0,1,NA,0,1
Perry,5/1/20,0,0,0,0,0,0,0,0,0,7,0,100,0,4,0,0,0,3,0,107,0,0,0,0,0,0,0,0,NA,0,3
Phillips,5/1/20,0,0,0,0,0,0,0,0,0,5,0,116,0,3,0,1,0,1,0,121,0,0,0,0,0,0,0,0,NA,0,6
Pike,5/1/20,0,0,0,0,0,0,0,0,0,3,0,282,0,2,0,0,0,1,0,285,0,0,0,0,0,0,0,0,NA,0,8
Poinsett,5/1/20,0,0,0,0,0,0,0,0,0,23,0,123,0,10,0,2,0,11,0,146,0,0,0,0,0,0,0,2,NA,1,0
Polk,5/1/20,0,0,0,0,0,0,0,0,0,8,0,259,0,7,0,0,0,1,0,267,0,0,0,0,0,0,0,0,NA,0,5
Pope,5/1/20,0,0,0,0,0,0,0,0,0,43,0,1463,0,35,0,0,0,8,0,1506,0,0,0,0,0,0,0,0,NA,0,24
Prairie,5/1/20,0,0,0,0,0,0,0,0,0,2,0,23,0,1,0,0,0,1,0,25,0,0,0,0,0,0,0,0,NA,0,0
Pulaski,5/1/20,0,0,0,0,0,0,0,0,0,525,0,4607,0,369,0,18,0,138,0,5132,0,0,0,0,0,0,0,10,NA,1,257
Randolph,5/1/20,0,0,0,0,0,0,0,0,0,17,0,505,0,14,0,0,0,3,0,522,0,0,0,0,0,0,0,0,NA,0,3
Saline,5/1/20,0,0,0,0,0,0,0,0,0,67,0,1191,0,46,0,1,0,20,0,1258,0,0,0,0,0,0,0,0,NA,0,70
Scott,5/1/20,0,0,0,0,0,0,0,0,0,1,0,5,0,1,0,0,0,0,0,6,0,0,0,0,0,0,0,0,NA,0,0
Searcy,5/1/20,0,0,0,0,0,0,0,0,0,6,0,121,0,6,0,0,0,0,0,127,0,0,0,0,0,0,0,0,NA,0,7
Sebastian,5/1/20,0,0,0,0,0,0,0,0,0,13,0,224,0,12,0,0,0,1,0,237,0,0,0,0,0,0,0,0,NA,0,17
Sevier,5/1/20,0,0,0,0,0,0,0,0,0,12,0,217,0,9,0,1,0,2,0,229,0,0,0,0,0,0,0,1,NA,0,-9
Sharp,5/1/20,0,0,0,0,0,0,0,0,0,9,0,59,0,3,0,0,0,6,0,68,0,0,0,0,0,0,0,0,NA,0,13
St.Francis,5/1/20,0,0,0,0,0,0,0,0,0,84,0,416,0,67,0,0,0,17,0,500,0,0,0,0,0,0,0,1,NA,0,5
Stone,5/1/20,0,0,0,0,0,0,0,0,0,7,0,85,0,7,0,0,0,0,0,92,0,0,0,0,0,0,0,0,NA,0,-5
Union,5/1/20,0,0,0,0,0,0,0,0,0,54,0,263,0,30,0,0,0,24,0,317,0,0,0,0,0,0,0,10,NA,0,-5
VanBuren,5/1/20,0,0,0,0,0,0,0,0,0,28,0,247,0,24,0,2,0,2,0,275,0,0,0,0,0,0,0,0,NA,0,5
Washington,5/1/20,0,0,0,0,0,0,0,0,0,86,0,1324,0,58,0,3,0,25,0,1410,0,0,0,0,0,0,0,0,NA,0,54
White,5/1/20,0,0,0,0,0,0,0,0,0,34,0,402,0,28,0,1,0,5,0,436,0,0,0,0,0,0,0,0,NA,0,-21
Woodruff,5/1/20,0,0,0,0,0,0,0,0,0,1,0,12,0,1,0,0,0,0,0,13,0,0,0,0,0,0,0,0,NA,0,0
Yell,5/1/20,0,0,0,0,0,0,0,0,0,3,0,165,0,3,0,0,0,0,0,168,0,0,0,0,0,0,0,0,NA,0,6
Arkansas_all_counties,4/30/20,0,0,0,0,0,0,0,0,2990671,3255,0,45124,0,1305,0,60,0,1890,0,48379,0,0,0,0,0,0,0,63,NA,1,2636
Arkansas_county,4/30/20,0,0,0,0,0,0,0,0,0,2,0,70,0,2,0,0,0,0,0,72,0,0,0,0,0,0,0,0,NA,0,3
Ashley,4/30/20,0,0,0,0,0,0,0,0,0,15,0,298,0,8,0,0,0,7,0,313,0,0,0,0,0,0,0,2,NA,0,22
Baxter,4/30/20,0,0,0,0,0,0,0,0,0,5,0,260,0,5,0,0,0,0,0,265,0,0,0,0,0,0,0,0,NA,0,16
Benton,4/30/20,0,0,0,0,0,0,0,0,0,101,0,2503,0,65,0,0,0,36,0,2604,0,0,0,0,0,0,0,0,NA,0,191
Boone,4/30/20,0,0,0,0,0,0,0,0,0,5,0,144,0,3,0,0,0,2,0,149,0,0,0,0,0,0,0,0,NA,0,20
Bradley,4/30/20,0,0,0,0,0,0,0,0,0,12,0,212,0,5,0,1,0,6,0,224,0,0,0,0,0,0,0,1,NA,0,70
Calhoun,4/30/20,0,0,0,0,0,0,0,0,0,0,0,19,0,0,0,0,0,0,0,19,0,0,0,0,0,0,0,0,NA,0,1
Carroll,4/30/20,0,0,0,0,0,0,0,0,0,5,0,210,0,2,0,0,0,3,0,215,0,0,0,0,0,0,0,0,NA,0,11
Chicot,4/30/20,0,0,0,0,0,0,0,0,0,9,0,53,0,3,0,0,0,6,0,62,0,0,0,0,0,0,0,0,NA,0,1
Clark,4/30/20,0,0,0,0,0,0,0,0,0,30,0,157,0,24,0,0,0,6,0,187,0,0,0,0,0,0,0,3,NA,0,11
Clay,4/30/20,0,0,0,0,0,0,0,0,0,3,0,235,0,0,0,0,0,3,0,238,0,0,0,0,0,0,0,0,NA,0,12
Cleburne,4/30/20,0,0,0,0,0,0,0,0,0,73,0,158,0,61,0,4,0,8,0,231,0,0,0,0,0,0,0,1,NA,0,2
Cleveland,4/30/20,0,0,0,0,0,0,0,0,0,11,0,167,0,7,0,0,0,4,0,178,0,0,0,0,0,0,0,1,NA,0,19
Columbia,4/30/20,0,0,0,0,0,0,0,0,0,12,0,153,0,3,0,0,0,9,0,165,0,0,0,0,0,0,0,0,NA,0,1
Conway,4/30/20,0,0,0,0,0,0,0,0,0,13,0,267,0,3,0,1,0,9,0,280,0,0,0,0,0,0,0,0,NA,0,9
Craighead,4/30/20,0,0,0,0,0,0,0,0,0,74,0,953,0,42,0,0,0,32,0,1027,0,0,0,0,0,0,0,1,NA,0,103
Crawford,4/30/20,0,0,0,0,0,0,0,0,0,4,0,176,0,4,0,0,0,0,0,180,0,0,0,0,0,0,0,0,NA,0,5
Crittenden,4/30/20,0,0,0,0,0,0,0,0,0,184,0,1021,0,112,0,5,0,67,0,1205,0,0,0,0,0,0,0,4,NA,0,29
Cross,4/30/20,0,0,0,0,0,0,0,0,0,17,0,188,0,5,0,0,0,12,0,205,0,0,0,0,0,0,0,1,NA,0,8
Dallas,4/30/20,0,0,0,0,0,0,0,0,0,1,0,54,0,1,0,0,0,0,0,55,0,0,0,0,0,0,0,0,NA,0,4
Desha,4/30/20,0,0,0,0,0,0,0,0,0,16,0,143,0,5,0,0,0,11,0,159,0,0,0,0,0,0,0,0,NA,0,9
Drew,4/30/20,0,0,0,0,0,0,0,0,0,16,0,214,0,7,0,1,0,8,0,230,0,0,0,0,0,0,0,2,NA,0,19
Faulkner,4/30/20,0,0,0,0,0,0,0,0,0,76,0,1395,0,53,0,2,0,21,0,1471,0,0,0,0,0,0,0,0,NA,0,25
Franklin,4/30/20,0,0,0,0,0,0,0,0,0,2,0,81,0,1,0,0,0,1,0,83,0,0,0,0,0,0,0,0,NA,0,9
Fulton,4/30/20,0,0,0,0,0,0,0,0,0,1,0,76,0,0,0,0,0,1,0,77,0,0,0,0,0,0,0,0,NA,0,7
Garland,4/30/20,0,0,0,0,0,0,0,0,0,116,0,2056,0,82,0,0,0,34,0,2172,0,0,0,0,0,0,0,1,NA,0,76
Grant,4/30/20,0,0,0,0,0,0,0,0,0,14,0,187,0,9,0,0,0,5,0,201,0,0,0,0,0,0,0,1,NA,0,16
Greene,4/30/20,0,0,0,0,0,0,0,0,0,16,0,665,0,6,0,0,0,10,0,681,0,0,0,0,0,0,0,0,NA,0,31
Hempstead,4/30/20,0,0,0,0,0,0,0,0,0,6,0,87,0,5,0,1,0,0,0,93,0,0,0,0,0,0,0,0,NA,0,5
HotSpring,4/30/20,0,0,0,0,0,0,0,0,0,18,0,300,0,7,0,0,0,11,0,318,0,0,0,0,0,0,0,2,NA,0,20
Howard,4/30/20,0,0,0,0,0,0,0,0,0,13,0,129,0,10,0,0,0,3,0,142,0,0,0,0,0,0,0,0,NA,0,58
Independence,4/30/20,0,0,0,0,0,0,0,0,0,9,0,170,0,5,0,0,0,4,0,179,0,0,0,0,0,0,0,0,NA,0,5
Izard,4/30/20,0,0,0,0,0,0,0,0,0,5,0,59,0,3,0,0,0,2,0,64,0,0,0,0,0,0,0,0,NA,0,2
Jackson,4/30/20,0,0,0,0,0,0,0,0,0,1,0,78,0,1,0,0,0,0,0,79,0,0,0,0,0,0,0,0,NA,0,8
Jefferson,4/30/20,0,0,0,0,0,0,0,0,0,169,0,1161,0,79,0,14,0,76,0,1330,0,0,0,0,0,0,0,1,NA,0,40
Johnson,4/30/20,0,0,0,0,0,0,0,0,0,30,0,160,0,20,0,0,0,10,0,190,0,0,0,0,0,0,0,1,NA,0,1
Lafayette,4/30/20,0,0,0,0,0,0,0,0,0,7,0,18,0,4,0,1,0,2,0,25,0,0,0,0,0,0,0,0,NA,0,2
Lawrence,4/30/20,0,0,0,0,0,0,0,0,0,49,0,260,0,6,0,1,0,42,0,309,0,0,0,0,0,0,0,3,NA,0,18
Lee,4/30/20,0,0,0,0,0,0,0,0,0,3,0,63,0,2,0,1,0,0,0,66,0,0,0,0,0,0,0,0,NA,0,0
Lincoln,4/30/20,0,0,0,0,0,0,0,0,0,814,0,699,0,13,0,0,0,801,0,1513,0,0,0,0,0,0,0,58,NA,0,70
LittleRiver,4/30/20,0,0,0,0,0,0,0,0,0,0,0,103,0,0,0,0,0,0,0,103,0,0,0,0,0,0,0,0,NA,0,1
Logan,4/30/20,0,0,0,0,0,0,0,0,0,3,0,80,0,2,0,0,0,1,0,83,0,0,0,0,0,0,0,0,NA,0,7
Lonoke,4/30/20,0,0,0,0,0,0,0,0,0,41,0,526,0,25,0,0,0,16,0,567,0,0,0,0,0,0,0,0,NA,0,31
Madison,4/30/20,0,0,0,0,0,0,0,0,0,1,0,109,0,0,0,0,0,1,0,110,0,0,0,0,0,0,0,0,NA,0,8
Marion,4/30/20,0,0,0,0,0,0,0,0,0,1,0,64,0,1,0,0,0,0,0,65,0,0,0,0,0,0,0,0,NA,0,1
Miller,4/30/20,0,0,0,0,0,0,0,0,0,34,0,250,0,26,0,1,0,7,0,284,0,0,0,0,0,0,0,1,NA,0,14
MissingCountyInfo,4/30/20,0,0,0,0,0,0,0,0,0,175,0,16230,0,41,0,NA,0,134,0,16405,0,0,0,0,0,0,0,-53,NA,NA,909
Mississippi,4/30/20,0,0,0,0,0,0,0,0,0,16,0,195,0,8,0,0,0,8,0,211,0,0,0,0,0,0,0,1,NA,0,22
Monroe,4/30/20,0,0,0,0,0,0,0,0,0,4,0,20,0,2,0,0,0,2,0,24,0,0,0,0,0,0,0,0,NA,0,1
Montgomery,4/30/20,0,0,0,0,0,0,0,0,0,1,0,73,0,0,0,0,0,1,0,74,0,0,0,0,0,0,0,0,NA,0,2
Nevada,4/30/20,0,0,0,0,0,0,0,0,0,1,0,45,0,1,0,0,0,0,0,46,0,0,0,0,0,0,0,0,NA,0,1
Newton,4/30/20,0,0,0,0,0,0,0,0,0,3,0,76,0,2,0,0,0,1,0,79,0,0,0,0,0,0,0,0,NA,0,1
Ouachita,4/30/20,0,0,0,0,0,0,0,0,0,6,0,262,0,5,0,0,0,1,0,268,0,0,0,0,0,0,0,0,NA,0,15
Perry,4/30/20,0,0,0,0,0,0,0,0,0,7,0,97,0,2,0,0,0,5,0,104,0,0,0,0,0,0,0,1,NA,0,3
Phillips,4/30/20,0,0,0,0,0,0,0,0,0,5,0,110,0,2,0,1,0,2,0,115,0,0,0,0,0,0,0,0,NA,0,0
Pike,4/30/20,0,0,0,0,0,0,0,0,0,3,0,274,0,2,0,0,0,1,0,277,0,0,0,0,0,0,0,0,NA,0,9
Poinsett,4/30/20,0,0,0,0,0,0,0,0,0,21,0,125,0,9,0,1,0,11,0,146,0,0,0,0,0,0,0,2,NA,0,13
Polk,4/30/20,0,0,0,0,0,0,0,0,0,8,0,254,0,6,0,0,0,2,0,262,0,0,0,0,0,0,0,0,NA,0,4
Pope,4/30/20,0,0,0,0,0,0,0,0,0,43,0,1439,0,33,0,0,0,10,0,1482,0,0,0,0,0,0,0,0,NA,0,35
Prairie,4/30/20,0,0,0,0,0,0,0,0,0,2,0,23,0,1,0,0,0,1,0,25,0,0,0,0,0,0,0,0,NA,0,0
Pulaski,4/30/20,0,0,0,0,0,0,0,0,0,515,0,4360,0,245,0,17,0,253,0,4875,0,0,0,0,0,0,0,15,NA,1,333
Randolph,4/30/20,0,0,0,0,0,0,0,0,0,17,0,502,0,11,0,0,0,6,0,519,0,0,0,0,0,0,0,0,NA,0,12
Saline,4/30/20,0,0,0,0,0,0,0,0,0,67,0,1121,0,43,0,1,0,23,0,1188,0,0,0,0,0,0,0,8,NA,0,78
Scott,4/30/20,0,0,0,0,0,0,0,0,0,1,0,5,0,1,0,0,0,0,0,6,0,0,0,0,0,0,0,0,NA,0,0
Searcy,4/30/20,0,0,0,0,0,0,0,0,0,6,0,114,0,5,0,0,0,1,0,120,0,0,0,0,0,0,0,0,NA,0,3
Sebastian,4/30/20,0,0,0,0,0,0,0,0,0,13,0,207,0,11,0,0,0,2,0,220,0,0,0,0,0,0,0,1,NA,0,17
Sevier,4/30/20,0,0,0,0,0,0,0,0,0,11,0,227,0,9,0,1,0,1,0,238,0,0,0,0,0,0,0,0,NA,0,19
Sharp,4/30/20,0,0,0,0,0,0,0,0,0,6,0,49,0,3,0,0,0,3,0,55,0,0,0,0,0,0,0,0,NA,0,4
St.Francis,4/30/20,0,0,0,0,0,0,0,0,0,83,0,412,0,10,0,0,0,73,0,495,0,0,0,0,0,0,0,0,NA,0,13
Stone,4/30/20,0,0,0,0,0,0,0,0,0,7,0,90,0,7,0,0,0,0,0,97,0,0,0,0,0,0,0,0,NA,0,1
Union,4/30/20,0,0,0,0,0,0,0,0,0,45,0,277,0,24,0,0,0,21,0,322,0,0,0,0,0,0,0,1,NA,0,22
VanBuren,4/30/20,0,0,0,0,0,0,0,0,0,28,0,242,0,24,0,2,0,2,0,270,0,0,0,0,0,0,0,0,NA,0,6
Washington,4/30/20,0,0,0,0,0,0,0,0,0,86,0,1270,0,42,0,3,0,41,0,1356,0,0,0,0,0,0,0,2,NA,0,60
White,4/30/20,0,0,0,0,0,0,0,0,0,34,0,423,0,26,0,1,0,7,0,457,0,0,0,0,0,0,0,1,NA,0,20
Woodruff,4/30/20,0,0,0,0,0,0,0,0,0,1,0,12,0,0,0,0,0,1,0,13,0,0,0,0,0,0,0,0,NA,0,1
Yell,4/30/20,0,0,0,0,0,0,0,0,0,3,0,159,0,3,0,0,0,0,0,162,0,0,0,0,0,0,0,0,NA,0,8
Arkansas_all_counties,4/29/20,0,0,0,0,0,0,0,0,2990671,3192,0,42551,0,1249,0,59,0,1884,0,45743,0,0,0,0,0,0,0,81,NA,8,2784
Arkansas_county,4/29/20,0,0,0,0,0,0,0,0,0,2,0,67,0,2,0,0,0,0,0,69,0,0,0,0,0,0,0,0,NA,0,3
Ashley,4/29/20,0,0,0,0,0,0,0,0,0,13,0,278,0,8,0,0,0,5,0,291,0,0,0,0,0,0,0,0,NA,0,9
Baxter,4/29/20,0,0,0,0,0,0,0,0,0,5,0,244,0,5,0,0,0,0,0,249,0,0,0,0,0,0,0,0,NA,0,10
Benton,4/29/20,0,0,0,0,0,0,0,0,0,101,0,2312,0,60,0,0,0,41,0,2413,0,0,0,0,0,0,0,7,NA,0,296
Boone,4/29/20,0,0,0,0,0,0,0,0,0,5,0,124,0,3,0,0,0,2,0,129,0,0,0,0,0,0,0,0,NA,0,11
Bradley,4/29/20,0,0,0,0,0,0,0,0,0,11,0,143,0,5,0,1,0,5,0,154,0,0,0,0,0,0,0,3,NA,0,2
Calhoun,4/29/20,0,0,0,0,0,0,0,0,0,0,0,18,0,0,0,0,0,0,0,18,0,0,0,0,0,0,0,0,NA,0,0
Carroll,4/29/20,0,0,0,0,0,0,0,0,0,5,0,199,0,1,0,0,0,4,0,204,0,0,0,0,0,0,0,0,NA,0,10
Chicot,4/29/20,0,0,0,0,0,0,0,0,0,9,0,52,0,3,0,0,0,6,0,61,0,0,0,0,0,0,0,0,NA,0,2
Clark,4/29/20,0,0,0,0,0,0,0,0,0,27,0,149,0,24,0,0,0,3,0,176,0,0,0,0,0,0,0,0,NA,0,2
Clay,4/29/20,0,0,0,0,0,0,0,0,0,3,0,223,0,0,0,0,0,3,0,226,0,0,0,0,0,0,0,0,NA,0,4
Cleburne,4/29/20,0,0,0,0,0,0,0,0,0,72,0,157,0,61,0,4,0,7,0,229,0,0,0,0,0,0,0,0,NA,0,6
Cleveland,4/29/20,0,0,0,0,0,0,0,0,0,10,0,149,0,7,0,0,0,3,0,159,0,0,0,0,0,0,0,0,NA,0,2
Columbia,4/29/20,0,0,0,0,0,0,0,0,0,12,0,152,0,3,0,0,0,9,0,164,0,0,0,0,0,0,0,0,NA,0,1
Conway,4/29/20,0,0,0,0,0,0,0,0,0,13,0,258,0,3,0,1,0,9,0,271,0,0,0,0,0,0,0,1,NA,0,9
Craighead,4/29/20,0,0,0,0,0,0,0,0,0,73,0,851,0,42,0,0,0,31,0,924,0,0,0,0,0,0,0,3,NA,0,66
Crawford,4/29/20,0,0,0,0,0,0,0,0,0,4,0,171,0,4,0,0,0,0,0,175,0,0,0,0,0,0,0,0,NA,0,7
Crittenden,4/29/20,0,0,0,0,0,0,0,0,0,180,0,996,0,107,0,5,0,68,0,1176,0,0,0,0,0,0,0,3,NA,0,25
Cross,4/29/20,0,0,0,0,0,0,0,0,0,16,0,181,0,5,0,0,0,11,0,197,0,0,0,0,0,0,0,0,NA,0,5
Dallas,4/29/20,0,0,0,0,0,0,0,0,0,1,0,50,0,1,0,0,0,0,0,51,0,0,0,0,0,0,0,0,NA,0,1
Desha,4/29/20,0,0,0,0,0,0,0,0,0,16,0,134,0,4,0,0,0,12,0,150,0,0,0,0,0,0,0,0,NA,0,6
Drew,4/29/20,0,0,0,0,0,0,0,0,0,14,0,197,0,5,0,1,0,8,0,211,0,0,0,0,0,0,0,1,NA,0,14
Faulkner,4/29/20,0,0,0,0,0,0,0,0,0,76,0,1370,0,52,0,2,0,22,0,1446,0,0,0,0,0,0,0,1,NA,0,69
Franklin,4/29/20,0,0,0,0,0,0,0,0,0,2,0,72,0,0,0,0,0,2,0,74,0,0,0,0,0,0,0,0,NA,0,3
Fulton,4/29/20,0,0,0,0,0,0,0,0,0,1,0,69,0,0,0,0,0,1,0,70,0,0,0,0,0,0,0,0,NA,0,21
Garland,4/29/20,0,0,0,0,0,0,0,0,0,115,0,1981,0,79,0,0,0,36,0,2096,0,0,0,0,0,0,0,0,NA,0,105
Grant,4/29/20,0,0,0,0,0,0,0,0,0,13,0,172,0,9,0,0,0,4,0,185,0,0,0,0,0,0,0,1,NA,0,9
Greene,4/29/20,0,0,0,0,0,0,0,0,0,16,0,634,0,5,0,0,0,11,0,650,0,0,0,0,0,0,0,0,NA,0,27
Hempstead,4/29/20,0,0,0,0,0,0,0,0,0,6,0,82,0,4,0,1,0,1,0,88,0,0,0,0,0,0,0,0,NA,0,0
HotSpring,4/29/20,0,0,0,0,0,0,0,0,0,16,0,282,0,7,0,0,0,9,0,298,0,0,0,0,0,0,0,1,NA,0,18
Howard,4/29/20,0,0,0,0,0,0,0,0,0,13,0,71,0,10,0,0,0,3,0,84,0,0,0,0,0,0,0,0,NA,0,5
Independence,4/29/20,0,0,0,0,0,0,0,0,0,9,0,165,0,5,0,0,0,4,0,174,0,0,0,0,0,0,0,0,NA,0,13
Izard,4/29/20,0,0,0,0,0,0,0,0,0,5,0,57,0,3,0,0,0,2,0,62,0,0,0,0,0,0,0,0,NA,0,2
Jackson,4/29/20,0,0,0,0,0,0,0,0,0,1,0,70,0,1,0,0,0,0,0,71,0,0,0,0,0,0,0,0,NA,0,3
Jefferson,4/29/20,0,0,0,0,0,0,0,0,0,168,0,1122,0,75,0,14,0,79,0,1290,0,0,0,0,0,0,0,6,NA,5,22
Johnson,4/29/20,0,0,0,0,0,0,0,0,0,29,0,160,0,20,0,0,0,9,0,189,0,0,0,0,0,0,0,0,NA,0,5
Lafayette,4/29/20,0,0,0,0,0,0,0,0,0,7,0,16,0,4,0,1,0,2,0,23,0,0,0,0,0,0,0,0,NA,0,0
Lawrence,4/29/20,0,0,0,0,0,0,0,0,0,46,0,245,0,4,0,1,0,41,0,291,0,0,0,0,0,0,0,1,NA,0,8
Lee,4/29/20,0,0,0,0,0,0,0,0,0,3,0,63,0,2,0,1,0,0,0,66,0,0,0,0,0,0,0,0,NA,0,0
Lincoln,4/29/20,0,0,0,0,0,0,0,0,0,756,0,687,0,12,0,0,0,744,0,1443,0,0,0,0,0,0,0,1,NA,0,7
LittleRiver,4/29/20,0,0,0,0,0,0,0,0,0,0,0,102,0,0,0,0,0,0,0,102,0,0,0,0,0,0,0,0,NA,0,2
Logan,4/29/20,0,0,0,0,0,0,0,0,0,3,0,73,0,2,0,0,0,1,0,76,0,0,0,0,0,0,0,0,NA,0,4
Lonoke,4/29/20,0,0,0,0,0,0,0,0,0,41,0,495,0,23,0,0,0,18,0,536,0,0,0,0,0,0,0,1,NA,0,39
Madison,4/29/20,0,0,0,0,0,0,0,0,0,1,0,101,0,0,0,0,0,1,0,102,0,0,0,0,0,0,0,0,NA,0,8
Marion,4/29/20,0,0,0,0,0,0,0,0,0,1,0,63,0,1,0,0,0,0,0,64,0,0,0,0,0,0,0,0,NA,0,2
Miller,4/29/20,0,0,0,0,0,0,0,0,0,33,0,237,0,24,0,1,0,8,0,270,0,0,0,0,0,0,0,0,NA,0,5
MissingCountyInfo,4/29/20,0,0,0,0,0,0,0,0,0,228,0,15268,0,37,0,NA,0,191,0,15496,0,0,0,0,0,0,0,8,NA,NA,753
Mississippi,4/29/20,0,0,0,0,0,0,0,0,0,15,0,174,0,8,0,0,0,7,0,189,0,0,0,0,0,0,0,1,NA,0,20
Monroe,4/29/20,0,0,0,0,0,0,0,0,0,4,0,19,0,2,0,0,0,2,0,23,0,0,0,0,0,0,0,0,NA,0,1
Montgomery,4/29/20,0,0,0,0,0,0,0,0,0,1,0,71,0,0,0,0,0,1,0,72,0,0,0,0,0,0,0,0,NA,0,1
Nevada,4/29/20,0,0,0,0,0,0,0,0,0,1,0,44,0,1,0,0,0,0,0,45,0,0,0,0,0,0,0,0,NA,0,1
Newton,4/29/20,0,0,0,0,0,0,0,0,0,3,0,75,0,2,0,0,0,1,0,78,0,0,0,0,0,0,0,0,NA,0,0
Ouachita,4/29/20,0,0,0,0,0,0,0,0,0,6,0,247,0,5,0,0,0,1,0,253,0,0,0,0,0,0,0,0,NA,0,1
Perry,4/29/20,0,0,0,0,0,0,0,0,0,6,0,95,0,2,0,0,0,4,0,101,0,0,0,0,0,0,0,0,NA,0,8
Phillips,4/29/20,0,0,0,0,0,0,0,0,0,5,0,110,0,2,0,1,0,2,0,115,0,0,0,0,0,0,0,0,NA,0,0
Pike,4/29/20,0,0,0,0,0,0,0,0,0,3,0,265,0,2,0,0,0,1,0,268,0,0,0,0,0,0,0,0,NA,0,10
Poinsett,4/29/20,0,0,0,0,0,0,0,0,0,19,0,114,0,8,0,1,0,10,0,133,0,0,0,0,0,0,0,1,NA,1,12
Polk,4/29/20,0,0,0,0,0,0,0,0,0,8,0,250,0,5,0,0,0,3,0,258,0,0,0,0,0,0,0,0,NA,0,10
Pope,4/29/20,0,0,0,0,0,0,0,0,0,43,0,1404,0,31,0,0,0,12,0,1447,0,0,0,0,0,0,0,1,NA,0,32
Prairie,4/29/20,0,0,0,0,0,0,0,0,0,2,0,23,0,1,0,0,0,1,0,25,0,0,0,0,0,0,0,0,NA,0,0
Pulaski,4/29/20,0,0,0,0,0,0,0,0,0,500,0,4042,0,237,0,16,0,247,0,4542,0,0,0,0,0,0,0,10,NA,1,417
Randolph,4/29/20,0,0,0,0,0,0,0,0,0,17,0,490,0,11,0,0,0,6,0,507,0,0,0,0,0,0,0,0,NA,0,13
Saline,4/29/20,0,0,0,0,0,0,0,0,0,59,0,1051,0,42,0,1,0,16,0,1110,0,0,0,0,0,0,0,2,NA,0,96
Scott,4/29/20,0,0,0,0,0,0,0,0,0,1,0,5,0,1,0,0,0,0,0,6,0,0,0,0,0,0,0,0,NA,0,0
Searcy,4/29/20,0,0,0,0,0,0,0,0,0,6,0,111,0,5,0,0,0,1,0,117,0,0,0,0,0,0,0,0,NA,0,4
Sebastian,4/29/20,0,0,0,0,0,0,0,0,0,12,0,191,0,11,0,0,0,1,0,203,0,0,0,0,0,0,0,0,NA,0,12
Sevier,4/29/20,0,0,0,0,0,0,0,0,0,11,0,208,0,9,0,1,0,1,0,219,0,0,0,0,0,0,0,0,NA,1,7
Sharp,4/29/20,0,0,0,0,0,0,0,0,0,6,0,45,0,3,0,0,0,3,0,51,0,0,0,0,0,0,0,0,NA,0,6
St.Francis,4/29/20,0,0,0,0,0,0,0,0,0,83,0,399,0,10,0,0,0,73,0,482,0,0,0,0,0,0,0,1,NA,0,8
Stone,4/29/20,0,0,0,0,0,0,0,0,0,7,0,89,0,7,0,0,0,0,0,96,0,0,0,0,0,0,0,0,NA,0,1
Union,4/29/20,0,0,0,0,0,0,0,0,0,44,0,256,0,22,0,0,0,22,0,300,0,0,0,0,0,0,0,1,NA,0,9
VanBuren,4/29/20,0,0,0,0,0,0,0,0,0,28,0,236,0,22,0,2,0,4,0,264,0,0,0,0,0,0,0,1,NA,0,1
Washington,4/29/20,0,0,0,0,0,0,0,0,0,84,0,1212,0,40,0,3,0,41,0,1296,0,0,0,0,0,0,0,7,NA,0,102
White,4/29/20,0,0,0,0,0,0,0,0,0,33,0,404,0,25,0,1,0,7,0,437,0,0,0,0,0,0,0,2,NA,0,25
Woodruff,4/29/20,0,0,0,0,0,0,0,0,0,1,0,11,0,0,0,0,0,1,0,12,0,0,0,0,0,0,0,0,NA,0,0
Yell,4/29/20,0,0,0,0,0,0,0,0,0,3,0,151,0,3,0,0,0,0,0,154,0,0,0,0,0,0,0,0,NA,0,7
Arkansas_all_counties,4/28/20,0,0,0,0,0,0,0,0,2990671,3111,0,39848,0,1146,0,51,0,1914,0,42959,0,0,0,0,0,0,0,94,NA,2,2502
Arkansas_county,4/28/20,0,0,0,0,0,0,0,0,0,2,0,64,0,2,0,0,0,0,0,66,0,0,0,0,0,0,0,0,NA,0,5
Ashley,4/28/20,0,0,0,0,0,0,0,0,0,13,0,269,0,7,0,0,0,6,0,282,0,0,0,0,0,0,0,0,NA,0,8
Baxter,4/28/20,0,0,0,0,0,0,0,0,0,5,0,234,0,4,0,0,0,1,0,239,0,0,0,0,0,0,0,0,NA,0,5
Benton,4/28/20,0,0,0,0,0,0,0,0,0,94,0,2023,0,57,0,0,0,37,0,2117,0,0,0,0,0,0,0,1,NA,0,79
Boone,4/28/20,0,0,0,0,0,0,0,0,0,5,0,113,0,3,0,0,0,2,0,118,0,0,0,0,0,0,0,0,NA,0,2
Bradley,4/28/20,0,0,0,0,0,0,0,0,0,8,0,144,0,5,0,1,0,2,0,152,0,0,0,0,0,0,0,0,NA,0,9
Calhoun,4/28/20,0,0,0,0,0,0,0,0,0,0,0,18,0,0,0,0,0,0,0,18,0,0,0,0,0,0,0,0,NA,0,0
Carroll,4/28/20,0,0,0,0,0,0,0,0,0,5,0,189,0,1,0,0,0,4,0,194,0,0,0,0,0,0,0,1,NA,0,2
Chicot,4/28/20,0,0,0,0,0,0,0,0,0,9,0,50,0,3,0,0,0,6,0,59,0,0,0,0,0,0,0,0,NA,0,1
Clark,4/28/20,0,0,0,0,0,0,0,0,0,27,0,147,0,23,0,0,0,4,0,174,0,0,0,0,0,0,0,-1,NA,0,4
Clay,4/28/20,0,0,0,0,0,0,0,0,0,3,0,219,0,0,0,0,0,3,0,222,0,0,0,0,0,0,0,1,NA,0,5
Cleburne,4/28/20,0,0,0,0,0,0,0,0,0,72,0,151,0,60,0,4,0,8,0,223,0,0,0,0,0,0,0,0,NA,0,2
Cleveland,4/28/20,0,0,0,0,0,0,0,0,0,10,0,147,0,7,0,0,0,3,0,157,0,0,0,0,0,0,0,0,NA,0,3
Columbia,4/28/20,0,0,0,0,0,0,0,0,0,12,0,151,0,3,0,0,0,9,0,163,0,0,0,0,0,0,0,6,NA,0,8
Conway,4/28/20,0,0,0,0,0,0,0,0,0,12,0,250,0,3,0,1,0,8,0,262,0,0,0,0,0,0,0,0,NA,0,10
Craighead,4/28/20,0,0,0,0,0,0,0,0,0,70,0,788,0,38,0,0,0,32,0,858,0,0,0,0,0,0,0,8,NA,0,86
Crawford,4/28/20,0,0,0,0,0,0,0,0,0,4,0,164,0,4,0,0,0,0,0,168,0,0,0,0,0,0,0,0,NA,0,7
Crittenden,4/28/20,0,0,0,0,0,0,0,0,0,177,0,974,0,107,0,5,0,65,0,1151,0,0,0,0,0,0,0,6,NA,0,38
Cross,4/28/20,0,0,0,0,0,0,0,0,0,16,0,176,0,4,0,0,0,12,0,192,0,0,0,0,0,0,0,0,NA,0,11
Dallas,4/28/20,0,0,0,0,0,0,0,0,0,1,0,49,0,1,0,0,0,0,0,50,0,0,0,0,0,0,0,0,NA,0,1
Desha,4/28/20,0,0,0,0,0,0,0,0,0,16,0,128,0,4,0,0,0,12,0,144,0,0,0,0,0,0,0,0,NA,0,4
Drew,4/28/20,0,0,0,0,0,0,0,0,0,13,0,184,0,5,0,1,0,7,0,197,0,0,0,0,0,0,0,0,NA,0,1
Faulkner,4/28/20,0,0,0,0,0,0,0,0,0,75,0,1302,0,52,0,2,0,21,0,1377,0,0,0,0,0,0,0,2,NA,0,86
Franklin,4/28/20,0,0,0,0,0,0,0,0,0,2,0,69,0,0,0,0,0,2,0,71,0,0,0,0,0,0,0,1,NA,0,8
Fulton,4/28/20,0,0,0,0,0,0,0,0,0,1,0,48,0,0,0,0,0,1,0,49,0,0,0,0,0,0,0,0,NA,0,0
Garland,4/28/20,0,0,0,0,0,0,0,0,0,115,0,1876,0,78,0,0,0,37,0,1991,0,0,0,0,0,0,0,3,NA,0,51
Grant,4/28/20,0,0,0,0,0,0,0,0,0,12,0,164,0,9,0,0,0,3,0,176,0,0,0,0,0,0,0,1,NA,0,8
Greene,4/28/20,0,0,0,0,0,0,0,0,0,16,0,607,0,5,0,0,0,11,0,623,0,0,0,0,0,0,0,0,NA,0,58
Hempstead,4/28/20,0,0,0,0,0,0,0,0,0,6,0,82,0,4,0,1,0,1,0,88,0,0,0,0,0,0,0,1,NA,0,6
HotSpring,4/28/20,0,0,0,0,0,0,0,0,0,15,0,265,0,6,0,0,0,9,0,280,0,0,0,0,0,0,0,5,NA,0,14
Howard,4/28/20,0,0,0,0,0,0,0,0,0,13,0,66,0,9,0,0,0,4,0,79,0,0,0,0,0,0,0,0,NA,0,1
Independence,4/28/20,0,0,0,0,0,0,0,0,0,9,0,152,0,5,0,0,0,4,0,161,0,0,0,0,0,0,0,0,NA,0,6
Izard,4/28/20,0,0,0,0,0,0,0,0,0,5,0,55,0,3,0,0,0,2,0,60,0,0,0,0,0,0,0,0,NA,0,0
Jackson,4/28/20,0,0,0,0,0,0,0,0,0,1,0,67,0,1,0,0,0,0,0,68,0,0,0,0,0,0,0,0,NA,0,4
Jefferson,4/28/20,0,0,0,0,0,0,0,0,0,162,0,1106,0,71,0,9,0,82,0,1268,0,0,0,0,0,0,0,9,NA,1,87
Johnson,4/28/20,0,0,0,0,0,0,0,0,0,29,0,155,0,20,0,0,0,9,0,184,0,0,0,0,0,0,0,0,NA,0,11
Lafayette,4/28/20,0,0,0,0,0,0,0,0,0,7,0,16,0,4,0,1,0,2,0,23,0,0,0,0,0,0,0,1,NA,0,1
Lawrence,4/28/20,0,0,0,0,0,0,0,0,0,45,0,238,0,4,0,1,0,40,0,283,0,0,0,0,0,0,0,3,NA,0,11
Lee,4/28/20,0,0,0,0,0,0,0,0,0,3,0,63,0,2,0,1,0,0,0,66,0,0,0,0,0,0,0,0,NA,0,0
Lincoln,4/28/20,0,0,0,0,0,0,0,0,0,755,0,681,0,12,0,0,0,743,0,1436,0,0,0,0,0,0,0,14,NA,0,20
LittleRiver,4/28/20,0,0,0,0,0,0,0,0,0,0,0,100,0,0,0,0,0,0,0,100,0,0,0,0,0,0,0,0,NA,0,1
Logan,4/28/20,0,0,0,0,0,0,0,0,0,3,0,69,0,2,0,0,0,1,0,72,0,0,0,0,0,0,0,0,NA,0,4
Lonoke,4/28/20,0,0,0,0,0,0,0,0,0,40,0,457,0,23,0,0,0,17,0,497,0,0,0,0,0,0,0,2,NA,0,24
Madison,4/28/20,0,0,0,0,0,0,0,0,0,1,0,93,0,0,0,0,0,1,0,94,0,0,0,0,0,0,0,0,NA,0,2
Marion,4/28/20,0,0,0,0,0,0,0,0,0,1,0,61,0,1,0,0,0,0,0,62,0,0,0,0,0,0,0,0,NA,0,0
Miller,4/28/20,0,0,0,0,0,0,0,0,0,33,0,232,0,23,0,1,0,9,0,265,0,0,0,0,0,0,0,1,NA,0,10
MissingCountyInfo,4/28/20,0,0,0,0,0,0,0,0,0,220,0,14523,0,33,0,NA,0,187,0,14743,0,0,0,0,0,0,0,7,NA,NA,1507
Mississippi,4/28/20,0,0,0,0,0,0,0,0,0,14,0,155,0,8,0,0,0,6,0,169,0,0,0,0,0,0,0,3,NA,0,19
Monroe,4/28/20,0,0,0,0,0,0,0,0,0,4,0,18,0,2,0,0,0,2,0,22,0,0,0,0,0,0,0,0,NA,0,3
Montgomery,4/28/20,0,0,0,0,0,0,0,0,0,1,0,70,0,0,0,0,0,1,0,71,0,0,0,0,0,0,0,1,NA,0,2
Nevada,4/28/20,0,0,0,0,0,0,0,0,0,1,0,43,0,1,0,0,0,0,0,44,0,0,0,0,0,0,0,0,NA,0,3
Newton,4/28/20,0,0,0,0,0,0,0,0,0,3,0,75,0,2,0,0,0,1,0,78,0,0,0,0,0,0,0,0,NA,0,0
Ouachita,4/28/20,0,0,0,0,0,0,0,0,0,6,0,246,0,5,0,0,0,1,0,252,0,0,0,0,0,0,0,1,NA,0,4
Perry,4/28/20,0,0,0,0,0,0,0,0,0,6,0,87,0,2,0,0,0,4,0,93,0,0,0,0,0,0,0,0,NA,0,9
Phillips,4/28/20,0,0,0,0,0,0,0,0,0,5,0,110,0,2,0,1,0,2,0,115,0,0,0,0,0,0,0,1,NA,0,3
Pike,4/28/20,0,0,0,0,0,0,0,0,0,3,0,255,0,2,0,0,0,1,0,258,0,0,0,0,0,0,0,0,NA,0,2
Poinsett,4/28/20,0,0,0,0,0,0,0,0,0,18,0,103,0,8,0,0,0,10,0,121,0,0,0,0,0,0,0,1,NA,0,10
Polk,4/28/20,0,0,0,0,0,0,0,0,0,8,0,240,0,5,0,0,0,3,0,248,0,0,0,0,0,0,0,1,NA,0,9
Pope,4/28/20,0,0,0,0,0,0,0,0,0,42,0,1373,0,31,0,0,0,11,0,1415,0,0,0,0,0,0,0,1,NA,0,20
Prairie,4/28/20,0,0,0,0,0,0,0,0,0,2,0,23,0,1,0,0,0,1,0,25,0,0,0,0,0,0,0,0,NA,0,4
Pulaski,4/28/20,0,0,0,0,0,0,0,0,0,490,0,3635,0,232,0,15,0,243,0,4125,0,0,0,0,0,0,0,11,NA,1,302
Randolph,4/28/20,0,0,0,0,0,0,0,0,0,17,0,477,0,11,0,0,0,6,0,494,0,0,0,0,0,0,0,1,NA,0,9
Saline,4/28/20,0,0,0,0,0,0,0,0,0,57,0,957,0,40,0,1,0,16,0,1014,0,0,0,0,0,0,0,2,NA,0,66
Scott,4/28/20,0,0,0,0,0,0,0,0,0,1,0,5,0,1,0,0,0,0,0,6,0,0,0,0,0,0,0,0,NA,0,0
Searcy,4/28/20,0,0,0,0,0,0,0,0,0,6,0,107,0,5,0,0,0,1,0,113,0,0,0,0,0,0,0,0,NA,0,0
Sebastian,4/28/20,0,0,0,0,0,0,0,0,0,12,0,179,0,11,0,0,0,1,0,191,0,0,0,0,0,0,0,0,NA,0,13
Sevier,4/28/20,0,0,0,0,0,0,0,0,0,11,0,201,0,9,0,0,0,2,0,212,0,0,0,0,0,0,0,0,NA,0,23
Sharp,4/28/20,0,0,0,0,0,0,0,0,0,6,0,39,0,3,0,0,0,3,0,45,0,0,0,0,0,0,0,4,NA,0,5
St.Francis,4/28/20,0,0,0,0,0,0,0,0,0,82,0,392,0,10,0,0,0,72,0,474,0,0,0,0,0,0,0,1,NA,0,89
Stone,4/28/20,0,0,0,0,0,0,0,0,0,7,0,88,0,7,0,0,0,0,0,95,0,0,0,0,0,0,0,0,NA,0,0
Union,4/28/20,0,0,0,0,0,0,0,0,0,43,0,248,0,22,0,0,0,21,0,291,0,0,0,0,0,0,0,10,NA,0,11
VanBuren,4/28/20,0,0,0,0,0,0,0,0,0,27,0,236,0,22,0,2,0,3,0,263,0,0,0,0,0,0,0,0,NA,0,3
Washington,4/28/20,0,0,0,0,0,0,0,0,0,77,0,1117,0,38,0,3,0,36,0,1194,0,0,0,0,0,0,0,0,NA,0,27
White,4/28/20,0,0,0,0,0,0,0,0,0,31,0,381,0,25,0,1,0,5,0,412,0,0,0,0,0,0,0,0,NA,0,12
Woodruff,4/28/20,0,0,0,0,0,0,0,0,0,1,0,11,0,0,0,0,0,1,0,12,0,0,0,0,0,0,0,0,NA,0,0
Yell,4/28/20,0,0,0,0,0,0,0,0,0,3,0,144,0,3,0,0,0,0,0,147,0,0,0,0,0,0,0,0,NA,0,5
Arkansas_all_counties,4/27/20,0,0,0,0,0,0,0,0,2990671,3017,0,37440,0,987,0,49,0,1981,0,40457,0,0,0,0,0,0,0,76,NA,1,988
Arkansas_county,4/27/20,0,0,0,0,0,0,0,0,0,2,0,59,0,1,0,0,0,1,0,61,0,0,0,0,0,0,0,0,NA,0,0
Ashley,4/27/20,0,0,0,0,0,0,0,0,0,13,0,261,0,4,0,0,0,9,0,274,0,0,0,0,0,0,0,0,NA,0,-7
Baxter,4/27/20,0,0,0,0,0,0,0,0,0,5,0,229,0,1,0,0,0,4,0,234,0,0,0,0,0,0,0,0,NA,0,-16
Benton,4/27/20,0,0,0,0,0,0,0,0,0,93,0,1945,0,47,0,0,0,46,0,2038,0,0,0,0,0,0,0,13,NA,0,87
Boone,4/27/20,0,0,0,0,0,0,0,0,0,5,0,111,0,3,0,0,0,2,0,116,0,0,0,0,0,0,0,1,NA,0,1
Bradley,4/27/20,0,0,0,0,0,0,0,0,0,8,0,135,0,5,0,1,0,2,0,143,0,0,0,0,0,0,0,0,NA,0,5
Calhoun,4/27/20,0,0,0,0,0,0,0,0,0,0,0,18,0,0,0,0,0,0,0,18,0,0,0,0,0,0,0,0,NA,0,2
Carroll,4/27/20,0,0,0,0,0,0,0,0,0,4,0,188,0,1,0,0,0,3,0,192,0,0,0,0,0,0,0,0,NA,0,5
Chicot,4/27/20,0,0,0,0,0,0,0,0,0,9,0,49,0,2,0,0,0,7,0,58,0,0,0,0,0,0,0,1,NA,0,4
Clark,4/27/20,0,0,0,0,0,0,0,0,0,28,0,142,0,18,0,0,0,10,0,170,0,0,0,0,0,0,0,0,NA,0,4
Clay,4/27/20,0,0,0,0,0,0,0,0,0,2,0,215,0,0,0,0,0,2,0,217,0,0,0,0,0,0,0,0,NA,0,11
Cleburne,4/27/20,0,0,0,0,0,0,0,0,0,72,0,149,0,52,0,4,0,16,0,221,0,0,0,0,0,0,0,0,NA,0,2
Cleveland,4/27/20,0,0,0,0,0,0,0,0,0,10,0,144,0,7,0,0,0,3,0,154,0,0,0,0,0,0,0,1,NA,0,9
Columbia,4/27/20,0,0,0,0,0,0,0,0,0,6,0,149,0,3,0,0,0,3,0,155,0,0,0,0,0,0,0,1,NA,0,-4
Conway,4/27/20,0,0,0,0,0,0,0,0,0,12,0,240,0,3,0,1,0,8,0,252,0,0,0,0,0,0,0,0,NA,0,12
Craighead,4/27/20,0,0,0,0,0,0,0,0,0,62,0,710,0,33,0,-1,0,30,0,772,0,0,0,0,0,0,0,0,NA,-1,-8
Crawford,4/27/20,0,0,0,0,0,0,0,0,0,4,0,157,0,3,0,0,0,1,0,161,0,0,0,0,0,0,0,0,NA,0,0
Crittenden,4/27/20,0,0,0,0,0,0,0,0,0,171,0,942,0,82,0,5,0,84,0,1113,0,0,0,0,0,0,0,1,NA,0,-25
Cross,4/27/20,0,0,0,0,0,0,0,0,0,16,0,165,0,4,0,0,0,12,0,181,0,0,0,0,0,0,0,4,NA,0,-1
Dallas,4/27/20,0,0,0,0,0,0,0,0,0,1,0,48,0,1,0,0,0,0,0,49,0,0,0,0,0,0,0,0,NA,0,1
Desha,4/27/20,0,0,0,0,0,0,0,0,0,16,0,124,0,2,0,0,0,14,0,140,0,0,0,0,0,0,0,0,NA,0,-1
Drew,4/27/20,0,0,0,0,0,0,0,0,0,13,0,183,0,4,0,1,0,8,0,196,0,0,0,0,0,0,0,0,NA,0,5
Faulkner,4/27/20,0,0,0,0,0,0,0,0,0,73,0,1218,0,45,0,2,0,26,0,1291,0,0,0,0,0,0,0,2,NA,0,9
Franklin,4/27/20,0,0,0,0,0,0,0,0,0,1,0,62,0,0,0,0,0,1,0,63,0,0,0,0,0,0,0,0,NA,0,-1
Fulton,4/27/20,0,0,0,0,0,0,0,0,0,1,0,48,0,0,0,0,0,1,0,49,0,0,0,0,0,0,0,0,NA,0,-7
Garland,4/27/20,0,0,0,0,0,0,0,0,0,112,0,1828,0,72,0,0,0,40,0,1940,0,0,0,0,0,0,0,1,NA,0,126
Grant,4/27/20,0,0,0,0,0,0,0,0,0,11,0,157,0,9,0,0,0,2,0,168,0,0,0,0,0,0,0,0,NA,0,13
Greene,4/27/20,0,0,0,0,0,0,0,0,0,16,0,549,0,4,0,0,0,12,0,565,0,0,0,0,0,0,0,2,NA,0,1
Hempstead,4/27/20,0,0,0,0,0,0,0,0,0,5,0,77,0,2,0,1,0,2,0,82,0,0,0,0,0,0,0,0,NA,0,5
HotSpring,4/27/20,0,0,0,0,0,0,0,0,0,10,0,256,0,5,0,0,0,5,0,266,0,0,0,0,0,0,0,1,NA,0,23
Howard,4/27/20,0,0,0,0,0,0,0,0,0,13,0,65,0,8,0,0,0,5,0,78,0,0,0,0,0,0,0,0,NA,0,-4
Independence,4/27/20,0,0,0,0,0,0,0,0,0,9,0,146,0,4,0,0,0,5,0,155,0,0,0,0,0,0,0,0,NA,0,5
Izard,4/27/20,0,0,0,0,0,0,0,0,0,5,0,55,0,2,0,0,0,3,0,60,0,0,0,0,0,0,0,2,NA,0,8
Jackson,4/27/20,0,0,0,0,0,0,0,0,0,1,0,63,0,1,0,0,0,0,0,64,0,0,0,0,0,0,0,0,NA,0,4
Jefferson,4/27/20,0,0,0,0,0,0,0,0,0,153,0,1028,0,62,0,8,0,83,0,1181,0,0,0,0,0,0,0,4,NA,1,8
Johnson,4/27/20,0,0,0,0,0,0,0,0,0,29,0,144,0,14,0,0,0,15,0,173,0,0,0,0,0,0,0,3,NA,0,28
Lafayette,4/27/20,0,0,0,0,0,0,0,0,0,6,0,16,0,4,0,1,0,1,0,22,0,0,0,0,0,0,0,0,NA,0,2
Lawrence,4/27/20,0,0,0,0,0,0,0,0,0,42,0,230,0,2,0,1,0,39,0,272,0,0,0,0,0,0,0,1,NA,0,-5
Lee,4/27/20,0,0,0,0,0,0,0,0,0,3,0,63,0,1,0,1,0,1,0,66,0,0,0,0,0,0,0,0,NA,0,-2
Lincoln,4/27/20,0,0,0,0,0,0,0,0,0,741,0,675,0,8,0,0,0,733,0,1416,0,0,0,0,0,0,0,15,NA,0,14
LittleRiver,4/27/20,0,0,0,0,0,0,0,0,0,0,0,99,0,0,0,0,0,0,0,99,0,0,0,0,0,0,0,0,NA,0,-4
Logan,4/27/20,0,0,0,0,0,0,0,0,0,3,0,65,0,2,0,0,0,1,0,68,0,0,0,0,0,0,0,0,NA,0,-4
Lonoke,4/27/20,0,0,0,0,0,0,0,0,0,38,0,435,0,20,0,0,0,18,0,473,0,0,0,0,0,0,0,4,NA,0,13
Madison,4/27/20,0,0,0,0,0,0,0,0,0,1,0,91,0,0,0,0,0,1,0,92,0,0,0,0,0,0,0,0,NA,0,-32
Marion,4/27/20,0,0,0,0,0,0,0,0,0,1,0,61,0,1,0,0,0,0,0,62,0,0,0,0,0,0,0,0,NA,0,-5
Miller,4/27/20,0,0,0,0,0,0,0,0,0,32,0,223,0,19,0,1,0,12,0,255,0,0,0,0,0,0,0,0,NA,0,-36
MissingCountyInfo,4/27/20,0,0,0,0,0,0,0,0,0,213,0,13023,0,7,0,NA,0,206,0,13236,0,0,0,0,0,0,0,-2,NA,NA,507
Mississippi,4/27/20,0,0,0,0,0,0,0,0,0,11,0,139,0,7,0,0,0,4,0,150,0,0,0,0,0,0,0,0,NA,0,1
Monroe,4/27/20,0,0,0,0,0,0,0,0,0,4,0,15,0,2,0,0,0,2,0,19,0,0,0,0,0,0,0,0,NA,0,1
Montgomery,4/27/20,0,0,0,0,0,0,0,0,0,0,0,69,0,0,0,0,0,0,0,69,0,0,0,0,0,0,0,0,NA,0,5
Nevada,4/27/20,0,0,0,0,0,0,0,0,0,1,0,40,0,1,0,0,0,0,0,41,0,0,0,0,0,0,0,0,NA,0,5
Newton,4/27/20,0,0,0,0,0,0,0,0,0,3,0,75,0,2,0,0,0,1,0,78,0,0,0,0,0,0,0,0,NA,0,0
Ouachita,4/27/20,0,0,0,0,0,0,0,0,0,5,0,243,0,5,0,0,0,0,0,248,0,0,0,0,0,0,0,0,NA,0,3
Perry,4/27/20,0,0,0,0,0,0,0,0,0,6,0,78,0,2,0,0,0,4,0,84,0,0,0,0,0,0,0,0,NA,0,9
Phillips,4/27/20,0,0,0,0,0,0,0,0,0,4,0,108,0,2,0,1,0,1,0,112,0,0,0,0,0,0,0,0,NA,0,2
Pike,4/27/20,0,0,0,0,0,0,0,0,0,3,0,253,0,2,0,0,0,1,0,256,0,0,0,0,0,0,0,0,NA,0,-8
Poinsett,4/27/20,0,0,0,0,0,0,0,0,0,17,0,94,0,6,0,0,0,11,0,111,0,0,0,0,0,0,0,3,NA,0,14
Polk,4/27/20,0,0,0,0,0,0,0,0,0,7,0,232,0,5,0,0,0,2,0,239,0,0,0,0,0,0,0,0,NA,0,11
Pope,4/27/20,0,0,0,0,0,0,0,0,0,41,0,1354,0,24,0,0,0,17,0,1395,0,0,0,0,0,0,0,3,NA,0,-36
Prairie,4/27/20,0,0,0,0,0,0,0,0,0,2,0,19,0,1,0,0,0,1,0,21,0,0,0,0,0,0,0,0,NA,0,-1
Pulaski,4/27/20,0,0,0,0,0,0,0,0,0,479,0,3344,0,186,0,14,0,279,0,3823,0,0,0,0,0,0,0,6,NA,0,121
Randolph,4/27/20,0,0,0,0,0,0,0,0,0,16,0,469,0,9,0,0,0,7,0,485,0,0,0,0,0,0,0,1,NA,0,-2
Saline,4/27/20,0,0,0,0,0,0,0,0,0,55,0,893,0,32,0,1,0,22,0,948,0,0,0,0,0,0,0,1,NA,0,28
Scott,4/27/20,0,0,0,0,0,0,0,0,0,1,0,5,0,1,0,0,0,0,0,6,0,0,0,0,0,0,0,0,NA,0,0
Searcy,4/27/20,0,0,0,0,0,0,0,0,0,6,0,107,0,2,0,0,0,4,0,113,0,0,0,0,0,0,0,0,NA,0,0
Sebastian,4/27/20,0,0,0,0,0,0,0,0,0,12,0,166,0,10,0,0,0,2,0,178,0,0,0,0,0,0,0,0,NA,0,13
Sevier,4/27/20,0,0,0,0,0,0,0,0,0,11,0,178,0,6,0,0,0,5,0,189,0,0,0,0,0,0,0,0,NA,0,-3
Sharp,4/27/20,0,0,0,0,0,0,0,0,0,2,0,38,0,2,0,0,0,0,0,40,0,0,0,0,0,0,0,0,NA,0,7
St.Francis,4/27/20,0,0,0,0,0,0,0,0,0,81,0,304,0,8,0,0,0,73,0,385,0,0,0,0,0,0,0,5,NA,0,4
Stone,4/27/20,0,0,0,0,0,0,0,0,0,7,0,88,0,7,0,0,0,0,0,95,0,0,0,0,0,0,0,0,NA,0,-3
Union,4/27/20,0,0,0,0,0,0,0,0,0,33,0,247,0,16,0,0,0,17,0,280,0,0,0,0,0,0,0,0,NA,0,1
VanBuren,4/27/20,0,0,0,0,0,0,0,0,0,27,0,233,0,21,0,2,0,4,0,260,0,0,0,0,0,0,0,0,NA,0,-2
Washington,4/27/20,0,0,0,0,0,0,0,0,0,77,0,1090,0,35,0,3,0,39,0,1167,0,0,0,0,0,0,0,0,NA,0,45
White,4/27/20,0,0,0,0,0,0,0,0,0,31,0,369,0,23,0,1,0,7,0,400,0,0,0,0,0,0,0,0,NA,0,3
Woodruff,4/27/20,0,0,0,0,0,0,0,0,0,1,0,11,0,0,0,0,0,1,0,12,0,0,0,0,0,0,0,0,NA,0,2
Yell,4/27/20,0,0,0,0,0,0,0,0,0,3,0,139,0,2,0,0,0,1,0,142,0,0,0,0,0,0,0,0,NA,0,16
Arkansas_all_counties,4/26/20,0,0,0,0,0,0,0,0,2990671,2941,0,36528,0,985,0,49,0,1907,0,39469,0,0,0,0,0,0,0,111,NA,0,1410
Arkansas_county,4/26/20,0,0,0,0,0,0,0,0,0,2,0,59,0,1,0,0,0,1,0,61,0,0,0,0,0,0,0,0,NA,0,15
Ashley,4/26/20,0,0,0,0,0,0,0,0,0,13,0,268,0,4,0,0,0,9,0,281,0,0,0,0,0,0,0,0,NA,0,5
Baxter,4/26/20,0,0,0,0,0,0,0,0,0,5,0,245,0,1,0,0,0,4,0,250,0,0,0,0,0,0,0,0,NA,0,14
Benton,4/26/20,0,0,0,0,0,0,0,0,0,80,0,1871,0,47,0,0,0,33,0,1951,0,0,0,0,0,0,0,2,NA,0,118
Boone,4/26/20,0,0,0,0,0,0,0,0,0,4,0,111,0,3,0,0,0,1,0,115,0,0,0,0,0,0,0,0,NA,0,12
Bradley,4/26/20,0,0,0,0,0,0,0,0,0,8,0,130,0,5,0,1,0,2,0,138,0,0,0,0,0,0,0,1,NA,0,9
Calhoun,4/26/20,0,0,0,0,0,0,0,0,0,0,0,16,0,0,0,0,0,0,0,16,0,0,0,0,0,0,0,0,NA,0,0
Carroll,4/26/20,0,0,0,0,0,0,0,0,0,4,0,183,0,1,0,0,0,3,0,187,0,0,0,0,0,0,0,1,NA,0,11
Chicot,4/26/20,0,0,0,0,0,0,0,0,0,8,0,46,0,2,0,0,0,6,0,54,0,0,0,0,0,0,0,0,NA,0,3
Clark,4/26/20,0,0,0,0,0,0,0,0,0,28,0,138,0,18,0,0,0,10,0,166,0,0,0,0,0,0,0,-1,NA,0,59
Clay,4/26/20,0,0,0,0,0,0,0,0,0,2,0,204,0,0,0,0,0,2,0,206,0,0,0,0,0,0,0,1,NA,0,76
Cleburne,4/26/20,0,0,0,0,0,0,0,0,0,72,0,147,0,52,0,4,0,16,0,219,0,0,0,0,0,0,0,0,NA,0,2
Cleveland,4/26/20,0,0,0,0,0,0,0,0,0,9,0,136,0,7,0,0,0,2,0,145,0,0,0,0,0,0,0,1,NA,0,1
Columbia,4/26/20,0,0,0,0,0,0,0,0,0,5,0,154,0,3,0,0,0,2,0,159,0,0,0,0,0,0,0,-1,NA,0,0
Conway,4/26/20,0,0,0,0,0,0,0,0,0,10,0,230,0,3,0,1,0,6,0,240,0,0,0,0,0,0,0,0,NA,0,1
Craighead,4/26/20,0,0,0,0,0,0,0,0,0,62,0,718,0,33,0,1,0,28,0,780,0,0,0,0,0,0,0,4,NA,0,20
Crawford,4/26/20,0,0,0,0,0,0,0,0,0,4,0,157,0,3,0,0,0,1,0,161,0,0,0,0,0,0,0,0,NA,0,10
Crittenden,4/26/20,0,0,0,0,0,0,0,0,0,170,0,968,0,82,0,5,0,83,0,1138,0,0,0,0,0,0,0,3,NA,0,27
Cross,4/26/20,0,0,0,0,0,0,0,0,0,12,0,170,0,4,0,0,0,8,0,182,0,0,0,0,0,0,0,1,NA,0,7
Dallas,4/26/20,0,0,0,0,0,0,0,0,0,1,0,47,0,1,0,0,0,0,0,48,0,0,0,0,0,0,0,0,NA,0,0
Desha,4/26/20,0,0,0,0,0,0,0,0,0,16,0,125,0,2,0,0,0,14,0,141,0,0,0,0,0,0,0,0,NA,0,8
Drew,4/26/20,0,0,0,0,0,0,0,0,0,13,0,178,0,4,0,1,0,8,0,191,0,0,0,0,0,0,0,0,NA,0,6
Faulkner,4/26/20,0,0,0,0,0,0,0,0,0,71,0,1211,0,45,0,2,0,24,0,1282,0,0,0,0,0,0,0,4,NA,0,35
Franklin,4/26/20,0,0,0,0,0,0,0,0,0,1,0,63,0,0,0,0,0,1,0,64,0,0,0,0,0,0,0,0,NA,0,5
Fulton,4/26/20,0,0,0,0,0,0,0,0,0,1,0,55,0,0,0,0,0,1,0,56,0,0,0,0,0,0,0,1,NA,0,9
Garland,4/26/20,0,0,0,0,0,0,0,0,0,111,0,1703,0,72,0,0,0,39,0,1814,0,0,0,0,0,0,0,1,NA,0,58
Grant,4/26/20,0,0,0,0,0,0,0,0,0,11,0,144,0,8,0,0,0,3,0,155,0,0,0,0,0,0,0,0,NA,0,4
Greene,4/26/20,0,0,0,0,0,0,0,0,0,14,0,550,0,4,0,0,0,10,0,564,0,0,0,0,0,0,0,0,NA,0,21
Hempstead,4/26/20,0,0,0,0,0,0,0,0,0,5,0,72,0,2,0,1,0,2,0,77,0,0,0,0,0,0,0,0,NA,0,2
HotSpring,4/26/20,0,0,0,0,0,0,0,0,0,9,0,234,0,5,0,0,0,4,0,243,0,0,0,0,0,0,0,0,NA,0,43
Howard,4/26/20,0,0,0,0,0,0,0,0,0,13,0,69,0,8,0,0,0,5,0,82,0,0,0,0,0,0,0,0,NA,0,2
Independence,4/26/20,0,0,0,0,0,0,0,0,0,9,0,141,0,4,0,0,0,5,0,150,0,0,0,0,0,0,0,0,NA,0,6
Izard,4/26/20,0,0,0,0,0,0,0,0,0,3,0,49,0,2,0,0,0,1,0,52,0,0,0,0,0,0,0,0,NA,0,1
Jackson,4/26/20,0,0,0,0,0,0,0,0,0,1,0,59,0,1,0,0,0,0,0,60,0,0,0,0,0,0,0,0,NA,0,4
Jefferson,4/26/20,0,0,0,0,0,0,0,0,0,149,0,1024,0,62,0,7,0,80,0,1173,0,0,0,0,0,0,0,4,NA,0,21
Johnson,4/26/20,0,0,0,0,0,0,0,0,0,26,0,119,0,13,0,0,0,13,0,145,0,0,0,0,0,0,0,0,NA,0,6
Lafayette,4/26/20,0,0,0,0,0,0,0,0,0,6,0,14,0,4,0,1,0,1,0,20,0,0,0,0,0,0,0,0,NA,0,0
Lawrence,4/26/20,0,0,0,0,0,0,0,0,0,41,0,236,0,2,0,1,0,38,0,277,0,0,0,0,0,0,0,2,NA,0,8
Lee,4/26/20,0,0,0,0,0,0,0,0,0,3,0,65,0,1,0,1,0,1,0,68,0,0,0,0,0,0,0,0,NA,0,1
Lincoln,4/26/20,0,0,0,0,0,0,0,0,0,726,0,676,0,8,0,0,0,718,0,1402,0,0,0,0,0,0,0,18,NA,0,20
LittleRiver,4/26/20,0,0,0,0,0,0,0,0,0,0,0,103,0,0,0,0,0,0,0,103,0,0,0,0,0,0,0,0,NA,0,5
Logan,4/26/20,0,0,0,0,0,0,0,0,0,3,0,69,0,2,0,0,0,1,0,72,0,0,0,0,0,0,0,0,NA,0,15
Lonoke,4/26/20,0,0,0,0,0,0,0,0,0,34,0,426,0,20,0,0,0,14,0,460,0,0,0,0,0,0,0,2,NA,0,19
Madison,4/26/20,0,0,0,0,0,0,0,0,0,1,0,123,0,0,0,0,0,1,0,124,0,0,0,0,0,0,0,0,NA,0,1
Marion,4/26/20,0,0,0,0,0,0,0,0,0,1,0,66,0,1,0,0,0,0,0,67,0,0,0,0,0,0,0,0,NA,0,5
Miller,4/26/20,0,0,0,0,0,0,0,0,0,32,0,259,0,19,0,1,0,12,0,291,0,0,0,0,0,0,0,0,NA,0,5
MissingCountyInfo,4/26/20,0,0,0,0,0,0,0,0,0,215,0,12514,0,5,0,NA,0,210,0,12729,0,0,0,0,0,0,0,34,NA,NA,-34
Mississippi,4/26/20,0,0,0,0,0,0,0,0,0,11,0,138,0,8,0,0,0,3,0,149,0,0,0,0,0,0,0,1,NA,0,48
Monroe,4/26/20,0,0,0,0,0,0,0,0,0,4,0,14,0,2,0,0,0,2,0,18,0,0,0,0,0,0,0,0,NA,0,0
Montgomery,4/26/20,0,0,0,0,0,0,0,0,0,0,0,64,0,0,0,0,0,0,0,64,0,0,0,0,0,0,0,0,NA,0,43
Nevada,4/26/20,0,0,0,0,0,0,0,0,0,1,0,35,0,1,0,0,0,0,0,36,0,0,0,0,0,0,0,0,NA,0,0
Newton,4/26/20,0,0,0,0,0,0,0,0,0,3,0,75,0,2,0,0,0,1,0,78,0,0,0,0,0,0,0,0,NA,0,0
Ouachita,4/26/20,0,0,0,0,0,0,0,0,0,5,0,240,0,5,0,0,0,0,0,245,0,0,0,0,0,0,0,0,NA,0,11
Perry,4/26/20,0,0,0,0,0,0,0,0,0,6,0,69,0,2,0,0,0,4,0,75,0,0,0,0,0,0,0,0,NA,0,2
Phillips,4/26/20,0,0,0,0,0,0,0,0,0,4,0,106,0,2,0,1,0,1,0,110,0,0,0,0,0,0,0,0,NA,0,2
Pike,4/26/20,0,0,0,0,0,0,0,0,0,3,0,261,0,2,0,0,0,1,0,264,0,0,0,0,0,0,0,0,NA,0,1
Poinsett,4/26/20,0,0,0,0,0,0,0,0,0,14,0,83,0,6,0,0,0,8,0,97,0,0,0,0,0,0,0,0,NA,0,2
Polk,4/26/20,0,0,0,0,0,0,0,0,0,7,0,221,0,5,0,0,0,2,0,228,0,0,0,0,0,0,0,0,NA,0,1
Pope,4/26/20,0,0,0,0,0,0,0,0,0,38,0,1393,0,24,0,0,0,14,0,1431,0,0,0,0,0,0,0,1,NA,0,35
Prairie,4/26/20,0,0,0,0,0,0,0,0,0,2,0,20,0,1,0,0,0,1,0,22,0,0,0,0,0,0,0,0,NA,0,1
Pulaski,4/26/20,0,0,0,0,0,0,0,0,0,473,0,3229,0,186,0,14,0,273,0,3702,0,0,0,0,0,0,0,22,NA,0,165
Randolph,4/26/20,0,0,0,0,0,0,0,0,0,15,0,472,0,9,0,0,0,6,0,487,0,0,0,0,0,0,0,0,NA,0,16
Saline,4/26/20,0,0,0,0,0,0,0,0,0,54,0,866,0,32,0,1,0,21,0,920,0,0,0,0,0,0,0,0,NA,0,69
Scott,4/26/20,0,0,0,0,0,0,0,0,0,1,0,5,0,1,0,0,0,0,0,6,0,0,0,0,0,0,0,0,NA,0,0
Searcy,4/26/20,0,0,0,0,0,0,0,0,0,6,0,107,0,2,0,0,0,4,0,113,0,0,0,0,0,0,0,0,NA,0,1
Sebastian,4/26/20,0,0,0,0,0,0,0,0,0,12,0,153,0,10,0,0,0,2,0,165,0,0,0,0,0,0,0,0,NA,0,11
Sevier,4/26/20,0,0,0,0,0,0,0,0,0,11,0,181,0,6,0,0,0,5,0,192,0,0,0,0,0,0,0,0,NA,0,6
Sharp,4/26/20,0,0,0,0,0,0,0,0,0,2,0,31,0,2,0,0,0,0,0,33,0,0,0,0,0,0,0,0,NA,0,1
St.Francis,4/26/20,0,0,0,0,0,0,0,0,0,76,0,305,0,8,0,0,0,68,0,381,0,0,0,0,0,0,0,2,NA,0,20
Stone,4/26/20,0,0,0,0,0,0,0,0,0,7,0,91,0,7,0,0,0,0,0,98,0,0,0,0,0,0,0,0,NA,0,3
Union,4/26/20,0,0,0,0,0,0,0,0,0,33,0,246,0,16,0,0,0,17,0,279,0,0,0,0,0,0,0,3,NA,0,14
VanBuren,4/26/20,0,0,0,0,0,0,0,0,0,27,0,235,0,21,0,2,0,4,0,262,0,0,0,0,0,0,0,1,NA,0,3
Washington,4/26/20,0,0,0,0,0,0,0,0,0,77,0,1045,0,36,0,3,0,38,0,1122,0,0,0,0,0,0,0,4,NA,0,259
White,4/26/20,0,0,0,0,0,0,0,0,0,31,0,366,0,23,0,1,0,7,0,397,0,0,0,0,0,0,0,0,NA,0,28
Woodruff,4/26/20,0,0,0,0,0,0,0,0,0,1,0,9,0,0,0,0,0,1,0,10,0,0,0,0,0,0,0,0,NA,0,0
Yell,4/26/20,0,0,0,0,0,0,0,0,0,3,0,123,0,2,0,0,0,1,0,126,0,0,0,0,0,0,0,0,NA,0,3
Arkansas_all_counties,4/25/20,0,0,0,0,0,0,0,0,2990671,2830,0,35229,0,970,0,49,0,1811,0,38059,0,0,0,0,0,0,0,89,NA,3,2397
Arkansas_county,4/25/20,0,0,0,0,0,0,0,0,0,2,0,44,0,1,0,0,0,1,0,46,0,0,0,0,0,0,0,0,NA,0,0
Ashley,4/25/20,0,0,0,0,0,0,0,0,0,13,0,263,0,4,0,0,0,9,0,276,0,0,0,0,0,0,0,0,NA,0,19
Baxter,4/25/20,0,0,0,0,0,0,0,0,0,5,0,231,0,1,0,0,0,4,0,236,0,0,0,0,0,0,0,0,NA,0,28
Benton,4/25/20,0,0,0,0,0,0,0,0,0,78,0,1755,0,46,0,0,0,32,0,1833,0,0,0,0,0,0,0,1,NA,0,111
Boone,4/25/20,0,0,0,0,0,0,0,0,0,4,0,99,0,3,0,0,0,1,0,103,0,0,0,0,0,0,0,0,NA,0,1
Bradley,4/25/20,0,0,0,0,0,0,0,0,0,7,0,122,0,5,0,1,0,1,0,129,0,0,0,0,0,0,0,0,NA,0,9
Calhoun,4/25/20,0,0,0,0,0,0,0,0,0,0,0,16,0,0,0,0,0,0,0,16,0,0,0,0,0,0,0,0,NA,0,0
Carroll,4/25/20,0,0,0,0,0,0,0,0,0,3,0,173,0,1,0,0,0,2,0,176,0,0,0,0,0,0,0,0,NA,0,4
Chicot,4/25/20,0,0,0,0,0,0,0,0,0,8,0,43,0,2,0,0,0,6,0,51,0,0,0,0,0,0,0,1,NA,0,4
Clark,4/25/20,0,0,0,0,0,0,0,0,0,29,0,78,0,18,0,0,0,11,0,107,0,0,0,0,0,0,0,1,NA,0,4
Clay,4/25/20,0,0,0,0,0,0,0,0,0,1,0,129,0,0,0,0,0,1,0,130,0,0,0,0,0,0,0,0,NA,0,13
Cleburne,4/25/20,0,0,0,0,0,0,0,0,0,72,0,145,0,52,0,4,0,16,0,217,0,0,0,0,0,0,0,0,NA,0,2
Cleveland,4/25/20,0,0,0,0,0,0,0,0,0,8,0,136,0,7,0,0,0,1,0,144,0,0,0,0,0,0,0,0,NA,0,9
Columbia,4/25/20,0,0,0,0,0,0,0,0,0,6,0,153,0,3,0,0,0,3,0,159,0,0,0,0,0,0,0,0,NA,0,7
Conway,4/25/20,0,0,0,0,0,0,0,0,0,10,0,229,0,3,0,1,0,6,0,239,0,0,0,0,0,0,0,0,NA,0,38
Craighead,4/25/20,0,0,0,0,0,0,0,0,0,58,0,702,0,31,0,1,0,26,0,760,0,0,0,0,0,0,0,0,NA,0,208
Crawford,4/25/20,0,0,0,0,0,0,0,0,0,4,0,147,0,3,0,0,0,1,0,151,0,0,0,0,0,0,0,0,NA,0,7
Crittenden,4/25/20,0,0,0,0,0,0,0,0,0,167,0,944,0,81,0,5,0,81,0,1111,0,0,0,0,0,0,0,0,NA,0,238
Cross,4/25/20,0,0,0,0,0,0,0,0,0,11,0,164,0,4,0,0,0,7,0,175,0,0,0,0,0,0,0,0,NA,0,27
Dallas,4/25/20,0,0,0,0,0,0,0,0,0,1,0,47,0,1,0,0,0,0,0,48,0,0,0,0,0,0,0,0,NA,0,0
Desha,4/25/20,0,0,0,0,0,0,0,0,0,16,0,117,0,2,0,0,0,14,0,133,0,0,0,0,0,0,0,0,NA,0,11
Drew,4/25/20,0,0,0,0,0,0,0,0,0,13,0,172,0,4,0,1,0,8,0,185,0,0,0,0,0,0,0,0,NA,0,67
Faulkner,4/25/20,0,0,0,0,0,0,0,0,0,67,0,1180,0,45,0,2,0,20,0,1247,0,0,0,0,0,0,0,0,NA,0,169
Franklin,4/25/20,0,0,0,0,0,0,0,0,0,1,0,58,0,0,0,0,0,1,0,59,0,0,0,0,0,0,0,0,NA,0,1
Fulton,4/25/20,0,0,0,0,0,0,0,0,0,0,0,47,0,0,0,0,0,0,0,47,0,0,0,0,0,0,0,0,NA,0,8
Garland,4/25/20,0,0,0,0,0,0,0,0,0,110,0,1646,0,71,0,0,0,39,0,1756,0,0,0,0,0,0,0,0,NA,0,63
Grant,4/25/20,0,0,0,0,0,0,0,0,0,11,0,140,0,8,0,0,0,3,0,151,0,0,0,0,0,0,0,0,NA,0,11
Greene,4/25/20,0,0,0,0,0,0,0,0,0,14,0,529,0,3,0,0,0,11,0,543,0,0,0,0,0,0,0,0,NA,0,39
Hempstead,4/25/20,0,0,0,0,0,0,0,0,0,5,0,70,0,2,0,1,0,2,0,75,0,0,0,0,0,0,0,0,NA,0,25
HotSpring,4/25/20,0,0,0,0,0,0,0,0,0,9,0,191,0,5,0,0,0,4,0,200,0,0,0,0,0,0,0,0,NA,0,6
Howard,4/25/20,0,0,0,0,0,0,0,0,0,13,0,67,0,8,0,0,0,5,0,80,0,0,0,0,0,0,0,0,NA,0,6
Independence,4/25/20,0,0,0,0,0,0,0,0,0,9,0,135,0,4,0,0,0,5,0,144,0,0,0,0,0,0,0,0,NA,0,4
Izard,4/25/20,0,0,0,0,0,0,0,0,0,3,0,48,0,2,0,0,0,1,0,51,0,0,0,0,0,0,0,0,NA,0,7
Jackson,4/25/20,0,0,0,0,0,0,0,0,0,1,0,55,0,1,0,0,0,0,0,56,0,0,0,0,0,0,0,0,NA,0,5
Jefferson,4/25/20,0,0,0,0,0,0,0,0,0,145,0,1007,0,62,0,7,0,76,0,1152,0,0,0,0,0,0,0,0,NA,0,173
Johnson,4/25/20,0,0,0,0,0,0,0,0,0,26,0,113,0,13,0,0,0,13,0,139,0,0,0,0,0,0,0,0,NA,0,5
Lafayette,4/25/20,0,0,0,0,0,0,0,0,0,6,0,14,0,4,0,1,0,1,0,20,0,0,0,0,0,0,0,0,NA,1,3
Lawrence,4/25/20,0,0,0,0,0,0,0,0,0,39,0,230,0,2,0,1,0,36,0,269,0,0,0,0,0,0,0,1,NA,0,94
Lee,4/25/20,0,0,0,0,0,0,0,0,0,3,0,64,0,1,0,1,0,1,0,67,0,0,0,0,0,0,0,0,NA,0,19
Lincoln,4/25/20,0,0,0,0,0,0,0,0,0,708,0,674,0,7,0,0,0,701,0,1382,0,0,0,0,0,0,0,1,NA,0,25
LittleRiver,4/25/20,0,0,0,0,0,0,0,0,0,0,0,98,0,0,0,0,0,0,0,98,0,0,0,0,0,0,0,0,NA,0,4
Logan,4/25/20,0,0,0,0,0,0,0,0,0,3,0,54,0,2,0,0,0,1,0,57,0,0,0,0,0,0,0,0,NA,0,0
Lonoke,4/25/20,0,0,0,0,0,0,0,0,0,32,0,409,0,20,0,0,0,12,0,441,0,0,0,0,0,0,0,1,NA,0,22
Madison,4/25/20,0,0,0,0,0,0,0,0,0,1,0,122,0,0,0,0,0,1,0,123,0,0,0,0,0,0,0,0,NA,0,5
Marion,4/25/20,0,0,0,0,0,0,0,0,0,1,0,61,0,1,0,0,0,0,0,62,0,0,0,0,0,0,0,0,NA,0,5
Miller,4/25/20,0,0,0,0,0,0,0,0,0,32,0,254,0,18,0,1,0,13,0,286,0,0,0,0,0,0,0,0,NA,0,83
MissingCountyInfo,4/25/20,0,0,0,0,0,0,0,0,0,181,0,12582,0,4,0,NA,0,177,0,12763,0,0,0,0,0,0,0,-1,NA,NA,842
Mississippi,4/25/20,0,0,0,0,0,0,0,0,0,10,0,91,0,8,0,0,0,2,0,101,0,0,0,0,0,0,0,0,NA,0,17
Monroe,4/25/20,0,0,0,0,0,0,0,0,0,4,0,14,0,2,0,0,0,2,0,18,0,0,0,0,0,0,0,0,NA,0,0
Montgomery,4/25/20,0,0,0,0,0,0,0,0,0,0,0,21,0,0,0,0,0,0,0,21,0,0,0,0,0,0,0,0,NA,0,0
Nevada,4/25/20,0,0,0,0,0,0,0,0,0,1,0,35,0,1,0,0,0,0,0,36,0,0,0,0,0,0,0,0,NA,0,1
Newton,4/25/20,0,0,0,0,0,0,0,0,0,3,0,75,0,2,0,0,0,1,0,78,0,0,0,0,0,0,0,0,NA,0,5
Ouachita,4/25/20,0,0,0,0,0,0,0,0,0,5,0,229,0,5,0,0,0,0,0,234,0,0,0,0,0,0,0,0,NA,0,13
Perry,4/25/20,0,0,0,0,0,0,0,0,0,6,0,67,0,2,0,0,0,4,0,73,0,0,0,0,0,0,0,0,NA,0,2
Phillips,4/25/20,0,0,0,0,0,0,0,0,0,4,0,104,0,2,0,1,0,1,0,108,0,0,0,0,0,0,0,0,NA,0,3
Pike,4/25/20,0,0,0,0,0,0,0,0,0,3,0,260,0,2,0,0,0,1,0,263,0,0,0,0,0,0,0,0,NA,0,5
Poinsett,4/25/20,0,0,0,0,0,0,0,0,0,14,0,81,0,6,0,0,0,8,0,95,0,0,0,0,0,0,0,0,NA,0,9
Polk,4/25/20,0,0,0,0,0,0,0,0,0,7,0,220,0,5,0,0,0,2,0,227,0,0,0,0,0,0,0,0,NA,0,9
Pope,4/25/20,0,0,0,0,0,0,0,0,0,37,0,1359,0,23,0,0,0,14,0,1396,0,0,0,0,0,0,0,0,NA,0,27
Prairie,4/25/20,0,0,0,0,0,0,0,0,0,2,0,19,0,1,0,0,0,1,0,21,0,0,0,0,0,0,0,0,NA,0,0
Pulaski,4/25/20,0,0,0,0,0,0,0,0,0,451,0,3086,0,185,0,14,0,252,0,3537,0,0,0,0,0,0,0,11,NA,1,245
Randolph,4/25/20,0,0,0,0,0,0,0,0,0,15,0,456,0,9,0,0,0,6,0,471,0,0,0,0,0,0,0,0,NA,0,24
Saline,4/25/20,0,0,0,0,0,0,0,0,0,54,0,797,0,31,0,1,0,22,0,851,0,0,0,0,0,0,0,0,NA,0,195
Scott,4/25/20,0,0,0,0,0,0,0,0,0,1,0,5,0,1,0,0,0,0,0,6,0,0,0,0,0,0,0,0,NA,0,0
Searcy,4/25/20,0,0,0,0,0,0,0,0,0,6,0,106,0,2,0,0,0,4,0,112,0,0,0,0,0,0,0,0,NA,0,2
Sebastian,4/25/20,0,0,0,0,0,0,0,0,0,12,0,142,0,10,0,0,0,2,0,154,0,0,0,0,0,0,0,0,NA,0,15
Sevier,4/25/20,0,0,0,0,0,0,0,0,0,11,0,175,0,6,0,0,0,5,0,186,0,0,0,0,0,0,0,1,NA,0,9
Sharp,4/25/20,0,0,0,0,0,0,0,0,0,2,0,30,0,2,0,0,0,0,0,32,0,0,0,0,0,0,0,0,NA,0,0
St.Francis,4/25/20,0,0,0,0,0,0,0,0,0,74,0,287,0,7,0,0,0,67,0,361,0,0,0,0,0,0,0,0,NA,0,60
Stone,4/25/20,0,0,0,0,0,0,0,0,0,7,0,88,0,7,0,0,0,0,0,95,0,0,0,0,0,0,0,0,NA,0,9
Union,4/25/20,0,0,0,0,0,0,0,0,0,30,0,235,0,15,0,0,0,15,0,265,0,0,0,0,0,0,0,0,NA,0,27
VanBuren,4/25/20,0,0,0,0,0,0,0,0,0,26,0,233,0,21,0,2,0,3,0,259,0,0,0,0,0,0,0,0,NA,0,23
Washington,4/25/20,0,0,0,0,0,0,0,0,0,73,0,790,0,36,0,3,0,34,0,863,0,0,0,0,0,0,0,2,NA,1,273
White,4/25/20,0,0,0,0,0,0,0,0,0,31,0,338,0,22,0,1,0,8,0,369,0,0,0,0,0,0,0,1,NA,0,44
Woodruff,4/25/20,0,0,0,0,0,0,0,0,0,1,0,9,0,0,0,0,0,1,0,10,0,0,0,0,0,0,0,0,NA,0,0
Yell,4/25/20,0,0,0,0,0,0,0,0,0,3,0,120,0,2,0,0,0,1,0,123,0,0,0,0,0,0,0,0,NA,0,4
Arkansas_all_counties,4/24/20,0,0,0,0,0,0,0,0,2990671,2741,0,32921,0,932,0,46,0,1763,0,35662,0,0,0,0,0,0,0,276,NA,1,1676
Arkansas_county,4/24/20,0,0,0,0,0,0,0,0,0,2,0,44,0,1,0,0,0,1,0,46,0,0,0,0,0,0,0,0,NA,0,3
Ashley,4/24/20,0,0,0,0,0,0,0,0,0,13,0,244,0,2,0,0,0,11,0,257,0,0,0,0,0,0,0,0,NA,0,6
Baxter,4/24/20,0,0,0,0,0,0,0,0,0,5,0,203,0,1,0,0,0,4,0,208,0,0,0,0,0,0,0,0,NA,0,18
Benton,4/24/20,0,0,0,0,0,0,0,0,0,77,0,1645,0,46,0,0,0,31,0,1722,0,0,0,0,0,0,0,8,NA,0,44
Boone,4/24/20,0,0,0,0,0,0,0,0,0,4,0,98,0,3,0,0,0,1,0,102,0,0,0,0,0,0,0,0,NA,0,-1
Bradley,4/24/20,0,0,0,0,0,0,0,0,0,7,0,113,0,5,0,1,0,1,0,120,0,0,0,0,0,0,0,0,NA,0,1
Calhoun,4/24/20,0,0,0,0,0,0,0,0,0,0,0,16,0,0,0,0,0,0,0,16,0,0,0,0,0,0,0,0,NA,0,0
Carroll,4/24/20,0,0,0,0,0,0,0,0,0,3,0,169,0,1,0,0,0,2,0,172,0,0,0,0,0,0,0,1,NA,0,8
Chicot,4/24/20,0,0,0,0,0,0,0,0,0,7,0,40,0,2,0,0,0,5,0,47,0,0,0,0,0,0,0,0,NA,0,-2
Clark,4/24/20,0,0,0,0,0,0,0,0,0,28,0,75,0,18,0,0,0,10,0,103,0,0,0,0,0,0,0,1,NA,0,-1
Clay,4/24/20,0,0,0,0,0,0,0,0,0,1,0,116,0,0,0,0,0,1,0,117,0,0,0,0,0,0,0,0,NA,0,-27
Cleburne,4/24/20,0,0,0,0,0,0,0,0,0,72,0,143,0,52,0,4,0,16,0,215,0,0,0,0,0,0,0,1,NA,0,4
Cleveland,4/24/20,0,0,0,0,0,0,0,0,0,8,0,127,0,7,0,0,0,1,0,135,0,0,0,0,0,0,0,0,NA,0,-1
Columbia,4/24/20,0,0,0,0,0,0,0,0,0,6,0,146,0,3,0,0,0,3,0,152,0,0,0,0,0,0,0,1,NA,0,-50
Crawford,4/24/20,0,0,0,0,0,0,0,0,0,4,0,140,0,3,0,0,0,1,0,144,0,0,0,0,0,0,0,0,NA,0,3
Cross,4/24/20,0,0,0,0,0,0,0,0,0,11,0,137,0,4,0,0,0,7,0,148,0,0,0,0,0,0,0,2,NA,0,13
Dallas,4/24/20,0,0,0,0,0,0,0,0,0,1,0,47,0,1,0,0,0,0,0,48,0,0,0,0,0,0,0,0,NA,0,0
Desha,4/24/20,0,0,0,0,0,0,0,0,0,16,0,106,0,2,0,0,0,14,0,122,0,0,0,0,0,0,0,6,NA,0,15
Franklin,4/24/20,0,0,0,0,0,0,0,0,0,1,0,57,0,0,0,0,0,1,0,58,0,0,0,0,0,0,0,0,NA,0,0
Fulton,4/24/20,0,0,0,0,0,0,0,0,0,0,0,39,0,0,0,0,0,0,0,39,0,0,0,0,0,0,0,0,NA,0,6
Garland,4/24/20,0,0,0,0,0,0,0,0,0,110,0,1583,0,71,0,0,0,39,0,1693,0,0,0,0,0,0,0,1,NA,0,33
Grant,4/24/20,0,0,0,0,0,0,0,0,0,11,0,129,0,8,0,0,0,3,0,140,0,0,0,0,0,0,0,0,NA,0,2
Greene,4/24/20,0,0,0,0,0,0,0,0,0,14,0,490,0,3,0,0,0,11,0,504,0,0,0,0,0,0,0,1,NA,0,50
HotSpring,4/24/20,0,0,0,0,0,0,0,0,0,9,0,185,0,5,0,0,0,4,0,194,0,0,0,0,0,0,0,0,NA,0,-1
Howard,4/24/20,0,0,0,0,0,0,0,0,0,13,0,61,0,8,0,0,0,5,0,74,0,0,0,0,0,0,0,0,NA,0,6
Independence,4/24/20,0,0,0,0,0,0,0,0,0,9,0,131,0,4,0,0,0,5,0,140,0,0,0,0,0,0,0,1,NA,0,-26
Izard,4/24/20,0,0,0,0,0,0,0,0,0,3,0,41,0,2,0,0,0,1,0,44,0,0,0,0,0,0,0,1,NA,0,-7
Jackson,4/24/20,0,0,0,0,0,0,0,0,0,1,0,50,0,1,0,0,0,0,0,51,0,0,0,0,0,0,0,0,NA,0,1
Johnson,4/24/20,0,0,0,0,0,0,0,0,0,26,0,108,0,13,0,0,0,13,0,134,0,0,0,0,0,0,0,1,NA,0,-20
Lafayette,4/24/20,0,0,0,0,0,0,0,0,0,6,0,11,0,4,0,0,0,2,0,17,0,0,0,0,0,0,0,0,NA,0,-1
Lincoln,4/24/20,0,0,0,0,0,0,0,0,0,707,0,650,0,7,0,0,0,700,0,1357,0,0,0,0,0,0,0,178,NA,0,239
LittleRiver,4/24/20,0,0,0,0,0,0,0,0,0,0,0,94,0,0,0,0,0,0,0,94,0,0,0,0,0,0,0,0,NA,0,1
Logan,4/24/20,0,0,0,0,0,0,0,0,0,3,0,54,0,2,0,0,0,1,0,57,0,0,0,0,0,0,0,0,NA,0,5
Lonoke,4/24/20,0,0,0,0,0,0,0,0,0,31,0,388,0,20,0,0,0,11,0,419,0,0,0,0,0,0,0,1,NA,0,8
Madison,4/24/20,0,0,0,0,0,0,0,0,0,1,0,117,0,0,0,0,0,1,0,118,0,0,0,0,0,0,0,0,NA,0,33
Marion,4/24/20,0,0,0,0,0,0,0,0,0,1,0,56,0,1,0,0,0,0,0,57,0,0,0,0,0,0,0,0,NA,0,3
MissingCountyInfo,4/24/20,0,0,0,0,0,0,0,0,0,182,0,11739,0,4,0,NA,0,178,0,11921,0,0,0,0,0,0,0,49,NA,NA,606
Mississippi,4/24/20,0,0,0,0,0,0,0,0,0,10,0,74,0,8,0,0,0,2,0,84,0,0,0,0,0,0,0,1,NA,0,-1
Monroe,4/24/20,0,0,0,0,0,0,0,0,0,4,0,14,0,2,0,0,0,2,0,18,0,0,0,0,0,0,0,0,NA,0,1
Montgomery,4/24/20,0,0,0,0,0,0,0,0,0,0,0,21,0,0,0,0,0,0,0,21,0,0,0,0,0,0,0,-1,NA,0,0
Nevada,4/24/20,0,0,0,0,0,0,0,0,0,1,0,34,0,1,0,0,0,0,0,35,0,0,0,0,0,0,0,0,NA,0,-2
Newton,4/24/20,0,0,0,0,0,0,0,0,0,3,0,70,0,2,0,0,0,1,0,73,0,0,0,0,0,0,0,1,NA,0,1
Ouachita,4/24/20,0,0,0,0,0,0,0,0,0,5,0,216,0,5,0,0,0,0,0,221,0,0,0,0,0,0,0,0,NA,0,11
Perry,4/24/20,0,0,0,0,0,0,0,0,0,6,0,65,0,2,0,0,0,4,0,71,0,0,0,0,0,0,0,1,NA,0,7
Pike,4/24/20,0,0,0,0,0,0,0,0,0,3,0,255,0,2,0,0,0,1,0,258,0,0,0,0,0,0,0,0,NA,0,19
Poinsett,4/24/20,0,0,0,0,0,0,0,0,0,14,0,72,0,6,0,0,0,8,0,86,0,0,0,0,0,0,0,1,NA,0,-2
Polk,4/24/20,0,0,0,0,0,0,0,0,0,7,0,211,0,5,0,0,0,2,0,218,0,0,0,0,0,0,0,0,NA,0,8
Pope,4/24/20,0,0,0,0,0,0,0,0,0,37,0,1332,0,22,0,0,0,15,0,1369,0,0,0,0,0,0,0,1,NA,0,67
Prairie,4/24/20,0,0,0,0,0,0,0,0,0,2,0,19,0,1,0,0,0,1,0,21,0,0,0,0,0,0,0,0,NA,0,1
Pulaski,4/24/20,0,0,0,0,0,0,0,0,0,440,0,2852,0,184,0,13,0,243,0,3292,0,0,0,0,0,0,0,17,NA,1,338
Randolph,4/24/20,0,0,0,0,0,0,0,0,0,15,0,432,0,9,0,0,0,6,0,447,0,0,0,0,0,0,0,1,NA,0,31
Scott,4/24/20,0,0,0,0,0,0,0,0,0,1,0,5,0,1,0,0,0,0,0,6,0,0,0,0,0,0,0,0,NA,0,1
Searcy,4/24/20,0,0,0,0,0,0,0,0,0,6,0,104,0,2,0,0,0,4,0,110,0,0,0,0,0,0,0,0,NA,0,4
Sebastian,4/24/20,0,0,0,0,0,0,0,0,0,12,0,127,0,10,0,0,0,2,0,139,0,0,0,0,0,0,0,0,NA,0,-3
Sevier,4/24/20,0,0,0,0,0,0,0,0,0,10,0,167,0,6,0,0,0,4,0,177,0,0,0,0,0,0,0,0,NA,0,11
Sharp,4/24/20,0,0,0,0,0,0,0,0,0,2,0,30,0,2,0,0,0,0,0,32,0,0,0,0,0,0,0,0,NA,0,-7
St.Francis,4/24/20,0,0,0,0,0,0,0,0,0,74,0,227,0,7,0,0,0,67,0,301,0,0,0,0,0,0,0,5,NA,0,12
Stone,4/24/20,0,0,0,0,0,0,0,0,0,7,0,79,0,7,0,0,0,0,0,86,0,0,0,0,0,0,0,0,NA,0,-6
Union,4/24/20,0,0,0,0,0,0,0,0,0,30,0,208,0,15,0,0,0,15,0,238,0,0,0,0,0,0,0,2,NA,0,8
Woodruff,4/24/20,0,0,0,0,0,0,0,0,0,1,0,9,0,0,0,0,0,1,0,10,0,0,0,0,0,0,0,0,NA,0,-4
Yell,4/24/20,0,0,0,0,0,0,0,0,0,3,0,116,0,2,0,0,0,1,0,119,0,0,0,0,0,0,0,0,NA,0,-14
Arkansas_all_counties,4/23/20,0,0,0,0,0,0,0,0,2990671,2465,0,31521,0,902,0,45,0,1518,0,33986,0,0,0,0,0,0,0,189,NA,3,4273
Arkansas_county,4/23/20,0,0,0,0,0,0,0,0,0,2,0,41,0,1,0,0,0,1,0,43,0,0,0,0,0,0,0,0,NA,0,5
Ashley,4/23/20,0,0,0,0,0,0,0,0,0,13,0,238,0,2,0,0,0,11,0,251,0,0,0,0,0,0,0,0,NA,0,14
Baxter,4/23/20,0,0,0,0,0,0,0,0,0,5,0,185,0,1,0,0,0,4,0,190,0,0,0,0,0,0,0,0,NA,0,22
Benton,4/23/20,0,0,0,0,0,0,0,0,0,69,0,1609,0,44,0,0,0,25,0,1678,0,0,0,0,0,0,0,1,NA,0,344
Boone,4/23/20,0,0,0,0,0,0,0,0,0,4,0,99,0,3,0,0,0,1,0,103,0,0,0,0,0,0,0,0,NA,0,13
Bradley,4/23/20,0,0,0,0,0,0,0,0,0,7,0,112,0,4,0,1,0,2,0,119,0,0,0,0,0,0,0,0,NA,0,9
Calhoun,4/23/20,0,0,0,0,0,0,0,0,0,0,0,16,0,0,0,0,0,0,0,16,0,0,0,0,0,0,0,0,NA,0,1
Carroll,4/23/20,0,0,0,0,0,0,0,0,0,2,0,162,0,1,0,0,0,1,0,164,0,0,0,0,0,0,0,0,NA,0,42
Chicot,4/23/20,0,0,0,0,0,0,0,0,0,7,0,42,0,2,0,0,0,5,0,49,0,0,0,0,0,0,0,0,NA,0,10
Clark,4/23/20,0,0,0,0,0,0,0,0,0,27,0,77,0,18,0,0,0,9,0,104,0,0,0,0,0,0,0,0,NA,0,10
Clay,4/23/20,0,0,0,0,0,0,0,0,0,1,0,143,0,0,0,0,0,1,0,144,0,0,0,0,0,0,0,0,NA,0,20
Cleburne,4/23/20,0,0,0,0,0,0,0,0,0,71,0,140,0,52,0,4,0,15,0,211,0,0,0,0,0,0,0,0,NA,0,9
Cleveland,4/23/20,0,0,0,0,0,0,0,0,0,8,0,128,0,7,0,0,0,1,0,136,0,0,0,0,0,0,0,0,NA,0,12
Columbia,4/23/20,0,0,0,0,0,0,0,0,0,5,0,197,0,3,0,0,0,2,0,202,0,0,0,0,0,0,0,0,NA,0,-6
Crawford,4/23/20,0,0,0,0,0,0,0,0,0,4,0,137,0,2,0,0,0,2,0,141,0,0,0,0,0,0,0,0,NA,0,46
Cross,4/23/20,0,0,0,0,0,0,0,0,0,9,0,126,0,4,0,0,0,5,0,135,0,0,0,0,0,0,0,0,NA,0,52
Dallas,4/23/20,0,0,0,0,0,0,0,0,0,1,0,47,0,1,0,0,0,0,0,48,0,0,0,0,0,0,0,0,NA,0,2
Desha,4/23/20,0,0,0,0,0,0,0,0,0,10,0,97,0,2,0,0,0,8,0,107,0,0,0,0,0,0,0,1,NA,0,22
Franklin,4/23/20,0,0,0,0,0,0,0,0,0,1,0,57,0,0,0,0,0,1,0,58,0,0,0,0,0,0,0,0,NA,0,8
Fulton,4/23/20,0,0,0,0,0,0,0,0,0,0,0,33,0,0,0,0,0,0,0,33,0,0,0,0,0,0,0,0,NA,0,2
Garland,4/23/20,0,0,0,0,0,0,0,0,0,109,0,1551,0,68,0,0,0,41,0,1660,0,0,0,0,0,0,0,0,NA,0,70
Grant,4/23/20,0,0,0,0,0,0,0,0,0,11,0,127,0,7,0,0,0,4,0,138,0,0,0,0,0,0,0,0,NA,0,15
Greene,4/23/20,0,0,0,0,0,0,0,0,0,13,0,441,0,3,0,0,0,10,0,454,0,0,0,0,0,0,0,3,NA,0,23
HotSpring,4/23/20,0,0,0,0,0,0,0,0,0,9,0,186,0,5,0,0,0,4,0,195,0,0,0,0,0,0,0,1,NA,0,11
Howard,4/23/20,0,0,0,0,0,0,0,0,0,13,0,55,0,8,0,0,0,5,0,68,0,0,0,0,0,0,0,-1,NA,0,10
Independence,4/23/20,0,0,0,0,0,0,0,0,0,8,0,158,0,4,0,0,0,4,0,166,0,0,0,0,0,0,0,0,NA,0,20
Izard,4/23/20,0,0,0,0,0,0,0,0,0,2,0,49,0,2,0,0,0,0,0,51,0,0,0,0,0,0,0,0,NA,0,8
Jackson,4/23/20,0,0,0,0,0,0,0,0,0,1,0,49,0,1,0,0,0,0,0,50,0,0,0,0,0,0,0,0,NA,0,5
Johnson,4/23/20,0,0,0,0,0,0,0,0,0,25,0,129,0,12,0,0,0,13,0,154,0,0,0,0,0,0,0,3,NA,0,18
Lafayette,4/23/20,0,0,0,0,0,0,0,0,0,6,0,12,0,4,0,0,0,2,0,18,0,0,0,0,0,0,0,2,NA,0,2
Lincoln,4/23/20,0,0,0,0,0,0,0,0,0,529,0,589,0,7,0,0,0,522,0,1118,0,0,0,0,0,0,0,84,NA,0,100
LittleRiver,4/23/20,0,0,0,0,0,0,0,0,0,0,0,93,0,0,0,0,0,0,0,93,0,0,0,0,0,0,0,0,NA,0,2
Logan,4/23/20,0,0,0,0,0,0,0,0,0,3,0,49,0,2,0,0,0,1,0,52,0,0,0,0,0,0,0,0,NA,0,7
Lonoke,4/23/20,0,0,0,0,0,0,0,0,0,30,0,381,0,20,0,0,0,10,0,411,0,0,0,0,0,0,0,3,NA,0,50
Madison,4/23/20,0,0,0,0,0,0,0,0,0,1,0,84,0,0,0,0,0,1,0,85,0,0,0,0,0,0,0,0,NA,0,20
Marion,4/23/20,0,0,0,0,0,0,0,0,0,1,0,53,0,1,0,0,0,0,0,54,0,0,0,0,0,0,0,0,NA,0,10
MissingCountyInfo,4/23/20,0,0,0,0,0,0,0,0,0,133,0,11182,0,4,0,NA,0,129,0,11315,0,0,0,0,0,0,0,38,NA,NA,2060
MissingCountyInfo,4/23/20,0,0,0,0,0,0,0,0,0,133,0,11182,0,4,0,NA,0,129,0,11315,0,0,0,0,0,0,0,38,NA,NA,0
Mississippi,4/23/20,0,0,0,0,0,0,0,0,0,9,0,76,0,7,0,0,0,2,0,85,0,0,0,0,0,0,0,0,NA,0,15
Monroe,4/23/20,0,0,0,0,0,0,0,0,0,4,0,13,0,2,0,0,0,2,0,17,0,0,0,0,0,0,0,0,NA,0,-1
Montgomery,4/23/20,0,0,0,0,0,0,0,0,0,1,0,20,0,0,0,0,0,1,0,21,0,0,0,0,0,0,0,1,NA,0,1
Nevada,4/23/20,0,0,0,0,0,0,0,0,0,1,0,36,0,1,0,0,0,0,0,37,0,0,0,0,0,0,0,0,NA,0,3
Newton,4/23/20,0,0,0,0,0,0,0,0,0,2,0,70,0,2,0,0,0,0,0,72,0,0,0,0,0,0,0,0,NA,0,6
Ouachita,4/23/20,0,0,0,0,0,0,0,0,0,5,0,205,0,5,0,0,0,0,0,210,0,0,0,0,0,0,0,0,NA,0,39
Perry,4/23/20,0,0,0,0,0,0,0,0,0,3,0,61,0,2,0,0,0,1,0,64,0,0,0,0,0,0,0,0,NA,0,3
Pike,4/23/20,0,0,0,0,0,0,0,0,0,3,0,236,0,2,0,0,0,1,0,239,0,0,0,0,0,0,0,0,NA,0,18
Poinsett,4/23/20,0,0,0,0,0,0,0,0,0,13,0,75,0,6,0,0,0,7,0,88,0,0,0,0,0,0,0,2,NA,0,13
Polk,4/23/20,0,0,0,0,0,0,0,0,0,7,0,203,0,5,0,0,0,2,0,210,0,0,0,0,0,0,0,0,NA,0,12
Pope,4/23/20,0,0,0,0,0,0,0,0,0,36,0,1266,0,20,0,0,0,16,0,1302,0,0,0,0,0,0,0,1,NA,0,97
Prairie,4/23/20,0,0,0,0,0,0,0,0,0,2,0,18,0,1,0,0,0,1,0,20,0,0,0,0,0,0,0,0,NA,0,0
Pulaski,4/23/20,0,0,0,0,0,0,0,0,0,423,0,2531,0,173,0,12,0,238,0,2954,0,0,0,0,0,0,0,19,NA,0,388
Randolph,4/23/20,0,0,0,0,0,0,0,0,0,14,0,402,0,8,0,0,0,6,0,416,0,0,0,0,0,0,0,0,NA,0,196
Scott,4/23/20,0,0,0,0,0,0,0,0,0,1,0,4,0,1,0,0,0,0,0,5,0,0,0,0,0,0,0,0,NA,0,0
Searcy,4/23/20,0,0,0,0,0,0,0,0,0,6,0,100,0,2,0,0,0,4,0,106,0,0,0,0,0,0,0,0,NA,0,12
Sebastian,4/23/20,0,0,0,0,0,0,0,0,0,11,0,131,0,10,0,0,0,1,0,142,0,0,0,0,0,0,0,0,NA,0,8
Sevier,4/23/20,0,0,0,0,0,0,0,0,0,10,0,156,0,6,0,0,0,4,0,166,0,0,0,0,0,0,0,0,NA,0,5
Sharp,4/23/20,0,0,0,0,0,0,0,0,0,2,0,37,0,2,0,0,0,0,0,39,0,0,0,0,0,0,0,0,NA,0,3
St.Francis,4/23/20,0,0,0,0,0,0,0,0,0,69,0,220,0,7,0,0,0,62,0,289,0,0,0,0,0,0,0,3,NA,0,29
Stone,4/23/20,0,0,0,0,0,0,0,0,0,7,0,85,0,7,0,0,0,0,0,92,0,0,0,0,0,0,0,0,NA,0,7
Union,4/23/20,0,0,0,0,0,0,0,0,0,28,0,202,0,12,0,0,0,16,0,230,0,0,0,0,0,0,0,2,NA,0,17
Woodruff,4/23/20,0,0,0,0,0,0,0,0,0,1,0,13,0,0,0,0,0,1,0,14,0,0,0,0,0,0,0,0,NA,0,1
Yell,4/23/20,0,0,0,0,0,0,0,0,0,3,0,130,0,1,0,0,0,2,0,133,0,0,0,0,0,0,0,1,NA,0,9
Arkansas_all_counties,4/22/20,0,0,0,0,0,0,0,0,2990671,2276,0,27437,0,863,0,42,0,1371,0,29713,0,0,0,0,0,0,0,49,NA,0,656
Arkansas_county,4/22/20,0,0,0,0,0,0,0,0,0,2,0,36,0,1,0,0,0,1,0,38,0,0,0,0,0,0,0,0,NA,0,4
Ashley,4/22/20,0,0,0,0,0,0,0,0,0,13,0,224,0,1,0,0,0,12,0,237,0,0,0,0,0,0,0,0,NA,0,0
Baxter,4/22/20,0,0,0,0,0,0,0,0,0,5,0,163,0,1,0,0,0,4,0,168,0,0,0,0,0,0,0,0,NA,0,8
Benton,4/22/20,0,0,0,0,0,0,0,0,0,68,0,1266,0,41,0,0,0,27,0,1334,0,0,0,0,0,0,0,1,NA,0,60
Boone,4/22/20,0,0,0,0,0,0,0,0,0,4,0,86,0,3,0,0,0,1,0,90,0,0,0,0,0,0,0,0,NA,0,-2
Bradley,4/22/20,0,0,0,0,0,0,0,0,0,7,0,103,0,4,0,1,0,2,0,110,0,0,0,0,0,0,0,0,NA,0,3
Calhoun,4/22/20,0,0,0,0,0,0,0,0,0,0,0,15,0,0,0,0,0,0,0,15,0,0,0,0,0,0,0,0,NA,0,-1
Carroll,4/22/20,0,0,0,0,0,0,0,0,0,2,0,120,0,1,0,0,0,1,0,122,0,0,0,0,0,0,0,0,NA,0,-6
Chicot,4/22/20,0,0,0,0,0,0,0,0,0,7,0,32,0,2,0,0,0,5,0,39,0,0,0,0,0,0,0,0,NA,0,-1
Clark,4/22/20,0,0,0,0,0,0,0,0,0,27,0,67,0,18,0,0,0,9,0,94,0,0,0,0,0,0,0,0,NA,0,6
Clay,4/22/20,0,0,0,0,0,0,0,0,0,1,0,123,0,0,0,0,0,1,0,124,0,0,0,0,0,0,0,0,NA,0,-5
Cleburne,4/22/20,0,0,0,0,0,0,0,0,0,71,0,131,0,52,0,4,0,15,0,202,0,0,0,0,0,0,0,0,NA,0,3
Cleveland,4/22/20,0,0,0,0,0,0,0,0,0,8,0,116,0,7,0,0,0,1,0,124,0,0,0,0,0,0,0,0,NA,0,-1
Columbia,4/22/20,0,0,0,0,0,0,0,0,0,5,0,203,0,3,0,0,0,2,0,208,0,0,0,0,0,0,0,0,NA,0,1
Conway,4/22/20,0,0,0,0,0,0,0,0,0,5,0,196,0,3,0,1,0,1,0,201,0,0,0,0,0,0,0,0,NA,0,12
Craighead,4/22/20,0,0,0,0,0,0,0,0,0,48,0,504,0,28,0,1,0,19,0,552,0,0,0,0,0,0,0,0,NA,0,-5
Crawford,4/22/20,0,0,0,0,0,0,0,0,0,4,0,91,0,2,0,0,0,2,0,95,0,0,0,0,0,0,0,0,NA,0,7
Crittenden,4/22/20,0,0,0,0,0,0,0,0,0,147,0,726,0,64,0,5,0,78,0,873,0,0,0,0,0,0,0,0,NA,0,-22
Cross,4/22/20,0,0,0,0,0,0,0,0,0,9,0,74,0,4,0,0,0,5,0,83,0,0,0,0,0,0,0,0,NA,0,-8
Dallas,4/22/20,0,0,0,0,0,0,0,0,0,1,0,45,0,1,0,0,0,0,0,46,0,0,0,0,0,0,0,0,NA,0,-7
Desha,4/22/20,0,0,0,0,0,0,0,0,0,9,0,76,0,2,0,0,0,7,0,85,0,0,0,0,0,0,0,1,NA,0,18
Drew,4/22/20,0,0,0,0,0,0,0,0,0,7,0,111,0,4,0,1,0,2,0,118,0,0,0,0,0,0,0,1,NA,0,-8
Faulkner,4/22/20,0,0,0,0,0,0,0,0,0,64,0,1014,0,43,0,2,0,19,0,1078,0,0,0,0,0,0,0,1,NA,0,-5
Franklin,4/22/20,0,0,0,0,0,0,0,0,0,1,0,49,0,0,0,0,0,1,0,50,0,0,0,0,0,0,0,0,NA,0,-1
Fulton,4/22/20,0,0,0,0,0,0,0,0,0,0,0,31,0,0,0,0,0,0,0,31,0,0,0,0,0,0,0,0,NA,0,0
Garland,4/22/20,0,0,0,0,0,0,0,0,0,109,0,1481,0,67,0,0,0,42,0,1590,0,0,0,0,0,0,0,0,NA,0,17
Grant,4/22/20,0,0,0,0,0,0,0,0,0,11,0,112,0,7,0,0,0,4,0,123,0,0,0,0,0,0,0,0,NA,0,4
Greene,4/22/20,0,0,0,0,0,0,0,0,0,10,0,421,0,3,0,0,0,7,0,431,0,0,0,0,0,0,0,1,NA,0,8
Hempstead,4/22/20,0,0,0,0,0,0,0,0,0,5,0,45,0,2,0,1,0,2,0,50,0,0,0,0,0,0,0,0,NA,0,-1
HotSpring,4/22/20,0,0,0,0,0,0,0,0,0,8,0,176,0,5,0,0,0,3,0,184,0,0,0,0,0,0,0,0,NA,0,-6
Howard,4/22/20,0,0,0,0,0,0,0,0,0,14,0,44,0,7,0,0,0,7,0,58,0,0,0,0,0,0,0,0,NA,0,-1
Independence,4/22/20,0,0,0,0,0,0,0,0,0,8,0,138,0,4,0,0,0,4,0,146,0,0,0,0,0,0,0,0,NA,0,-3
Izard,4/22/20,0,0,0,0,0,0,0,0,0,2,0,41,0,2,0,0,0,0,0,43,0,0,0,0,0,0,0,0,NA,0,-1
Jackson,4/22/20,0,0,0,0,0,0,0,0,0,1,0,44,0,1,0,0,0,0,0,45,0,0,0,0,0,0,0,0,NA,0,-2
Jefferson,4/22/20,0,0,0,0,0,0,0,0,0,135,0,844,0,51,0,7,0,77,0,979,0,0,0,0,0,0,0,0,NA,0,-10
Johnson,4/22/20,0,0,0,0,0,0,0,0,0,22,0,114,0,12,0,0,0,10,0,136,0,0,0,0,0,0,0,0,NA,0,-19
Lafayette,4/22/20,0,0,0,0,0,0,0,0,0,4,0,12,0,3,0,0,0,1,0,16,0,0,0,0,0,0,0,0,NA,0,1
Lawrence,4/22/20,0,0,0,0,0,0,0,0,0,29,0,146,0,2,0,1,0,26,0,175,0,0,0,0,0,0,0,1,NA,0,6
Lee,4/22/20,0,0,0,0,0,0,0,0,0,3,0,45,0,1,0,1,0,1,0,48,0,0,0,0,0,0,0,0,NA,0,-9
Lincoln,4/22/20,0,0,0,0,0,0,0,0,0,445,0,573,0,7,0,0,0,438,0,1018,0,0,0,0,0,0,0,2,NA,0,30
LittleRiver,4/22/20,0,0,0,0,0,0,0,0,0,0,0,91,0,0,0,0,0,0,0,91,0,0,0,0,0,0,0,0,NA,0,16
Logan,4/22/20,0,0,0,0,0,0,0,0,0,3,0,42,0,2,0,0,0,1,0,45,0,0,0,0,0,0,0,0,NA,0,-1
Lonoke,4/22/20,0,0,0,0,0,0,0,0,0,27,0,334,0,20,0,0,0,7,0,361,0,0,0,0,0,0,0,0,NA,0,3
Madison,4/22/20,0,0,0,0,0,0,0,0,0,1,0,64,0,0,0,0,0,1,0,65,0,0,0,0,0,0,0,0,NA,0,1
Marion,4/22/20,0,0,0,0,0,0,0,0,0,1,0,43,0,1,0,0,0,0,0,44,0,0,0,0,0,0,0,0,NA,0,3
Miller,4/22/20,0,0,0,0,0,0,0,0,0,30,0,173,0,14,0,0,0,16,0,203,0,0,0,0,0,0,0,0,NA,0,-1
Mississippi,4/22/20,0,0,0,0,0,0,0,0,0,9,0,61,0,6,0,0,0,3,0,70,0,0,0,0,0,0,0,0,NA,0,1
Monroe,4/22/20,0,0,0,0,0,0,0,0,0,4,0,14,0,2,0,0,0,2,0,18,0,0,0,0,0,0,0,0,NA,0,2
Montgomery,4/22/20,0,0,0,0,0,0,0,0,0,0,0,20,0,0,0,0,0,0,0,20,0,0,0,0,0,0,0,0,NA,0,2
Nevada,4/22/20,0,0,0,0,0,0,0,0,0,1,0,33,0,1,0,0,0,0,0,34,0,0,0,0,0,0,0,0,NA,0,2
Newton,4/22/20,0,0,0,0,0,0,0,0,0,2,0,64,0,2,0,0,0,0,0,66,0,0,0,0,0,0,0,0,NA,0,3
Ouachita,4/22/20,0,0,0,0,0,0,0,0,0,5,0,166,0,5,0,0,0,0,0,171,0,0,0,0,0,0,0,0,NA,0,3
Perry,4/22/20,0,0,0,0,0,0,0,0,0,3,0,58,0,2,0,0,0,1,0,61,0,0,0,0,0,0,0,0,NA,0,2
Phillips,4/22/20,0,0,0,0,0,0,0,0,0,4,0,101,0,1,0,1,0,2,0,105,0,0,0,0,0,0,0,0,NA,0,-30
Pike,4/22/20,0,0,0,0,0,0,0,0,0,3,0,218,0,2,0,0,0,1,0,221,0,0,0,0,0,0,0,1,NA,0,3
Poinsett,4/22/20,0,0,0,0,0,0,0,0,0,11,0,64,0,6,0,0,0,5,0,75,0,0,0,0,0,0,0,0,NA,0,1
Polk,4/22/20,0,0,0,0,0,0,0,0,0,7,0,191,0,5,0,0,0,2,0,198,0,0,0,0,0,0,0,0,NA,0,1
Pope,4/22/20,0,0,0,0,0,0,0,0,0,35,0,1170,0,20,0,0,0,15,0,1205,0,0,0,0,0,0,0,0,NA,0,-4
Prairie,4/22/20,0,0,0,0,0,0,0,0,0,2,0,18,0,1,0,0,0,1,0,20,0,0,0,0,0,0,0,0,NA,0,2
Pulaski,4/22/20,0,0,0,0,0,0,0,0,0,404,0,2162,0,161,0,12,0,231,0,2566,0,0,0,0,0,0,0,4,NA,0,113
Randolph,4/22/20,0,0,0,0,0,0,0,0,0,14,0,206,0,8,0,0,0,6,0,220,0,0,0,0,0,0,0,0,NA,0,-1
Saline,4/22/20,0,0,0,0,0,0,0,0,0,47,0,609,0,25,0,1,0,21,0,656,0,0,0,0,0,0,0,1,NA,0,8
Scott,4/22/20,0,0,0,0,0,0,0,0,0,1,0,4,0,1,0,0,0,0,0,5,0,0,0,0,0,0,0,0,NA,0,0
Searcy,4/22/20,0,0,0,0,0,0,0,0,0,6,0,88,0,2,0,0,0,4,0,94,0,0,0,0,0,0,0,0,NA,0,0
Sebastian,4/22/20,0,0,0,0,0,0,0,0,0,11,0,123,0,10,0,0,0,1,0,134,0,0,0,0,0,0,0,0,NA,0,-6
Sevier,4/22/20,0,0,0,0,0,0,0,0,0,10,0,151,0,6,0,0,0,4,0,161,0,0,0,0,0,0,0,0,NA,0,-2
Sharp,4/22/20,0,0,0,0,0,0,0,0,0,2,0,34,0,2,0,0,0,0,0,36,0,0,0,0,0,0,0,0,NA,0,-3
St.Francis,4/22/20,0,0,0,0,0,0,0,0,0,66,0,194,0,6,0,0,0,60,0,260,0,0,0,0,0,0,0,0,NA,0,-1
Stone,4/22/20,0,0,0,0,0,0,0,0,0,7,0,78,0,6,0,0,0,1,0,85,0,0,0,0,0,0,0,0,NA,0,-3
Union,4/22/20,0,0,0,0,0,0,0,0,0,26,0,187,0,12,0,0,0,14,0,213,0,0,0,0,0,0,0,0,NA,0,4
VanBuren,4/22/20,0,0,0,0,0,0,0,0,0,26,0,210,0,21,0,2,0,3,0,236,0,0,0,0,0,0,0,0,NA,0,2
Washington,4/22/20,0,0,0,0,0,0,0,0,0,60,0,530,0,35,0,0,0,25,0,590,0,0,0,0,0,0,0,0,NA,0,-10
White,4/22/20,0,0,0,0,0,0,0,0,0,29,0,296,0,14,0,1,0,14,0,325,0,0,0,0,0,0,0,0,NA,0,-9
Woodruff,4/22/20,0,0,0,0,0,0,0,0,0,1,0,12,0,0,0,0,0,1,0,13,0,0,0,0,0,0,0,0,NA,0,1
Yell,4/22/20,0,0,0,0,0,0,0,0,0,2,0,122,0,1,0,0,0,1,0,124,0,0,0,0,0,0,0,0,NA,0,0
Arkansas_all_counties,4/21/20,0,0,0,0,0,0,0,0,2990671,2227,0,26795,0,849,0,42,0,1336,0,29022,0,0,0,0,0,0,0,304,NA,0,2503
Arkansas_county,4/21/20,0,0,0,0,0,0,0,0,0,2,0,32,0,1,0,0,0,1,0,34,0,0,0,0,0,0,0,0,NA,0,-2
Ashley,4/21/20,0,0,0,0,0,0,0,0,0,13,0,224,0,1,0,0,0,12,0,237,0,0,0,0,0,0,0,1,NA,0,16
Baxter,4/21/20,0,0,0,0,0,0,0,0,0,5,0,155,0,1,0,0,0,4,0,160,0,0,0,0,0,0,0,0,NA,0,-3
Benton,4/21/20,0,0,0,0,0,0,0,0,0,67,0,1207,0,41,0,0,0,26,0,1274,0,0,0,0,0,0,0,5,NA,0,103
Boone,4/21/20,0,0,0,0,0,0,0,0,0,4,0,88,0,3,0,0,0,1,0,92,0,0,0,0,0,0,0,1,NA,0,7
Bradley,4/21/20,0,0,0,0,0,0,0,0,0,7,0,100,0,4,0,1,0,2,0,107,0,0,0,0,0,0,0,0,NA,0,3
Calhoun,4/21/20,0,0,0,0,0,0,0,0,0,0,0,16,0,0,0,0,0,0,0,16,0,0,0,0,0,0,0,0,NA,0,2
Carroll,4/21/20,0,0,0,0,0,0,0,0,0,2,0,126,0,1,0,0,0,1,0,128,0,0,0,0,0,0,0,0,NA,0,-1
Chicot,4/21/20,0,0,0,0,0,0,0,0,0,7,0,33,0,2,0,0,0,5,0,40,0,0,0,0,0,0,0,0,NA,0,2
Clark,4/21/20,0,0,0,0,0,0,0,0,0,27,0,61,0,18,0,0,0,9,0,88,0,0,0,0,0,0,0,0,NA,0,5
Clay,4/21/20,0,0,0,0,0,0,0,0,0,1,0,128,0,0,0,0,0,1,0,129,0,0,0,0,0,0,0,0,NA,0,11
Cleburne,4/21/20,0,0,0,0,0,0,0,0,0,71,0,128,0,51,0,4,0,16,0,199,0,0,0,0,0,0,0,0,NA,0,-2
Cleveland,4/21/20,0,0,0,0,0,0,0,0,0,8,0,117,0,7,0,0,0,1,0,125,0,0,0,0,0,0,0,0,NA,0,8
Columbia,4/21/20,0,0,0,0,0,0,0,0,0,5,0,202,0,3,0,0,0,2,0,207,0,0,0,0,0,0,0,0,NA,0,9
Conway,4/21/20,0,0,0,0,0,0,0,0,0,5,0,184,0,3,0,1,0,1,0,189,0,0,0,0,0,0,0,0,NA,0,-10
Craighead,4/21/20,0,0,0,0,0,0,0,0,0,48,0,509,0,28,0,1,0,19,0,557,0,0,0,0,0,0,0,4,NA,0,87
Crawford,4/21/20,0,0,0,0,0,0,0,0,0,4,0,84,0,2,0,0,0,2,0,88,0,0,0,0,0,0,0,0,NA,0,4
Crittenden,4/21/20,0,0,0,0,0,0,0,0,0,147,0,748,0,63,0,5,0,79,0,895,0,0,0,0,0,0,0,5,NA,0,67
Cross,4/21/20,0,0,0,0,0,0,0,0,0,9,0,82,0,4,0,0,0,5,0,91,0,0,0,0,0,0,0,1,NA,0,7
Dallas,4/21/20,0,0,0,0,0,0,0,0,0,1,0,52,0,1,0,0,0,0,0,53,0,0,0,0,0,0,0,0,NA,0,3
Desha,4/21/20,0,0,0,0,0,0,0,0,0,8,0,59,0,2,0,0,0,6,0,67,0,0,0,0,0,0,0,1,NA,0,1
Drew,4/21/20,0,0,0,0,0,0,0,0,0,6,0,120,0,4,0,1,0,1,0,126,0,0,0,0,0,0,0,0,NA,0,7
Faulkner,4/21/20,0,0,0,0,0,0,0,0,0,63,0,1020,0,43,0,2,0,18,0,1083,0,0,0,0,0,0,0,1,NA,0,13
Franklin,4/21/20,0,0,0,0,0,0,0,0,0,1,0,50,0,0,0,0,0,1,0,51,0,0,0,0,0,0,0,0,NA,0,-3
Fulton,4/21/20,0,0,0,0,0,0,0,0,0,0,0,31,0,0,0,0,0,0,0,31,0,0,0,0,0,0,0,0,NA,0,-2
Garland,4/21/20,0,0,0,0,0,0,0,0,0,109,0,1464,0,67,0,0,0,42,0,1573,0,0,0,0,0,0,0,1,NA,0,55
Grant,4/21/20,0,0,0,0,0,0,0,0,0,11,0,108,0,7,0,0,0,4,0,119,0,0,0,0,0,0,0,0,NA,0,9
Greene,4/21/20,0,0,0,0,0,0,0,0,0,9,0,414,0,3,0,0,0,6,0,423,0,0,0,0,0,0,0,1,NA,0,14
Hempstead,4/21/20,0,0,0,0,0,0,0,0,0,5,0,46,0,2,0,1,0,2,0,51,0,0,0,0,0,0,0,0,NA,0,4
HotSpring,4/21/20,0,0,0,0,0,0,0,0,0,8,0,182,0,5,0,0,0,3,0,190,0,0,0,0,0,0,0,0,NA,0,13
Howard,4/21/20,0,0,0,0,0,0,0,0,0,14,0,45,0,7,0,0,0,7,0,59,0,0,0,0,0,0,0,0,NA,0,0
Independence,4/21/20,0,0,0,0,0,0,0,0,0,8,0,141,0,4,0,0,0,4,0,149,0,0,0,0,0,0,0,0,NA,0,7
Izard,4/21/20,0,0,0,0,0,0,0,0,0,2,0,42,0,2,0,0,0,0,0,44,0,0,0,0,0,0,0,0,NA,0,10
Jackson,4/21/20,0,0,0,0,0,0,0,0,0,1,0,46,0,1,0,0,0,0,0,47,0,0,0,0,0,0,0,0,NA,0,5
Jefferson,4/21/20,0,0,0,0,0,0,0,0,0,135,0,854,0,49,0,7,0,79,0,989,0,0,0,0,0,0,0,9,NA,0,43
Johnson,4/21/20,0,0,0,0,0,0,0,0,0,22,0,133,0,11,0,0,0,11,0,155,0,0,0,0,0,0,0,0,NA,0,25
Lafayette,4/21/20,0,0,0,0,0,0,0,0,0,4,0,11,0,3,0,0,0,1,0,15,0,0,0,0,0,0,0,0,NA,0,1
Lawrence,4/21/20,0,0,0,0,0,0,0,0,0,28,0,141,0,2,0,1,0,25,0,169,0,0,0,0,0,0,0,2,NA,0,5
Lee,4/21/20,0,0,0,0,0,0,0,0,0,3,0,54,0,1,0,1,0,1,0,57,0,0,0,0,0,0,0,0,NA,0,10
Lincoln,4/21/20,0,0,0,0,0,0,0,0,0,443,0,545,0,7,0,0,0,436,0,988,0,0,0,0,0,0,0,185,NA,0,193
LittleRiver,4/21/20,0,0,0,0,0,0,0,0,0,0,0,75,0,0,0,0,0,0,0,75,0,0,0,0,0,0,0,0,NA,0,7
Logan,4/21/20,0,0,0,0,0,0,0,0,0,3,0,43,0,2,0,0,0,1,0,46,0,0,0,0,0,0,0,0,NA,0,1
Lonoke,4/21/20,0,0,0,0,0,0,0,0,0,27,0,331,0,19,0,0,0,8,0,358,0,0,0,0,0,0,0,1,NA,0,1
Madison,4/21/20,0,0,0,0,0,0,0,0,0,1,0,63,0,0,0,0,0,1,0,64,0,0,0,0,0,0,0,0,NA,0,-2
Marion,4/21/20,0,0,0,0,0,0,0,0,0,1,0,40,0,0,0,0,0,1,0,41,0,0,0,0,0,0,0,0,NA,0,2
Miller,4/21/20,0,0,0,0,0,0,0,0,0,30,0,174,0,14,0,0,0,16,0,204,0,0,0,0,0,0,0,0,NA,0,10
MissingCountyInfo,4/21/20,0,0,0,0,0,0,0,0,0,95,0,9160,0,4,0,NA,0,91,0,9255,0,0,0,0,0,0,0,52,NA,NA,1038
Mississippi,4/21/20,0,0,0,0,0,0,0,0,0,9,0,60,0,6,0,0,0,3,0,69,0,0,0,0,0,0,0,0,NA,0,10
Monroe,4/21/20,0,0,0,0,0,0,0,0,0,4,0,12,0,2,0,0,0,2,0,16,0,0,0,0,0,0,0,0,NA,0,0
Montgomery,4/21/20,0,0,0,0,0,0,0,0,0,0,0,18,0,0,0,0,0,0,0,18,0,0,0,0,0,0,0,0,NA,0,-2
Nevada,4/21/20,0,0,0,0,0,0,0,0,0,1,0,31,0,1,0,0,0,0,0,32,0,0,0,0,0,0,0,0,NA,0,1
Newton,4/21/20,0,0,0,0,0,0,0,0,0,2,0,61,0,2,0,0,0,0,0,63,0,0,0,0,0,0,0,0,NA,0,-3
Ouachita,4/21/20,0,0,0,0,0,0,0,0,0,5,0,163,0,5,0,0,0,0,0,168,0,0,0,0,0,0,0,0,NA,0,-2
Perry,4/21/20,0,0,0,0,0,0,0,0,0,3,0,56,0,2,0,0,0,1,0,59,0,0,0,0,0,0,0,0,NA,0,3
Phillips,4/21/20,0,0,0,0,0,0,0,0,0,4,0,131,0,1,0,1,0,2,0,135,0,0,0,0,0,0,0,0,NA,0,20
Pike,4/21/20,0,0,0,0,0,0,0,0,0,2,0,216,0,2,0,0,0,0,0,218,0,0,0,0,0,0,0,0,NA,0,-8
Poinsett,4/21/20,0,0,0,0,0,0,0,0,0,11,0,63,0,6,0,0,0,5,0,74,0,0,0,0,0,0,0,1,NA,0,18
Polk,4/21/20,0,0,0,0,0,0,0,0,0,7,0,190,0,5,0,0,0,2,0,197,0,0,0,0,0,0,0,0,NA,0,16
Pope,4/21/20,0,0,0,0,0,0,0,0,0,35,0,1174,0,20,0,0,0,15,0,1209,0,0,0,0,0,0,0,0,NA,0,-16
Prairie,4/21/20,0,0,0,0,0,0,0,0,0,2,0,16,0,1,0,0,0,1,0,18,0,0,0,0,0,0,0,0,NA,0,-3
Pulaski,4/21/20,0,0,0,0,0,0,0,0,0,400,0,2053,0,155,0,12,0,233,0,2453,0,0,0,0,0,0,0,12,NA,0,82
Randolph,4/21/20,0,0,0,0,0,0,0,0,0,14,0,207,0,8,0,0,0,6,0,221,0,0,0,0,0,0,0,0,NA,0,33
Saline,4/21/20,0,0,0,0,0,0,0,0,0,46,0,602,0,25,0,1,0,20,0,648,0,0,0,0,0,0,0,1,NA,0,22
Scott,4/21/20,0,0,0,0,0,0,0,0,0,1,0,4,0,1,0,0,0,0,0,5,0,0,0,0,0,0,0,0,NA,0,0
Searcy,4/21/20,0,0,0,0,0,0,0,0,0,6,0,88,0,2,0,0,0,4,0,94,0,0,0,0,0,0,0,0,NA,0,-1
Sebastian,4/21/20,0,0,0,0,0,0,0,0,0,11,0,129,0,10,0,0,0,1,0,140,0,0,0,0,0,0,0,0,NA,0,8
Sevier,4/21/20,0,0,0,0,0,0,0,0,0,10,0,153,0,6,0,0,0,4,0,163,0,0,0,0,0,0,0,0,NA,0,10
Sharp,4/21/20,0,0,0,0,0,0,0,0,0,2,0,37,0,1,0,0,0,1,0,39,0,0,0,0,0,0,0,0,NA,0,9
St.Francis,4/21/20,0,0,0,0,0,0,0,0,0,66,0,195,0,6,0,0,0,60,0,261,0,0,0,0,0,0,0,1,NA,0,3
Stone,4/21/20,0,0,0,0,0,0,0,0,0,7,0,81,0,6,0,0,0,1,0,88,0,0,0,0,0,0,0,0,NA,0,6
Union,4/21/20,0,0,0,0,0,0,0,0,0,26,0,183,0,11,0,0,0,15,0,209,0,0,0,0,0,0,0,0,NA,0,6
VanBuren,4/21/20,0,0,0,0,0,0,0,0,0,26,0,208,0,21,0,2,0,3,0,234,0,0,0,0,0,0,0,0,NA,0,-1
Washington,4/21/20,0,0,0,0,0,0,0,0,0,60,0,540,0,35,0,0,0,25,0,600,0,0,0,0,0,0,0,6,NA,0,85
White,4/21/20,0,0,0,0,0,0,0,0,0,29,0,305,0,14,0,1,0,14,0,334,0,0,0,0,0,0,0,0,NA,0,14
Woodruff,4/21/20,0,0,0,0,0,0,0,0,0,1,0,11,0,0,0,0,0,1,0,12,0,0,0,0,0,0,0,0,NA,0,2
Yell,4/21/20,0,0,0,0,0,0,0,0,0,2,0,122,0,1,0,0,0,1,0,124,0,0,0,0,0,0,0,0,NA,0,8
Arkansas_all_counties,4/20/20,0,0,0,0,0,0,0,0,2990671,1923,0,24631,0,749,0,42,0,1132,0,26554,0,0,0,0,0,0,0,142,NA,2,1703
Arkansas_county,4/20/20,0,0,0,0,0,0,0,0,0,2,0,34,0,1,0,0,0,1,0,36,0,0,0,0,0,0,0,0,NA,0,1
Ashley,4/20/20,0,0,0,0,0,0,0,0,0,12,0,209,0,0,0,0,0,12,0,221,0,0,0,0,0,0,0,1,NA,0,21
Baxter,4/20/20,0,0,0,0,0,0,0,0,0,5,0,158,0,1,0,0,0,4,0,163,0,0,0,0,0,0,0,0,NA,0,11
Benton,4/20/20,0,0,0,0,0,0,0,0,0,62,0,1109,0,41,0,0,0,21,0,1171,0,0,0,0,0,0,0,0,NA,0,76
Boone,4/20/20,0,0,0,0,0,0,0,0,0,3,0,82,0,2,0,0,0,1,0,85,0,0,0,0,0,0,0,0,NA,0,6
Bradley,4/20/20,0,0,0,0,0,0,0,0,0,7,0,97,0,3,0,1,0,3,0,104,0,0,0,0,0,0,0,0,NA,0,4
Calhoun,4/20/20,0,0,0,0,0,0,0,0,0,0,0,14,0,0,0,0,0,0,0,14,0,0,0,0,0,0,0,0,NA,0,0
Carroll,4/20/20,0,0,0,0,0,0,0,0,0,2,0,127,0,1,0,0,0,1,0,129,0,0,0,0,0,0,0,0,NA,0,1
Chicot,4/20/20,0,0,0,0,0,0,0,0,0,7,0,31,0,1,0,0,0,6,0,38,0,0,0,0,0,0,0,0,NA,0,8
Clark,4/20/20,0,0,0,0,0,0,0,0,0,27,0,56,0,15,0,0,0,12,0,83,0,0,0,0,0,0,0,0,NA,0,1
Clay,4/20/20,0,0,0,0,0,0,0,0,0,1,0,117,0,0,0,0,0,1,0,118,0,0,0,0,0,0,0,0,NA,0,43
Cleburne,4/20/20,0,0,0,0,0,0,0,0,0,71,0,130,0,51,0,4,0,16,0,201,0,0,0,0,0,0,0,1,NA,0,10
Cleveland,4/20/20,0,0,0,0,0,0,0,0,0,8,0,109,0,7,0,0,0,1,0,117,0,0,0,0,0,0,0,0,NA,0,3
Columbia,4/20/20,0,0,0,0,0,0,0,0,0,5,0,193,0,2,0,0,0,3,0,198,0,0,0,0,0,0,0,0,NA,0,128
Conway,4/20/20,0,0,0,0,0,0,0,0,0,5,0,194,0,3,0,1,0,1,0,199,0,0,0,0,0,0,0,0,NA,0,-1
Craighead,4/20/20,0,0,0,0,0,0,0,0,0,44,0,426,0,28,0,1,0,15,0,470,0,0,0,0,0,0,0,1,NA,0,-5
Crawford,4/20/20,0,0,0,0,0,0,0,0,0,4,0,80,0,2,0,0,0,2,0,84,0,0,0,0,0,0,0,0,NA,0,3
Crittenden,4/20/20,0,0,0,0,0,0,0,0,0,142,0,686,0,55,0,5,0,82,0,828,0,0,0,0,0,0,0,3,NA,1,14
Cross,4/20/20,0,0,0,0,0,0,0,0,0,8,0,76,0,4,0,0,0,4,0,84,0,0,0,0,0,0,0,0,NA,0,17
Dallas,4/20/20,0,0,0,0,0,0,0,0,0,1,0,49,0,1,0,0,0,0,0,50,0,0,0,0,0,0,0,0,NA,0,26
Desha,4/20/20,0,0,0,0,0,0,0,0,0,7,0,59,0,1,0,0,0,6,0,66,0,0,0,0,0,0,0,0,NA,0,-2
Drew,4/20/20,0,0,0,0,0,0,0,0,0,6,0,113,0,4,0,1,0,1,0,119,0,0,0,0,0,0,0,0,NA,0,23
Faulkner,4/20/20,0,0,0,0,0,0,0,0,0,62,0,1008,0,43,0,2,0,17,0,1070,0,0,0,0,0,0,0,0,NA,0,117
Franklin,4/20/20,0,0,0,0,0,0,0,0,0,1,0,53,0,0,0,0,0,1,0,54,0,0,0,0,0,0,0,0,NA,0,10
Fulton,4/20/20,0,0,0,0,0,0,0,0,0,0,0,33,0,0,0,0,0,0,0,33,0,0,0,0,0,0,0,0,NA,0,9
Garland,4/20/20,0,0,0,0,0,0,0,0,0,108,0,1410,0,62,0,0,0,46,0,1518,0,0,0,0,0,0,0,1,NA,0,1
Grant,4/20/20,0,0,0,0,0,0,0,0,0,11,0,99,0,7,0,0,0,4,0,110,0,0,0,0,0,0,0,0,NA,0,-2
Greene,4/20/20,0,0,0,0,0,0,0,0,0,8,0,401,0,3,0,0,0,5,0,409,0,0,0,0,0,0,0,0,NA,0,30
Hempstead,4/20/20,0,0,0,0,0,0,0,0,0,5,0,42,0,2,0,1,0,2,0,47,0,0,0,0,0,0,0,0,NA,0,2
HotSpring,4/20/20,0,0,0,0,0,0,0,0,0,8,0,169,0,5,0,0,0,3,0,177,0,0,0,0,0,0,0,0,NA,0,13
Howard,4/20/20,0,0,0,0,0,0,0,0,0,14,0,45,0,6,0,0,0,8,0,59,0,0,0,0,0,0,0,0,NA,0,0
Independence,4/20/20,0,0,0,0,0,0,0,0,0,8,0,134,0,4,0,0,0,4,0,142,0,0,0,0,0,0,0,0,NA,0,63
Izard,4/20/20,0,0,0,0,0,0,0,0,0,2,0,32,0,2,0,0,0,0,0,34,0,0,0,0,0,0,0,0,NA,0,4
Jackson,4/20/20,0,0,0,0,0,0,0,0,0,1,0,41,0,1,0,0,0,0,0,42,0,0,0,0,0,0,0,0,NA,0,4
Jefferson,4/20/20,0,0,0,0,0,0,0,0,0,126,0,820,0,45,0,7,0,74,0,946,0,0,0,0,0,0,0,8,NA,0,32
Johnson,4/20/20,0,0,0,0,0,0,0,0,0,22,0,108,0,11,0,0,0,11,0,130,0,0,0,0,0,0,0,0,NA,0,29
Lafayette,4/20/20,0,0,0,0,0,0,0,0,0,4,0,10,0,3,0,0,0,1,0,14,0,0,0,0,0,0,0,0,NA,0,0
Lawrence,4/20/20,0,0,0,0,0,0,0,0,0,26,0,138,0,0,0,1,0,25,0,164,0,0,0,0,0,0,0,0,NA,0,-1
Lee,4/20/20,0,0,0,0,0,0,0,0,0,3,0,44,0,1,0,1,0,1,0,47,0,0,0,0,0,0,0,0,NA,0,11
Lincoln,4/20/20,0,0,0,0,0,0,0,0,0,258,0,537,0,5,0,0,0,253,0,795,0,0,0,0,0,0,0,147,NA,0,465
LittleRiver,4/20/20,0,0,0,0,0,0,0,0,0,0,0,68,0,0,0,0,0,0,0,68,0,0,0,0,0,0,0,0,NA,0,19
Logan,4/20/20,0,0,0,0,0,0,0,0,0,3,0,42,0,1,0,0,0,2,0,45,0,0,0,0,0,0,0,0,NA,0,3
Lonoke,4/20/20,0,0,0,0,0,0,0,0,0,26,0,331,0,17,0,0,0,9,0,357,0,0,0,0,0,0,0,0,NA,0,33
Madison,4/20/20,0,0,0,0,0,0,0,0,0,1,0,65,0,0,0,0,0,1,0,66,0,0,0,0,0,0,0,0,NA,0,7
Marion,4/20/20,0,0,0,0,0,0,0,0,0,1,0,38,0,0,0,0,0,1,0,39,0,0,0,0,0,0,0,0,NA,0,-2
Miller,4/20/20,0,0,0,0,0,0,0,0,0,30,0,164,0,14,0,0,0,16,0,194,0,0,0,0,0,0,0,1,NA,0,7
MissingCountyInfo,4/20/20,0,0,0,0,0,0,0,0,0,43,0,8174,0,4,0,NA,0,39,0,8217,0,0,0,0,0,0,0,-3,NA,NA,369
Mississippi,4/20/20,0,0,0,0,0,0,0,0,0,9,0,50,0,6,0,0,0,3,0,59,0,0,0,0,0,0,0,1,NA,0,-1
Monroe,4/20/20,0,0,0,0,0,0,0,0,0,4,0,12,0,2,0,0,0,2,0,16,0,0,0,0,0,0,0,1,NA,0,0
Montgomery,4/20/20,0,0,0,0,0,0,0,0,0,0,0,20,0,0,0,0,0,0,0,20,0,0,0,0,0,0,0,0,NA,0,0
Nevada,4/20/20,0,0,0,0,0,0,0,0,0,1,0,30,0,1,0,0,0,0,0,31,0,0,0,0,0,0,0,0,NA,0,5
Newton,4/20/20,0,0,0,0,0,0,0,0,0,2,0,64,0,2,0,0,0,0,0,66,0,0,0,0,0,0,0,0,NA,0,-1
Ouachita,4/20/20,0,0,0,0,0,0,0,0,0,5,0,165,0,5,0,0,0,0,0,170,0,0,0,0,0,0,0,0,NA,0,9
Perry,4/20/20,0,0,0,0,0,0,0,0,0,3,0,53,0,2,0,0,0,1,0,56,0,0,0,0,0,0,0,0,NA,0,-4
Phillips,4/20/20,0,0,0,0,0,0,0,0,0,4,0,111,0,0,0,1,0,3,0,115,0,0,0,0,0,0,0,0,NA,0,43
Pike,4/20/20,0,0,0,0,0,0,0,0,0,2,0,224,0,2,0,0,0,0,0,226,0,0,0,0,0,0,0,0,NA,0,3
Poinsett,4/20/20,0,0,0,0,0,0,0,0,0,10,0,46,0,5,0,0,0,5,0,56,0,0,0,0,0,0,0,0,NA,0,-1
Polk,4/20/20,0,0,0,0,0,0,0,0,0,7,0,174,0,4,0,0,0,3,0,181,0,0,0,0,0,0,0,0,NA,0,1
Pope,4/20/20,0,0,0,0,0,0,0,0,0,35,0,1190,0,18,0,0,0,17,0,1225,0,0,0,0,0,0,0,0,NA,0,19
Prairie,4/20/20,0,0,0,0,0,0,0,0,0,2,0,19,0,1,0,0,0,1,0,21,0,0,0,0,0,0,0,0,NA,0,1
Pulaski,4/20/20,0,0,0,0,0,0,0,0,0,388,0,1983,0,144,0,12,0,232,0,2371,0,0,0,0,0,0,0,11,NA,0,179
Randolph,4/20/20,0,0,0,0,0,0,0,0,0,14,0,174,0,8,0,0,0,6,0,188,0,0,0,0,0,0,0,3,NA,0,7
Saline,4/20/20,0,0,0,0,0,0,0,0,0,45,0,581,0,24,0,1,0,20,0,626,0,0,0,0,0,0,0,2,NA,0,62
Scott,4/20/20,0,0,0,0,0,0,0,0,0,1,0,4,0,1,0,0,0,0,0,5,0,0,0,0,0,0,0,0,NA,0,0
Searcy,4/20/20,0,0,0,0,0,0,0,0,0,6,0,89,0,2,0,0,0,4,0,95,0,0,0,0,0,0,0,0,NA,0,0
Sebastian,4/20/20,0,0,0,0,0,0,0,0,0,11,0,121,0,10,0,0,0,1,0,132,0,0,0,0,0,0,0,0,NA,0,30
Sevier,4/20/20,0,0,0,0,0,0,0,0,0,10,0,143,0,6,0,0,0,4,0,153,0,0,0,0,0,0,0,1,NA,0,3
Sharp,4/20/20,0,0,0,0,0,0,0,0,0,2,0,28,0,1,0,0,0,1,0,30,0,0,0,0,0,0,0,0,NA,0,8
St.Francis,4/20/20,0,0,0,0,0,0,0,0,0,65,0,193,0,4,0,0,0,61,0,258,0,0,0,0,0,0,0,1,NA,0,11
Stone,4/20/20,0,0,0,0,0,0,0,0,0,7,0,75,0,6,0,0,0,1,0,82,0,0,0,0,0,0,0,0,NA,0,21
Union,4/20/20,0,0,0,0,0,0,0,0,0,26,0,177,0,10,0,0,0,16,0,203,0,0,0,0,0,0,0,2,NA,0,-3
VanBuren,4/20/20,0,0,0,0,0,0,0,0,0,26,0,209,0,21,0,2,0,3,0,235,0,0,0,0,0,0,0,0,NA,0,12
Washington,4/20/20,0,0,0,0,0,0,0,0,0,54,0,461,0,34,0,0,0,20,0,515,0,0,0,0,0,0,0,4,NA,0,37
White,4/20/20,0,0,0,0,0,0,0,0,0,29,0,291,0,15,0,1,0,13,0,320,0,0,0,0,0,0,0,0,NA,1,24
Woodruff,4/20/20,0,0,0,0,0,0,0,0,0,1,0,9,0,0,0,0,0,1,0,10,0,0,0,0,0,0,0,0,NA,0,1
Yell,4/20/20,0,0,0,0,0,0,0,0,0,2,0,114,0,1,0,0,0,1,0,116,0,0,0,0,0,0,0,0,NA,0,9
Arkansas_all_counties,4/19/20,0,0,0,0,0,0,0,0,2990671,1781,0,23070,0,721,0,40,0,1020,0,24851,0,0,0,0,0,0,0,42,NA,2,710
Arkansas_county,4/19/20,0,0,0,0,0,0,0,0,0,2,0,33,0,1,0,0,0,1,0,35,0,0,0,0,0,0,0,0,NA,0,3
Ashley,4/19/20,0,0,0,0,0,0,0,0,0,11,0,189,0,0,0,0,0,11,0,200,0,0,0,0,0,0,0,0,NA,0,1
Baxter,4/19/20,0,0,0,0,0,0,0,0,0,5,0,147,0,1,0,0,0,4,0,152,0,0,0,0,0,0,0,0,NA,0,1
Benton,4/19/20,0,0,0,0,0,0,0,0,0,62,0,1033,0,39,0,0,0,23,0,1095,0,0,0,0,0,0,0,0,NA,0,48
Boone,4/19/20,0,0,0,0,0,0,0,0,0,3,0,76,0,1,0,0,0,2,0,79,0,0,0,0,0,0,0,0,NA,0,3
Bradley,4/19/20,0,0,0,0,0,0,0,0,0,7,0,93,0,3,0,1,0,3,0,100,0,0,0,0,0,0,0,0,NA,1,1
Calhoun,4/19/20,0,0,0,0,0,0,0,0,0,0,0,14,0,0,0,0,0,0,0,14,0,0,0,0,0,0,0,0,NA,0,0
Carroll,4/19/20,0,0,0,0,0,0,0,0,0,2,0,126,0,1,0,0,0,1,0,128,0,0,0,0,0,0,0,0,NA,0,0
Chicot,4/19/20,0,0,0,0,0,0,0,0,0,7,0,23,0,1,0,0,0,6,0,30,0,0,0,0,0,0,0,0,NA,0,0
Clark,4/19/20,0,0,0,0,0,0,0,0,0,27,0,55,0,15,0,0,0,12,0,82,0,0,0,0,0,0,0,0,NA,0,1
Clay,4/19/20,0,0,0,0,0,0,0,0,0,1,0,74,0,0,0,0,0,1,0,75,0,0,0,0,0,0,0,0,NA,0,1
Cleburne,4/19/20,0,0,0,0,0,0,0,0,0,70,0,121,0,49,0,4,0,17,0,191,0,0,0,0,0,0,0,1,NA,0,2
Cleveland,4/19/20,0,0,0,0,0,0,0,0,0,8,0,106,0,7,0,0,0,1,0,114,0,0,0,0,0,0,0,0,NA,0,0
Columbia,4/19/20,0,0,0,0,0,0,0,0,0,5,0,65,0,1,0,0,0,4,0,70,0,0,0,0,0,0,0,1,NA,0,6
Conway,4/19/20,0,0,0,0,0,0,0,0,0,5,0,195,0,2,0,1,0,2,0,200,0,0,0,0,0,0,0,0,NA,0,5
Craighead,4/19/20,0,0,0,0,0,0,0,0,0,43,0,432,0,24,0,1,0,18,0,475,0,0,0,0,0,0,0,1,NA,0,18
Crawford,4/19/20,0,0,0,0,0,0,0,0,0,4,0,77,0,2,0,0,0,2,0,81,0,0,0,0,0,0,0,0,NA,0,3
Crittenden,4/19/20,0,0,0,0,0,0,0,0,0,139,0,675,0,46,0,4,0,89,0,814,0,0,0,0,0,0,0,6,NA,0,13
Cross,4/19/20,0,0,0,0,0,0,0,0,0,8,0,59,0,4,0,0,0,4,0,67,0,0,0,0,0,0,0,0,NA,0,3
Dallas,4/19/20,0,0,0,0,0,0,0,0,0,1,0,23,0,1,0,0,0,0,0,24,0,0,0,0,0,0,0,0,NA,0,1
Desha,4/19/20,0,0,0,0,0,0,0,0,0,7,0,61,0,1,0,0,0,6,0,68,0,0,0,0,0,0,0,1,NA,0,3
Drew,4/19/20,0,0,0,0,0,0,0,0,0,6,0,90,0,4,0,1,0,1,0,96,0,0,0,0,0,0,0,0,NA,0,2
Faulkner,4/19/20,0,0,0,0,0,0,0,0,0,62,0,891,0,41,0,2,0,19,0,953,0,0,0,0,0,0,0,2,NA,0,16
Franklin,4/19/20,0,0,0,0,0,0,0,0,0,1,0,43,0,0,0,0,0,1,0,44,0,0,0,0,0,0,0,0,NA,0,0
Fulton,4/19/20,0,0,0,0,0,0,0,0,0,0,0,24,0,0,0,0,0,0,0,24,0,0,0,0,0,0,0,0,NA,0,0
Garland,4/19/20,0,0,0,0,0,0,0,0,0,107,0,1410,0,57,0,0,0,50,0,1517,0,0,0,0,0,0,0,1,NA,0,58
Grant,4/19/20,0,0,0,0,0,0,0,0,0,11,0,101,0,5,0,0,0,6,0,112,0,0,0,0,0,0,0,0,NA,0,6
Greene,4/19/20,0,0,0,0,0,0,0,0,0,8,0,371,0,3,0,0,0,5,0,379,0,0,0,0,0,0,0,-1,NA,0,10
Hempstead,4/19/20,0,0,0,0,0,0,0,0,0,5,0,40,0,2,0,1,0,2,0,45,0,0,0,0,0,0,0,1,NA,0,1
HotSpring,4/19/20,0,0,0,0,0,0,0,0,0,8,0,156,0,5,0,0,0,3,0,164,0,0,0,0,0,0,0,0,NA,0,10
Howard,4/19/20,0,0,0,0,0,0,0,0,0,14,0,45,0,6,0,0,0,8,0,59,0,0,0,0,0,0,0,2,NA,0,5
Independence,4/19/20,0,0,0,0,0,0,0,0,0,8,0,71,0,4,0,0,0,4,0,79,0,0,0,0,0,0,0,1,NA,0,2
Izard,4/19/20,0,0,0,0,0,0,0,0,0,2,0,28,0,1,0,0,0,1,0,30,0,0,0,0,0,0,0,0,NA,0,1
Jackson,4/19/20,0,0,0,0,0,0,0,0,0,1,0,37,0,1,0,0,0,0,0,38,0,0,0,0,0,0,0,0,NA,0,3
Jefferson,4/19/20,0,0,0,0,0,0,0,0,0,118,0,796,0,40,0,6,0,72,0,914,0,0,0,0,0,0,0,4,NA,1,13
Johnson,4/19/20,0,0,0,0,0,0,0,0,0,22,0,79,0,11,0,0,0,11,0,101,0,0,0,0,0,0,0,1,NA,0,1
Lafayette,4/19/20,0,0,0,0,0,0,0,0,0,4,0,10,0,3,0,0,0,1,0,14,0,0,0,0,0,0,0,0,NA,0,0
Lawrence,4/19/20,0,0,0,0,0,0,0,0,0,26,0,139,0,0,0,1,0,25,0,165,0,0,0,0,0,0,0,1,NA,0,2
Lee,4/19/20,0,0,0,0,0,0,0,0,0,3,0,33,0,1,0,1,0,1,0,36,0,0,0,0,0,0,0,0,NA,0,0
Lincoln,4/19/20,0,0,0,0,0,0,0,0,0,111,0,219,0,5,0,0,0,106,0,330,0,0,0,0,0,0,0,1,NA,0,53
LittleRiver,4/19/20,0,0,0,0,0,0,0,0,0,0,0,49,0,0,0,0,0,0,0,49,0,0,0,0,0,0,0,0,NA,0,0
Logan,4/19/20,0,0,0,0,0,0,0,0,0,3,0,39,0,1,0,0,0,2,0,42,0,0,0,0,0,0,0,0,NA,0,1
Lonoke,4/19/20,0,0,0,0,0,0,0,0,0,26,0,298,0,16,0,0,0,10,0,324,0,0,0,0,0,0,0,0,NA,0,5
Madison,4/19/20,0,0,0,0,0,0,0,0,0,1,0,58,0,0,0,0,0,1,0,59,0,0,0,0,0,0,0,0,NA,0,1
Marion,4/19/20,0,0,0,0,0,0,0,0,0,1,0,40,0,0,0,0,0,1,0,41,0,0,0,0,0,0,0,0,NA,0,1
Miller,4/19/20,0,0,0,0,0,0,0,0,0,29,0,158,0,9,0,0,0,20,0,187,0,0,0,0,0,0,0,0,NA,0,9
MissingCountyInfo,4/19/20,0,0,0,0,0,0,0,0,0,46,0,7802,0,2,0,NA,0,44,0,7848,0,0,0,0,0,0,0,4,NA,NA,162
Mississippi,4/19/20,0,0,0,0,0,0,0,0,0,8,0,52,0,6,0,0,0,2,0,60,0,0,0,0,0,0,0,0,NA,0,0
Monroe,4/19/20,0,0,0,0,0,0,0,0,0,3,0,13,0,0,0,0,0,3,0,16,0,0,0,0,0,0,0,1,NA,0,1
Montgomery,4/19/20,0,0,0,0,0,0,0,0,0,0,0,20,0,0,0,0,0,0,0,20,0,0,0,0,0,0,0,0,NA,0,0
Nevada,4/19/20,0,0,0,0,0,0,0,0,0,1,0,25,0,1,0,0,0,0,0,26,0,0,0,0,0,0,0,0,NA,0,0
Newton,4/19/20,0,0,0,0,0,0,0,0,0,2,0,65,0,2,0,0,0,0,0,67,0,0,0,0,0,0,0,0,NA,0,0
Ouachita,4/19/20,0,0,0,0,0,0,0,0,0,5,0,156,0,5,0,0,0,0,0,161,0,0,0,0,0,0,0,0,NA,0,3
Perry,4/19/20,0,0,0,0,0,0,0,0,0,3,0,57,0,2,0,0,0,1,0,60,0,0,0,0,0,0,0,0,NA,0,1
Phillips,4/19/20,0,0,0,0,0,0,0,0,0,4,0,68,0,0,0,1,0,3,0,72,0,0,0,0,0,0,0,0,NA,0,18
Pike,4/19/20,0,0,0,0,0,0,0,0,0,2,0,221,0,2,0,0,0,0,0,223,0,0,0,0,0,0,0,0,NA,0,11
Poinsett,4/19/20,0,0,0,0,0,0,0,0,0,10,0,47,0,5,0,0,0,5,0,57,0,0,0,0,0,0,0,0,NA,0,1
Polk,4/19/20,0,0,0,0,0,0,0,0,0,7,0,173,0,4,0,0,0,3,0,180,0,0,0,0,0,0,0,0,NA,0,10
Pope,4/19/20,0,0,0,0,0,0,0,0,0,35,0,1171,0,16,0,0,0,19,0,1206,0,0,0,0,0,0,0,0,NA,0,24
Prairie,4/19/20,0,0,0,0,0,0,0,0,0,2,0,18,0,1,0,0,0,1,0,20,0,0,0,0,0,0,0,0,NA,0,0
Pulaski,4/19/20,0,0,0,0,0,0,0,0,0,377,0,1815,0,124,0,12,0,241,0,2192,0,0,0,0,0,0,0,9,NA,0,94
Randolph,4/19/20,0,0,0,0,0,0,0,0,0,11,0,170,0,8,0,0,0,3,0,181,0,0,0,0,0,0,0,0,NA,0,0
Saline,4/19/20,0,0,0,0,0,0,0,0,0,43,0,521,0,23,0,1,0,19,0,564,0,0,0,0,0,0,0,2,NA,0,24
Scott,4/19/20,0,0,0,0,0,0,0,0,0,1,0,4,0,1,0,0,0,0,0,5,0,0,0,0,0,0,0,0,NA,0,0
Searcy,4/19/20,0,0,0,0,0,0,0,0,0,6,0,89,0,2,0,0,0,4,0,95,0,0,0,0,0,0,0,0,NA,0,0
Sebastian,4/19/20,0,0,0,0,0,0,0,0,0,11,0,91,0,8,0,0,0,3,0,102,0,0,0,0,0,0,0,0,NA,0,2
Sevier,4/19/20,0,0,0,0,0,0,0,0,0,9,0,141,0,6,0,0,0,3,0,150,0,0,0,0,0,0,0,0,NA,0,6
Sharp,4/19/20,0,0,0,0,0,0,0,0,0,2,0,20,0,1,0,0,0,1,0,22,0,0,0,0,0,0,0,0,NA,0,0
St.Francis,4/19/20,0,0,0,0,0,0,0,0,0,64,0,183,0,4,0,0,0,60,0,247,0,0,0,0,0,0,0,0,NA,0,21
Stone,4/19/20,0,0,0,0,0,0,0,0,0,7,0,54,0,6,0,0,0,1,0,61,0,0,0,0,0,0,0,0,NA,0,0
Union,4/19/20,0,0,0,0,0,0,0,0,0,24,0,182,0,9,0,0,0,15,0,206,0,0,0,0,0,0,0,1,NA,0,3
VanBuren,4/19/20,0,0,0,0,0,0,0,0,0,26,0,197,0,21,0,2,0,3,0,223,0,0,0,0,0,0,0,0,NA,0,0
Washington,4/19/20,0,0,0,0,0,0,0,0,0,46,0,432,0,32,0,0,0,14,0,478,0,0,0,0,0,0,0,1,NA,0,13
White,4/19/20,0,0,0,0,0,0,0,0,0,29,0,267,0,15,0,0,0,14,0,296,0,0,0,0,0,0,0,0,NA,0,0
Woodruff,4/19/20,0,0,0,0,0,0,0,0,0,1,0,8,0,0,0,0,0,1,0,9,0,0,0,0,0,0,0,0,NA,0,0
Yell,4/19/20,0,0,0,0,0,0,0,0,0,2,0,105,0,1,0,0,0,1,0,107,0,0,0,0,0,0,0,0,NA,0,2
Arkansas_all_counties,4/18/20,0,0,0,0,0,0,0,0,2990671,1739,0,22402,0,703,0,38,0,998,0,24141,0,0,0,0,0,0,0,44,NA,1,0
Arkansas_county,4/18/20,0,0,0,0,0,0,0,0,0,2,0,30,0,1,0,0,0,1,0,32,0,0,0,0,0,0,0,0,NA,0,0
Ashley,4/18/20,0,0,0,0,0,0,0,0,0,11,0,188,0,0,0,0,0,11,0,199,0,0,0,0,0,0,0,0,NA,0,3
Baxter,4/18/20,0,0,0,0,0,0,0,0,0,5,0,146,0,1,0,0,0,4,0,151,0,0,0,0,0,0,0,1,NA,0,1
Benton,4/18/20,0,0,0,0,0,0,0,0,0,62,0,985,0,39,0,0,0,23,0,1047,0,0,0,0,0,0,0,0,NA,0,19
Boone,4/18/20,0,0,0,0,0,0,0,0,0,3,0,73,0,1,0,0,0,2,0,76,0,0,0,0,0,0,0,0,NA,0,3
Bradley,4/18/20,0,0,0,0,0,0,0,0,0,7,0,92,0,3,0,0,0,4,0,99,0,0,0,0,0,0,0,0,NA,0,2
Calhoun,4/18/20,0,0,0,0,0,0,0,0,0,0,0,14,0,0,0,0,0,0,0,14,0,0,0,0,0,0,0,0,NA,0,1
Carroll,4/18/20,0,0,0,0,0,0,0,0,0,2,0,126,0,1,0,0,0,1,0,128,0,0,0,0,0,0,0,0,NA,0,1
Chicot,4/18/20,0,0,0,0,0,0,0,0,0,7,0,23,0,1,0,0,0,6,0,30,0,0,0,0,0,0,0,0,NA,0,0
Clark,4/18/20,0,0,0,0,0,0,0,0,0,27,0,54,0,15,0,0,0,12,0,81,0,0,0,0,0,0,0,0,NA,0,0
Clay,4/18/20,0,0,0,0,0,0,0,0,0,1,0,73,0,0,0,0,0,1,0,74,0,0,0,0,0,0,0,0,NA,0,1
Cleburne,4/18/20,0,0,0,0,0,0,0,0,0,69,0,120,0,49,0,4,0,16,0,189,0,0,0,0,0,0,0,-1,NA,0,4
Cleveland,4/18/20,0,0,0,0,0,0,0,0,0,8,0,106,0,7,0,0,0,1,0,114,0,0,0,0,0,0,0,0,NA,0,1
Columbia,4/18/20,0,0,0,0,0,0,0,0,0,4,0,60,0,1,0,0,0,3,0,64,0,0,0,0,0,0,0,0,NA,0,3
Conway,4/18/20,0,0,0,0,0,0,0,0,0,5,0,190,0,2,0,1,0,2,0,195,0,0,0,0,0,0,0,0,NA,0,8
Craighead,4/18/20,0,0,0,0,0,0,0,0,0,42,0,415,0,24,0,1,0,17,0,457,0,0,0,0,0,0,0,2,NA,0,15
Crawford,4/18/20,0,0,0,0,0,0,0,0,0,4,0,74,0,2,0,0,0,2,0,78,0,0,0,0,0,0,0,0,NA,0,3
Crittenden,4/18/20,0,0,0,0,0,0,0,0,0,133,0,668,0,42,0,4,0,87,0,801,0,0,0,0,0,0,0,6,NA,0,18
Cross,4/18/20,0,0,0,0,0,0,0,0,0,8,0,56,0,4,0,0,0,4,0,64,0,0,0,0,0,0,0,0,NA,0,0
Dallas,4/18/20,0,0,0,0,0,0,0,0,0,1,0,22,0,1,0,0,0,0,0,23,0,0,0,0,0,0,0,0,NA,0,1
Desha,4/18/20,0,0,0,0,0,0,0,0,0,6,0,59,0,1,0,0,0,5,0,65,0,0,0,0,0,0,0,0,NA,0,1
Drew,4/18/20,0,0,0,0,0,0,0,0,0,6,0,88,0,3,0,1,0,2,0,94,0,0,0,0,0,0,0,0,NA,0,1
Faulkner,4/18/20,0,0,0,0,0,0,0,0,0,60,0,877,0,40,0,2,0,18,0,937,0,0,0,0,0,0,0,1,NA,0,53
Franklin,4/18/20,0,0,0,0,0,0,0,0,0,1,0,43,0,0,0,0,0,1,0,44,0,0,0,0,0,0,0,0,NA,0,1
Fulton,4/18/20,0,0,0,0,0,0,0,0,0,0,0,24,0,0,0,0,0,0,0,24,0,0,0,0,0,0,0,0,NA,0,1
Garland,4/18/20,0,0,0,0,0,0,0,0,0,106,0,1353,0,56,0,0,0,50,0,1459,0,0,0,0,0,0,0,-1,NA,0,39
Grant,4/18/20,0,0,0,0,0,0,0,0,0,11,0,95,0,5,0,0,0,6,0,106,0,0,0,0,0,0,0,0,NA,0,3
Greene,4/18/20,0,0,0,0,0,0,0,0,0,9,0,360,0,3,0,0,0,6,0,369,0,0,0,0,0,0,0,3,NA,0,9
Hempstead,4/18/20,0,0,0,0,0,0,0,0,0,4,0,40,0,2,0,1,0,1,0,44,0,0,0,0,0,0,0,0,NA,0,5
HotSpring,4/18/20,0,0,0,0,0,0,0,0,0,8,0,146,0,5,0,0,0,3,0,154,0,0,0,0,0,0,0,0,NA,0,3
Howard,4/18/20,0,0,0,0,0,0,0,0,0,12,0,42,0,6,0,0,0,6,0,54,0,0,0,0,0,0,0,0,NA,0,2
Independence,4/18/20,0,0,0,0,0,0,0,0,0,7,0,70,0,4,0,0,0,3,0,77,0,0,0,0,0,0,0,0,NA,0,0
Izard,4/18/20,0,0,0,0,0,0,0,0,0,2,0,27,0,1,0,0,0,1,0,29,0,0,0,0,0,0,0,0,NA,0,0
Jackson,4/18/20,0,0,0,0,0,0,0,0,0,1,0,34,0,1,0,0,0,0,0,35,0,0,0,0,0,0,0,0,NA,0,0
Jefferson,4/18/20,0,0,0,0,0,0,0,0,0,114,0,787,0,37,0,6,0,71,0,901,0,0,0,0,0,0,0,1,NA,0,8
Johnson,4/18/20,0,0,0,0,0,0,0,0,0,21,0,79,0,11,0,0,0,10,0,100,0,0,0,0,0,0,0,1,NA,0,2
Lafayette,4/18/20,0,0,0,0,0,0,0,0,0,4,0,10,0,3,0,0,0,1,0,14,0,0,0,0,0,0,0,-1,NA,0,1
Lawrence,4/18/20,0,0,0,0,0,0,0,0,0,25,0,138,0,0,0,1,0,24,0,163,0,0,0,0,0,0,0,1,NA,0,20
Lee,4/18/20,0,0,0,0,0,0,0,0,0,3,0,33,0,1,0,1,0,1,0,36,0,0,0,0,0,0,0,0,NA,0,1
Lincoln,4/18/20,0,0,0,0,0,0,0,0,0,110,0,167,0,5,0,0,0,105,0,277,0,0,0,0,0,0,0,16,NA,0,50
LittleRiver,4/18/20,0,0,0,0,0,0,0,0,0,0,0,49,0,0,0,0,0,0,0,49,0,0,0,0,0,0,0,0,NA,0,12
Logan,4/18/20,0,0,0,0,0,0,0,0,0,3,0,38,0,1,0,0,0,2,0,41,0,0,0,0,0,0,0,1,NA,0,2
Lonoke,4/18/20,0,0,0,0,0,0,0,0,0,26,0,293,0,16,0,0,0,10,0,319,0,0,0,0,0,0,0,-4,NA,0,4
Madison,4/18/20,0,0,0,0,0,0,0,0,0,1,0,57,0,0,0,0,0,1,0,58,0,0,0,0,0,0,0,0,NA,0,0
Marion,4/18/20,0,0,0,0,0,0,0,0,0,1,0,39,0,0,0,0,0,1,0,40,0,0,0,0,0,0,0,0,NA,0,0
Miller,4/18/20,0,0,0,0,0,0,0,0,0,29,0,149,0,9,0,0,0,20,0,178,0,0,0,0,0,0,0,0,NA,0,4
MissingCountyInfo,4/18/20,0,0,0,0,0,0,0,0,0,42,0,7644,0,2,0,NA,0,40,0,7686,0,0,0,0,0,0,0,-1,NA,NA,135
Mississippi,4/18/20,0,0,0,0,0,0,0,0,0,8,0,52,0,6,0,0,0,2,0,60,0,0,0,0,0,0,0,0,NA,0,0
Monroe,4/18/20,0,0,0,0,0,0,0,0,0,2,0,13,0,0,0,0,0,2,0,15,0,0,0,0,0,0,0,0,NA,0,0
Montgomery,4/18/20,0,0,0,0,0,0,0,0,0,0,0,20,0,0,0,0,0,0,0,20,0,0,0,0,0,0,0,0,NA,0,0
Nevada,4/18/20,0,0,0,0,0,0,0,0,0,1,0,25,0,1,0,0,0,0,0,26,0,0,0,0,0,0,0,0,NA,0,0
Newton,4/18/20,0,0,0,0,0,0,0,0,0,2,0,65,0,2,0,0,0,0,0,67,0,0,0,0,0,0,0,0,NA,0,0
Ouachita,4/18/20,0,0,0,0,0,0,0,0,0,5,0,153,0,5,0,0,0,0,0,158,0,0,0,0,0,0,0,0,NA,0,2
Perry,4/18/20,0,0,0,0,0,0,0,0,0,3,0,56,0,2,0,0,0,1,0,59,0,0,0,0,0,0,0,0,NA,0,4
Phillips,4/18/20,0,0,0,0,0,0,0,0,0,4,0,50,0,0,0,1,0,3,0,54,0,0,0,0,0,0,0,0,NA,0,0
Pike,4/18/20,0,0,0,0,0,0,0,0,0,2,0,210,0,2,0,0,0,0,0,212,0,0,0,0,0,0,0,0,NA,0,6
Poinsett,4/18/20,0,0,0,0,0,0,0,0,0,10,0,46,0,5,0,0,0,5,0,56,0,0,0,0,0,0,0,0,NA,0,1
Polk,4/18/20,0,0,0,0,0,0,0,0,0,7,0,163,0,4,0,0,0,3,0,170,0,0,0,0,0,0,0,0,NA,0,9
Pope,4/18/20,0,0,0,0,0,0,0,0,0,35,0,1147,0,14,0,0,0,21,0,1182,0,0,0,0,0,0,0,2,NA,0,18
Prairie,4/18/20,0,0,0,0,0,0,0,0,0,2,0,18,0,1,0,0,0,1,0,20,0,0,0,0,0,0,0,0,NA,0,0
Pulaski,4/18/20,0,0,0,0,0,0,0,0,0,368,0,1730,0,122,0,12,0,234,0,2098,0,0,0,0,0,0,0,8,NA,1,83
Randolph,4/18/20,0,0,0,0,0,0,0,0,0,11,0,170,0,8,0,0,0,3,0,181,0,0,0,0,0,0,0,1,NA,0,2
Saline,4/18/20,0,0,0,0,0,0,0,0,0,41,0,499,0,22,0,1,0,18,0,540,0,0,0,0,0,0,0,4,NA,0,34
Scott,4/18/20,0,0,0,0,0,0,0,0,0,1,0,4,0,1,0,0,0,0,0,5,0,0,0,0,0,0,0,0,NA,0,0
Searcy,4/18/20,0,0,0,0,0,0,0,0,0,6,0,89,0,2,0,0,0,4,0,95,0,0,0,0,0,0,0,0,NA,0,0
Sebastian,4/18/20,0,0,0,0,0,0,0,0,0,11,0,89,0,8,0,0,0,3,0,100,0,0,0,0,0,0,0,0,NA,0,1
Sevier,4/18/20,0,0,0,0,0,0,0,0,0,8,0,136,0,6,0,0,0,2,0,144,0,0,0,0,0,0,0,0,NA,0,5
Sharp,4/18/20,0,0,0,0,0,0,0,0,0,2,0,20,0,1,0,0,0,1,0,22,0,0,0,0,0,0,0,0,NA,0,0
St.Francis,4/18/20,0,0,0,0,0,0,0,0,0,64,0,162,0,4,0,0,0,60,0,226,0,0,0,0,0,0,0,1,NA,0,16
Stone,4/18/20,0,0,0,0,0,0,0,0,0,7,0,54,0,6,0,0,0,1,0,61,0,0,0,0,0,0,0,0,NA,0,0
Union,4/18/20,0,0,0,0,0,0,0,0,0,23,0,180,0,8,0,0,0,15,0,203,0,0,0,0,0,0,0,3,NA,0,8
VanBuren,4/18/20,0,0,0,0,0,0,0,0,0,26,0,197,0,21,0,2,0,3,0,223,0,0,0,0,0,0,0,0,NA,0,3
Washington,4/18/20,0,0,0,0,0,0,0,0,0,45,0,420,0,31,0,0,0,14,0,465,0,0,0,0,0,0,0,0,NA,0,6
White,4/18/20,0,0,0,0,0,0,0,0,0,29,0,267,0,14,0,0,0,15,0,296,0,0,0,0,0,0,0,0,NA,0,5
Woodruff,4/18/20,0,0,0,0,0,0,0,0,0,1,0,8,0,0,0,0,0,1,0,9,0,0,0,0,0,0,0,0,NA,0,0
Yell,4/18/20,0,0,0,0,0,0,0,0,0,2,0,103,0,1,0,0,0,1,0,105,0,0,0,0,0,0,0,0,NA,0,3
Arkansas_all_counties,4/17/20,0,0,0,0,0,0,0,0,2990671,1695,0,22402,0,703,0,38,0,954,0,24097,0,0,0,0,0,0,0,75,NA,1,1466
Arkansas_county,4/17/20,0,0,0,0,0,0,0,0,0,2,0,30,0,1,0,0,0,1,0,32,0,0,0,0,0,0,0,0,NA,0,1
Ashley,4/17/20,0,0,0,0,0,0,0,0,0,11,0,185,0,0,0,0,0,11,0,196,0,0,0,0,0,0,0,0,NA,0,15
Baxter,4/17/20,0,0,0,0,0,0,0,0,0,4,0,146,0,0,0,0,0,4,0,150,0,0,0,0,0,0,0,0,NA,0,6
Benton,4/17/20,0,0,0,0,0,0,0,0,0,62,0,966,0,35,0,0,0,27,0,1028,0,0,0,0,0,0,0,1,NA,0,45
Boone,4/17/20,0,0,0,0,0,0,0,0,0,3,0,70,0,1,0,0,0,2,0,73,0,0,0,0,0,0,0,0,NA,0,4
Bradley,4/17/20,0,0,0,0,0,0,0,0,0,7,0,90,0,1,0,0,0,6,0,97,0,0,0,0,0,0,0,0,NA,0,4
Calhoun,4/17/20,0,0,0,0,0,0,0,0,0,0,0,13,0,0,0,0,0,0,0,13,0,0,0,0,0,0,0,0,NA,0,1
Carroll,4/17/20,0,0,0,0,0,0,0,0,0,2,0,125,0,0,0,0,0,2,0,127,0,0,0,0,0,0,0,0,NA,0,1
Chicot,4/17/20,0,0,0,0,0,0,0,0,0,7,0,23,0,0,0,0,0,7,0,30,0,0,0,0,0,0,0,0,NA,0,1
Clark,4/17/20,0,0,0,0,0,0,0,0,0,27,0,54,0,13,0,0,0,14,0,81,0,0,0,0,0,0,0,0,NA,0,4
Clay,4/17/20,0,0,0,0,0,0,0,0,0,1,0,72,0,0,0,0,0,1,0,73,0,0,0,0,0,0,0,0,NA,0,2
Cleburne,4/17/20,0,0,0,0,0,0,0,0,0,70,0,115,0,43,0,4,0,23,0,185,0,0,0,0,0,0,0,0,NA,0,1
Cleveland,4/17/20,0,0,0,0,0,0,0,0,0,8,0,105,0,6,0,0,0,2,0,113,0,0,0,0,0,0,0,0,NA,0,16
Columbia,4/17/20,0,0,0,0,0,0,0,0,0,4,0,57,0,1,0,0,0,3,0,61,0,0,0,0,0,0,0,0,NA,0,3
Conway,4/17/20,0,0,0,0,0,0,0,0,0,5,0,182,0,2,0,1,0,2,0,187,0,0,0,0,0,0,0,0,NA,0,8
Craighead,4/17/20,0,0,0,0,0,0,0,0,0,40,0,402,0,21,0,1,0,18,0,442,0,0,0,0,0,0,0,0,NA,0,17
Crawford,4/17/20,0,0,0,0,0,0,0,0,0,4,0,71,0,2,0,0,0,2,0,75,0,0,0,0,0,0,0,0,NA,0,7
Crittenden,4/17/20,0,0,0,0,0,0,0,0,0,127,0,656,0,33,0,4,0,90,0,783,0,0,0,0,0,0,0,5,NA,0,19
Cross,4/17/20,0,0,0,0,0,0,0,0,0,8,0,56,0,4,0,0,0,4,0,64,0,0,0,0,0,0,0,1,NA,0,2
Dallas,4/17/20,0,0,0,0,0,0,0,0,0,1,0,21,0,1,0,0,0,0,0,22,0,0,0,0,0,0,0,0,NA,0,0
Desha,4/17/20,0,0,0,0,0,0,0,0,0,6,0,58,0,1,0,0,0,5,0,64,0,0,0,0,0,0,0,0,NA,0,1
Drew,4/17/20,0,0,0,0,0,0,0,0,0,6,0,87,0,3,0,1,0,2,0,93,0,0,0,0,0,0,0,0,NA,0,3
Faulkner,4/17/20,0,0,0,0,0,0,0,0,0,59,0,825,0,36,0,2,0,21,0,884,0,0,0,0,0,0,0,0,NA,0,13
Franklin,4/17/20,0,0,0,0,0,0,0,0,0,1,0,42,0,0,0,0,0,1,0,43,0,0,0,0,0,0,0,0,NA,0,2
Fulton,4/17/20,0,0,0,0,0,0,0,0,0,0,0,23,0,0,0,0,0,0,0,23,0,0,0,0,0,0,0,0,NA,0,1
Garland,4/17/20,0,0,0,0,0,0,0,0,0,107,0,1313,0,50,0,0,0,57,0,1420,0,0,0,0,0,0,0,2,NA,0,49
Grant,4/17/20,0,0,0,0,0,0,0,0,0,11,0,92,0,4,0,0,0,7,0,103,0,0,0,0,0,0,0,0,NA,0,10
Greene,4/17/20,0,0,0,0,0,0,0,0,0,6,0,354,0,3,0,0,0,3,0,360,0,0,0,0,0,0,0,0,NA,0,9
Hempstead,4/17/20,0,0,0,0,0,0,0,0,0,4,0,35,0,2,0,1,0,1,0,39,0,0,0,0,0,0,0,0,NA,0,4
HotSpring,4/17/20,0,0,0,0,0,0,0,0,0,8,0,143,0,2,0,0,0,6,0,151,0,0,0,0,0,0,0,0,NA,0,7
Howard,4/17/20,0,0,0,0,0,0,0,0,0,12,0,40,0,6,0,0,0,6,0,52,0,0,0,0,0,0,0,0,NA,0,1
Independence,4/17/20,0,0,0,0,0,0,0,0,0,7,0,70,0,4,0,0,0,3,0,77,0,0,0,0,0,0,0,1,NA,0,3
Izard,4/17/20,0,0,0,0,0,0,0,0,0,2,0,27,0,1,0,0,0,1,0,29,0,0,0,0,0,0,0,0,NA,0,0
Jackson,4/17/20,0,0,0,0,0,0,0,0,0,1,0,34,0,0,0,0,0,1,0,35,0,0,0,0,0,0,0,0,NA,0,2
Jefferson,4/17/20,0,0,0,0,0,0,0,0,0,113,0,780,0,28,0,6,0,79,0,893,0,0,0,0,0,0,0,4,NA,0,28
Johnson,4/17/20,0,0,0,0,0,0,0,0,0,20,0,78,0,9,0,0,0,11,0,98,0,0,0,0,0,0,0,2,NA,0,8
Lafayette,4/17/20,0,0,0,0,0,0,0,0,0,5,0,8,0,2,0,0,0,3,0,13,0,0,0,0,0,0,0,0,NA,0,0
Lawrence,4/17/20,0,0,0,0,0,0,0,0,0,24,0,119,0,0,0,1,0,23,0,143,0,0,0,0,0,0,0,12,NA,0,21
Lee,4/17/20,0,0,0,0,0,0,0,0,0,3,0,32,0,1,0,1,0,1,0,35,0,0,0,0,0,0,0,0,NA,0,2
Lincoln,4/17/20,0,0,0,0,0,0,0,0,0,94,0,133,0,4,0,0,0,90,0,227,0,0,0,0,0,0,0,33,NA,0,71
LittleRiver,4/17/20,0,0,0,0,0,0,0,0,0,0,0,37,0,0,0,0,0,0,0,37,0,0,0,0,0,0,0,0,NA,0,4
Logan,4/17/20,0,0,0,0,0,0,0,0,0,2,0,37,0,1,0,0,0,1,0,39,0,0,0,0,0,0,0,0,NA,0,2
Lonoke,4/17/20,0,0,0,0,0,0,0,0,0,30,0,285,0,12,0,0,0,18,0,315,0,0,0,0,0,0,0,0,NA,0,15
Madison,4/17/20,0,0,0,0,0,0,0,0,0,1,0,57,0,0,0,0,0,1,0,58,0,0,0,0,0,0,0,0,NA,0,3
Marion,4/17/20,0,0,0,0,0,0,0,0,0,1,0,39,0,0,0,0,0,1,0,40,0,0,0,0,0,0,0,0,NA,0,2
Miller,4/17/20,0,0,0,0,0,0,0,0,0,29,0,145,0,8,0,0,0,21,0,174,0,0,0,0,0,0,0,0,NA,0,5
MissingCountyInfo,4/17/20,0,0,0,0,0,0,0,0,0,43,0,7508,0,NA,0,NA,0,43,0,7551,0,0,0,0,0,0,0,-1,NA,NA,174
Mississippi,4/17/20,0,0,0,0,0,0,0,0,0,8,0,52,0,6,0,0,0,2,0,60,0,0,0,0,0,0,0,0,NA,0,0
Monroe,4/17/20,0,0,0,0,0,0,0,0,0,2,0,13,0,0,0,0,0,2,0,15,0,0,0,0,0,0,0,0,NA,0,1
Montgomery,4/17/20,0,0,0,0,0,0,0,0,0,0,0,20,0,0,0,0,0,0,0,20,0,0,0,0,0,0,0,0,NA,0,0
Nevada,4/17/20,0,0,0,0,0,0,0,0,0,1,0,25,0,1,0,0,0,0,0,26,0,0,0,0,0,0,0,0,NA,0,4
Newton,4/17/20,0,0,0,0,0,0,0,0,0,2,0,65,0,2,0,0,0,0,0,67,0,0,0,0,0,0,0,1,NA,0,1
Ouachita,4/17/20,0,0,0,0,0,0,0,0,0,5,0,151,0,5,0,0,0,0,0,156,0,0,0,0,0,0,0,0,NA,0,3
Perry,4/17/20,0,0,0,0,0,0,0,0,0,3,0,52,0,2,0,0,0,1,0,55,0,0,0,0,0,0,0,1,NA,0,1
Phillips,4/17/20,0,0,0,0,0,0,0,0,0,4,0,50,0,0,0,1,0,3,0,54,0,0,0,0,0,0,0,0,NA,0,0
Pike,4/17/20,0,0,0,0,0,0,0,0,0,2,0,204,0,2,0,0,0,0,0,206,0,0,0,0,0,0,0,0,NA,0,3
Poinsett,4/17/20,0,0,0,0,0,0,0,0,0,10,0,45,0,4,0,0,0,6,0,55,0,0,0,0,0,0,0,1,NA,0,5
Polk,4/17/20,0,0,0,0,0,0,0,0,0,7,0,154,0,3,0,0,0,4,0,161,0,0,0,0,0,0,0,1,NA,0,4
Pope,4/17/20,0,0,0,0,0,0,0,0,0,33,0,1131,0,11,0,0,0,22,0,1164,0,0,0,0,0,0,0,0,NA,0,41
Prairie,4/17/20,0,0,0,0,0,0,0,0,0,2,0,18,0,1,0,0,0,1,0,20,0,0,0,0,0,0,0,0,NA,0,0
Pulaski,4/17/20,0,0,0,0,0,0,0,0,0,360,0,1655,0,104,0,11,0,245,0,2015,0,0,0,0,0,0,0,5,NA,0,90
Randolph,4/17/20,0,0,0,0,0,0,0,0,0,10,0,169,0,7,0,0,0,3,0,179,0,0,0,0,0,0,0,1,NA,0,5
Saline,4/17/20,0,0,0,0,0,0,0,0,0,37,0,469,0,16,0,1,0,20,0,506,0,0,0,0,0,0,0,1,NA,0,20
Scott,4/17/20,0,0,0,0,0,0,0,0,0,1,0,4,0,0,0,0,0,1,0,5,0,0,0,0,0,0,0,0,NA,0,0
Searcy,4/17/20,0,0,0,0,0,0,0,0,0,6,0,89,0,2,0,0,0,4,0,95,0,0,0,0,0,0,0,0,NA,0,1
Sebastian,4/17/20,0,0,0,0,0,0,0,0,0,11,0,88,0,8,0,0,0,3,0,99,0,0,0,0,0,0,0,0,NA,0,4
Sevier,4/17/20,0,0,0,0,0,0,0,0,0,8,0,131,0,5,0,0,0,3,0,139,0,0,0,0,0,0,0,0,NA,0,9
Sharp,4/17/20,0,0,0,0,0,0,0,0,0,2,0,20,0,1,0,0,0,1,0,22,0,0,0,0,0,0,0,0,NA,0,0
St.Francis,4/17/20,0,0,0,0,0,0,0,0,0,63,0,147,0,4,0,0,0,59,0,210,0,0,0,0,0,0,0,0,NA,0,2
Stone,4/17/20,0,0,0,0,0,0,0,0,0,7,0,54,0,6,0,0,0,1,0,61,0,0,0,0,0,0,0,0,NA,0,1
Union,4/17/20,0,0,0,0,0,0,0,0,0,20,0,175,0,7,0,0,0,13,0,195,0,0,0,0,0,0,0,1,NA,0,8
VanBuren,4/17/20,0,0,0,0,0,0,0,0,0,26,0,194,0,14,0,2,0,10,0,220,0,0,0,0,0,0,0,0,NA,0,2
Washington,4/17/20,0,0,0,0,0,0,0,0,0,45,0,414,0,29,0,0,0,16,0,459,0,0,0,0,0,0,0,1,NA,0,12
White,4/17/20,0,0,0,0,0,0,0,0,0,29,0,262,0,12,0,0,0,17,0,291,0,0,0,0,0,0,0,1,NA,0,8
Woodruff,4/17/20,0,0,0,0,0,0,0,0,0,1,0,8,0,0,0,0,0,1,0,9,0,0,0,0,0,0,0,0,NA,0,0
Yell,4/17/20,0,0,0,0,0,0,0,0,0,2,0,100,0,0,0,0,0,2,0,102,0,0,0,0,0,0,0,1,NA,0,2
Arkansas_all_counties,4/16/20,0,0,0,0,0,0,0,0,2990671,1620,0,21055,0,548,0,37,0,1035,0,22675,0,0,0,0,0,0,0,51,NA,4,1401
Arkansas_county,4/16/20,0,0,0,0,0,0,0,0,0,2,0,29,0,1,0,0,0,1,0,31,0,0,0,0,0,0,0,0,NA,0,0
Ashley,4/16/20,0,0,0,0,0,0,0,0,0,11,0,170,0,0,0,0,0,11,0,181,0,0,0,0,0,0,0,0,NA,0,1
Benton,4/16/20,0,0,0,0,0,0,0,0,0,61,0,922,0,36,0,0,0,25,0,983,0,0,0,0,0,0,0,-1,NA,0,34
Boone,4/16/20,0,0,0,0,0,0,0,0,0,3,0,66,0,1,0,0,0,2,0,69,0,0,0,0,0,0,0,0,NA,0,1
Bradley,4/16/20,0,0,0,0,0,0,0,0,0,7,0,86,0,1,0,0,0,6,0,93,0,0,0,0,0,0,0,0,NA,0,2
Calhoun,4/16/20,0,0,0,0,0,0,0,0,0,0,0,12,0,0,0,0,0,0,0,12,0,0,0,0,0,0,0,0,NA,0,0
Carroll,4/16/20,0,0,0,0,0,0,0,0,0,2,0,124,0,0,0,0,0,2,0,126,0,0,0,0,0,0,0,0,NA,0,3
Chicot,4/16/20,0,0,0,0,0,0,0,0,0,7,0,22,0,0,0,0,0,7,0,29,0,0,0,0,0,0,0,0,NA,0,0
Clark,4/16/20,0,0,0,0,0,0,0,0,0,27,0,50,0,13,0,0,0,14,0,77,0,0,0,0,0,0,0,0,NA,0,1
Clay,4/16/20,0,0,0,0,0,0,0,0,0,1,0,70,0,0,0,0,0,1,0,71,0,0,0,0,0,0,0,0,NA,0,1
Cleburne,4/16/20,0,0,0,0,0,0,0,0,0,70,0,114,0,42,0,4,0,24,0,184,0,0,0,0,0,0,0,0,NA,0,2
Cleveland,4/16/20,0,0,0,0,0,0,0,0,0,8,0,89,0,5,0,0,0,3,0,97,0,0,0,0,0,0,0,0,NA,0,19
Columbia,4/16/20,0,0,0,0,0,0,0,0,0,4,0,54,0,1,0,0,0,3,0,58,0,0,0,0,0,0,0,0,NA,0,2
Conway,4/16/20,0,0,0,0,0,0,0,0,0,5,0,174,0,2,0,1,0,2,0,179,0,0,0,0,0,0,0,0,NA,0,6
Craighead,4/16/20,0,0,0,0,0,0,0,0,0,40,0,385,0,19,0,1,0,20,0,425,0,0,0,0,0,0,0,2,NA,1,9
Crawford,4/16/20,0,0,0,0,0,0,0,0,0,4,0,64,0,2,0,0,0,2,0,68,0,0,0,0,0,0,0,0,NA,0,1
Crittenden,4/16/20,0,0,0,0,0,0,0,0,0,122,0,642,0,30,0,4,0,88,0,764,0,0,0,0,0,0,0,1,NA,2,14
Cross,4/16/20,0,0,0,0,0,0,0,0,0,7,0,55,0,3,0,0,0,4,0,62,0,0,0,0,0,0,0,0,NA,0,2
Dallas,4/16/20,0,0,0,0,0,0,0,0,0,1,0,21,0,1,0,0,0,0,0,22,0,0,0,0,0,0,0,0,NA,0,1
Desha,4/16/20,0,0,0,0,0,0,0,0,0,6,0,57,0,1,0,0,0,5,0,63,0,0,0,0,0,0,0,0,NA,0,3
Drew,4/16/20,0,0,0,0,0,0,0,0,0,6,0,84,0,2,0,1,0,3,0,90,0,0,0,0,0,0,0,0,NA,0,2
Faulkner,4/16/20,0,0,0,0,0,0,0,0,0,59,0,812,0,32,0,2,0,25,0,871,0,0,0,0,0,0,0,1,NA,0,33
Franklin,4/16/20,0,0,0,0,0,0,0,0,0,1,0,40,0,0,0,0,0,1,0,41,0,0,0,0,0,0,0,0,NA,0,1
Fulton,4/16/20,0,0,0,0,0,0,0,0,0,0,0,22,0,0,0,0,0,0,0,22,0,0,0,0,0,0,0,0,NA,0,1
Garland,4/16/20,0,0,0,0,0,0,0,0,0,105,0,1266,0,43,0,0,0,62,0,1371,0,0,0,0,0,0,0,2,NA,0,61
Grant,4/16/20,0,0,0,0,0,0,0,0,0,11,0,82,0,4,0,0,0,7,0,93,0,0,0,0,0,0,0,0,NA,0,4
Greene,4/16/20,0,0,0,0,0,0,0,0,0,6,0,345,0,3,0,0,0,3,0,351,0,0,0,0,0,0,0,0,NA,0,2
Hempstead,4/16/20,0,0,0,0,0,0,0,0,0,4,0,31,0,2,0,1,0,1,0,35,0,0,0,0,0,0,0,0,NA,0,0
HotSpring,4/16/20,0,0,0,0,0,0,0,0,0,8,0,136,0,2,0,0,0,6,0,144,0,0,0,0,0,0,0,0,NA,0,3
Howard,4/16/20,0,0,0,0,0,0,0,0,0,12,0,39,0,5,0,0,0,7,0,51,0,0,0,0,0,0,0,2,NA,0,4
Independence,4/16/20,0,0,0,0,0,0,0,0,0,6,0,68,0,4,0,0,0,2,0,74,0,0,0,0,0,0,0,0,NA,0,2
Izard,4/16/20,0,0,0,0,0,0,0,0,0,2,0,27,0,1,0,0,0,1,0,29,0,0,0,0,0,0,0,0,NA,0,0
Jackson,4/16/20,0,0,0,0,0,0,0,0,0,1,0,32,0,0,0,0,0,1,0,33,0,0,0,0,0,0,0,0,NA,0,2
Jefferson,4/16/20,0,0,0,0,0,0,0,0,0,109,0,756,0,37,0,6,0,66,0,865,0,0,0,0,0,0,0,3,NA,0,29
Johnson,4/16/20,0,0,0,0,0,0,0,0,0,18,0,72,0,9,0,0,0,9,0,90,0,0,0,0,0,0,0,2,NA,0,4
Lafayette,4/16/20,0,0,0,0,0,0,0,0,0,5,0,8,0,2,0,0,0,3,0,13,0,0,0,0,0,0,0,1,NA,0,1
Lawrence,4/16/20,0,0,0,0,0,0,0,0,0,12,0,110,0,0,0,1,0,11,0,122,0,0,0,0,0,0,0,1,NA,0,3
Lee,4/16/20,0,0,0,0,0,0,0,0,0,3,0,30,0,1,0,1,0,1,0,33,0,0,0,0,0,0,0,0,NA,0,1
Lincoln,4/16/20,0,0,0,0,0,0,0,0,0,61,0,95,0,4,0,0,0,57,0,156,0,0,0,0,0,0,0,2,NA,0,9
LittleRiver,4/16/20,0,0,0,0,0,0,0,0,0,0,0,33,0,0,0,0,0,0,0,33,0,0,0,0,0,0,0,0,NA,0,0
Logan,4/16/20,0,0,0,0,0,0,0,0,0,2,0,35,0,1,0,0,0,1,0,37,0,0,0,0,0,0,0,0,NA,0,2
Lonoke,4/16/20,0,0,0,0,0,0,0,0,0,30,0,270,0,11,0,0,0,19,0,300,0,0,0,0,0,0,0,0,NA,0,7
Madison,4/16/20,0,0,0,0,0,0,0,0,0,1,0,54,0,0,0,0,0,1,0,55,0,0,0,0,0,0,0,0,NA,0,0
Marion,4/16/20,0,0,0,0,0,0,0,0,0,1,0,37,0,0,0,0,0,1,0,38,0,0,0,0,0,0,0,0,NA,0,0
Miller,4/16/20,0,0,0,0,0,0,0,0,0,29,0,140,0,7,0,0,0,22,0,169,0,0,0,0,0,0,0,1,NA,0,8
MissingCountyInfo,4/16/20,0,0,0,0,0,0,0,0,0,44,0,7333,0,NA,0,NA,0,44,0,7377,0,0,0,0,0,0,0,-3,NA,NA,323
Mississippi,4/16/20,0,0,0,0,0,0,0,0,0,8,0,52,0,6,0,0,0,2,0,60,0,0,0,0,0,0,0,1,NA,0,1
Monroe,4/16/20,0,0,0,0,0,0,0,0,0,2,0,12,0,0,0,0,0,2,0,14,0,0,0,0,0,0,0,0,NA,0,0
Montgomery,4/16/20,0,0,0,0,0,0,0,0,0,0,0,20,0,0,0,0,0,0,0,20,0,0,0,0,0,0,0,0,NA,0,1
Nevada,4/16/20,0,0,0,0,0,0,0,0,0,1,0,21,0,1,0,0,0,0,0,22,0,0,0,0,0,0,0,0,NA,0,0
Newton,4/16/20,0,0,0,0,0,0,0,0,0,1,0,65,0,1,0,0,0,0,0,66,0,0,0,0,0,0,0,0,NA,0,0
Ouachita,4/16/20,0,0,0,0,0,0,0,0,0,5,0,148,0,5,0,0,0,0,0,153,0,0,0,0,0,0,0,0,NA,0,0
Perry,4/16/20,0,0,0,0,0,0,0,0,0,2,0,52,0,2,0,0,0,0,0,54,0,0,0,0,0,0,0,0,NA,0,1
Phillips,4/16/20,0,0,0,0,0,0,0,0,0,4,0,50,0,0,0,1,0,3,0,54,0,0,0,0,0,0,0,0,NA,0,0
Pike,4/16/20,0,0,0,0,0,0,0,0,0,2,0,201,0,2,0,0,0,0,0,203,0,0,0,0,0,0,0,0,NA,0,3
Poinsett,4/16/20,0,0,0,0,0,0,0,0,0,9,0,41,0,4,0,0,0,5,0,50,0,0,0,0,0,0,0,2,NA,0,3
Polk,4/16/20,0,0,0,0,0,0,0,0,0,6,0,151,0,3,0,0,0,3,0,157,0,0,0,0,0,0,0,0,NA,0,12
Pope,4/16/20,0,0,0,0,0,0,0,0,0,33,0,1090,0,11,0,0,0,22,0,1123,0,0,0,0,0,0,0,2,NA,0,35
Prairie,4/16/20,0,0,0,0,0,0,0,0,0,2,0,18,0,1,0,0,0,1,0,20,0,0,0,0,0,0,0,0,NA,0,0
Pulaski,4/16/20,0,0,0,0,0,0,0,0,0,355,0,1570,0,88,0,11,0,256,0,1925,0,0,0,0,0,0,0,12,NA,1,81
Randolph,4/16/20,0,0,0,0,0,0,0,0,0,9,0,165,0,7,0,0,0,2,0,174,0,0,0,0,0,0,0,0,NA,0,2
Saline,4/16/20,0,0,0,0,0,0,0,0,0,36,0,450,0,13,0,1,0,22,0,486,0,0,0,0,0,0,0,2,NA,0,24
Scott,4/16/20,0,0,0,0,0,0,0,0,0,1,0,4,0,0,0,0,0,1,0,5,0,0,0,0,0,0,0,0,NA,0,0
Searcy,4/16/20,0,0,0,0,0,0,0,0,0,6,0,88,0,2,0,0,0,4,0,94,0,0,0,0,0,0,0,0,NA,0,5
Sebastian,4/16/20,0,0,0,0,0,0,0,0,0,11,0,84,0,8,0,0,0,3,0,95,0,0,0,0,0,0,0,0,NA,0,1
Sevier,4/16/20,0,0,0,0,0,0,0,0,0,8,0,122,0,5,0,0,0,3,0,130,0,0,0,0,0,0,0,0,NA,0,5
Sharp,4/16/20,0,0,0,0,0,0,0,0,0,2,0,20,0,1,0,0,0,1,0,22,0,0,0,0,0,0,0,0,NA,0,0
St.Francis,4/16/20,0,0,0,0,0,0,0,0,0,63,0,145,0,3,0,0,0,60,0,208,0,0,0,0,0,0,0,8,NA,0,20
Stone,4/16/20,0,0,0,0,0,0,0,0,0,7,0,53,0,6,0,0,0,1,0,60,0,0,0,0,0,0,0,0,NA,0,1
Union,4/16/20,0,0,0,0,0,0,0,0,0,19,0,168,0,6,0,0,0,13,0,187,0,0,0,0,0,0,0,1,NA,0,3
VanBuren,4/16/20,0,0,0,0,0,0,0,0,0,26,0,192,0,14,0,2,0,10,0,218,0,0,0,0,0,0,0,0,NA,0,1
Washington,4/16/20,0,0,0,0,0,0,0,0,0,44,0,403,0,29,0,0,0,15,0,447,0,0,0,0,0,0,0,0,NA,0,21
White,4/16/20,0,0,0,0,0,0,0,0,0,28,0,255,0,12,0,0,0,16,0,283,0,0,0,0,0,0,0,0,NA,0,7
Woodruff,4/16/20,0,0,0,0,0,0,0,0,0,1,0,8,0,0,0,0,0,1,0,9,0,0,0,0,0,0,0,0,NA,0,0
Yell,4/16/20,0,0,0,0,0,0,0,0,0,1,0,99,0,0,0,0,0,1,0,100,0,0,0,0,0,0,0,0,NA,0,6
Arkansas_all_counties,4/15/20,0,0,0,0,0,0,0,0,2990671,1569,0,19705,0,489,0,33,0,1047,0,21274,0,0,0,0,0,0,0,71,NA,1,71
Arkansas_county,4/15/20,0,0,0,0,0,0,0,0,0,2,0,29,0,1,0,0,0,1,0,31,0,0,0,0,0,0,0,0,NA,0,2
Ashley,4/15/20,0,0,0,0,0,0,0,0,0,11,0,169,0,0,0,0,0,11,0,180,0,0,0,0,0,0,0,0,NA,0,3
Baxter,4/15/20,0,0,0,0,0,0,0,0,0,4,0,140,0,0,0,0,0,4,0,144,0,0,0,0,0,0,0,0,NA,0,5
Benton,4/15/20,0,0,0,0,0,0,0,0,0,62,0,887,0,34,0,0,0,28,0,949,0,0,0,0,0,0,0,2,NA,0,21
Boone,4/15/20,0,0,0,0,0,0,0,0,0,3,0,65,0,1,0,0,0,2,0,68,0,0,0,0,0,0,0,0,NA,0,0
Bradley,4/15/20,0,0,0,0,0,0,0,0,0,7,0,84,0,1,0,0,0,6,0,91,0,0,0,0,0,0,0,0,NA,0,0
Calhoun,4/15/20,0,0,0,0,0,0,0,0,0,0,0,12,0,0,0,0,0,0,0,12,0,0,0,0,0,0,0,0,NA,0,0
Carroll,4/15/20,0,0,0,0,0,0,0,0,0,2,0,121,0,0,0,0,0,2,0,123,0,0,0,0,0,0,0,0,NA,0,0
Chicot,4/15/20,0,0,0,0,0,0,0,0,0,7,0,22,0,0,0,0,0,7,0,29,0,0,0,0,0,0,0,0,NA,0,0
Clark,4/15/20,0,0,0,0,0,0,0,0,0,27,0,49,0,13,0,0,0,14,0,76,0,0,0,0,0,0,0,1,NA,0,2
Clay,4/15/20,0,0,0,0,0,0,0,0,0,1,0,69,0,0,0,0,0,1,0,70,0,0,0,0,0,0,0,0,NA,0,3
Cleburne,4/15/20,0,0,0,0,0,0,0,0,0,70,0,112,0,40,0,4,0,26,0,182,0,0,0,0,0,0,0,0,NA,0,1
Cleveland,4/15/20,0,0,0,0,0,0,0,0,0,8,0,70,0,4,0,0,0,4,0,78,0,0,0,0,0,0,0,0,NA,0,2
Columbia,4/15/20,0,0,0,0,0,0,0,0,0,4,0,52,0,1,0,0,0,3,0,56,0,0,0,0,0,0,0,1,NA,0,1
Conway,4/15/20,0,0,0,0,0,0,0,0,0,5,0,168,0,2,0,1,0,2,0,173,0,0,0,0,0,0,0,1,NA,0,7
Craighead,4/15/20,0,0,0,0,0,0,0,0,0,38,0,378,0,16,0,0,0,22,0,416,0,0,0,0,0,0,0,2,NA,0,13
Crawford,4/15/20,0,0,0,0,0,0,0,0,0,4,0,63,0,2,0,0,0,2,0,67,0,0,0,0,0,0,0,0,NA,0,3
Crittenden,4/15/20,0,0,0,0,0,0,0,0,0,121,0,629,0,25,0,2,0,94,0,750,0,0,0,0,0,0,0,5,NA,0,28
Cross,4/15/20,0,0,0,0,0,0,0,0,0,7,0,53,0,3,0,0,0,4,0,60,0,0,0,0,0,0,0,0,NA,0,1
Dallas,4/15/20,0,0,0,0,0,0,0,0,0,1,0,20,0,1,0,0,0,0,0,21,0,0,0,0,0,0,0,0,NA,0,2
Desha,4/15/20,0,0,0,0,0,0,0,0,0,6,0,54,0,1,0,0,0,5,0,60,0,0,0,0,0,0,0,0,NA,0,0
Drew,4/15/20,0,0,0,0,0,0,0,0,0,6,0,82,0,1,0,1,0,4,0,88,0,0,0,0,0,0,0,0,NA,0,1
Faulkner,4/15/20,0,0,0,0,0,0,0,0,0,58,0,780,0,30,0,2,0,26,0,838,0,0,0,0,0,0,0,1,NA,0,27
Franklin,4/15/20,0,0,0,0,0,0,0,0,0,1,0,39,0,0,0,0,0,1,0,40,0,0,0,0,0,0,0,-1,NA,0,1
Fulton,4/15/20,0,0,0,0,0,0,0,0,0,0,0,21,0,0,0,0,0,0,0,21,0,0,0,0,0,0,0,0,NA,0,0
Garland,4/15/20,0,0,0,0,0,0,0,0,0,103,0,1207,0,39,0,0,0,64,0,1310,0,0,0,0,0,0,0,1,NA,0,57
Grant,4/15/20,0,0,0,0,0,0,0,0,0,11,0,78,0,4,0,0,0,7,0,89,0,0,0,0,0,0,0,1,NA,0,4
Greene,4/15/20,0,0,0,0,0,0,0,0,0,6,0,343,0,3,0,0,0,3,0,349,0,0,0,0,0,0,0,0,NA,0,5
Hempstead,4/15/20,0,0,0,0,0,0,0,0,0,4,0,31,0,2,0,1,0,1,0,35,0,0,0,0,0,0,0,0,NA,0,2
HotSpring,4/15/20,0,0,0,0,0,0,0,0,0,8,0,133,0,1,0,0,0,7,0,141,0,0,0,0,0,0,0,0,NA,0,1
Howard,4/15/20,0,0,0,0,0,0,0,0,0,10,0,37,0,4,0,0,0,6,0,47,0,0,0,0,0,0,0,1,NA,0,2
Independence,4/15/20,0,0,0,0,0,0,0,0,0,6,0,66,0,4,0,0,0,2,0,72,0,0,0,0,0,0,0,0,NA,0,0
Izard,4/15/20,0,0,0,0,0,0,0,0,0,2,0,27,0,1,0,0,0,1,0,29,0,0,0,0,0,0,0,0,NA,0,1
Jackson,4/15/20,0,0,0,0,0,0,0,0,0,1,0,30,0,0,0,0,0,1,0,31,0,0,0,0,0,0,0,0,NA,0,1
Jefferson,4/15/20,0,0,0,0,0,0,0,0,0,106,0,730,0,23,0,6,0,77,0,836,0,0,0,0,0,0,0,1,NA,1,17
Johnson,4/15/20,0,0,0,0,0,0,0,0,0,16,0,70,0,9,0,0,0,7,0,86,0,0,0,0,0,0,0,-3,NA,0,2
Lafayette,4/15/20,0,0,0,0,0,0,0,0,0,4,0,8,0,1,0,0,0,3,0,12,0,0,0,0,0,0,0,1,NA,0,1
Lawrence,4/15/20,0,0,0,0,0,0,0,0,0,11,0,108,0,0,0,1,0,10,0,119,0,0,0,0,0,0,0,0,NA,0,2
Lee,4/15/20,0,0,0,0,0,0,0,0,0,3,0,29,0,0,0,1,0,2,0,32,0,0,0,0,0,0,0,1,NA,0,0
Lincoln,4/15/20,0,0,0,0,0,0,0,0,0,59,0,88,0,3,0,0,0,56,0,147,0,0,0,0,0,0,0,3,NA,0,9
LittleRiver,4/15/20,0,0,0,0,0,0,0,0,0,0,0,33,0,0,0,0,0,0,0,33,0,0,0,0,0,0,0,0,NA,0,3
Logan,4/15/20,0,0,0,0,0,0,0,0,0,2,0,33,0,0,0,0,0,2,0,35,0,0,0,0,0,0,0,0,NA,0,0
Lonoke,4/15/20,0,0,0,0,0,0,0,0,0,30,0,263,0,8,0,0,0,22,0,293,0,0,0,0,0,0,0,1,NA,0,7
Madison,4/15/20,0,0,0,0,0,0,0,0,0,1,0,54,0,0,0,0,0,1,0,55,0,0,0,0,0,0,0,0,NA,0,1
Marion,4/15/20,0,0,0,0,0,0,0,0,0,1,0,37,0,0,0,0,0,1,0,38,0,0,0,0,0,0,0,0,NA,0,2
Miller,4/15/20,0,0,0,0,0,0,0,0,0,28,0,133,0,4,0,0,0,24,0,161,0,0,0,0,0,0,0,0,NA,0,9
MissingCountyInfo,4/15/20,0,0,0,0,0,0,0,0,0,48,0,7006,0,NA,0,NA,0,48,0,7054,0,0,0,0,0,0,0,3,NA,NA,131
Mississippi,4/15/20,0,0,0,0,0,0,0,0,0,7,0,52,0,5,0,0,0,2,0,59,0,0,0,0,0,0,0,0,NA,0,5
Monroe,4/15/20,0,0,0,0,0,0,0,0,0,2,0,12,0,0,0,0,0,2,0,14,0,0,0,0,0,0,0,0,NA,0,1
Montgomery,4/15/20,0,0,0,0,0,0,0,0,0,0,0,19,0,0,0,0,0,0,0,19,0,0,0,0,0,0,0,0,NA,0,1
Nevada,4/15/20,0,0,0,0,0,0,0,0,0,1,0,21,0,1,0,0,0,0,0,22,0,0,0,0,0,0,0,0,NA,0,0
Newton,4/15/20,0,0,0,0,0,0,0,0,0,1,0,65,0,1,0,0,0,0,0,66,0,0,0,0,0,0,0,0,NA,0,0
Ouachita,4/15/20,0,0,0,0,0,0,0,0,0,5,0,148,0,4,0,0,0,1,0,153,0,0,0,0,0,0,0,0,NA,0,0
Perry,4/15/20,0,0,0,0,0,0,0,0,0,2,0,51,0,2,0,0,0,0,0,53,0,0,0,0,0,0,0,0,NA,0,3
Phillips,4/15/20,0,0,0,0,0,0,0,0,0,4,0,50,0,0,0,1,0,3,0,54,0,0,0,0,0,0,0,0,NA,0,0
Pike,4/15/20,0,0,0,0,0,0,0,0,0,2,0,198,0,2,0,0,0,0,0,200,0,0,0,0,0,0,0,0,NA,0,4
Poinsett,4/15/20,0,0,0,0,0,0,0,0,0,7,0,40,0,4,0,0,0,3,0,47,0,0,0,0,0,0,0,0,NA,0,3
Polk,4/15/20,0,0,0,0,0,0,0,0,0,6,0,139,0,3,0,0,0,3,0,145,0,0,0,0,0,0,0,0,NA,0,9
Pope,4/15/20,0,0,0,0,0,0,0,0,0,31,0,1057,0,8,0,0,0,23,0,1088,0,0,0,0,0,0,0,0,NA,0,6
Prairie,4/15/20,0,0,0,0,0,0,0,0,0,2,0,18,0,1,0,0,0,1,0,20,0,0,0,0,0,0,0,0,NA,0,0
Pulaski,4/15/20,0,0,0,0,0,0,0,0,0,343,0,1501,0,81,0,10,0,252,0,1844,0,0,0,0,0,0,0,46,NA,0,178
Randolph,4/15/20,0,0,0,0,0,0,0,0,0,9,0,163,0,7,0,0,0,2,0,172,0,0,0,0,0,0,0,1,NA,0,3
Saline,4/15/20,0,0,0,0,0,0,0,0,0,34,0,428,0,11,0,1,0,22,0,462,0,0,0,0,0,0,0,1,NA,0,9
Scott,4/15/20,0,0,0,0,0,0,0,0,0,1,0,4,0,0,0,0,0,1,0,5,0,0,0,0,0,0,0,0,NA,0,0
Searcy,4/15/20,0,0,0,0,0,0,0,0,0,6,0,83,0,1,0,0,0,5,0,89,0,0,0,0,0,0,0,0,NA,0,1
Sebastian,4/15/20,0,0,0,0,0,0,0,0,0,11,0,83,0,6,0,0,0,5,0,94,0,0,0,0,0,0,0,0,NA,0,1
Sevier,4/15/20,0,0,0,0,0,0,0,0,0,8,0,117,0,5,0,0,0,3,0,125,0,0,0,0,0,0,0,0,NA,0,4
Sharp,4/15/20,0,0,0,0,0,0,0,0,0,2,0,20,0,1,0,0,0,1,0,22,0,0,0,0,0,0,0,0,NA,0,0
St.Francis,4/15/20,0,0,0,0,0,0,0,0,0,45,0,143,0,3,0,0,0,42,0,188,0,0,0,0,0,0,0,0,NA,0,5
Stone,4/15/20,0,0,0,0,0,0,0,0,0,7,0,52,0,6,0,0,0,1,0,59,0,0,0,0,0,0,0,0,NA,0,0
Union,4/15/20,0,0,0,0,0,0,0,0,0,18,0,166,0,5,0,0,0,13,0,184,0,0,0,0,0,0,0,1,NA,0,2
VanBuren,4/15/20,0,0,0,0,0,0,0,0,0,26,0,191,0,13,0,2,0,11,0,217,0,0,0,0,0,0,0,0,NA,0,2
Washington,4/15/20,0,0,0,0,0,0,0,0,0,44,0,382,0,26,0,0,0,18,0,426,0,0,0,0,0,0,0,1,NA,0,8
White,4/15/20,0,0,0,0,0,0,0,0,0,28,0,248,0,11,0,0,0,17,0,276,0,0,0,0,0,0,0,0,NA,0,3
Woodruff,4/15/20,0,0,0,0,0,0,0,0,0,1,0,8,0,0,0,0,0,1,0,9,0,0,0,0,0,0,0,0,NA,0,0
Yell,4/15/20,0,0,0,0,0,0,0,0,0,1,0,93,0,0,0,0,0,1,0,94,0,0,0,0,0,0,0,0,NA,0,2
Arkansas_all_counties,4/14/20,0,0,0,0,0,0,0,0,2990671,1498,0,19705,0,444,0,32,0,1022,0,21203,0,0,0,0,0,0,0,88,NA,2,399
Arkansas_county,4/14/20,0,0,0,0,0,0,0,0,0,2,0,27,0,1,0,0,0,1,0,29,0,0,0,0,0,0,0,0,NA,0,0
Ashley,4/14/20,0,0,0,0,0,0,0,0,0,11,0,166,0,0,0,0,0,11,0,177,0,0,0,0,0,0,0,0,NA,0,0
Baxter,4/14/20,0,0,0,0,0,0,0,0,0,4,0,135,0,0,0,0,0,4,0,139,0,0,0,0,0,0,0,0,NA,0,0
Benton,4/14/20,0,0,0,0,0,0,0,0,0,60,0,868,0,32,0,0,0,28,0,928,0,0,0,0,0,0,0,10,NA,0,12
Boone,4/14/20,0,0,0,0,0,0,0,0,0,3,0,65,0,1,0,0,0,2,0,68,0,0,0,0,0,0,0,0,NA,0,0
Bradley,4/14/20,0,0,0,0,0,0,0,0,0,7,0,84,0,0,0,0,0,7,0,91,0,0,0,0,0,0,0,0,NA,0,3
Calhoun,4/14/20,0,0,0,0,0,0,0,0,0,0,0,12,0,0,0,0,0,0,0,12,0,0,0,0,0,0,0,0,NA,0,0
Carroll,4/14/20,0,0,0,0,0,0,0,0,0,2,0,121,0,0,0,0,0,2,0,123,0,0,0,0,0,0,0,0,NA,0,0
Chicot,4/14/20,0,0,0,0,0,0,0,0,0,7,0,22,0,0,0,0,0,7,0,29,0,0,0,0,0,0,0,2,NA,0,2
Clark,4/14/20,0,0,0,0,0,0,0,0,0,26,0,48,0,12,0,0,0,14,0,74,0,0,0,0,0,0,0,0,NA,0,1
Clay,4/14/20,0,0,0,0,0,0,0,0,0,1,0,66,0,0,0,0,0,1,0,67,0,0,0,0,0,0,0,0,NA,0,1
Cleburne,4/14/20,0,0,0,0,0,0,0,0,0,70,0,111,0,38,0,4,0,28,0,181,0,0,0,0,0,0,0,0,NA,0,0
Cleveland,4/14/20,0,0,0,0,0,0,0,0,0,8,0,68,0,4,0,0,0,4,0,76,0,0,0,0,0,0,0,0,NA,0,0
Columbia,4/14/20,0,0,0,0,0,0,0,0,0,3,0,52,0,1,0,0,0,2,0,55,0,0,0,0,0,0,0,0,NA,0,0
Conway,4/14/20,0,0,0,0,0,0,0,0,0,4,0,162,0,2,0,1,0,1,0,166,0,0,0,0,0,0,0,0,NA,0,3
Craighead,4/14/20,0,0,0,0,0,0,0,0,0,36,0,367,0,15,0,0,0,21,0,403,0,0,0,0,0,0,0,5,NA,0,17
Crawford,4/14/20,0,0,0,0,0,0,0,0,0,4,0,60,0,2,0,0,0,2,0,64,0,0,0,0,0,0,0,0,NA,0,0
Crittenden,4/14/20,0,0,0,0,0,0,0,0,0,116,0,606,0,19,0,2,0,95,0,722,0,0,0,0,0,0,0,13,NA,0,64
Cross,4/14/20,0,0,0,0,0,0,0,0,0,7,0,52,0,3,0,0,0,4,0,59,0,0,0,0,0,0,0,0,NA,0,1
Dallas,4/14/20,0,0,0,0,0,0,0,0,0,1,0,18,0,1,0,0,0,0,0,19,0,0,0,0,0,0,0,0,NA,0,0
Desha,4/14/20,0,0,0,0,0,0,0,0,0,6,0,54,0,1,0,0,0,5,0,60,0,0,0,0,0,0,0,0,NA,0,0
Drew,4/14/20,0,0,0,0,0,0,0,0,0,6,0,81,0,1,0,1,0,4,0,87,0,0,0,0,0,0,0,0,NA,0,1
Faulkner,4/14/20,0,0,0,0,0,0,0,0,0,58,0,753,0,27,0,1,0,30,0,811,0,0,0,0,0,0,0,1,NA,0,7
Franklin,4/14/20,0,0,0,0,0,0,0,0,0,2,0,37,0,0,0,0,0,2,0,39,0,0,0,0,0,0,0,1,NA,0,1
Fulton,4/14/20,0,0,0,0,0,0,0,0,0,0,0,21,0,0,0,0,0,0,0,21,0,0,0,0,0,0,0,0,NA,0,0
Garland,4/14/20,0,0,0,0,0,0,0,0,0,102,0,1151,0,34,0,0,0,68,0,1253,0,0,0,0,0,0,0,1,NA,0,20
Grant,4/14/20,0,0,0,0,0,0,0,0,0,10,0,75,0,4,0,0,0,6,0,85,0,0,0,0,0,0,0,0,NA,0,0
Greene,4/14/20,0,0,0,0,0,0,0,0,0,6,0,338,0,3,0,0,0,3,0,344,0,0,0,0,0,0,0,0,NA,0,4
Hempstead,4/14/20,0,0,0,0,0,0,0,0,0,4,0,29,0,2,0,1,0,1,0,33,0,0,0,0,0,0,0,-1,NA,0,0
HotSpring,4/14/20,0,0,0,0,0,0,0,0,0,8,0,132,0,0,0,0,0,8,0,140,0,0,0,0,0,0,0,0,NA,0,1
Howard,4/14/20,0,0,0,0,0,0,0,0,0,9,0,36,0,4,0,0,0,5,0,45,0,0,0,0,0,0,0,0,NA,0,0
Independence,4/14/20,0,0,0,0,0,0,0,0,0,6,0,66,0,4,0,0,0,2,0,72,0,0,0,0,0,0,0,0,NA,0,1
Izard,4/14/20,0,0,0,0,0,0,0,0,0,2,0,26,0,1,0,0,0,1,0,28,0,0,0,0,0,0,0,0,NA,0,0
Jackson,4/14/20,0,0,0,0,0,0,0,0,0,1,0,29,0,0,0,0,0,1,0,30,0,0,0,0,0,0,0,1,NA,0,1
Jefferson,4/14/20,0,0,0,0,0,0,0,0,0,105,0,714,0,23,0,5,0,77,0,819,0,0,0,0,0,0,0,5,NA,1,13
Johnson,4/14/20,0,0,0,0,0,0,0,0,0,19,0,65,0,6,0,0,0,13,0,84,0,0,0,0,0,0,0,6,NA,0,7
Lafayette,4/14/20,0,0,0,0,0,0,0,0,0,3,0,8,0,1,0,0,0,2,0,11,0,0,0,0,0,0,0,0,NA,0,0
Lawrence,4/14/20,0,0,0,0,0,0,0,0,0,11,0,106,0,0,0,1,0,10,0,117,0,0,0,0,0,0,0,0,NA,0,0
Lee,4/14/20,0,0,0,0,0,0,0,0,0,2,0,30,0,0,0,1,0,1,0,32,0,0,0,0,0,0,0,0,NA,1,1
Lincoln,4/14/20,0,0,0,0,0,0,0,0,0,56,0,82,0,3,0,0,0,53,0,138,0,0,0,0,0,0,0,0,NA,0,10
LittleRiver,4/14/20,0,0,0,0,0,0,0,0,0,0,0,30,0,0,0,0,0,0,0,30,0,0,0,0,0,0,0,0,NA,0,1
Logan,4/14/20,0,0,0,0,0,0,0,0,0,2,0,33,0,0,0,0,0,2,0,35,0,0,0,0,0,0,0,0,NA,0,0
Lonoke,4/14/20,0,0,0,0,0,0,0,0,0,29,0,257,0,8,0,0,0,21,0,286,0,0,0,0,0,0,0,0,NA,0,1
Madison,4/14/20,0,0,0,0,0,0,0,0,0,1,0,53,0,0,0,0,0,1,0,54,0,0,0,0,0,0,0,0,NA,0,0
Marion,4/14/20,0,0,0,0,0,0,0,0,0,1,0,35,0,0,0,0,0,1,0,36,0,0,0,0,0,0,0,0,NA,0,0
Miller,4/14/20,0,0,0,0,0,0,0,0,0,28,0,124,0,4,0,0,0,24,0,152,0,0,0,0,0,0,0,4,NA,0,5
MissingCountyInfo,4/14/20,0,0,0,0,0,0,0,0,0,45,0,6878,0,NA,0,NA,0,45,0,6923,0,0,0,0,0,0,0,9,NA,NA,137
Mississippi,4/14/20,0,0,0,0,0,0,0,0,0,7,0,47,0,4,0,0,0,3,0,54,0,0,0,0,0,0,0,0,NA,0,0
Monroe,4/14/20,0,0,0,0,0,0,0,0,0,2,0,11,0,0,0,0,0,2,0,13,0,0,0,0,0,0,0,0,NA,0,0
Montgomery,4/14/20,0,0,0,0,0,0,0,0,0,0,0,18,0,0,0,0,0,0,0,18,0,0,0,0,0,0,0,0,NA,0,0
Nevada,4/14/20,0,0,0,0,0,0,0,0,0,1,0,21,0,1,0,0,0,0,0,22,0,0,0,0,0,0,0,0,NA,0,1
Newton,4/14/20,0,0,0,0,0,0,0,0,0,1,0,65,0,1,0,0,0,0,0,66,0,0,0,0,0,0,0,0,NA,0,0
Ouachita,4/14/20,0,0,0,0,0,0,0,0,0,5,0,148,0,4,0,0,0,1,0,153,0,0,0,0,0,0,0,0,NA,0,0
Perry,4/14/20,0,0,0,0,0,0,0,0,0,2,0,48,0,2,0,0,0,0,0,50,0,0,0,0,0,0,0,0,NA,0,0
Phillips,4/14/20,0,0,0,0,0,0,0,0,0,4,0,50,0,0,0,1,0,3,0,54,0,0,0,0,0,0,0,0,NA,0,0
Pike,4/14/20,0,0,0,0,0,0,0,0,0,2,0,194,0,1,0,0,0,1,0,196,0,0,0,0,0,0,0,0,NA,0,0
Poinsett,4/14/20,0,0,0,0,0,0,0,0,0,7,0,37,0,4,0,0,0,3,0,44,0,0,0,0,0,0,0,0,NA,0,0
Polk,4/14/20,0,0,0,0,0,0,0,0,0,6,0,130,0,3,0,0,0,3,0,136,0,0,0,0,0,0,0,0,NA,0,3
Pope,4/14/20,0,0,0,0,0,0,0,0,0,31,0,1051,0,7,0,0,0,24,0,1082,0,0,0,0,0,0,0,0,NA,0,4
Prairie,4/14/20,0,0,0,0,0,0,0,0,0,2,0,18,0,1,0,0,0,1,0,20,0,0,0,0,0,0,0,0,NA,0,0
Pulaski,4/14/20,0,0,0,0,0,0,0,0,0,297,0,1369,0,68,0,10,0,219,0,1666,0,0,0,0,0,0,0,24,NA,0,38
Randolph,4/14/20,0,0,0,0,0,0,0,0,0,8,0,161,0,7,0,0,0,1,0,169,0,0,0,0,0,0,0,0,NA,0,1
Saline,4/14/20,0,0,0,0,0,0,0,0,0,33,0,420,0,10,0,1,0,22,0,453,0,0,0,0,0,0,0,1,NA,0,7
Scott,4/14/20,0,0,0,0,0,0,0,0,0,1,0,4,0,0,0,0,0,1,0,5,0,0,0,0,0,0,0,0,NA,0,0
Searcy,4/14/20,0,0,0,0,0,0,0,0,0,6,0,82,0,1,0,0,0,5,0,88,0,0,0,0,0,0,0,0,NA,0,0
Sebastian,4/14/20,0,0,0,0,0,0,0,0,0,11,0,82,0,6,0,0,0,5,0,93,0,0,0,0,0,0,0,0,NA,0,0
Sevier,4/14/20,0,0,0,0,0,0,0,0,0,8,0,113,0,5,0,0,0,3,0,121,0,0,0,0,0,0,0,0,NA,0,6
Sharp,4/14/20,0,0,0,0,0,0,0,0,0,2,0,20,0,0,0,0,0,2,0,22,0,0,0,0,0,0,0,0,NA,0,0
St.Francis,4/14/20,0,0,0,0,0,0,0,0,0,45,0,138,0,3,0,0,0,42,0,183,0,0,0,0,0,0,0,11,NA,0,20
Stone,4/14/20,0,0,0,0,0,0,0,0,0,7,0,52,0,5,0,0,0,2,0,59,0,0,0,0,0,0,0,0,NA,0,0
Union,4/14/20,0,0,0,0,0,0,0,0,0,17,0,165,0,5,0,0,0,12,0,182,0,0,0,0,0,0,0,0,NA,0,0
VanBuren,4/14/20,0,0,0,0,0,0,0,0,0,26,0,189,0,13,0,2,0,11,0,215,0,0,0,0,0,0,0,0,NA,0,1
Washington,4/14/20,0,0,0,0,0,0,0,0,0,43,0,375,0,25,0,0,0,18,0,418,0,0,0,0,0,0,0,6,NA,0,1
White,4/14/20,0,0,0,0,0,0,0,0,0,28,0,245,0,11,0,0,0,17,0,273,0,0,0,0,0,0,0,0,NA,0,1
Woodruff,4/14/20,0,0,0,0,0,0,0,0,0,1,0,8,0,0,0,0,0,1,0,9,0,0,0,0,0,0,0,0,NA,0,0
Yell,4/14/20,0,0,0,0,0,0,0,0,0,1,0,91,0,0,0,0,0,1,0,92,0,0,0,0,0,0,0,0,NA,0,1
Arkansas_all_counties,4/13/20,0,0,0,0,0,0,0,0,2990671,1410,0,19394,0,391,0,30,0,989,0,20804,0,0,0,0,0,0,0,130,24,3,1082
Arkansas_county,4/13/20,0,0,0,0,0,0,0,0,0,2,0,27,0,0,0,0,0,2,0,29,0,0,0,0,0,0,0,0,0,0,3
Ashley,4/13/20,0,0,0,0,0,0,0,0,0,11,0,166,0,0,0,0,0,11,0,177,0,0,0,0,0,0,0,1,0,0,13
Baxter,4/13/20,0,0,0,0,0,0,0,0,0,4,0,135,0,0,0,0,0,4,0,139,0,0,0,0,0,0,0,0,0,0,19
Benton,4/13/20,0,0,0,0,0,0,0,0,0,50,0,866,0,28,0,0,0,22,0,916,0,0,0,0,0,0,0,2,1,0,48
Boone,4/13/20,0,0,0,0,0,0,0,0,0,3,0,65,0,1,0,0,0,2,0,68,0,0,0,0,0,0,0,0,1,0,1
Bradley,4/13/20,0,0,0,0,0,0,0,0,0,7,0,81,0,0,0,0,0,7,0,88,0,0,0,0,0,0,0,0,0,0,4
Calhoun,4/13/20,0,0,0,0,0,0,0,0,0,0,0,12,0,0,0,0,0,0,0,12,0,0,0,0,0,0,0,0,0,0,0
Carroll,4/13/20,0,0,0,0,0,0,0,0,0,2,0,121,0,0,0,0,0,2,0,123,0,0,0,0,0,0,0,0,0,0,11
Chicot,4/13/20,0,0,0,0,0,0,0,0,0,5,0,22,0,0,0,0,0,5,0,27,0,0,0,0,0,0,0,0,0,0,1
Clark,4/13/20,0,0,0,0,0,0,0,0,0,26,0,47,0,12,0,0,0,14,0,73,0,0,0,0,0,0,0,-1,1,0,0
Clay,4/13/20,0,0,0,0,0,0,0,0,0,1,0,65,0,0,0,0,0,1,0,66,0,0,0,0,0,0,0,0,0,0,2
Cleburne,4/13/20,0,0,0,0,0,0,0,0,0,70,0,111,0,36,0,4,0,30,0,181,0,0,0,0,0,0,0,0,0,0,3
Cleveland,4/13/20,0,0,0,0,0,0,0,0,0,8,0,68,0,4,0,0,0,4,0,76,0,0,0,0,0,0,0,0,0,0,9
Columbia,4/13/20,0,0,0,0,0,0,0,0,0,3,0,52,0,1,0,0,0,2,0,55,0,0,0,0,0,0,0,0,0,0,2
Conway,4/13/20,0,0,0,0,0,0,0,0,0,4,0,159,0,2,0,1,0,1,0,163,0,0,0,0,0,0,0,0,1,0,7
Craighead,4/13/20,0,0,0,0,0,0,0,0,0,36,0,350,0,14,0,0,0,22,0,386,0,0,0,0,0,0,0,5,2,0,14
Crawford,4/13/20,0,0,0,0,0,0,0,0,0,4,0,60,0,2,0,0,0,2,0,64,0,0,0,0,0,0,0,1,1,0,5
Crittenden,4/13/20,0,0,0,0,0,0,0,0,0,103,0,555,0,14,0,2,0,87,0,658,0,0,0,0,0,0,0,10,1,0,28
Cross,4/13/20,0,0,0,0,0,0,0,0,0,7,0,51,0,3,0,0,0,4,0,58,0,0,0,0,0,0,0,1,1,0,3
Dallas,4/13/20,0,0,0,0,0,0,0,0,0,1,0,18,0,1,0,0,0,0,0,19,0,0,0,0,0,0,0,0,0,0,1
Desha,4/13/20,0,0,0,0,0,0,0,0,0,6,0,54,0,1,0,0,0,5,0,60,0,0,0,0,0,0,0,0,1,0,2
Drew,4/13/20,0,0,0,0,0,0,0,0,0,6,0,80,0,1,0,1,0,4,0,86,0,0,0,0,0,0,0,0,0,0,7
Faulkner,4/13/20,0,0,0,0,0,0,0,0,0,57,0,747,0,25,0,2,0,30,0,804,0,0,0,0,0,0,0,-2,1,1,14
Franklin,4/13/20,0,0,0,0,0,0,0,0,0,1,0,37,0,0,0,0,0,1,0,38,0,0,0,0,0,0,0,0,0,0,0
Fulton,4/13/20,0,0,0,0,0,0,0,0,0,0,0,21,0,0,0,0,0,0,0,21,0,0,0,0,0,0,0,0,0,0,0
Garland,4/13/20,0,0,0,0,0,0,0,0,0,101,0,1132,0,28,0,0,0,73,0,1233,0,0,0,0,0,0,0,20,3,0,56
Grant,4/13/20,0,0,0,0,0,0,0,0,0,10,0,75,0,4,0,0,0,6,0,85,0,0,0,0,0,0,0,0,0,0,3
Greene,4/13/20,0,0,0,0,0,0,0,0,0,6,0,334,0,3,0,0,0,3,0,340,0,0,0,0,0,0,0,0,0,0,3
Hempstead,4/13/20,0,0,0,0,0,0,0,0,0,5,0,28,0,2,0,1,0,2,0,33,0,0,0,0,0,0,0,0,0,0,1
HotSpring,4/13/20,0,0,0,0,0,0,0,0,0,8,0,131,0,0,0,0,0,8,0,139,0,0,0,0,0,0,0,0,0,0,6
Howard,4/13/20,0,0,0,0,0,0,0,0,0,9,0,36,0,3,0,0,0,6,0,45,0,0,0,0,0,0,0,1,1,0,1
Independence,4/13/20,0,0,0,0,0,0,0,0,0,6,0,65,0,4,0,0,0,2,0,71,0,0,0,0,0,0,0,1,0,0,2
Izard,4/13/20,0,0,0,0,0,0,0,0,0,2,0,26,0,1,0,0,0,1,0,28,0,0,0,0,0,0,0,1,0,0,2
Jackson,4/13/20,0,0,0,0,0,0,0,0,0,0,0,29,0,0,0,0,0,0,0,29,0,0,0,0,0,0,0,0,0,0,0
Jefferson,4/13/20,0,0,0,0,0,0,0,0,0,100,0,706,0,18,0,4,0,78,0,806,0,0,0,0,0,0,0,5,0,1,39
Johnson,4/13/20,0,0,0,0,0,0,0,0,0,13,0,64,0,5,0,0,0,8,0,77,0,0,0,0,0,0,0,0,0,0,1
Lafayette,4/13/20,0,0,0,0,0,0,0,0,0,3,0,8,0,1,0,0,0,2,0,11,0,0,0,0,0,0,0,1,0,0,1
Lawrence,4/13/20,0,0,0,0,0,0,0,0,0,11,0,106,0,0,0,1,0,10,0,117,0,0,0,0,0,0,0,0,0,0,0
Lee,4/13/20,0,0,0,0,0,0,0,0,0,2,0,29,0,0,0,0,0,2,0,31,0,0,0,0,0,0,0,0,0,0,0
Lincoln,4/13/20,0,0,0,0,0,0,0,0,0,56,0,72,0,3,0,0,0,53,0,128,0,0,0,0,0,0,0,45,0,0,48
LittleRiver,4/13/20,0,0,0,0,0,0,0,0,0,0,0,29,0,0,0,0,0,0,0,29,0,0,0,0,0,0,0,0,0,0,4
Logan,4/13/20,0,0,0,0,0,0,0,0,0,2,0,33,0,0,0,0,0,2,0,35,0,0,0,0,0,0,0,0,0,0,0
Lonoke,4/13/20,0,0,0,0,0,0,0,0,0,29,0,256,0,7,0,0,0,22,0,285,0,0,0,0,0,0,0,-1,1,0,7
Madison,4/13/20,0,0,0,0,0,0,0,0,0,1,0,53,0,0,0,0,0,1,0,54,0,0,0,0,0,0,0,0,0,0,5
Marion,4/13/20,0,0,0,0,0,0,0,0,0,1,0,35,0,0,0,0,0,1,0,36,0,0,0,0,0,0,0,0,0,0,1
Miller,4/13/20,0,0,0,0,0,0,0,0,0,24,0,123,0,4,0,0,0,20,0,147,0,0,0,0,0,0,0,2,1,0,8
MissingCountyInfo,4/13/20,0,0,0,0,0,0,0,0,0,36,0,6750,0,NA,0,NA,0,36,0,6786,0,0,0,0,0,0,0,11,NA,NA,416
Mississippi,4/13/20,0,0,0,0,0,0,0,0,0,7,0,47,0,4,0,0,0,3,0,54,0,0,0,0,0,0,0,0,0,0,2
Monroe,4/13/20,0,0,0,0,0,0,0,0,0,2,0,11,0,0,0,0,0,2,0,13,0,0,0,0,0,0,0,0,0,0,0
Montgomery,4/13/20,0,0,0,0,0,0,0,0,0,0,0,18,0,0,0,0,0,0,0,18,0,0,0,0,0,0,0,0,0,0,0
Nevada,4/13/20,0,0,0,0,0,0,0,0,0,1,0,20,0,1,0,0,0,0,0,21,0,0,0,0,0,0,0,0,0,0,2
Newton,4/13/20,0,0,0,0,0,0,0,0,0,1,0,65,0,1,0,0,0,0,0,66,0,0,0,0,0,0,0,0,0,0,3
Ouachita,4/13/20,0,0,0,0,0,0,0,0,0,5,0,148,0,4,0,0,0,1,0,153,0,0,0,0,0,0,0,0,0,0,9
Perry,4/13/20,0,0,0,0,0,0,0,0,0,2,0,48,0,2,0,0,0,0,0,50,0,0,0,0,0,0,0,0,0,0,2
Phillips,4/13/20,0,0,0,0,0,0,0,0,0,4,0,50,0,0,0,1,0,3,0,54,0,0,0,0,0,0,0,1,0,0,1
Pike,4/13/20,0,0,0,0,0,0,0,0,0,2,0,194,0,1,0,0,0,1,0,196,0,0,0,0,0,0,0,0,0,0,5
Poinsett,4/13/20,0,0,0,0,0,0,0,0,0,7,0,37,0,4,0,0,0,3,0,44,0,0,0,0,0,0,0,0,0,0,0
Polk,4/13/20,0,0,0,0,0,0,0,0,0,6,0,127,0,3,0,0,0,3,0,133,0,0,0,0,0,0,0,0,0,0,9
Pope,4/13/20,0,0,0,0,0,0,0,0,0,31,0,1047,0,5,0,0,0,26,0,1078,0,0,0,0,0,0,0,1,2,0,55
Prairie,4/13/20,0,0,0,0,0,0,0,0,0,2,0,18,0,1,0,0,0,1,0,20,0,0,0,0,0,0,0,0,0,0,1
Pulaski,4/13/20,0,0,0,0,0,0,0,0,0,273,0,1355,0,57,0,10,0,206,0,1628,0,0,0,0,0,0,0,17,7,1,86
Randolph,4/13/20,0,0,0,0,0,0,0,0,0,8,0,160,0,5,0,0,0,3,0,168,0,0,0,0,0,0,0,0,0,0,9
Saline,4/13/20,0,0,0,0,0,0,0,0,0,32,0,414,0,10,0,1,0,21,0,446,0,0,0,0,0,0,0,0,0,0,20
Scott,4/13/20,0,0,0,0,0,0,0,0,0,1,0,4,0,0,0,0,0,1,0,5,0,0,0,0,0,0,0,0,0,0,0
Searcy,4/13/20,0,0,0,0,0,0,0,0,0,6,0,82,0,1,0,0,0,5,0,88,0,0,0,0,0,0,0,0,0,0,3
Sebastian,4/13/20,0,0,0,0,0,0,0,0,0,11,0,82,0,5,0,0,0,6,0,93,0,0,0,0,0,0,0,1,0,0,8
Sevier,4/13/20,0,0,0,0,0,0,0,0,0,8,0,107,0,4,0,0,0,4,0,115,0,0,0,0,0,0,0,0,0,0,8
Sharp,4/13/20,0,0,0,0,0,0,0,0,0,2,0,20,0,0,0,0,0,2,0,22,0,0,0,0,0,0,0,0,0,0,0
St.Francis,4/13/20,0,0,0,0,0,0,0,0,0,34,0,129,0,1,0,0,0,33,0,163,0,0,0,0,0,0,0,2,0,0,6
Stone,4/13/20,0,0,0,0,0,0,0,0,0,7,0,52,0,5,0,0,0,2,0,59,0,0,0,0,0,0,0,0,0,0,4
Union,4/13/20,0,0,0,0,0,0,0,0,0,17,0,165,0,5,0,0,0,12,0,182,0,0,0,0,0,0,0,-1,1,0,2
VanBuren,4/13/20,0,0,0,0,0,0,0,0,0,26,0,188,0,11,0,2,0,13,0,214,0,0,0,0,0,0,0,0,1,0,20
Washington,4/13/20,0,0,0,0,0,0,0,0,0,43,0,374,0,23,0,0,0,20,0,417,0,0,0,0,0,0,0,6,0,0,21
White,4/13/20,0,0,0,0,0,0,0,0,0,28,0,244,0,11,0,0,0,17,0,272,0,0,0,0,0,0,0,0,0,0,6
Woodruff,4/13/20,0,0,0,0,0,0,0,0,0,1,0,8,0,0,0,0,0,1,0,9,0,0,0,0,0,0,0,0,0,0,0
Yell,4/13/20,0,0,0,0,0,0,0,0,0,1,0,90,0,0,0,0,0,1,0,91,0,0,0,0,0,0,0,0,0,0,3
Arkansas_all_counties,4/12/20,0,0,0,0,0,0,0,0,2990671,1280,0,18442,0,367,0,27,0,886,0,19722,0,0,0,0,0,0,0,54,27,3,1144
Arkansas_county,4/12/20,0,0,0,0,0,0,0,0,0,2,0,24,0,0,0,0,0,2,0,26,0,0,0,0,0,0,0,0,0,0,1
Ashley,4/12/20,0,0,0,0,0,0,0,0,0,10,0,154,0,0,0,0,0,10,0,164,0,0,0,0,0,0,0,0,0,0,2
Baxter,4/12/20,0,0,0,0,0,0,0,0,0,4,0,116,0,0,0,0,0,4,0,120,0,0,0,0,0,0,0,0,0,0,0
Benton,4/12/20,0,0,0,0,0,0,0,0,0,48,0,820,0,28,0,0,0,20,0,868,0,0,0,0,0,0,0,1,1,0,55
Boone,4/12/20,0,0,0,0,0,0,0,0,0,3,0,64,0,0,0,0,0,3,0,67,0,0,0,0,0,0,0,0,0,0,2
Bradley,4/12/20,0,0,0,0,0,0,0,0,0,7,0,77,0,0,0,0,0,7,0,84,0,0,0,0,0,0,0,1,0,0,5
Calhoun,4/12/20,0,0,0,0,0,0,0,0,0,0,0,12,0,0,0,0,0,0,0,12,0,0,0,0,0,0,0,0,0,0,1
Carroll,4/12/20,0,0,0,0,0,0,0,0,0,2,0,110,0,0,0,0,0,2,0,112,0,0,0,0,0,0,0,0,0,0,11
Chicot,4/12/20,0,0,0,0,0,0,0,0,0,5,0,21,0,0,0,0,0,5,0,26,0,0,0,0,0,0,0,0,0,0,0
Clark,4/12/20,0,0,0,0,0,0,0,0,0,27,0,46,0,12,0,0,0,15,0,73,0,0,0,0,0,0,0,0,1,0,4
Clay,4/12/20,0,0,0,0,0,0,0,0,0,1,0,63,0,0,0,0,0,1,0,64,0,0,0,0,0,0,0,0,0,0,10
Cleburne,4/12/20,0,0,0,0,0,0,0,0,0,70,0,108,0,36,0,4,0,30,0,178,0,0,0,0,0,0,0,1,1,0,3
Cleveland,4/12/20,0,0,0,0,0,0,0,0,0,8,0,59,0,4,0,0,0,4,0,67,0,0,0,0,0,0,0,0,0,0,8
Columbia,4/12/20,0,0,0,0,0,0,0,0,0,3,0,50,0,1,0,0,0,2,0,53,0,0,0,0,0,0,0,0,0,0,1
Conway,4/12/20,0,0,0,0,0,0,0,0,0,4,0,152,0,1,0,1,0,2,0,156,0,0,0,0,0,0,0,0,0,0,12
Craighead,4/12/20,0,0,0,0,0,0,0,0,0,31,0,341,0,12,0,0,0,19,0,372,0,0,0,0,0,0,0,0,0,0,30
Crawford,4/12/20,0,0,0,0,0,0,0,0,0,3,0,56,0,1,0,0,0,2,0,59,0,0,0,0,0,0,0,0,0,0,4
Crittenden,4/12/20,0,0,0,0,0,0,0,0,0,93,0,537,0,13,0,2,0,78,0,630,0,0,0,0,0,0,0,4,2,0,52
Cross,4/12/20,0,0,0,0,0,0,0,0,0,6,0,49,0,2,0,0,0,4,0,55,0,0,0,0,0,0,0,0,0,0,1
Dallas,4/12/20,0,0,0,0,0,0,0,0,0,1,0,17,0,1,0,0,0,0,0,18,0,0,0,0,0,0,0,0,0,0,0
Desha,4/12/20,0,0,0,0,0,0,0,0,0,6,0,52,0,0,0,0,0,6,0,58,0,0,0,0,0,0,0,0,0,0,2
Drew,4/12/20,0,0,0,0,0,0,0,0,0,6,0,73,0,1,0,1,0,4,0,79,0,0,0,0,0,0,0,0,0,0,2
Faulkner,4/12/20,0,0,0,0,0,0,0,0,0,59,0,731,0,24,0,1,0,34,0,790,0,0,0,0,0,0,0,2,0,0,32
Franklin,4/12/20,0,0,0,0,0,0,0,0,0,1,0,37,0,0,0,0,0,1,0,38,0,0,0,0,0,0,0,0,0,0,1
Fulton,4/12/20,0,0,0,0,0,0,0,0,0,0,0,21,0,0,0,0,0,0,0,21,0,0,0,0,0,0,0,0,0,0,2
Garland,4/12/20,0,0,0,0,0,0,0,0,0,81,0,1096,0,25,0,0,0,56,0,1177,0,0,0,0,0,0,0,9,3,0,119
Grant,4/12/20,0,0,0,0,0,0,0,0,0,10,0,72,0,4,0,0,0,6,0,82,0,0,0,0,0,0,0,1,0,0,7
Greene,4/12/20,0,0,0,0,0,0,0,0,0,6,0,331,0,3,0,0,0,3,0,337,0,0,0,0,0,0,0,0,0,0,16
Hempstead,4/12/20,0,0,0,0,0,0,0,0,0,5,0,27,0,2,0,1,0,2,0,32,0,0,0,0,0,0,0,1,0,0,2
HotSpring,4/12/20,0,0,0,0,0,0,0,0,0,8,0,125,0,NA,0,NA,0,8,0,133,0,0,0,0,0,0,0,0,NA,NA,8
Howard,4/12/20,0,0,0,0,0,0,0,0,0,8,0,36,0,2,0,0,0,6,0,44,0,0,0,0,0,0,0,2,0,0,6
Independence,4/12/20,0,0,0,0,0,0,0,0,0,5,0,64,0,4,0,0,0,1,0,69,0,0,0,0,0,0,0,0,0,0,3
Izard,4/12/20,0,0,0,0,0,0,0,0,0,1,0,25,0,1,0,0,0,0,0,26,0,0,0,0,0,0,0,0,0,0,1
Jackson,4/12/20,0,0,0,0,0,0,0,0,0,0,0,29,0,0,0,0,0,0,0,29,0,0,0,0,0,0,0,0,0,0,3
Jefferson,4/12/20,0,0,0,0,0,0,0,0,0,95,0,672,0,18,0,3,0,74,0,767,0,0,0,0,0,0,0,4,2,1,24
Johnson,4/12/20,0,0,0,0,0,0,0,0,0,13,0,63,0,5,0,0,0,8,0,76,0,0,0,0,0,0,0,0,0,0,6
Lafayette,4/12/20,0,0,0,0,0,0,0,0,0,2,0,8,0,1,0,0,0,1,0,10,0,0,0,0,0,0,0,0,0,0,0
Lawrence,4/12/20,0,0,0,0,0,0,0,0,0,11,0,106,0,0,0,1,0,10,0,117,0,0,0,0,0,0,0,1,0,0,4
Lee,4/12/20,0,0,0,0,0,0,0,0,0,2,0,29,0,0,0,0,0,2,0,31,0,0,0,0,0,0,0,0,0,0,1
Lincoln,4/12/20,0,0,0,0,0,0,0,0,0,11,0,69,0,3,0,0,0,8,0,80,0,0,0,0,0,0,0,1,0,0,5
LittleRiver,4/12/20,0,0,0,0,0,0,0,0,0,0,0,25,0,0,0,0,0,0,0,25,0,0,0,0,0,0,0,0,0,0,2
Logan,4/12/20,0,0,0,0,0,0,0,0,0,2,0,33,0,0,0,0,0,2,0,35,0,0,0,0,0,0,0,0,0,0,2
Lonoke,4/12/20,0,0,0,0,0,0,0,0,0,30,0,248,0,6,0,0,0,24,0,278,0,0,0,0,0,0,0,3,1,0,12
Madison,4/12/20,0,0,0,0,0,0,0,0,0,1,0,48,0,0,0,0,0,1,0,49,0,0,0,0,0,0,0,0,0,0,1
Marion,4/12/20,0,0,0,0,0,0,0,0,0,1,0,34,0,0,0,0,0,1,0,35,0,0,0,0,0,0,0,0,0,0,0
Miller,4/12/20,0,0,0,0,0,0,0,0,0,22,0,117,0,3,0,0,0,19,0,139,0,0,0,0,0,0,0,0,0,0,13
MissingCountyInfo,4/12/20,0,0,0,0,0,0,0,0,0,25,0,6345,0,NA,0,NA,0,25,0,6370,0,0,0,0,0,0,0,6,NA,NA,303
Mississippi,4/12/20,0,0,0,0,0,0,0,0,0,7,0,45,0,4,0,0,0,3,0,52,0,0,0,0,0,0,0,0,0,0,4
Monroe,4/12/20,0,0,0,0,0,0,0,0,0,2,0,11,0,0,0,0,0,2,0,13,0,0,0,0,0,0,0,1,0,0,2
Montgomery,4/12/20,0,0,0,0,0,0,0,0,0,0,0,18,0,0,0,0,0,0,0,18,0,0,0,0,0,0,0,0,0,0,0
Nevada,4/12/20,0,0,0,0,0,0,0,0,0,1,0,18,0,1,0,0,0,0,0,19,0,0,0,0,0,0,0,0,0,0,1
Newton,4/12/20,0,0,0,0,0,0,0,0,0,1,0,62,0,1,0,0,0,0,0,63,0,0,0,0,0,0,0,0,0,0,1
Ouachita,4/12/20,0,0,0,0,0,0,0,0,0,5,0,139,0,4,0,0,0,1,0,144,0,0,0,0,0,0,0,0,1,0,3
Perry,4/12/20,0,0,0,0,0,0,0,0,0,2,0,46,0,2,0,0,0,0,0,48,0,0,0,0,0,0,0,0,0,0,3
Phillips,4/12/20,0,0,0,0,0,0,0,0,0,3,0,50,0,0,0,1,0,2,0,53,0,0,0,0,0,0,0,0,0,1,7
Pike,4/12/20,0,0,0,0,0,0,0,0,0,2,0,189,0,1,0,0,0,1,0,191,0,0,0,0,0,0,0,0,0,0,15
Poinsette,4/12/20,0,0,0,0,0,0,0,0,0,7,0,37,0,4,0,0,0,3,0,44,0,0,0,0,0,0,0,0,0,0,4
Polk,4/12/20,0,0,0,0,0,0,0,0,0,6,0,118,0,3,0,0,0,3,0,124,0,0,0,0,0,0,0,0,0,0,15
Pope,4/12/20,0,0,0,0,0,0,0,0,0,30,0,993,0,3,0,0,0,27,0,1023,0,0,0,0,0,0,0,4,0,0,87
Prairie,4/12/20,0,0,0,0,0,0,0,0,0,2,0,17,0,1,0,0,0,1,0,19,0,0,0,0,0,0,0,0,0,0,0
Pulaski,4/12/20,0,0,0,0,0,0,0,0,0,256,0,1286,0,50,0,9,0,197,0,1542,0,0,0,0,0,0,0,7,4,0,59
Randolph,4/12/20,0,0,0,0,0,0,0,0,0,8,0,151,0,5,0,0,0,3,0,159,0,0,0,0,0,0,0,0,0,0,6
Saline,4/12/20,0,0,0,0,0,0,0,0,0,32,0,394,0,10,0,1,0,21,0,426,0,0,0,0,0,0,0,0,0,0,18
Scott,4/12/20,0,0,0,0,0,0,0,0,0,1,0,4,0,0,0,0,0,1,0,5,0,0,0,0,0,0,0,0,0,0,0
Searcy,4/12/20,0,0,0,0,0,0,0,0,0,6,0,79,0,1,0,0,0,5,0,85,0,0,0,0,0,0,0,0,0,0,8
Sebastian,4/12/20,0,0,0,0,0,0,0,0,0,10,0,75,0,5,0,0,0,5,0,85,0,0,0,0,0,0,0,0,0,0,2
Sevier,4/12/20,0,0,0,0,0,0,0,0,0,8,0,99,0,4,0,0,0,4,0,107,0,0,0,0,0,0,0,2,0,0,12
Sharp,4/12/20,0,0,0,0,0,0,0,0,0,2,0,20,0,0,0,0,0,2,0,22,0,0,0,0,0,0,0,0,0,0,0
St.Francis,4/12/20,0,0,0,0,0,0,0,0,0,32,0,125,0,1,0,0,0,31,0,157,0,0,0,0,0,0,0,1,0,0,3
Stone,4/12/20,0,0,0,0,0,0,0,0,0,7,0,48,0,5,0,0,0,2,0,55,0,0,0,0,0,0,0,0,1,0,0
Union,4/12/20,0,0,0,0,0,0,0,0,0,18,0,162,0,4,0,0,0,14,0,180,0,0,0,0,0,0,0,0,0,0,3
VanBuren,4/12/20,0,0,0,0,0,0,0,0,0,26,0,168,0,10,0,2,0,14,0,194,0,0,0,0,0,0,0,0,0,0,29
Washington,4/12/20,0,0,0,0,0,0,0,0,0,37,0,359,0,23,0,0,0,14,0,396,0,0,0,0,0,0,0,0,4,0,19
White,4/12/20,0,0,0,0,0,0,0,0,0,28,0,238,0,11,0,0,0,17,0,266,0,0,0,0,0,0,0,0,0,0,15
Woodruff,4/12/20,0,0,0,0,0,0,0,0,0,1,0,8,0,0,0,0,0,1,0,9,0,0,0,0,0,0,0,0,0,0,1
Yell,4/12/20,0,0,0,0,0,0,0,0,0,1,0,87,0,0,0,0,0,1,0,88,0,0,0,0,0,0,0,0,0,0,7
Arkansas_all_counties,4/11/20,0,0,0,0,0,0,0,0,2990671,1226,0,17352,0,340,0,25,0,861,0,18578,0,0,0,0,0,0,0,55,28,1,1427
Arkansas_county,4/11/20,0,0,0,0,0,0,0,0,0,2,0,23,0,0,0,0,0,2,0,25,0,0,0,0,0,0,0,0,0,0,0
Ashley,4/11/20,0,0,0,0,0,0,0,0,0,10,0,152,0,0,0,0,0,10,0,162,0,0,0,0,0,0,0,0,0,0,14
Baxter,4/11/20,0,0,0,0,0,0,0,0,0,4,0,116,0,0,0,0,0,4,0,120,0,0,0,0,0,0,0,0,0,0,9
Benton,4/11/20,0,0,0,0,0,0,0,0,0,47,0,766,0,27,0,0,0,20,0,813,0,0,0,0,0,0,0,0,2,0,29
Boone,4/11/20,0,0,0,0,0,0,0,0,0,3,0,62,0,0,0,0,0,3,0,65,0,0,0,0,0,0,0,0,0,0,3
Bradley,4/11/20,0,0,0,0,0,0,0,0,0,6,0,73,0,0,0,0,0,6,0,79,0,0,0,0,0,0,0,0,0,0,2
Calhoun,4/11/20,0,0,0,0,0,0,0,0,0,0,0,11,0,0,0,0,0,0,0,11,0,0,0,0,0,0,0,0,0,0,2
Carroll,4/11/20,0,0,0,0,0,0,0,0,0,2,0,99,0,0,0,0,0,2,0,101,0,0,0,0,0,0,0,0,0,0,13
Chicot,4/11/20,0,0,0,0,0,0,0,0,0,5,0,21,0,0,0,0,0,5,0,26,0,0,0,0,0,0,0,0,0,0,1
Clark,4/11/20,0,0,0,0,0,0,0,0,0,27,0,42,0,11,0,0,0,16,0,69,0,0,0,0,0,0,0,0,2,0,6
Clay,4/11/20,0,0,0,0,0,0,0,0,0,1,0,53,0,0,0,0,0,1,0,54,0,0,0,0,0,0,0,0,0,0,6
Cleburne,4/11/20,0,0,0,0,0,0,0,0,0,69,0,106,0,35,0,4,0,30,0,175,0,0,0,0,0,0,0,0,1,0,6
Cleveland,4/11/20,0,0,0,0,0,0,0,0,0,8,0,51,0,4,0,0,0,4,0,59,0,0,0,0,0,0,0,0,0,0,3
Columbia,4/11/20,0,0,0,0,0,0,0,0,0,3,0,49,0,1,0,0,0,2,0,52,0,0,0,0,0,0,0,0,0,0,2
Conway,4/11/20,0,0,0,0,0,0,0,0,0,4,0,140,0,1,0,1,0,2,0,144,0,0,0,0,0,0,0,0,0,0,10
Craighead,4/11/20,0,0,0,0,0,0,0,0,0,31,0,311,0,12,0,0,0,19,0,342,0,0,0,0,0,0,0,0,0,0,36
Crawford,4/11/20,0,0,0,0,0,0,0,0,0,3,0,52,0,1,0,0,0,2,0,55,0,0,0,0,0,0,0,0,0,0,0
Crittenden,4/11/20,0,0,0,0,0,0,0,0,0,89,0,489,0,11,0,2,0,76,0,578,0,0,0,0,0,0,0,0,0,0,29
Cross,4/11/20,0,0,0,0,0,0,0,0,0,6,0,48,0,2,0,0,0,4,0,54,0,0,0,0,0,0,0,0,0,0,3
Dallas,4/11/20,0,0,0,0,0,0,0,0,0,1,0,17,0,1,0,0,0,0,0,18,0,0,0,0,0,0,0,0,0,0,0
Desha,4/11/20,0,0,0,0,0,0,0,0,0,6,0,50,0,0,0,0,0,6,0,56,0,0,0,0,0,0,0,0,0,0,1
Drew,4/11/20,0,0,0,0,0,0,0,0,0,6,0,71,0,1,0,1,0,4,0,77,0,0,0,0,0,0,0,0,0,0,3
Faulkner,4/11/20,0,0,0,0,0,0,0,0,0,57,0,701,0,24,0,1,0,32,0,758,0,0,0,0,0,0,0,0,1,0,26
Franklin,4/11/20,0,0,0,0,0,0,0,0,0,1,0,36,0,0,0,0,0,1,0,37,0,0,0,0,0,0,0,0,0,0,0
Fulton,4/11/20,0,0,0,0,0,0,0,0,0,0,0,19,0,0,0,0,0,0,0,19,0,0,0,0,0,0,0,0,0,0,2
Garland,4/11/20,0,0,0,0,0,0,0,0,0,72,0,986,0,22,0,0,0,50,0,1058,0,0,0,0,0,0,0,3,3,0,128
Grant,4/11/20,0,0,0,0,0,0,0,0,0,9,0,66,0,4,0,0,0,5,0,75,0,0,0,0,0,0,0,0,0,0,9
Greene,4/11/20,0,0,0,0,0,0,0,0,0,6,0,315,0,3,0,0,0,3,0,321,0,0,0,0,0,0,0,0,0,0,22
Hempstead,4/11/20,0,0,0,0,0,0,0,0,0,4,0,26,0,2,0,1,0,1,0,30,0,0,0,0,0,0,0,1,0,0,1
HotSpring,4/11/20,0,0,0,0,0,0,0,0,0,8,0,117,0,NA,0,NA,0,8,0,125,0,0,0,0,0,0,0,0,NA,NA,21
Howard,4/11/20,0,0,0,0,0,0,0,0,0,6,0,32,0,2,0,0,0,4,0,38,0,0,0,0,0,0,0,0,0,0,6
Independence,4/11/20,0,0,0,0,0,0,0,0,0,5,0,61,0,4,0,0,0,1,0,66,0,0,0,0,0,0,0,0,0,0,0
Izard,4/11/20,0,0,0,0,0,0,0,0,0,1,0,24,0,1,0,0,0,0,0,25,0,0,0,0,0,0,0,0,0,0,3
Jackson,4/11/20,0,0,0,0,0,0,0,0,0,0,0,26,0,0,0,0,0,0,0,26,0,0,0,0,0,0,0,0,0,0,1
Jefferson,4/11/20,0,0,0,0,0,0,0,0,0,91,0,652,0,16,0,2,0,73,0,743,0,0,0,0,0,0,0,1,2,0,39
Johnson,4/11/20,0,0,0,0,0,0,0,0,0,13,0,57,0,5,0,0,0,8,0,70,0,0,0,0,0,0,0,0,0,0,3
Lafayette,4/11/20,0,0,0,0,0,0,0,0,0,2,0,8,0,1,0,0,0,1,0,10,0,0,0,0,0,0,0,0,0,0,1
Lawrence,4/11/20,0,0,0,0,0,0,0,0,0,10,0,103,0,0,0,1,0,9,0,113,0,0,0,0,0,0,0,0,0,0,5
Lee,4/11/20,0,0,0,0,0,0,0,0,0,2,0,28,0,0,0,0,0,2,0,30,0,0,0,0,0,0,0,0,0,0,1
Lincoln,4/11/20,0,0,0,0,0,0,0,0,0,10,0,65,0,3,0,0,0,7,0,75,0,0,0,0,0,0,0,0,0,0,7
LittleRiver,4/11/20,0,0,0,0,0,0,0,0,0,0,0,23,0,0,0,0,0,0,0,23,0,0,0,0,0,0,0,0,0,0,1
Logan,4/11/20,0,0,0,0,0,0,0,0,0,2,0,31,0,0,0,0,0,2,0,33,0,0,0,0,0,0,0,0,0,0,5
Lonoke,4/11/20,0,0,0,0,0,0,0,0,0,27,0,239,0,5,0,0,0,22,0,266,0,0,0,0,0,0,0,0,1,0,13
Madison,4/11/20,0,0,0,0,0,0,0,0,0,1,0,47,0,0,0,0,0,1,0,48,0,0,0,0,0,0,0,0,0,0,0
Marion,4/11/20,0,0,0,0,0,0,0,0,0,1,0,34,0,0,0,0,0,1,0,35,0,0,0,0,0,0,0,0,0,0,3
Miller,4/11/20,0,0,0,0,0,0,0,0,0,22,0,104,0,3,0,0,0,19,0,126,0,0,0,0,0,0,0,2,0,0,33
MissingCountyInfo,4/11/20,0,0,0,0,0,0,0,0,0,19,0,6048,0,NA,0,NA,0,19,0,6067,0,0,0,0,0,0,0,3,NA,NA,522
Mississippi,4/11/20,0,0,0,0,0,0,0,0,0,7,0,41,0,4,0,0,0,3,0,48,0,0,0,0,0,0,0,0,0,0,7
Monroe,4/11/20,0,0,0,0,0,0,0,0,0,1,0,10,0,0,0,0,0,1,0,11,0,0,0,0,0,0,0,0,0,0,2
Montgomery,4/11/20,0,0,0,0,0,0,0,0,0,0,0,18,0,0,0,0,0,0,0,18,0,0,0,0,0,0,0,0,0,0,3
Nevada,4/11/20,0,0,0,0,0,0,0,0,0,1,0,17,0,1,0,0,0,0,0,18,0,0,0,0,0,0,0,0,0,0,2
Newton,4/11/20,0,0,0,0,0,0,0,0,0,1,0,61,0,1,0,0,0,0,0,62,0,0,0,0,0,0,0,0,0,0,1
Ouachita,4/11/20,0,0,0,0,0,0,0,0,0,5,0,136,0,3,0,0,0,2,0,141,0,0,0,0,0,0,0,0,0,0,12
Perry,4/11/20,0,0,0,0,0,0,0,0,0,2,0,43,0,2,0,0,0,0,0,45,0,0,0,0,0,0,0,0,0,0,3
Phillips,4/11/20,0,0,0,0,0,0,0,0,0,3,0,43,0,0,0,0,0,3,0,46,0,0,0,0,0,0,0,0,0,0,1
Pike,4/11/20,0,0,0,0,0,0,0,0,0,2,0,174,0,1,0,0,0,1,0,176,0,0,0,0,0,0,0,0,0,0,16
Poinsette,4/11/20,0,0,0,0,0,0,0,0,0,7,0,33,0,4,0,0,0,3,0,40,0,0,0,0,0,0,0,0,0,0,4
Polk,4/11/20,0,0,0,0,0,0,0,0,0,6,0,103,0,3,0,0,0,3,0,109,0,0,0,0,0,0,0,0,0,0,13
Pope,4/11/20,0,0,0,0,0,0,0,0,0,26,0,910,0,3,0,0,0,23,0,936,0,0,0,0,0,0,0,0,1,0,60
Prairie,4/11/20,0,0,0,0,0,0,0,0,0,2,0,17,0,1,0,0,0,1,0,19,0,0,0,0,0,0,0,0,0,0,0
Pulaski,4/11/20,0,0,0,0,0,0,0,0,0,249,0,1234,0,46,0,9,0,194,0,1483,0,0,0,0,0,0,0,13,1,1,144
Randolph,4/11/20,0,0,0,0,0,0,0,0,0,8,0,145,0,5,0,0,0,3,0,153,0,0,0,0,0,0,0,0,1,0,11
Saline,4/11/20,0,0,0,0,0,0,0,0,0,32,0,376,0,10,0,1,0,21,0,408,0,0,0,0,0,0,0,0,0,0,28
Scott,4/11/20,0,0,0,0,0,0,0,0,0,1,0,4,0,0,0,0,0,1,0,5,0,0,0,0,0,0,0,0,0,0,0
Searcy,4/11/20,0,0,0,0,0,0,0,0,0,6,0,71,0,1,0,0,0,5,0,77,0,0,0,0,0,0,0,0,0,0,4
Sebastian,4/11/20,0,0,0,0,0,0,0,0,0,10,0,73,0,5,0,0,0,5,0,83,0,0,0,0,0,0,0,1,0,0,2
Sevier,4/11/20,0,0,0,0,0,0,0,0,0,6,0,89,0,4,0,0,0,2,0,95,0,0,0,0,0,0,0,0,0,0,15
Sharp,4/11/20,0,0,0,0,0,0,0,0,0,2,0,20,0,0,0,0,0,2,0,22,0,0,0,0,0,0,0,0,0,0,1
St.Francis,4/11/20,0,0,0,0,0,0,0,0,0,31,0,123,0,1,0,0,0,30,0,154,0,0,0,0,0,0,0,0,0,0,8
Stone,4/11/20,0,0,0,0,0,0,0,0,0,7,0,48,0,4,0,0,0,3,0,55,0,0,0,0,0,0,0,0,0,0,5
Union,4/11/20,0,0,0,0,0,0,0,0,0,18,0,159,0,4,0,0,0,14,0,177,0,0,0,0,0,0,0,1,0,0,14
VanBuren,4/11/20,0,0,0,0,0,0,0,0,0,26,0,139,0,10,0,2,0,14,0,165,0,0,0,0,0,0,0,0,0,0,40
Washington,4/11/20,0,0,0,0,0,0,0,0,0,37,0,340,0,19,0,0,0,18,0,377,0,0,0,0,0,0,0,0,1,0,21
White,4/11/20,0,0,0,0,0,0,0,0,0,28,0,223,0,11,0,0,0,17,0,251,0,0,0,0,0,0,0,0,0,0,6
Woodruff,4/11/20,0,0,0,0,0,0,0,0,0,1,0,7,0,0,0,0,0,1,0,8,0,0,0,0,0,0,0,0,0,0,0
Yell,4/11/20,0,0,0,0,0,0,0,0,0,1,0,80,0,0,0,0,0,1,0,81,0,0,0,0,0,0,0,0,0,0,11
Arkansas_all_counties,4/10/20,0,0,0,0,0,0,0,0,2990671,1171,0,15949,0,312,0,24,0,835,0,17120,0,0,0,0,0,0,0,77,59,3,2225
Arkansas_county,4/10/20,0,0,0,0,0,0,0,0,0,2,0,23,0,0,0,0,0,2,0,25,0,0,0,0,0,0,0,0,0,0,1
Ashley,4/10/20,0,0,0,0,0,0,0,0,0,9,0,139,0,0,0,0,0,9,0,148,0,0,0,0,0,0,0,1,0,0,14
Baxter,4/10/20,0,0,0,0,0,0,0,0,0,4,0,107,0,0,0,0,0,4,0,111,0,0,0,0,0,0,0,0,0,0,20
Benton,4/10/20,0,0,0,0,0,0,0,0,0,47,0,737,0,25,0,0,0,22,0,784,0,0,0,0,0,0,0,0,1,0,51
Boone,4/10/20,0,0,0,0,0,0,0,0,0,3,0,59,0,0,0,0,0,3,0,62,0,0,0,0,0,0,0,0,0,0,3
Bradley,4/10/20,0,0,0,0,0,0,0,0,0,6,0,71,0,0,0,0,0,6,0,77,0,0,0,0,0,0,0,0,0,0,12
Calhoun,4/10/20,0,0,0,0,0,0,0,0,0,0,0,9,0,0,0,0,0,0,0,9,0,0,0,0,0,0,0,0,0,0,0
Carroll,4/10/20,0,0,0,0,0,0,0,0,0,2,0,86,0,0,0,0,0,2,0,88,0,0,0,0,0,0,0,0,0,0,3
Chicot,4/10/20,0,0,0,0,0,0,0,0,0,5,0,20,0,0,0,0,0,5,0,25,0,0,0,0,0,0,0,0,0,0,3
Clark,4/10/20,0,0,0,0,0,0,0,0,0,27,0,36,0,9,0,0,0,18,0,63,0,0,0,0,0,0,0,0,0,0,1
Clay,4/10/20,0,0,0,0,0,0,0,0,0,1,0,47,0,0,0,0,0,1,0,48,0,0,0,0,0,0,0,0,0,0,5
Cleburne,4/10/20,0,0,0,0,0,0,0,0,0,69,0,100,0,34,0,4,0,31,0,169,0,0,0,0,0,0,0,0,2,0,1
Cleveland,4/10/20,0,0,0,0,0,0,0,0,0,8,0,48,0,4,0,0,0,4,0,56,0,0,0,0,0,0,0,0,1,0,2
Columbia,4/10/20,0,0,0,0,0,0,0,0,0,3,0,47,0,1,0,0,0,2,0,50,0,0,0,0,0,0,0,0,0,0,4
Conway,4/10/20,0,0,0,0,0,0,0,0,0,4,0,130,0,1,0,1,0,2,0,134,0,0,0,0,0,0,0,0,0,0,5
Craighead,4/10/20,0,0,0,0,0,0,0,0,0,31,0,275,0,12,0,0,0,19,0,306,0,0,0,0,0,0,0,3,0,0,42
Crawford,4/10/20,0,0,0,0,0,0,0,0,0,3,0,52,0,1,0,0,0,2,0,55,0,0,0,0,0,0,0,0,0,0,13
Crittenden,4/10/20,0,0,0,0,0,0,0,0,0,89,0,460,0,11,0,2,0,76,0,549,0,0,0,0,0,0,0,12,3,0,72
Cross,4/10/20,0,0,0,0,0,0,0,0,0,6,0,45,0,2,0,0,0,4,0,51,0,0,0,0,0,0,0,0,0,0,8
Dallas,4/10/20,0,0,0,0,0,0,0,0,0,1,0,17,0,1,0,0,0,0,0,18,0,0,0,0,0,0,0,0,0,0,1
Desha,4/10/20,0,0,0,0,0,0,0,0,0,6,0,49,0,0,0,0,0,6,0,55,0,0,0,0,0,0,0,1,0,0,2
Drew,4/10/20,0,0,0,0,0,0,0,0,0,6,0,68,0,1,0,1,0,4,0,74,0,0,0,0,0,0,0,1,0,1,1
Faulkner,4/10/20,0,0,0,0,0,0,0,0,0,57,0,675,0,23,0,1,0,33,0,732,0,0,0,0,0,0,0,1,2,0,38
Franklin,4/10/20,0,0,0,0,0,0,0,0,0,1,0,36,0,0,0,0,0,1,0,37,0,0,0,0,0,0,0,0,0,0,2
Fulton,4/10/20,0,0,0,0,0,0,0,0,0,0,0,17,0,0,0,0,0,0,0,17,0,0,0,0,0,0,0,0,0,0,3
Garland,4/10/20,0,0,0,0,0,0,0,0,0,69,0,861,0,19,0,0,0,50,0,930,0,0,0,0,0,0,0,3,1,0,111
Grant,4/10/20,0,0,0,0,0,0,0,0,0,9,0,57,0,4,0,0,0,5,0,66,0,0,0,0,0,0,0,2,0,0,4
Greene,4/10/20,0,0,0,0,0,0,0,0,0,6,0,293,0,3,0,0,0,3,0,299,0,0,0,0,0,0,0,0,0,0,26
Hempstead,4/10/20,0,0,0,0,0,0,0,0,0,3,0,26,0,2,0,1,0,0,0,29,0,0,0,0,0,0,0,0,0,0,1
HotSpring,4/10/20,0,0,0,0,0,0,0,0,0,8,0,96,0,0,0,0,0,8,0,104,0,0,0,0,0,0,0,0,0,0,9
Howard,4/10/20,0,0,0,0,0,0,0,0,0,6,0,26,0,2,0,0,0,4,0,32,0,0,0,0,0,0,0,0,0,0,1
Independence,4/10/20,0,0,0,0,0,0,0,0,0,5,0,61,0,4,0,0,0,1,0,66,0,0,0,0,0,0,0,0,0,0,3
Izard,4/10/20,0,0,0,0,0,0,0,0,0,1,0,21,0,1,0,0,0,0,0,22,0,0,0,0,0,0,0,0,0,0,1
Jackson,4/10/20,0,0,0,0,0,0,0,0,0,0,0,25,0,0,0,0,0,0,0,25,0,0,0,0,0,0,0,0,0,0,4
Jefferson,4/10/20,0,0,0,0,0,0,0,0,0,90,0,614,0,14,0,2,0,74,0,704,0,0,0,0,0,0,0,-1,1,1,29
Johnson,4/10/20,0,0,0,0,0,0,0,0,0,13,0,54,0,5,0,0,0,8,0,67,0,0,0,0,0,0,0,2,1,0,6
Lafayette,4/10/20,0,0,0,0,0,0,0,0,0,2,0,7,0,1,0,0,0,1,0,9,0,0,0,0,0,0,0,0,0,0,1
Lawrence,4/10/20,0,0,0,0,0,0,0,0,0,10,0,98,0,0,0,1,0,9,0,108,0,0,0,0,0,0,0,1,-1,0,12
Lee,4/10/20,0,0,0,0,0,0,0,0,0,2,0,27,0,0,0,0,0,2,0,29,0,0,0,0,0,0,0,0,0,0,4
Lincoln,4/10/20,0,0,0,0,0,0,0,0,0,10,0,58,0,3,0,0,0,7,0,68,0,0,0,0,0,0,0,0,0,0,9
LittleRiver,4/10/20,0,0,0,0,0,0,0,0,0,0,0,22,0,0,0,0,0,0,0,22,0,0,0,0,0,0,0,0,0,0,1
Logan,4/10/20,0,0,0,0,0,0,0,0,0,2,0,26,0,0,0,0,0,2,0,28,0,0,0,0,0,0,0,1,0,0,5
Lonoke,4/10/20,0,0,0,0,0,0,0,0,0,27,0,226,0,4,0,0,0,23,0,253,0,0,0,0,0,0,0,1,0,0,18
Madison,4/10/20,0,0,0,0,0,0,0,0,0,1,0,47,0,0,0,0,0,1,0,48,0,0,0,0,0,0,0,0,0,0,6
Marion,4/10/20,0,0,0,0,0,0,0,0,0,1,0,31,0,0,0,0,0,1,0,32,0,0,0,0,0,0,0,1,0,0,6
Miller,4/10/20,0,0,0,0,0,0,0,0,0,20,0,73,0,3,0,0,0,17,0,93,0,0,0,0,0,0,0,0,1,0,10
MissingCountyInfo,4/10/20,0,0,0,0,0,0,0,0,0,16,0,5529,0,NA,0,NA,0,16,0,5545,0,0,0,0,0,0,0,2,NA,NA,527
Mississippi,4/10/20,0,0,0,0,0,0,0,0,0,7,0,34,0,4,0,0,0,3,0,41,0,0,0,0,0,0,0,1,1,0,5
Monroe,4/10/20,0,0,0,0,0,0,0,0,0,1,0,8,0,0,0,0,0,1,0,9,0,0,0,0,0,0,0,0,0,0,0
Montgomery,4/10/20,0,0,0,0,0,0,0,0,0,0,0,15,0,0,0,0,0,0,0,15,0,0,0,0,0,0,0,0,0,0,0
Nevada,4/10/20,0,0,0,0,0,0,0,0,0,1,0,15,0,1,0,0,0,0,0,16,0,0,0,0,0,0,0,0,0,0,0
Newton,4/10/20,0,0,0,0,0,0,0,0,0,1,0,60,0,1,0,0,0,0,0,61,0,0,0,0,0,0,0,0,0,0,3
Ouachita,4/10/20,0,0,0,0,0,0,0,0,0,5,0,124,0,3,0,0,0,2,0,129,0,0,0,0,0,0,0,0,0,0,18
Perry,4/10/20,0,0,0,0,0,0,0,0,0,2,0,40,0,2,0,0,0,0,0,42,0,0,0,0,0,0,0,0,0,0,3
Phillips,4/10/20,0,0,0,0,0,0,0,0,0,3,0,42,0,0,0,0,0,3,0,45,0,0,0,0,0,0,0,1,0,0,3
Pike,4/10/20,0,0,0,0,0,0,0,0,0,2,0,158,0,1,0,0,0,1,0,160,0,0,0,0,0,0,0,0,0,0,11
Poinsette,4/10/20,0,0,0,0,0,0,0,0,0,7,0,29,0,4,0,0,0,3,0,36,0,0,0,0,0,0,0,1,0,0,3
Polk,4/10/20,0,0,0,0,0,0,0,0,0,6,0,90,0,3,0,0,0,3,0,96,0,0,0,0,0,0,0,0,1,0,9
Pope,4/10/20,0,0,0,0,0,0,0,0,0,26,0,850,0,2,0,0,0,24,0,876,0,0,0,0,0,0,0,3,0,0,77
Prairie,4/10/20,0,0,0,0,0,0,0,0,0,2,0,17,0,1,0,0,0,1,0,19,0,0,0,0,0,0,0,0,0,0,2
Pulaski,4/10/20,0,0,0,0,0,0,0,0,0,236,0,1103,0,45,0,8,0,183,0,1339,0,0,0,0,0,0,0,15,3,0,76
Randolph,4/10/20,0,0,0,0,0,0,0,0,0,8,0,134,0,4,0,0,0,4,0,142,0,0,0,0,0,0,0,1,0,0,8
Saline,4/10/20,0,0,0,0,0,0,0,0,0,32,0,348,0,10,0,1,0,21,0,380,0,0,0,0,0,0,0,1,4,0,21
Scott,4/10/20,0,0,0,0,0,0,0,0,0,1,0,4,0,0,0,0,0,1,0,5,0,0,0,0,0,0,0,0,0,0,0
Searcy,4/10/20,0,0,0,0,0,0,0,0,0,6,0,67,0,1,0,0,0,5,0,73,0,0,0,0,0,0,0,0,0,0,4
Sebastian,4/10/20,0,0,0,0,0,0,0,0,0,9,0,72,0,5,0,0,0,4,0,81,0,0,0,0,0,0,0,0,0,0,1
Sevier,4/10/20,0,0,0,0,0,0,0,0,0,6,0,74,0,4,0,0,0,2,0,80,0,0,0,0,0,0,0,0,0,0,12
Sharp,4/10/20,0,0,0,0,0,0,0,0,0,2,0,19,0,0,0,0,0,2,0,21,0,0,0,0,0,0,0,0,0,0,4
St.Francis,4/10/20,0,0,0,0,0,0,0,0,0,31,0,115,0,1,0,0,0,30,0,146,0,0,0,0,0,0,0,0,0,0,9
Stone,4/10/20,0,0,0,0,0,0,0,0,0,7,0,43,0,4,0,0,0,3,0,50,0,0,0,0,0,0,0,0,2,0,3
Union,4/10/20,0,0,0,0,0,0,0,0,0,17,0,146,0,4,0,0,0,13,0,163,0,0,0,0,0,0,0,1,0,0,12
VanBuren,4/10/20,0,0,0,0,0,0,0,0,0,26,0,99,0,10,0,2,0,14,0,125,0,0,0,0,0,0,0,0,1,1,13
Washington,4/10/20,0,0,0,0,0,0,0,0,0,37,0,319,0,18,0,0,0,19,0,356,0,0,0,0,0,0,0,0,0,0,39
White,4/10/20,0,0,0,0,0,0,0,0,0,28,0,217,0,11,0,0,0,17,0,245,0,0,0,0,0,0,0,1,0,0,12
Woodruff,4/10/20,0,0,0,0,0,0,0,0,0,1,0,7,0,0,0,0,0,1,0,8,0,0,0,0,0,0,0,0,0,0,1
Yell,4/10/20,0,0,0,0,0,0,0,0,0,1,0,69,0,0,0,0,0,1,0,70,0,0,0,0,0,0,0,0,0,0,6
Arkansas_all_counties,4/9/20,0,0,0,0,0,0,0,0,2990671,1094,0,13832,0,253,0,21,0,820,0,14926,0,0,0,0,0,0,0,71,45,3,NA
Arkansas_county,4/9/20,0,0,0,0,0,0,0,0,0,2,0,22,0,1,0,0,0,1,0,24,0,0,0,0,0,0,0,1,1,0,NA
Ashley,4/9/20,0,0,0,0,0,0,0,0,0,8,0,126,0,0,0,0,0,8,0,134,0,0,0,0,0,0,0,0,0,0,NA
Baxter,4/9/20,0,0,0,0,0,0,0,0,0,4,0,87,0,0,0,0,0,4,0,91,0,0,0,0,0,0,0,0,0,0,NA
Benton,4/9/20,0,0,0,0,0,0,0,0,0,47,0,686,0,24,0,0,0,23,0,733,0,0,0,0,0,0,0,1,3,0,NA
Boone,4/9/20,0,0,0,0,0,0,0,0,0,3,0,56,0,0,0,0,0,3,0,59,0,0,0,0,0,0,0,0,0,0,NA
Bradley,4/9/20,0,0,0,0,0,0,0,0,0,6,0,59,0,0,0,0,0,6,0,65,0,0,0,0,0,0,0,1,0,0,NA
Calhoun,4/9/20,0,0,0,0,0,0,0,0,0,0,0,9,0,0,0,0,0,0,0,9,0,0,0,0,0,0,0,0,0,0,NA
Carroll,4/9/20,0,0,0,0,0,0,0,0,0,2,0,83,0,0,0,0,0,2,0,85,0,0,0,0,0,0,0,0,0,0,NA
Chicot,4/9/20,0,0,0,0,0,0,0,0,0,4,0,18,0,0,0,0,0,4,0,22,0,0,0,0,0,0,0,0,0,0,NA
Clark,4/9/20,0,0,0,0,0,0,0,0,0,27,0,35,0,9,0,0,0,18,0,62,0,0,0,0,0,0,0,0,0,0,NA
Clay,4/9/20,0,0,0,0,0,0,0,0,0,1,0,42,0,0,0,0,0,1,0,43,0,0,0,0,0,0,0,0,0,0,NA
Cleburne,4/9/20,0,0,0,0,0,0,0,0,0,69,0,99,0,32,0,4,0,33,0,168,0,0,0,0,0,0,0,-1,6,0,NA
Cleveland,4/9/20,0,0,0,0,0,0,0,0,0,8,0,46,0,3,0,0,0,5,0,54,0,0,0,0,0,0,0,0,2,0,NA
Columbia,4/9/20,0,0,0,0,0,0,0,0,0,3,0,43,0,1,0,0,0,2,0,46,0,0,0,0,0,0,0,0,0,0,NA
Conway,4/9/20,0,0,0,0,0,0,0,0,0,4,0,125,0,1,0,1,0,2,0,129,0,0,0,0,0,0,0,0,0,0,NA
Craighead,4/9/20,0,0,0,0,0,0,0,0,0,28,0,236,0,12,0,0,0,16,0,264,0,0,0,0,0,0,0,1,4,0,NA
Crawford,4/9/20,0,0,0,0,0,0,0,0,0,3,0,39,0,1,0,0,0,2,0,42,0,0,0,0,0,0,0,0,0,0,NA
Crittenden,4/9/20,0,0,0,0,0,0,0,0,0,77,0,400,0,8,0,2,0,67,0,477,0,0,0,0,0,0,0,12,1,1,NA
Cross,4/9/20,0,0,0,0,0,0,0,0,0,6,0,37,0,2,0,0,0,4,0,43,0,0,0,0,0,0,0,0,0,0,NA
Dallas,4/9/20,0,0,0,0,0,0,0,0,0,1,0,16,0,1,0,0,0,0,0,17,0,0,0,0,0,0,0,0,1,0,NA
Desha,4/9/20,0,0,0,0,0,0,0,0,0,5,0,48,0,0,0,0,0,5,0,53,0,0,0,0,0,0,0,0,0,0,NA
Drew,4/9/20,0,0,0,0,0,0,0,0,0,5,0,68,0,1,0,0,0,4,0,73,0,0,0,0,0,0,0,0,0,0,NA
Faulkner,4/9/20,0,0,0,0,0,0,0,0,0,56,0,638,0,21,0,1,0,34,0,694,0,0,0,0,0,0,0,1,2,0,NA
Franklin,4/9/20,0,0,0,0,0,0,0,0,0,1,0,34,0,0,0,0,0,1,0,35,0,0,0,0,0,0,0,0,0,0,NA
Fulton,4/9/20,0,0,0,0,0,0,0,0,0,0,0,14,0,0,0,0,0,0,0,14,0,0,0,0,0,0,0,0,0,0,NA
Garland,4/9/20,0,0,0,0,0,0,0,0,0,66,0,753,0,18,0,0,0,48,0,819,0,0,0,0,0,0,0,8,4,0,NA
Grant,4/9/20,0,0,0,0,0,0,0,0,0,7,0,55,0,4,0,0,0,3,0,62,0,0,0,0,0,0,0,0,1,0,NA
Greene,4/9/20,0,0,0,0,0,0,0,0,0,6,0,267,0,3,0,0,0,3,0,273,0,0,0,0,0,0,0,0,0,0,NA
Hempstead,4/9/20,0,0,0,0,0,0,0,0,0,3,0,25,0,2,0,1,0,0,0,28,0,0,0,0,0,0,0,0,0,1,NA
HotSpring,4/9/20,0,0,0,0,0,0,0,0,0,8,0,87,0,0,0,0,0,8,0,95,0,0,0,0,0,0,0,1,0,0,NA
Howard,4/9/20,0,0,0,0,0,0,0,0,0,6,0,25,0,2,0,0,0,4,0,31,0,0,0,0,0,0,0,1,0,0,NA
Independence,4/9/20,0,0,0,0,0,0,0,0,0,5,0,58,0,4,0,0,0,1,0,63,0,0,0,0,0,0,0,0,0,0,NA
Izard,4/9/20,0,0,0,0,0,0,0,0,0,1,0,20,0,1,0,0,0,0,0,21,0,0,0,0,0,0,0,0,1,0,NA
Jackson,4/9/20,0,0,0,0,0,0,0,0,0,0,0,21,0,0,0,0,0,0,0,21,0,0,0,0,0,0,0,0,0,0,NA
Jefferson,4/9/20,0,0,0,0,0,0,0,0,0,91,0,584,0,13,0,1,0,77,0,675,0,0,0,0,0,0,0,6,1,0,NA
Johnson,4/9/20,0,0,0,0,0,0,0,0,0,11,0,50,0,4,0,0,0,7,0,61,0,0,0,0,0,0,0,0,2,0,NA
Lafayette,4/9/20,0,0,0,0,0,0,0,0,0,2,0,6,0,1,0,0,0,1,0,8,0,0,0,0,0,0,0,0,1,0,NA
Lawrence,4/9/20,0,0,0,0,0,0,0,0,0,9,0,87,0,1,0,1,0,7,0,96,0,0,0,0,0,0,0,1,1,0,NA
Lee,4/9/20,0,0,0,0,0,0,0,0,0,2,0,23,0,0,0,0,0,2,0,25,0,0,0,0,0,0,0,0,0,0,NA
Lincoln,4/9/20,0,0,0,0,0,0,0,0,0,10,0,49,0,3,0,0,0,7,0,59,0,0,0,0,0,0,0,-1,3,0,NA
LittleRiver,4/9/20,0,0,0,0,0,0,0,0,0,0,0,21,0,0,0,0,0,0,0,21,0,0,0,0,0,0,0,0,0,0,NA
Logan,4/9/20,0,0,0,0,0,0,0,0,0,1,0,22,0,0,0,0,0,1,0,23,0,0,0,0,0,0,0,0,0,0,NA
Lonoke,4/9/20,0,0,0,0,0,0,0,0,0,26,0,209,0,4,0,0,0,22,0,235,0,0,0,0,0,0,0,2,2,0,NA
Madison,4/9/20,0,0,0,0,0,0,0,0,0,1,0,41,0,0,0,0,0,1,0,42,0,0,0,0,0,0,0,0,0,0,NA
Marion,4/9/20,0,0,0,0,0,0,0,0,0,0,0,26,0,0,0,0,0,0,0,26,0,0,0,0,0,0,0,0,0,0,NA
Miller,4/9/20,0,0,0,0,0,0,0,0,0,20,0,63,0,2,0,0,0,18,0,83,0,0,0,0,0,0,0,3,1,0,NA
MissingCountyInfo,4/9/20,0,0,0,0,0,0,0,0,0,14,0,5004,0,NA,0,NA,0,14,0,5018,0,0,0,0,0,0,0,1,NA,NA,NA
Mississippi,4/9/20,0,0,0,0,0,0,0,0,0,6,0,30,0,3,0,0,0,3,0,36,0,0,0,0,0,0,0,2,1,0,NA
Monroe,4/9/20,0,0,0,0,0,0,0,0,0,1,0,8,0,0,0,0,0,1,0,9,0,0,0,0,0,0,0,0,0,0,NA
Montgomery,4/9/20,0,0,0,0,0,0,0,0,0,0,0,15,0,0,0,0,0,0,0,15,0,0,0,0,0,0,0,0,0,0,NA
Nevada,4/9/20,0,0,0,0,0,0,0,0,0,1,0,15,0,1,0,0,0,0,0,16,0,0,0,0,0,0,0,0,0,0,NA
Newton,4/9/20,0,0,0,0,0,0,0,0,0,1,0,57,0,1,0,0,0,0,0,58,0,0,0,0,0,0,0,0,0,0,NA
Ouachita,4/9/20,0,0,0,0,0,0,0,0,0,5,0,106,0,3,0,0,0,2,0,111,0,0,0,0,0,0,0,0,1,0,NA
Perry,4/9/20,0,0,0,0,0,0,0,0,0,2,0,37,0,2,0,0,0,0,0,39,0,0,0,0,0,0,0,0,2,0,NA
Phillips,4/9/20,0,0,0,0,0,0,0,0,0,2,0,40,0,0,0,0,0,2,0,42,0,0,0,0,0,0,0,1,0,0,NA
Pike,4/9/20,0,0,0,0,0,0,0,0,0,2,0,147,0,1,0,0,0,1,0,149,0,0,0,0,0,0,0,0,0,0,NA
Poinsette,4/9/20,0,0,0,0,0,0,0,0,0,6,0,27,0,4,0,0,0,2,0,33,0,0,0,0,0,0,0,0,1,0,NA
Polk,4/9/20,0,0,0,0,0,0,0,0,0,6,0,81,0,2,0,0,0,4,0,87,0,0,0,0,0,0,0,0,0,0,NA
Pope,4/9/20,0,0,0,0,0,0,0,0,0,23,0,776,0,2,0,0,0,21,0,799,0,0,0,0,0,0,0,2,0,0,NA
Prairie,4/9/20,0,0,0,0,0,0,0,0,0,2,0,15,0,1,0,0,0,1,0,17,0,0,0,0,0,0,0,0,0,0,NA
Pulaski,4/9/20,0,0,0,0,0,0,0,0,0,221,0,1042,0,41,0,8,0,172,0,1263,0,0,0,0,0,0,0,20,13,1,NA
Randolph,4/9/20,0,0,0,0,0,0,0,0,0,7,0,127,0,4,0,0,0,3,0,134,0,0,0,0,0,0,0,1,3,0,NA
Saline,4/9/20,0,0,0,0,0,0,0,0,0,31,0,328,0,6,0,1,0,24,0,359,0,0,0,0,0,0,0,1,3,0,NA
Scott,4/9/20,0,0,0,0,0,0,0,0,0,1,0,4,0,0,0,0,0,1,0,5,0,0,0,0,0,0,0,0,0,0,NA
Searcy,4/9/20,0,0,0,0,0,0,0,0,0,6,0,63,0,1,0,0,0,5,0,69,0,0,0,0,0,0,0,0,0,0,NA
Sebastian,4/9/20,0,0,0,0,0,0,0,0,0,9,0,71,0,5,0,0,0,4,0,80,0,0,0,0,0,0,0,0,2,0,NA
Sevier,4/9/20,0,0,0,0,0,0,0,0,0,6,0,62,0,4,0,0,0,2,0,68,0,0,0,0,0,0,0,0,0,0,NA
Sharp,4/9/20,0,0,0,0,0,0,0,0,0,2,0,15,0,0,0,0,0,2,0,17,0,0,0,0,0,0,0,0,0,0,NA
St.Francis,4/9/20,0,0,0,0,0,0,0,0,0,31,0,106,0,1,0,0,0,30,0,137,0,0,0,0,0,0,0,0,0,0,NA
Stone,4/9/20,0,0,0,0,0,0,0,0,0,7,0,40,0,2,0,0,0,5,0,47,0,0,0,0,0,0,0,0,0,0,NA
Union,4/9/20,0,0,0,0,0,0,0,0,0,16,0,135,0,4,0,0,0,12,0,151,0,0,0,0,0,0,0,1,0,0,NA
VanBuren,4/9/20,0,0,0,0,0,0,0,0,0,26,0,86,0,9,0,1,0,16,0,112,0,0,0,0,0,0,0,1,1,0,NA
Washington,4/9/20,0,0,0,0,0,0,0,0,0,37,0,280,0,18,0,0,0,19,0,317,0,0,0,0,0,0,0,1,3,0,NA
White,4/9/20,0,0,0,0,0,0,0,0,0,27,0,206,0,11,0,0,0,16,0,233,0,0,0,0,0,0,0,0,1,0,NA
Woodruff,4/9/20,0,0,0,0,0,0,0,0,0,1,0,6,0,0,0,0,0,1,0,7,0,0,0,0,0,0,0,0,0,0,NA
Yell,4/9/20,0,0,0,0,0,0,0,0,0,1,0,63,0,0,0,0,0,1,0,64,0,0,0,0,0,0,0,0,0,0,NA
Arkansas_all_counties,4/8/20,0,0,0,0,0,0,0,0,2990671,1023,0,13833,0,208,0,18,0,797,0,14904,0,0,0,0,0,0,0,77,56,0,1213
Arkansas_all_counties,4/7/20,0,0,0,0,0,0,0,0,2990671,946,0,NA,0,NA,0,18,0,NA,0,NA,0,0,0,0,0,0,0,71,NA,NA,NA
Arkansas_all_counties,4/6/20,0,0,0,0,0,0,0,0,2990671,875,0,NA,0,NA,0,16,0,NA,0,NA,0,0,0,0,0,0,0,45,NA,NA,NA
Arkansas_all_counties,4/5/20,0,0,0,0,0,0,0,0,2990671,830,0,NA,0,NA,0,16,0,NA,0,NA,0,0,0,0,0,0,0,87,NA,NA,NA
Arkansas_all_counties,4/4/20,0,0,0,0,0,0,0,0,2990671,743,0,NA,0,NA,0,14,0,NA,0,NA,0,0,0,0,0,0,0,39,NA,NA,NA
Arkansas_all_counties,4/3/20,0,0,0,0,0,0,0,0,2990671,704,0,NA,0,NA,0,12,0,NA,0,NA,0,0,0,0,0,0,0,61,NA,NA,NA
Arkansas_all_counties,4/2/20,0,0,0,0,0,0,0,0,2990671,643,0,NA,0,NA,0,12,0,NA,0,NA,0,0,0,0,0,0,0,59,NA,NA,NA
Arkansas_all_counties,4/1/20,0,0,0,0,0,0,0,0,2990671,584,0,NA,0,NA,0,10,0,NA,0,NA,0,0,0,0,0,0,0,61,NA,NA,NA
Arkansas_all_counties,3/31/20,0,0,0,0,0,0,0,0,2990671,523,0,NA,0,NA,0,8,0,NA,0,NA,0,0,0,0,0,0,0,50,NA,NA,NA
Arkansas_all_counties,3/30/20,0,0,0,0,0,0,0,0,2990671,473,0,NA,0,NA,0,7,0,NA,0,NA,0,0,0,0,0,0,0,47,NA,NA,NA
Arkansas_all_counties,3/29/20,0,0,0,0,0,0,0,0,2990671,426,0,NA,0,NA,0,6,0,NA,0,NA,0,0,0,0,0,0,0,22,NA,NA,NA
Arkansas_all_counties,3/28/20,0,0,0,0,0,0,0,0,2990671,404,0,NA,0,NA,0,5,0,NA,0,NA,0,0,0,0,0,0,0,20,NA,NA,NA
Arkansas_all_counties,3/27/20,0,0,0,0,0,0,0,0,2990671,384,0,NA,0,NA,0,3,0,NA,0,NA,0,0,0,0,0,0,0,NA,NA,NA,NA
Arkansas_all_counties,3/26/20,0,0,0,0,0,0,0,0,2990671,335,0,NA,0,NA,0,3,0,NA,0,NA,0,0,0,0,0,0,0,NA,NA,NA,NA
Arkansas_all_counties,3/25/20,0,0,0,0,0,0,0,0,2990671,308,0,NA,0,NA,0,2,0,NA,0,NA,0,0,0,0,0,0,0,NA,NA,NA,NA
Arkansas_all_counties,3/24/20,0,0,0,0,0,0,0,0,2990671,232,0,NA,0,NA,0,2,0,NA,0,NA,0,0,0,0,0,0,0,NA,NA,NA,NA
Arkansas_all_counties,3/23/20,0,0,0,0,0,0,0,0,2990671,201,0,NA,0,NA,0,0,0,NA,0,NA,0,0,0,0,0,0,0,NA,NA,NA,NA